	#chrom	chromStart	chromEnd	peakLength	peakCenter	refSeqFuncElems_hg38_soTerm
0	chr1	10244	10510	266	133.0	
1	chr1	267824	268191	367	184.0	
2	chr1	629718	630174	456	228.0	
3	chr1	633792	634265	473	236.0	
4	chr1	778041	779715	1674	837.0	
5	chr1	817006	817681	675	338.0	
6	chr1	826704	827979	1275	638.0	
7	chr1	844208	844872	664	332.0	
8	chr1	857965	858684	719	360.0	
9	chr1	865653	865950	297	148.0	
10	chr1	869466	870392	926	463.0	
11	chr1	904102	905856	1754	877.0	
12	chr1	906657	907159	502	251.0	
13	chr1	920876	921491	615	308.0	
14	chr1	923066	926304	3238	1619.0	
15	chr1	935409	935805	396	198.0	
16	chr1	938301	938467	166	83.0	
17	chr1	939371	943431	4060	2030.0	
18	chr1	958623	961564	2941	1470.0	
19	chr1	965936	967493	1557	778.0	
20	chr1	975747	976662	915	458.0	
21	chr1	983770	984716	946	473.0	
22	chr1	989919	991912	1993	996.0	
23	chr1	993086	1002587	9501	4750.0	
24	chr1	1003304	1003658	354	177.0	
25	chr1	1004441	1005661	1220	610.0	
26	chr1	1009035	1009617	582	291.0	
27	chr1	1012748	1015792	3044	1522.0	
28	chr1	1018868	1023059	4191	2096.0	
29	chr1	1023841	1024751	910	455.0	
30	chr1	1032357	1034827	2470	1235.0	
31	chr1	1035752	1036194	442	221.0	
32	chr1	1038468	1043241	4773	2386.0	
33	chr1	1058631	1060325	1694	847.0	
34	chr1	1061810	1062469	659	330.0	
35	chr1	1063521	1064884	1363	682.0	
36	chr1	1066626	1067402	776	388.0	
37	chr1	1068032	1070929	2897	1448.0	enhancer
38	chr1	1079286	1080536	1250	625.0	
39	chr1	1098753	1100043	1290	645.0	
40	chr1	1115585	1117729	2144	1072.0	
41	chr1	1121702	1122913	1211	606.0	
42	chr1	1124316	1124672	356	178.0	
43	chr1	1136319	1138181	1862	931.0	
44	chr1	1143879	1144874	995	498.0	
45	chr1	1156537	1158833	2296	1148.0	
46	chr1	1165949	1166351	402	201.0	
47	chr1	1171476	1172501	1025	512.0	
48	chr1	1173498	1174277	779	390.0	
49	chr1	1189092	1189432	340	170.0	
50	chr1	1197800	1201988	4188	2094.0	
51	chr1	1203025	1203558	533	266.0	
52	chr1	1204194	1209503	5309	2654.0	
53	chr1	1210744	1210919	175	88.0	
54	chr1	1211846	1217587	5741	2870.0	
55	chr1	1219122	1219948	826	413.0	
56	chr1	1221855	1222470	615	308.0	
57	chr1	1230791	1233055	2264	1132.0	
58	chr1	1236101	1236282	181	90.0	
59	chr1	1238109	1238419	310	155.0	
60	chr1	1246495	1246970	475	238.0	
61	chr1	1250243	1251515	1272	636.0	
62	chr1	1259920	1261529	1609	804.0	
63	chr1	1272502	1274954	2452	1226.0	
64	chr1	1283834	1284075	241	120.0	
65	chr1	1290131	1290597	466	233.0	
66	chr1	1291607	1292455	848	424.0	
67	chr1	1293582	1294009	427	214.0	
68	chr1	1300023	1300404	381	190.0	
69	chr1	1301958	1302311	353	176.0	
70	chr1	1304657	1311665	7008	3504.0	
71	chr1	1324089	1325908	1819	910.0	
72	chr1	1335181	1335200	19	10.0	
73	chr1	1337668	1338120	452	226.0	
74	chr1	1344864	1345254	390	195.0	
75	chr1	1346307	1346312	5	2.0	
76	chr1	1348123	1350184	2061	1030.0	
77	chr1	1351876	1356047	4171	2086.0	
78	chr1	1358251	1359674	1423	712.0	
79	chr1	1370842	1373570	2728	1364.0	
80	chr1	1374371	1376666	2295	1148.0	
81	chr1	1397942	1400853	2911	1456.0	
82	chr1	1401892	1402493	601	300.0	
83	chr1	1406460	1408184	1724	862.0	
84	chr1	1419955	1420392	437	218.0	
85	chr1	1426457	1427690	1233	616.0	
86	chr1	1433563	1436151	2588	1294.0	
87	chr1	1440674	1441348	674	337.0	
88	chr1	1462174	1462986	812	406.0	
89	chr1	1470645	1473046	2401	1200.0	
90	chr1	1504619	1505916	1297	648.0	
91	chr1	1510896	1512838	1942	971.0	
92	chr1	1539437	1541287	1850	925.0	
93	chr1	1573641	1575707	2066	1033.0	
94	chr1	1577419	1577484	65	32.0	
95	chr1	1596937	1597961	1024	512.0	
96	chr1	1599303	1600827	1524	762.0	
97	chr1	1602405	1602799	394	197.0	
98	chr1	1606753	1607619	866	433.0	
99	chr1	1613974	1617127	3153	1576.0	
100	chr1	1617930	1618459	529	264.0	
101	chr1	1620048	1621043	995	498.0	
102	chr1	1621917	1622264	347	174.0	
103	chr1	1624161	1624401	240	120.0	
104	chr1	1624989	1626341	1352	676.0	
105	chr1	1627401	1632663	5262	2631.0	
106	chr1	1658463	1659706	1243	622.0	
107	chr1	1665620	1666106	486	243.0	
108	chr1	1677307	1679325	2018	1009.0	
109	chr1	1686096	1686817	721	360.0	
110	chr1	1692147	1693717	1570	785.0	
111	chr1	1694733	1695147	414	207.0	
112	chr1	1723740	1724980	1240	620.0	
113	chr1	1728540	1729167	627	314.0	
114	chr1	1746045	1747510	1465	732.0	
115	chr1	1758734	1759395	661	330.0	
116	chr1	1763960	1765429	1469	734.0	
117	chr1	1775348	1776237	889	444.0	
118	chr1	1777691	1783544	5853	2926.0	
119	chr1	1789144	1789401	257	128.0	
120	chr1	1796432	1796862	430	215.0	
121	chr1	1797971	1798362	391	196.0	
122	chr1	1834040	1834337	297	148.0	
123	chr1	1841528	1842518	990	495.0	
124	chr1	1849166	1849575	409	204.0	
125	chr1	1855954	1855983	29	14.0	
126	chr1	1857012	1857792	780	390.0	
127	chr1	1858530	1859252	722	361.0	
128	chr1	1860665	1861380	715	358.0	
129	chr1	1862192	1862256	64	32.0	
130	chr1	1864382	1865016	634	317.0	
131	chr1	1865854	1866192	338	169.0	
132	chr1	1869245	1870256	1011	506.0	
133	chr1	1872529	1874140	1611	806.0	
134	chr1	1875058	1875216	158	79.0	
135	chr1	1875904	1876175	271	136.0	
136	chr1	1877840	1878231	391	196.0	
137	chr1	1880827	1882317	1490	745.0	
138	chr1	1883048	1884305	1257	628.0	
139	chr1	1886086	1886973	887	444.0	
140	chr1	1888093	1892841	4748	2374.0	
141	chr1	1894757	1895145	388	194.0	
142	chr1	1899175	1899572	397	198.0	
143	chr1	1905975	1910109	4134	2067.0	
144	chr1	1918241	1922366	4125	2062.0	
145	chr1	1943880	1944367	487	244.0	
146	chr1	1960009	1960440	431	216.0	
147	chr1	1996137	1996633	496	248.0	
148	chr1	2019075	2019909	834	417.0	
149	chr1	2044446	2045467	1021	510.0	
150	chr1	2046420	2046866	446	223.0	
151	chr1	2049380	2051560	2180	1090.0	
152	chr1	2091560	2092033	473	236.0	
153	chr1	2112193	2112938	745	372.0	
154	chr1	2115201	2115632	431	216.0	
155	chr1	2126508	2127751	1243	622.0	
156	chr1	2132214	2134343	2129	1064.0	
157	chr1	2137399	2137690	291	146.0	
158	chr1	2139669	2140362	693	346.0	
159	chr1	2142697	2143321	624	312.0	
160	chr1	2146136	2147018	882	441.0	
161	chr1	2148447	2149590	1143	572.0	
162	chr1	2150662	2152189	1527	764.0	
163	chr1	2152907	2153410	503	252.0	
164	chr1	2163235	2163573	338	169.0	
165	chr1	2174206	2174879	673	336.0	
166	chr1	2189003	2190529	1526	763.0	
167	chr1	2193768	2196134	2366	1183.0	
168	chr1	2198538	2200091	1553	776.0	
169	chr1	2202029	2202166	137	68.0	
170	chr1	2203083	2206240	3157	1578.0	
171	chr1	2208536	2208685	149	74.0	
172	chr1	2209714	2209945	231	116.0	
173	chr1	2210673	2210984	311	156.0	
174	chr1	2212194	2213479	1285	642.0	
175	chr1	2224041	2225497	1456	728.0	
176	chr1	2226253	2260820	34567	17284.0	
177	chr1	2261464	2261867	403	202.0	
178	chr1	2263090	2263334	244	122.0	
179	chr1	2264649	2265121	472	236.0	
180	chr1	2265995	2266657	662	331.0	
181	chr1	2267279	2268955	1676	838.0	
182	chr1	2269532	2269600	68	34.0	
183	chr1	2270397	2272075	1678	839.0	
184	chr1	2273434	2274128	694	347.0	
185	chr1	2275046	2276937	1891	946.0	
186	chr1	2279071	2279809	738	369.0	
187	chr1	2288215	2293352	5137	2568.0	
188	chr1	2294386	2295157	771	386.0	
189	chr1	2296164	2303349	7185	3592.0	
190	chr1	2304617	2305860	1243	622.0	
191	chr1	2308991	2309224	233	116.0	
192	chr1	2310419	2317064	6645	3322.0	
193	chr1	2321975	2322358	383	192.0	
194	chr1	2381337	2382970	1633	816.0	
195	chr1	2390647	2392592	1945	972.0	
196	chr1	2411741	2416942	5201	2600.0	
197	chr1	2443580	2444241	661	330.0	
198	chr1	2467152	2468431	1279	640.0	
199	chr1	2493630	2494587	957	478.0	
200	chr1	2495609	2496808	1199	600.0	
201	chr1	2497565	2500632	3067	1534.0	
202	chr1	2503172	2503885	713	356.0	
203	chr1	2522816	2527685	4869	2434.0	
204	chr1	2528897	2531382	2485	1242.0	
205	chr1	2539283	2539787	504	252.0	
206	chr1	2540528	2550685	10157	5078.0	
207	chr1	2554449	2558458	4009	2004.0	
208	chr1	2559599	2560000	401	200.0	
209	chr1	2561381	2563499	2118	1059.0	
210	chr1	2564472	2564720	248	124.0	
211	chr1	2566173	2566557	384	192.0	
212	chr1	2570303	2570789	486	243.0	
213	chr1	2575647	2579148	3501	1750.0	
214	chr1	2581553	2582143	590	295.0	
215	chr1	2583793	2587915	4122	2061.0	
216	chr1	2611216	2611607	391	196.0	
217	chr1	2628318	2628666	348	174.0	
218	chr1	2642045	2644033	1988	994.0	
219	chr1	2697632	2697882	250	125.0	
220	chr1	2772266	2772762	496	248.0	
221	chr1	2786550	2787056	506	253.0	
222	chr1	2789042	2789443	401	200.0	
223	chr1	2801509	2802034	525	262.0	
224	chr1	2821915	2822391	476	238.0	
225	chr1	2839897	2840959	1062	531.0	
226	chr1	2894417	2895091	674	337.0	
227	chr1	2912751	2913016	265	132.0	
228	chr1	2922065	2922371	306	153.0	
229	chr1	2926447	2927794	1347	674.0	
230	chr1	2953871	2954280	409	204.0	
231	chr1	2956674	2956822	148	74.0	
232	chr1	3012528	3012842	314	157.0	
233	chr1	3032798	3033646	848	424.0	
234	chr1	3070323	3070336	13	6.0	
235	chr1	3171131	3171269	138	69.0	
236	chr1	3313059	3313532	473	236.0	
237	chr1	3316384	3317248	864	432.0	
238	chr1	3319956	3320256	300	150.0	
239	chr1	3372324	3372810	486	243.0	
240	chr1	3384481	3384825	344	172.0	
241	chr1	3424657	3425100	443	222.0	
242	chr1	3453036	3455304	2268	1134.0	
243	chr1	3483849	3484261	412	206.0	
244	chr1	3490941	3492015	1074	537.0	
245	chr1	3501900	3501930	30	15.0	
246	chr1	3518374	3518379	5	2.0	
247	chr1	3530434	3532618	2184	1092.0	
248	chr1	3565164	3565666	502	251.0	
249	chr1	3597250	3597940	690	345.0	
250	chr1	3599549	3600182	633	316.0	
251	chr1	3610516	3612353	1837	918.0	
252	chr1	3615180	3615516	336	168.0	
253	chr1	3618570	3619810	1240	620.0	
254	chr1	3620884	3621512	628	314.0	
255	chr1	3623435	3625968	2533	1266.0	
256	chr1	3630196	3630633	437	218.0	
257	chr1	3649336	3653270	3934	1967.0	
258	chr1	3656019	3656245	226	113.0	
259	chr1	3666037	3666915	878	439.0	
260	chr1	3667540	3667560	20	10.0	
261	chr1	3668568	3669325	757	378.0	
262	chr1	3673239	3673756	517	258.0	
263	chr1	3676818	3679421	2603	1302.0	
264	chr1	3684144	3684380	236	118.0	
265	chr1	3695558	3696036	478	239.0	
266	chr1	3718037	3718345	308	154.0	
267	chr1	3720030	3720411	381	190.0	
268	chr1	3724177	3724819	642	321.0	
269	chr1	3727318	3727408	90	45.0	
270	chr1	3746092	3747812	1720	860.0	
271	chr1	3771628	3773891	2263	1132.0	
272	chr1	3775377	3776377	1000	500.0	
273	chr1	3787275	3788061	786	393.0	
274	chr1	3793539	3794154	615	308.0	
275	chr1	3795833	3797203	1370	685.0	
276	chr1	3801209	3801806	597	298.0	
277	chr1	3810149	3810631	482	241.0	
278	chr1	3842973	3843331	358	179.0	
279	chr1	3856429	3858438	2009	1004.0	
280	chr1	3883182	3884175	993	496.0	
281	chr1	3889851	3891553	1702	851.0	
282	chr1	3899311	3903813	4502	2251.0	
283	chr1	3907245	3907586	341	170.0	
284	chr1	3910706	3911392	686	343.0	
285	chr1	3922055	3922762	707	354.0	
286	chr1	4006935	4008177	1242	621.0	
287	chr1	4027433	4028025	592	296.0	
288	chr1	4044920	4045339	419	210.0	
289	chr1	4638258	4638801	543	272.0	
290	chr1	4652530	4652970	440	220.0	
291	chr1	4736218	4736680	462	231.0	
292	chr1	4796403	4796871	468	234.0	
293	chr1	5348850	5349181	331	166.0	
294	chr1	5385463	5385739	276	138.0	
295	chr1	5388608	5389660	1052	526.0	
296	chr1	5423213	5423544	331	166.0	
297	chr1	5481862	5482320	458	229.0	
298	chr1	5509836	5510272	436	218.0	
299	chr1	5514549	5514920	371	186.0	
300	chr1	5666776	5668436	1660	830.0	
301	chr1	5745784	5746167	383	192.0	
302	chr1	5915996	5916375	379	190.0	
303	chr1	5955254	5955276	22	11.0	
304	chr1	5975140	5975925	785	392.0	
305	chr1	5978271	5978746	475	238.0	
306	chr1	5980367	5980864	497	248.0	
307	chr1	5991156	5995441	4285	2142.0	
308	chr1	6001079	6004239	3160	1580.0	
309	chr1	6005203	6006031	828	414.0	
310	chr1	6012681	6013506	825	412.0	
311	chr1	6014573	6015260	687	344.0	
312	chr1	6025221	6029172	3951	1976.0	
313	chr1	6034345	6034869	524	262.0	
314	chr1	6037210	6037712	502	251.0	
315	chr1	6041444	6041842	398	199.0	
316	chr1	6052394	6053192	798	399.0	
317	chr1	6056062	6057058	996	498.0	
318	chr1	6058564	6059132	568	284.0	
319	chr1	6094969	6095038	69	34.0	
320	chr1	6097030	6097508	478	239.0	
321	chr1	6098959	6101754	2795	1398.0	
322	chr1	6108786	6109259	473	236.0	
323	chr1	6123035	6123489	454	227.0	
324	chr1	6127457	6128435	978	489.0	
325	chr1	6148380	6149255	875	438.0	
326	chr1	6179905	6181104	1199	600.0	
327	chr1	6185780	6186042	262	131.0	
328	chr1	6198781	6200400	1619	810.0	
329	chr1	6204849	6206747	1898	949.0	
330	chr1	6208605	6210034	1429	714.0	
331	chr1	6235184	6236674	1490	745.0	
332	chr1	6238845	6239000	155	78.0	
333	chr1	6241933	6242705	772	386.0	
334	chr1	6244649	6247339	2690	1345.0	
335	chr1	6249287	6249679	392	196.0	
336	chr1	6259511	6262179	2668	1334.0	
337	chr1	6293954	6295364	1410	705.0	
338	chr1	6343227	6343881	654	327.0	
339	chr1	6347852	6349505	1653	826.0	
340	chr1	6357325	6357497	172	86.0	
341	chr1	6358034	6360375	2341	1170.0	
342	chr1	6363024	6363637	613	306.0	
343	chr1	6364869	6365635	766	383.0	
344	chr1	6392054	6394634	2580	1290.0	
345	chr1	6401610	6402155	545	272.0	
346	chr1	6404592	6405116	524	262.0	
347	chr1	6414313	6414742	429	214.0	
348	chr1	6419587	6421089	1502	751.0	
349	chr1	6423335	6425476	2141	1070.0	
350	chr1	6437771	6438635	864	432.0	
351	chr1	6439878	6441269	1391	696.0	
352	chr1	6445058	6445524	466	233.0	
353	chr1	6446926	6449684	2758	1379.0	
354	chr1	6454498	6455780	1282	641.0	
355	chr1	6459457	6461196	1739	870.0	
356	chr1	6462008	6462620	612	306.0	
357	chr1	6463567	6466801	3234	1617.0	
358	chr1	6475261	6476260	999	500.0	
359	chr1	6485422	6487094	1672	836.0	
360	chr1	6489613	6491411	1798	899.0	
361	chr1	6493247	6493643	396	198.0	
362	chr1	6495218	6495466	248	124.0	
363	chr1	6496414	6498030	1616	808.0	
364	chr1	6545470	6546099	629	314.0	
365	chr1	6553773	6555080	1307	654.0	
366	chr1	6578345	6583079	4734	2367.0	
367	chr1	6586220	6588746	2526	1263.0	
368	chr1	6589273	6589389	116	58.0	
369	chr1	6591020	6592073	1053	526.0	
370	chr1	6592785	6592791	6	3.0	
371	chr1	6598671	6604370	5699	2850.0	
372	chr1	6612551	6615703	3152	1576.0	
373	chr1	6624448	6626209	1761	880.0	
374	chr1	6634588	6635009	421	210.0	
375	chr1	6646375	6646943	568	284.0	
376	chr1	6701098	6702589	1491	746.0	
377	chr1	6719928	6720427	499	250.0	
378	chr1	6727410	6727928	518	259.0	
379	chr1	6740234	6740574	340	170.0	
380	chr1	6741550	6744398	2848	1424.0	
381	chr1	6745074	6745538	464	232.0	
382	chr1	6747769	6748019	250	125.0	
383	chr1	6751877	6752030	153	76.0	
384	chr1	6753366	6753377	11	6.0	
385	chr1	6776904	6777257	353	176.0	
386	chr1	6783863	6786760	2897	1448.0	
387	chr1	6889934	6890261	327	164.0	
388	chr1	6962177	6963809	1632	816.0	
389	chr1	7070450	7070733	283	142.0	
390	chr1	7647206	7647624	418	209.0	
391	chr1	7667420	7668329	909	454.0	
392	chr1	7669245	7670073	828	414.0	
393	chr1	7679889	7681161	1272	636.0	
394	chr1	7703773	7705997	2224	1112.0	
395	chr1	7728756	7729238	482	241.0	
396	chr1	7752786	7754025	1239	620.0	
397	chr1	7770439	7772273	1834	917.0	
398	chr1	7781381	7784906	3525	1762.0	
399	chr1	7786782	7787183	401	200.0	
400	chr1	7808258	7808623	365	182.0	
401	chr1	7827107	7827610	503	252.0	
402	chr1	7898971	7899258	287	144.0	
403	chr1	7902520	7903187	667	334.0	
404	chr1	7915806	7916251	445	222.0	
405	chr1	7927165	7927305	140	70.0	
406	chr1	7929586	7931834	2248	1124.0	
407	chr1	7940570	7943430	2860	1430.0	
408	chr1	7948813	7949662	849	424.0	
409	chr1	7953604	7955057	1453	726.0	
410	chr1	7960230	7962696	2466	1233.0	
411	chr1	7975205	7975660	455	228.0	
412	chr1	7981246	7981286	40	20.0	
413	chr1	7982059	7982883	824	412.0	
414	chr1	8004761	8005509	748	374.0	
415	chr1	8014928	8015434	506	253.0	
416	chr1	8019980	8020421	441	220.0	
417	chr1	8025260	8027175	1915	958.0	
418	chr1	8031155	8031556	401	200.0	
419	chr1	8083802	8084054	252	126.0	
420	chr1	8096699	8097820	1121	560.0	
421	chr1	8104476	8105093	617	308.0	
422	chr1	8106689	8107279	590	295.0	
423	chr1	8113221	8113666	445	222.0	
424	chr1	8120977	8121368	391	196.0	
425	chr1	8126780	8127795	1015	508.0	
426	chr1	8145587	8145942	355	178.0	
427	chr1	8149699	8150150	451	226.0	
428	chr1	8152182	8153946	1764	882.0	
429	chr1	8167229	8167705	476	238.0	
430	chr1	8169326	8170528	1202	601.0	
431	chr1	8182034	8183391	1357	678.0	
432	chr1	8198798	8198843	45	22.0	
433	chr1	8204322	8204774	452	226.0	
434	chr1	8211429	8212398	969	484.0	
435	chr1	8217044	8217909	865	432.0	
436	chr1	8218557	8219214	657	328.0	
437	chr1	8224584	8225529	945	472.0	
438	chr1	8283218	8283642	424	212.0	
439	chr1	8314247	8314887	640	320.0	
440	chr1	8317622	8318858	1236	618.0	
441	chr1	8348735	8349725	990	495.0	
442	chr1	8350932	8352283	1351	676.0	
443	chr1	8382785	8383598	813	406.0	
444	chr1	8387988	8388538	550	275.0	
445	chr1	8395091	8396087	996	498.0	
446	chr1	8396881	8398276	1395	698.0	
447	chr1	8407701	8408100	399	200.0	
448	chr1	8409045	8409638	593	296.0	
449	chr1	8417846	8417993	147	74.0	
450	chr1	8422193	8425341	3148	1574.0	
451	chr1	8426525	8428440	1915	958.0	
452	chr1	8429778	8431457	1679	840.0	
453	chr1	8438842	8439509	667	334.0	
454	chr1	8443748	8443946	198	99.0	
455	chr1	8449129	8449138	9	4.0	
456	chr1	8457735	8458205	470	235.0	
457	chr1	8463070	8463701	631	316.0	
458	chr1	8472590	8473042	452	226.0	
459	chr1	8476002	8476563	561	280.0	
460	chr1	8477398	8477560	162	81.0	
461	chr1	8495868	8497943	2075	1038.0	
462	chr1	8509893	8510701	808	404.0	
463	chr1	8511648	8511881	233	116.0	
464	chr1	8516868	8517275	407	204.0	
465	chr1	8520457	8520932	475	238.0	
466	chr1	8523611	8524076	465	232.0	
467	chr1	8524682	8526474	1792	896.0	
468	chr1	8533126	8533537	411	206.0	
469	chr1	8560995	8561502	507	254.0	
470	chr1	8602780	8602824	44	22.0	
471	chr1	8604212	8604740	528	264.0	
472	chr1	8623675	8624078	403	202.0	
473	chr1	8625547	8625801	254	127.0	
474	chr1	8629360	8630243	883	442.0	
475	chr1	8643588	8643839	251	126.0	
476	chr1	8660461	8660774	313	156.0	
477	chr1	8663833	8664519	686	343.0	
478	chr1	8671277	8671688	411	206.0	
479	chr1	8700885	8702014	1129	564.0	
480	chr1	8702821	8703905	1084	542.0	
481	chr1	8712289	8713334	1045	522.0	
482	chr1	8726468	8726909	441	220.0	
483	chr1	8815743	8818796	3053	1526.0	
484	chr1	8822806	8822925	119	60.0	
485	chr1	8825965	8826340	375	188.0	
486	chr1	8829310	8830088	778	389.0	
487	chr1	8848124	8849321	1197	598.0	
488	chr1	8854588	8854593	5	2.0	
489	chr1	8858072	8860040	1968	984.0	
490	chr1	8862227	8863035	808	404.0	
491	chr1	8870932	8871974	1042	521.0	
492	chr1	8873389	8874381	992	496.0	
493	chr1	8875207	8880641	5434	2717.0	
494	chr1	8889531	8890381	850	425.0	
495	chr1	8891724	8892180	456	228.0	
496	chr1	8899792	8900526	734	367.0	
497	chr1	8908224	8908732	508	254.0	
498	chr1	8917987	8918540	553	276.0	
499	chr1	8925652	8925803	151	76.0	
500	chr1	8926646	8927618	972	486.0	
501	chr1	8938427	8938593	166	83.0	
502	chr1	8946478	8947551	1073	536.0	
503	chr1	8962861	8963321	460	230.0	
504	chr1	8969943	8971610	1667	834.0	
505	chr1	8986786	8988467	1681	840.0	
506	chr1	9004272	9005552	1280	640.0	
507	chr1	9007658	9008173	515	258.0	
508	chr1	9010008	9012007	1999	1000.0	
509	chr1	9037440	9037716	276	138.0	
510	chr1	9067172	9067645	473	236.0	
511	chr1	9069280	9070116	836	418.0	
512	chr1	9073215	9073473	258	129.0	
513	chr1	9074905	9075458	553	276.0	
514	chr1	9076226	9076529	303	152.0	
515	chr1	9078218	9078971	753	376.0	
516	chr1	9082927	9083675	748	374.0	
517	chr1	9093302	9094140	838	419.0	
518	chr1	9101535	9101962	427	214.0	
519	chr1	9110647	9111203	556	278.0	
520	chr1	9119700	9120057	357	178.0	
521	chr1	9121644	9122531	887	444.0	
522	chr1	9128123	9130841	2718	1359.0	
523	chr1	9131446	9132000	554	277.0	
524	chr1	9135451	9135914	463	232.0	
525	chr1	9142164	9143686	1522	761.0	
526	chr1	9162776	9164518	1742	871.0	
527	chr1	9174271	9174344	73	36.0	
528	chr1	9181226	9182477	1251	626.0	
529	chr1	9196162	9196957	795	398.0	
530	chr1	9201950	9201958	8	4.0	
531	chr1	9233049	9235616	2567	1284.0	
532	chr1	9239520	9240287	767	384.0	
533	chr1	9243157	9243547	390	195.0	
534	chr1	9249988	9250399	411	206.0	
535	chr1	9266982	9267503	521	260.0	
536	chr1	9275284	9276157	873	436.0	
537	chr1	9280591	9280813	222	111.0	
538	chr1	9288952	9290791	1839	920.0	
539	chr1	9292213	9295574	3361	1680.0	
540	chr1	9315770	9316203	433	216.0	
541	chr1	9340905	9341196	291	146.0	
542	chr1	9362603	9362974	371	186.0	
543	chr1	9410648	9411436	788	394.0	
544	chr1	9412924	9414011	1087	544.0	
545	chr1	9417792	9418117	325	162.0	
546	chr1	9420868	9421234	366	183.0	
547	chr1	9425765	9427143	1378	689.0	
548	chr1	9428293	9429698	1405	702.0	
549	chr1	9439386	9439733	347	174.0	
550	chr1	9455734	9456217	483	242.0	
551	chr1	9490793	9491496	703	352.0	
552	chr1	9494983	9495843	860	430.0	
553	chr1	9522391	9522941	550	275.0	
554	chr1	9526127	9526526	399	200.0	
555	chr1	9529212	9529433	221	110.0	
556	chr1	9538723	9541210	2487	1244.0	
557	chr1	9542067	9542540	473	236.0	
558	chr1	9546766	9547018	252	126.0	
559	chr1	9549143	9549229	86	43.0	
560	chr1	9559601	9560099	498	249.0	
561	chr1	9561364	9561896	532	266.0	
562	chr1	9573726	9573920	194	97.0	
563	chr1	9588171	9590254	2083	1042.0	
564	chr1	9591110	9591979	869	434.0	
565	chr1	9593290	9594348	1058	529.0	
566	chr1	9615519	9616028	509	254.0	
567	chr1	9625875	9631203	5328	2664.0	enhancer
568	chr1	9633518	9633858	340	170.0	
569	chr1	9638608	9638909	301	150.0	
570	chr1	9643630	9645309	1679	840.0	
571	chr1	9651095	9656185	5090	2545.0	
572	chr1	9657661	9658687	1026	513.0	
573	chr1	9669985	9670468	483	242.0	
574	chr1	9683963	9685005	1042	521.0	
575	chr1	9685540	9691905	6365	3182.0	
576	chr1	9702199	9702668	469	234.0	
577	chr1	9703891	9705189	1298	649.0	
578	chr1	9711491	9712086	595	298.0	
579	chr1	9714142	9722816	8674	4337.0	
580	chr1	9723927	9725495	1568	784.0	
581	chr1	9726663	9733965	7302	3651.0	
582	chr1	9737122	9737487	365	182.0	
583	chr1	9768139	9768647	508	254.0	
584	chr1	9784428	9785015	587	294.0	
585	chr1	9787039	9788317	1278	639.0	
586	chr1	9799980	9800823	843	422.0	
587	chr1	9822704	9828256	5552	2776.0	
588	chr1	9846032	9846167	135	68.0	
589	chr1	9849829	9851083	1254	627.0	
590	chr1	9867105	9868114	1009	504.0	
591	chr1	9874611	9875616	1005	502.0	
592	chr1	9881940	9882868	928	464.0	
593	chr1	9892725	9893683	958	479.0	
594	chr1	9900121	9901125	1004	502.0	
595	chr1	9908958	9911480	2522	1261.0	
596	chr1	9942286	9944126	1840	920.0	
597	chr1	9949967	9951623	1656	828.0	
598	chr1	9961170	9961564	394	197.0	
599	chr1	9990915	9991526	611	306.0	
600	chr1	9996803	9998156	1353	676.0	
601	chr1	10022714	10023117	403	202.0	
602	chr1	10029006	10029561	555	278.0	
603	chr1	10032230	10034805	2575	1288.0	
604	chr1	10055656	10056395	739	370.0	
605	chr1	10066945	10067426	481	240.0	
606	chr1	10074314	10074794	480	240.0	
607	chr1	10147988	10148566	578	289.0	
608	chr1	10151263	10151524	261	130.0	
609	chr1	10152919	10153334	415	208.0	
610	chr1	10186922	10186990	68	34.0	
611	chr1	10189555	10190085	530	265.0	
612	chr1	10208390	10209074	684	342.0	
613	chr1	10209629	10212301	2672	1336.0	
614	chr1	10216047	10216737	690	345.0	
615	chr1	10242848	10243210	362	181.0	
616	chr1	10253927	10254039	112	56.0	
617	chr1	10307857	10308433	576	288.0	
618	chr1	10324598	10325039	441	220.0	
619	chr1	10338036	10338432	396	198.0	
620	chr1	10377258	10378926	1668	834.0	
621	chr1	10380235	10380451	216	108.0	
622	chr1	10387760	10388826	1066	533.0	
623	chr1	10398091	10400960	2869	1434.0	
624	chr1	10414860	10415860	1000	500.0	
625	chr1	10427848	10428550	702	351.0	
626	chr1	10429733	10431496	1763	882.0	
627	chr1	10471688	10473095	1407	704.0	
628	chr1	10474449	10475923	1474	737.0	
629	chr1	10484343	10484990	647	324.0	
630	chr1	10494418	10496600	2182	1091.0	
631	chr1	10497128	10497587	459	230.0	
632	chr1	10498113	10498702	589	294.0	
633	chr1	10507275	10508043	768	384.0	
634	chr1	10510435	10511955	1520	760.0	
635	chr1	10513191	10513554	363	182.0	
636	chr1	10514164	10514842	678	339.0	
637	chr1	10515583	10516109	526	263.0	
638	chr1	10524937	10525955	1018	509.0	
639	chr1	10544276	10544506	230	115.0	
640	chr1	10638262	10638573	311	156.0	
641	chr1	10679644	10679651	7	4.0	
642	chr1	10691968	10695699	3731	1866.0	
643	chr1	10755807	10756402	595	298.0	
644	chr1	10831191	10831249	58	29.0	
645	chr1	10866439	10867731	1292	646.0	
646	chr1	10903742	10904141	399	200.0	
647	chr1	10904650	10905277	627	314.0	enhancer
648	chr1	10909840	10910505	665	332.0	
649	chr1	10917714	10918578	864	432.0	
650	chr1	10932169	10932488	319	160.0	
651	chr1	10937401	10937755	354	177.0	
652	chr1	10939927	10940647	720	360.0	
653	chr1	10941907	10942420	513	256.0	
654	chr1	10960896	10961590	694	347.0	
655	chr1	10964868	10966949	2081	1040.0	
656	chr1	11011631	11013614	1983	992.0	
657	chr1	11037505	11038225	720	360.0	
658	chr1	11051834	11052257	423	212.0	
659	chr1	11059118	11061692	2574	1287.0	
660	chr1	11062868	11063388	520	260.0	
661	chr1	11099094	11100463	1369	684.0	
662	chr1	11241621	11242154	533	266.0	
663	chr1	11246133	11246697	564	282.0	
664	chr1	11261873	11263416	1543	772.0	
665	chr1	11272395	11274173	1778	889.0	
666	chr1	11280821	11281900	1079	540.0	
667	chr1	11295963	11296242	279	140.0	
668	chr1	11320171	11320519	348	174.0	
669	chr1	11335282	11336126	844	422.0	
670	chr1	11337462	11337955	493	246.0	
671	chr1	11478513	11480479	1966	983.0	
672	chr1	11501405	11501959	554	277.0	
673	chr1	11642195	11642880	685	342.0	
674	chr1	11645628	11646316	688	344.0	
675	chr1	11648704	11651355	2651	1326.0	
676	chr1	11652848	11655461	2613	1306.0	
677	chr1	11662716	11663038	322	161.0	
678	chr1	11663559	11665478	1919	960.0	
679	chr1	11670586	11671113	527	264.0	
680	chr1	11680207	11682063	1856	928.0	
681	chr1	11690581	11693741	3160	1580.0	
682	chr1	11711057	11711533	476	238.0	
683	chr1	11718922	11720394	1472	736.0	
684	chr1	11725495	11726023	528	264.0	
685	chr1	11729514	11732405	2891	1446.0	
686	chr1	11735422	11739285	3863	1932.0	
687	chr1	11740377	11741356	979	490.0	
688	chr1	11748812	11749668	856	428.0	
689	chr1	11761989	11762359	370	185.0	
690	chr1	11772484	11772726	242	121.0	
691	chr1	11784894	11785732	838	419.0	
692	chr1	11789421	11789822	401	200.0	
693	chr1	11790482	11791566	1084	542.0	
694	chr1	11802554	11807513	4959	2480.0	
695	chr1	11812977	11813405	428	214.0	
696	chr1	11814533	11815575	1042	521.0	
697	chr1	11838425	11839118	693	346.0	
698	chr1	11841288	11841446	158	79.0	
699	chr1	11842305	11843179	874	437.0	
700	chr1	11843685	11844036	351	176.0	
701	chr1	11851228	11851703	475	238.0	
702	chr1	11859192	11859703	511	256.0	
703	chr1	11865464	11865914	450	225.0	
704	chr1	11893735	11894383	648	324.0	
705	chr1	11905422	11906196	774	387.0	
706	chr1	11907099	11911441	4342	2171.0	
707	chr1	11925180	11927169	1989	994.0	
708	chr1	11933953	11935331	1378	689.0	
709	chr1	11960595	11961628	1033	516.0	
710	chr1	11967125	11967526	401	200.0	
711	chr1	11978307	11978662	355	178.0	
712	chr1	11979523	11981121	1598	799.0	
713	chr1	11981959	11982364	405	202.0	
714	chr1	11985397	11986351	954	477.0	
715	chr1	12018795	12020689	1894	947.0	
716	chr1	12031250	12031613	363	182.0	
717	chr1	12040291	12040979	688	344.0	
718	chr1	12046989	12047999	1010	505.0	
719	chr1	12051950	12052479	529	264.0	
720	chr1	12063026	12064124	1098	549.0	
721	chr1	12065944	12066249	305	152.0	
722	chr1	12068572	12068874	302	151.0	
723	chr1	12079559	12079754	195	98.0	
724	chr1	12087487	12089223	1736	868.0	
725	chr1	12102647	12103035	388	194.0	
726	chr1	12118514	12119187	673	336.0	
727	chr1	12121322	12121586	264	132.0	
728	chr1	12124578	12126580	2002	1001.0	
729	chr1	12132145	12133685	1540	770.0	
730	chr1	12140853	12141512	659	330.0	
731	chr1	12142358	12144443	2085	1042.0	
732	chr1	12146795	12147235	440	220.0	
733	chr1	12147987	12153971	5984	2992.0	
734	chr1	12157244	12158953	1709	854.0	
735	chr1	12159746	12160218	472	236.0	
736	chr1	12161066	12163022	1956	978.0	
737	chr1	12164206	12164628	422	211.0	
738	chr1	12165254	12165898	644	322.0	
739	chr1	12166467	12186727	20260	10130.0	
740	chr1	12187946	12188286	340	170.0	
741	chr1	12191876	12191971	95	48.0	
742	chr1	12194332	12195169	837	418.0	
743	chr1	12196322	12197399	1077	538.0	
744	chr1	12198148	12198385	237	118.0	
745	chr1	12199542	12199657	115	58.0	
746	chr1	12201266	12202448	1182	591.0	
747	chr1	12203185	12204614	1429	714.0	
748	chr1	12208248	12209777	1529	764.0	
749	chr1	12210308	12211289	981	490.0	
750	chr1	12229474	12231591	2117	1058.0	
751	chr1	12276350	12276611	261	130.0	
752	chr1	12314354	12314673	319	160.0	
753	chr1	12344347	12346120	1773	886.0	
754	chr1	12376539	12377337	798	399.0	
755	chr1	12386132	12386559	427	214.0	
756	chr1	12407437	12407826	389	194.0	
757	chr1	12416132	12416485	353	176.0	
758	chr1	12433745	12434788	1043	522.0	
759	chr1	12435488	12436303	815	408.0	
760	chr1	12438312	12439024	712	356.0	
761	chr1	12449097	12450287	1190	595.0	
762	chr1	12472373	12473813	1440	720.0	
763	chr1	12475190	12476295	1105	552.0	
764	chr1	12478180	12479113	933	466.0	
765	chr1	12480704	12481361	657	328.0	
766	chr1	12510226	12511354	1128	564.0	
767	chr1	12595031	12597024	1993	996.0	
768	chr1	12597703	12598205	502	251.0	
769	chr1	12601170	12602484	1314	657.0	
770	chr1	12603973	12604992	1019	510.0	
771	chr1	12615183	12621016	5833	2916.0	
772	chr1	12631107	12631617	510	255.0	
773	chr1	12658918	12659436	518	259.0	
774	chr1	13593447	13594263	816	408.0	
775	chr1	13623164	13623790	626	313.0	
776	chr1	13642553	13643364	811	406.0	
777	chr1	13662500	13662772	272	136.0	
778	chr1	13664069	13664450	381	190.0	
779	chr1	13665405	13666278	873	436.0	
780	chr1	13667752	13668229	477	238.0	
781	chr1	13699500	13703505	4005	2002.0	
782	chr1	13706424	13706497	73	36.0	
783	chr1	13713279	13713881	602	301.0	
784	chr1	13723483	13724313	830	415.0	
785	chr1	13725588	13726319	731	366.0	
786	chr1	13730221	13731726	1505	752.0	
787	chr1	13732925	13733680	755	378.0	
788	chr1	13748480	13750389	1909	954.0	
789	chr1	13751677	13752222	545	272.0	
790	chr1	13752986	13754989	2003	1002.0	
791	chr1	13756213	13757590	1377	688.0	
792	chr1	13758328	13758329	1	0.0	
793	chr1	13759135	13759430	295	148.0	
794	chr1	13762473	13763528	1055	528.0	
795	chr1	13764659	13765386	727	364.0	
796	chr1	13766491	13766740	249	124.0	
797	chr1	13767698	13767780	82	41.0	
798	chr1	13768752	13770086	1334	667.0	
799	chr1	13777190	13777417	227	114.0	
800	chr1	13780262	13780413	151	76.0	
801	chr1	13782174	13782723	549	274.0	
802	chr1	13783233	13783539	306	153.0	
803	chr1	13784719	13785017	298	149.0	
804	chr1	13790417	13790983	566	283.0	
805	chr1	13811171	13811616	445	222.0	
806	chr1	13813566	13814051	485	242.0	
807	chr1	13960398	13960731	333	166.0	
808	chr1	14739446	14739774	328	164.0	
809	chr1	14915365	14915708	343	172.0	
810	chr1	14923727	14924820	1093	546.0	
811	chr1	14969082	14969408	326	163.0	
812	chr1	15046571	15046699	128	64.0	
813	chr1	15065713	15066579	866	433.0	
814	chr1	15080376	15080702	326	163.0	
815	chr1	15083702	15083787	85	42.0	
816	chr1	15089632	15089878	246	123.0	
817	chr1	15090422	15090743	321	160.0	
818	chr1	15100347	15100746	399	200.0	
819	chr1	15128452	15128950	498	249.0	
820	chr1	15137751	15138275	524	262.0	
821	chr1	15146933	15147353	420	210.0	
822	chr1	15152274	15154751	2477	1238.0	
823	chr1	15156399	15156633	234	117.0	
824	chr1	15168439	15168900	461	230.0	
825	chr1	15218519	15218903	384	192.0	
826	chr1	15224153	15225319	1166	583.0	
827	chr1	15231506	15232185	679	340.0	
828	chr1	15245857	15247738	1881	940.0	
829	chr1	15248910	15249585	675	338.0	
830	chr1	15252585	15253301	716	358.0	
831	chr1	15258055	15259306	1251	626.0	
832	chr1	15260627	15262077	1450	725.0	
833	chr1	15272445	15272963	518	259.0	
834	chr1	15275930	15276331	401	200.0	
835	chr1	15296998	15297422	424	212.0	
836	chr1	15304663	15305139	476	238.0	
837	chr1	15323282	15324166	884	442.0	
838	chr1	15329085	15329261	176	88.0	
839	chr1	15340272	15340861	589	294.0	
840	chr1	15341924	15342579	655	328.0	
841	chr1	15345120	15347650	2530	1265.0	
842	chr1	15352380	15353089	709	354.0	
843	chr1	15362771	15363078	307	154.0	
844	chr1	15364830	15364951	121	60.0	
845	chr1	15384139	15384961	822	411.0	
846	chr1	15386063	15386752	689	344.0	
847	chr1	15405065	15422341	17276	8638.0	
848	chr1	15422891	15433519	10628	5314.0	
849	chr1	15434484	15435560	1076	538.0	
850	chr1	15438475	15438659	184	92.0	
851	chr1	15445520	15445603	83	42.0	
852	chr1	15464322	15466127	1805	902.0	
853	chr1	15501388	15501828	440	220.0	
854	chr1	15514982	15515667	685	342.0	
855	chr1	15521470	15521628	158	79.0	
856	chr1	15523155	15527640	4485	2242.0	
857	chr1	15564172	15564383	211	106.0	
858	chr1	15571771	15572229	458	229.0	
859	chr1	15577725	15578042	317	158.0	
860	chr1	15578803	15580019	1216	608.0	
861	chr1	15584325	15585453	1128	564.0	
862	chr1	15595095	15595486	391	196.0	
863	chr1	15602908	15604372	1464	732.0	
864	chr1	15616449	15619130	2681	1340.0	
865	chr1	15620090	15620541	451	226.0	
866	chr1	15674671	15674789	118	59.0	
867	chr1	15678541	15678960	419	210.0	
868	chr1	15680658	15681119	461	230.0	
869	chr1	15681883	15683009	1126	563.0	
870	chr1	15683746	15685440	1694	847.0	
871	chr1	15696638	15697746	1108	554.0	
872	chr1	15741153	15741801	648	324.0	
873	chr1	15758519	15758969	450	225.0	
874	chr1	15788553	15789101	548	274.0	
875	chr1	15791942	15792487	545	272.0	
876	chr1	15803363	15803736	373	186.0	
877	chr1	15815424	15815978	554	277.0	
878	chr1	15829429	15830496	1067	534.0	
879	chr1	15832999	15837883	4884	2442.0	
880	chr1	15846656	15850419	3763	1882.0	
881	chr1	15882691	15883097	406	203.0	
882	chr1	15885692	15886988	1296	648.0	
883	chr1	15893146	15893550	404	202.0	
884	chr1	15915926	15916537	611	306.0	
885	chr1	15919312	15919715	403	202.0	
886	chr1	15937040	15938062	1022	511.0	
887	chr1	15941375	15941552	177	88.0	
888	chr1	15947914	15951839	3925	1962.0	
889	chr1	15952549	15953252	703	352.0	
890	chr1	15963862	15964400	538	269.0	
891	chr1	15965269	15966756	1487	744.0	
892	chr1	15974718	15976767	2049	1024.0	
893	chr1	15994478	15994970	492	246.0	
894	chr1	16008927	16009450	523	262.0	
895	chr1	16012638	16013692	1054	527.0	
896	chr1	16026603	16027173	570	285.0	
897	chr1	16032742	16033297	555	278.0	
898	chr1	16048381	16049047	666	333.0	
899	chr1	16055607	16056572	965	482.0	
900	chr1	16073068	16074164	1096	548.0	
901	chr1	16078603	16079802	1199	600.0	
902	chr1	16082269	16082767	498	249.0	
903	chr1	16122746	16124191	1445	722.0	
904	chr1	16154461	16156381	1920	960.0	
905	chr1	16157077	16157086	9	4.0	
906	chr1	16157923	16158464	541	270.0	
907	chr1	16161450	16162911	1461	730.0	
908	chr1	16164441	16164618	177	88.0	
909	chr1	16167334	16169294	1960	980.0	
910	chr1	16172988	16173889	901	450.0	
911	chr1	16187554	16188369	815	408.0	
912	chr1	16204952	16207801	2849	1424.0	
913	chr1	16215913	16218657	2744	1372.0	
914	chr1	16226976	16227139	163	82.0	
915	chr1	16228304	16228459	155	78.0	
916	chr1	16236072	16238392	2320	1160.0	
917	chr1	16243973	16245032	1059	530.0	
918	chr1	16248777	16248956	179	90.0	
919	chr1	16293422	16294125	703	352.0	
920	chr1	16296714	16296768	54	27.0	
921	chr1	16318701	16318855	154	77.0	
922	chr1	16342789	16342807	18	9.0	
923	chr1	16348895	16349291	396	198.0	
924	chr1	16350833	16353565	2732	1366.0	
925	chr1	16363128	16363969	841	420.0	
926	chr1	16364506	16365517	1011	506.0	
927	chr1	16366484	16368613	2129	1064.0	
928	chr1	16371667	16372265	598	299.0	
929	chr1	16386381	16387846	1465	732.0	
930	chr1	16391533	16391846	313	156.0	
931	chr1	16420411	16421702	1291	646.0	
932	chr1	16433321	16433326	5	2.0	
933	chr1	16440034	16442623	2589	1294.0	
934	chr1	16444282	16444795	513	256.0	
935	chr1	16497395	16501405	4010	2005.0	
936	chr1	16509090	16509468	378	189.0	
937	chr1	16512472	16515092	2620	1310.0	
938	chr1	16534255	16535799	1544	772.0	
939	chr1	16567131	16567255	124	62.0	
940	chr1	16591699	16592206	507	254.0	
941	chr1	16607500	16607852	352	176.0	
942	chr1	16611907	16615514	3607	1804.0	
943	chr1	16618117	16618286	169	84.0	
944	chr1	16620218	16621644	1426	713.0	
945	chr1	16622462	16623158	696	348.0	
946	chr1	16624108	16626472	2364	1182.0	
947	chr1	16628525	16629351	826	413.0	
948	chr1	16642795	16645650	2855	1428.0	
949	chr1	16647434	16648320	886	443.0	
950	chr1	16676773	16677244	471	236.0	
951	chr1	16677865	16678554	689	344.0	
952	chr1	16687612	16687922	310	155.0	
953	chr1	16691679	16694040	2361	1180.0	
954	chr1	16696009	16702128	6119	3060.0	
955	chr1	16702938	16705318	2380	1190.0	
956	chr1	16706154	16708599	2445	1222.0	
957	chr1	16709178	16710878	1700	850.0	
958	chr1	16712119	16712347	228	114.0	
959	chr1	16713451	16713527	76	38.0	
960	chr1	16714153	16714508	355	178.0	
961	chr1	16715069	16715854	785	392.0	
962	chr1	16727082	16728594	1512	756.0	
963	chr1	16872573	16873917	1344	672.0	
964	chr1	16888734	16890086	1352	676.0	
965	chr1	16895189	16897949	2760	1380.0	
966	chr1	16899054	16899194	140	70.0	
967	chr1	16900682	16901769	1087	544.0	
968	chr1	16903076	16907570	4494	2247.0	
969	chr1	16909818	16910220	402	201.0	
970	chr1	16912242	16916271	4029	2014.0	
971	chr1	16921462	16922287	825	412.0	
972	chr1	16927440	16927878	438	219.0	
973	chr1	16951441	16952170	729	364.0	
974	chr1	16960408	16961474	1066	533.0	
975	chr1	16963418	16963852	434	217.0	
976	chr1	16980527	16980888	361	180.0	
977	chr1	17009506	17012558	3052	1526.0	
978	chr1	17013810	17014370	560	280.0	
979	chr1	17045076	17046479	1403	702.0	
980	chr1	17052674	17054912	2238	1119.0	
981	chr1	17059524	17060880	1356	678.0	
982	chr1	17061509	17061911	402	201.0	
983	chr1	17065646	17067511	1865	932.0	
984	chr1	17075383	17075842	459	230.0	
985	chr1	17097881	17099120	1239	620.0	
986	chr1	17099893	17100070	177	88.0	
987	chr1	17118615	17120386	1771	886.0	
988	chr1	17123326	17123709	383	192.0	
989	chr1	17125673	17126220	547	274.0	
990	chr1	17128310	17128885	575	288.0	
991	chr1	17141175	17142309	1134	567.0	
992	chr1	17161290	17161662	372	186.0	
993	chr1	17176612	17177059	447	224.0	
994	chr1	17181673	17182095	422	211.0	
995	chr1	17191265	17192160	895	448.0	
996	chr1	17201537	17202080	543	272.0	
997	chr1	17206957	17208511	1554	777.0	
998	chr1	17212625	17213269	644	322.0	
999	chr1	17233777	17234106	329	164.0	
1000	chr1	17236956	17237482	526	263.0	
1001	chr1	17239356	17239814	458	229.0	
1002	chr1	17274222	17274571	349	174.0	
1003	chr1	17276589	17277032	443	222.0	
1004	chr1	17281715	17282698	983	492.0	
1005	chr1	17287370	17287857	487	244.0	
1006	chr1	17304182	17304736	554	277.0	
1007	chr1	17307903	17308999	1096	548.0	
1008	chr1	17310639	17310806	167	84.0	
1009	chr1	17312326	17312569	243	122.0	
1010	chr1	17336085	17336479	394	197.0	
1011	chr1	17365187	17365794	607	304.0	
1012	chr1	17393250	17393607	357	178.0	
1013	chr1	17398242	17398738	496	248.0	
1014	chr1	17405937	17406602	665	332.0	
1015	chr1	17419602	17420454	852	426.0	
1016	chr1	17431351	17432620	1269	634.0	
1017	chr1	17436429	17440394	3965	1982.0	
1018	chr1	17441680	17441755	75	38.0	
1019	chr1	17494146	17494646	500	250.0	
1020	chr1	17502267	17502731	464	232.0	
1021	chr1	17509372	17509680	308	154.0	
1022	chr1	17536194	17536856	662	331.0	
1023	chr1	17539569	17540036	467	234.0	
1024	chr1	17569818	17570103	285	142.0	
1025	chr1	17603222	17603908	686	343.0	
1026	chr1	17606808	17607255	447	224.0	
1027	chr1	17614748	17615599	851	426.0	
1028	chr1	17617964	17618853	889	444.0	
1029	chr1	17629675	17631621	1946	973.0	
1030	chr1	17635271	17636464	1193	596.0	
1031	chr1	17639946	17640865	919	460.0	
1032	chr1	17653784	17654106	322	161.0	
1033	chr1	17658777	17659325	548	274.0	
1034	chr1	17661522	17662001	479	240.0	
1035	chr1	17673721	17675504	1783	892.0	
1036	chr1	17676569	17677031	462	231.0	
1037	chr1	18069953	18070278	325	162.0	
1038	chr1	18160391	18160984	593	296.0	
1039	chr1	18165773	18165790	17	8.0	
1040	chr1	18178037	18178467	430	215.0	
1041	chr1	18182801	18183162	361	180.0	
1042	chr1	18643503	18643895	392	196.0	
1043	chr1	18645146	18645579	433	216.0	
1044	chr1	18651671	18652058	387	194.0	
1045	chr1	18653459	18653620	161	80.0	
1046	chr1	18681401	18681560	159	80.0	
1047	chr1	18816861	18817172	311	156.0	
1048	chr1	18828185	18828634	449	224.0	
1049	chr1	18875201	18875614	413	206.0	
1050	chr1	18884040	18884587	547	274.0	
1051	chr1	18901064	18903800	2736	1368.0	
1052	chr1	18906712	18908925	2213	1106.0	
1053	chr1	18912792	18913850	1058	529.0	
1054	chr1	18917005	18917647	642	321.0	
1055	chr1	18918423	18918425	2	1.0	
1056	chr1	18921169	18922618	1449	724.0	
1057	chr1	18923226	18932288	9062	4531.0	
1058	chr1	18934590	18936280	1690	845.0	
1059	chr1	18937092	18940172	3080	1540.0	
1060	chr1	18941016	18942615	1599	800.0	
1061	chr1	18943644	18958557	14913	7456.0	
1062	chr1	18972254	18973422	1168	584.0	
1063	chr1	19010945	19011558	613	306.0	
1064	chr1	19045235	19045517	282	141.0	
1065	chr1	19074045	19075506	1461	730.0	
1066	chr1	19081162	19082103	941	470.0	
1067	chr1	19096447	19096591	144	72.0	
1068	chr1	19113631	19113990	359	180.0	
1069	chr1	19123837	19124596	759	380.0	
1070	chr1	19179608	19180327	719	360.0	
1071	chr1	19202530	19202811	281	140.0	
1072	chr1	19204465	19204898	433	216.0	
1073	chr1	19208936	19211310	2374	1187.0	
1074	chr1	19241036	19241831	795	398.0	
1075	chr1	19250941	19252697	1756	878.0	
1076	chr1	19288539	19289254	715	358.0	
1077	chr1	19310973	19316255	5282	2641.0	
1078	chr1	19322389	19322877	488	244.0	
1079	chr1	19326088	19326099	11	6.0	
1080	chr1	19329492	19329525	33	16.0	
1081	chr1	19331684	19332204	520	260.0	
1082	chr1	19333936	19334189	253	126.0	
1083	chr1	19336592	19336939	347	174.0	
1084	chr1	19341217	19342487	1270	635.0	
1085	chr1	19343761	19344881	1120	560.0	
1086	chr1	19345968	19346411	443	222.0	
1087	chr1	19347537	19348205	668	334.0	
1088	chr1	19359625	19360648	1023	512.0	
1089	chr1	19370305	19371032	727	364.0	
1090	chr1	19390456	19393416	2960	1480.0	
1091	chr1	19411614	19411968	354	177.0	
1092	chr1	19435108	19435642	534	267.0	
1093	chr1	19436667	19437423	756	378.0	
1094	chr1	19439799	19440212	413	206.0	
1095	chr1	19445836	19446119	283	142.0	
1096	chr1	19448555	19449570	1015	508.0	
1097	chr1	19454030	19455229	1199	600.0	
1098	chr1	19459122	19460386	1264	632.0	
1099	chr1	19461182	19461297	115	58.0	
1100	chr1	19462763	19463987	1224	612.0	
1101	chr1	19468204	19470055	1851	926.0	
1102	chr1	19476278	19479384	3106	1553.0	
1103	chr1	19483209	19486826	3617	1808.0	
1104	chr1	19487582	19488594	1012	506.0	
1105	chr1	19502326	19502583	257	128.0	
1106	chr1	19505004	19506316	1312	656.0	
1107	chr1	19508654	19509467	813	406.0	
1108	chr1	19511090	19511501	411	206.0	
1109	chr1	19516932	19517431	499	250.0	
1110	chr1	19533630	19534060	430	215.0	
1111	chr1	19557629	19558174	545	272.0	
1112	chr1	19579861	19580323	462	231.0	
1113	chr1	19582046	19582867	821	410.0	
1114	chr1	19595168	19598629	3461	1730.0	
1115	chr1	19599421	19600996	1575	788.0	
1116	chr1	19606138	19607272	1134	567.0	
1117	chr1	19643389	19645785	2396	1198.0	
1118	chr1	19646331	19646787	456	228.0	
1119	chr1	19647393	19648103	710	355.0	
1120	chr1	19651041	19651584	543	272.0	
1121	chr1	19653312	19654303	991	496.0	
1122	chr1	19659531	19660255	724	362.0	
1123	chr1	19661479	19662342	863	432.0	
1124	chr1	19664110	19666168	2058	1029.0	
1125	chr1	19676671	19676765	94	47.0	
1126	chr1	19687567	19689171	1604	802.0	
1127	chr1	19704330	19704974	644	322.0	
1128	chr1	19715455	19716187	732	366.0	
1129	chr1	19762219	19762546	327	164.0	
1130	chr1	19793807	19793921	114	57.0	
1131	chr1	19794897	19794990	93	46.0	
1132	chr1	19799129	19800911	1782	891.0	
1133	chr1	19811211	19811584	373	186.0	
1134	chr1	19881820	19883350	1530	765.0	
1135	chr1	19917948	19918437	489	244.0	
1136	chr1	19974818	19975159	341	170.0	
1137	chr1	20058495	20058854	359	180.0	
1138	chr1	20059830	20060280	450	225.0	
1139	chr1	20078216	20078699	483	242.0	
1140	chr1	20081029	20081369	340	170.0	
1141	chr1	20100882	20101304	422	211.0	
1142	chr1	20123834	20124045	211	106.0	
1143	chr1	20151923	20155014	3091	1546.0	
1144	chr1	20164679	20166040	1361	680.0	
1145	chr1	20171328	20172007	679	340.0	
1146	chr1	20175026	20175109	83	42.0	
1147	chr1	20179062	20179463	401	200.0	
1148	chr1	20184581	20187907	3326	1663.0	
1149	chr1	20195100	20195591	491	246.0	
1150	chr1	20212570	20213435	865	432.0	
1151	chr1	20216652	20217011	359	180.0	
1152	chr1	20248884	20249415	531	266.0	
1153	chr1	20255660	20255952	292	146.0	
1154	chr1	20322109	20323594	1485	742.0	
1155	chr1	20343105	20344103	998	499.0	
1156	chr1	20376878	20377278	400	200.0	
1157	chr1	20440704	20441220	516	258.0	
1158	chr1	20483883	20487295	3412	1706.0	
1159	chr1	20493257	20494630	1373	686.0	
1160	chr1	20507225	20508650	1425	712.0	
1161	chr1	20522244	20522766	522	261.0	
1162	chr1	20575142	20576764	1622	811.0	
1163	chr1	20587500	20590973	3473	1736.0	
1164	chr1	20597130	20598044	914	457.0	
1165	chr1	20603480	20605119	1639	820.0	
1166	chr1	20632848	20634990	2142	1071.0	
1167	chr1	20639885	20640641	756	378.0	
1168	chr1	20660518	20662403	1885	942.0	
1169	chr1	20678607	20679039	432	216.0	
1170	chr1	20682537	20682972	435	218.0	
1171	chr1	20696155	20697445	1290	645.0	
1172	chr1	20711585	20711918	333	166.0	
1173	chr1	20717387	20718565	1178	589.0	
1174	chr1	20727958	20728146	188	94.0	
1175	chr1	20730364	20733847	3483	1742.0	
1176	chr1	20783760	20784120	360	180.0	
1177	chr1	20785495	20788339	2844	1422.0	
1178	chr1	20851725	20852290	565	282.0	
1179	chr1	20932091	20933166	1075	538.0	
1180	chr1	20964571	20965317	746	373.0	
1181	chr1	21022174	21023175	1001	500.0	
1182	chr1	21051207	21051606	399	200.0	
1183	chr1	21077187	21077463	276	138.0	
1184	chr1	21090740	21091501	761	380.0	
1185	chr1	21100603	21101014	411	206.0	
1186	chr1	21165773	21165967	194	97.0	
1187	chr1	21174476	21178367	3891	1946.0	
1188	chr1	21183339	21183528	189	94.0	
1189	chr1	21184143	21184712	569	284.0	
1190	chr1	21195076	21195613	537	268.0	
1191	chr1	21216748	21218328	1580	790.0	
1192	chr1	21231900	21232596	696	348.0	
1193	chr1	21253972	21254236	264	132.0	
1194	chr1	21255122	21255850	728	364.0	
1195	chr1	21261488	21262619	1131	566.0	
1196	chr1	21270002	21270780	778	389.0	
1197	chr1	21278812	21279306	494	247.0	
1198	chr1	21279820	21280728	908	454.0	
1199	chr1	21284731	21285328	597	298.0	
1200	chr1	21287901	21288307	406	203.0	
1201	chr1	21289310	21291293	1983	992.0	
1202	chr1	21292436	21295495	3059	1530.0	
1203	chr1	21298809	21299508	699	350.0	
1204	chr1	21302727	21303021	294	147.0	
1205	chr1	21307337	21308038	701	350.0	
1206	chr1	21317162	21317834	672	336.0	
1207	chr1	21322569	21323049	480	240.0	
1208	chr1	21324198	21325971	1773	886.0	
1209	chr1	21329429	21330146	717	358.0	
1210	chr1	21331877	21336126	4249	2124.0	
1211	chr1	21337402	21338890	1488	744.0	
1212	chr1	21340570	21340837	267	134.0	
1213	chr1	21342651	21346583	3932	1966.0	
1214	chr1	21365069	21365463	394	197.0	
1215	chr1	21368301	21369077	776	388.0	
1216	chr1	21397714	21398336	622	311.0	
1217	chr1	21439584	21441166	1582	791.0	
1218	chr1	21453967	21454383	416	208.0	
1219	chr1	21488683	21489105	422	211.0	
1220	chr1	21508909	21509500	591	296.0	
1221	chr1	21514315	21514491	176	88.0	
1222	chr1	21517309	21518412	1103	552.0	
1223	chr1	21519057	21519439	382	191.0	
1224	chr1	21534857	21534914	57	28.0	
1225	chr1	21607665	21608252	587	294.0	
1226	chr1	21622336	21622920	584	292.0	
1227	chr1	21647919	21648283	364	182.0	
1228	chr1	21651376	21652425	1049	524.0	
1229	chr1	21658858	21659909	1051	526.0	
1230	chr1	21663934	21664444	510	255.0	
1231	chr1	21668447	21670188	1741	870.0	
1232	chr1	21673334	21673658	324	162.0	
1233	chr1	21706545	21706747	202	101.0	
1234	chr1	21761106	21761474	368	184.0	
1235	chr1	21762100	21762436	336	168.0	
1236	chr1	21764480	21765089	609	304.0	
1237	chr1	21767939	21768930	991	496.0	
1238	chr1	21771640	21772029	389	194.0	
1239	chr1	21773569	21773970	401	200.0	
1240	chr1	21779695	21780553	858	429.0	
1241	chr1	21781502	21784264	2762	1381.0	
1242	chr1	21788366	21788373	7	4.0	
1243	chr1	21791558	21792069	511	256.0	
1244	chr1	21814226	21814896	670	335.0	
1245	chr1	21815609	21816408	799	400.0	
1246	chr1	21818604	21819125	521	260.0	
1247	chr1	21857477	21857621	144	72.0	
1248	chr1	21865722	21866535	813	406.0	
1249	chr1	21909799	21910265	466	233.0	
1250	chr1	21913739	21914168	429	214.0	
1251	chr1	21936368	21938121	1753	876.0	
1252	chr1	21939701	21940242	541	270.0	
1253	chr1	21956758	21957754	996	498.0	
1254	chr1	21963843	21964417	574	287.0	
1255	chr1	22005175	22005510	335	168.0	
1256	chr1	22018751	22019959	1208	604.0	
1257	chr1	22022618	22023451	833	416.0	
1258	chr1	22024007	22027119	3112	1556.0	
1259	chr1	22031347	22032083	736	368.0	
1260	chr1	22037718	22038018	300	150.0	
1261	chr1	22039211	22040828	1617	808.0	
1262	chr1	22048207	22049223	1016	508.0	
1263	chr1	22051729	22055773	4044	2022.0	
1264	chr1	22056453	22058664	2211	1106.0	
1265	chr1	22059918	22060355	437	218.0	
1266	chr1	22061405	22063276	1871	936.0	
1267	chr1	22067200	22067826	626	313.0	
1268	chr1	22068794	22069053	259	130.0	
1269	chr1	22071762	22072505	743	372.0	
1270	chr1	22073761	22073776	15	8.0	
1271	chr1	22074456	22076478	2022	1011.0	
1272	chr1	22088412	22088431	19	10.0	
1273	chr1	22088988	22090565	1577	788.0	
1274	chr1	22092226	22092877	651	326.0	
1275	chr1	22104244	22104262	18	9.0	
1276	chr1	22104770	22106074	1304	652.0	
1277	chr1	22119111	22119240	129	64.0	
1278	chr1	22122482	22122798	316	158.0	
1279	chr1	22126508	22126655	147	74.0	
1280	chr1	22131844	22132318	474	237.0	
1281	chr1	22142115	22143676	1561	780.0	
1282	chr1	22416533	22417030	497	248.0	
1283	chr1	22420399	22420867	468	234.0	
1284	chr1	22428530	22429223	693	346.0	
1285	chr1	22451217	22453059	1842	921.0	
1286	chr1	22494417	22494484	67	34.0	
1287	chr1	22634155	22634397	242	121.0	
1288	chr1	22636421	22636666	245	122.0	
1289	chr1	22641949	22642443	494	247.0	
1290	chr1	22704387	22704888	501	250.0	
1291	chr1	22708683	22709149	466	233.0	
1292	chr1	22710232	22711381	1149	574.0	
1293	chr1	22735143	22735764	621	310.0	
1294	chr1	22738076	22738444	368	184.0	
1295	chr1	22745871	22746693	822	411.0	
1296	chr1	22750098	22750791	693	346.0	
1297	chr1	22832015	22832475	460	230.0	
1298	chr1	22885074	22885554	480	240.0	
1299	chr1	22964205	22964559	354	177.0	
1300	chr1	22976341	22976840	499	250.0	
1301	chr1	23011126	23011413	287	144.0	
1302	chr1	23013541	23014063	522	261.0	
1303	chr1	23015511	23015746	235	118.0	
1304	chr1	23018746	23020825	2079	1040.0	
1305	chr1	23098478	23099215	737	368.0	
1306	chr1	23100145	23100859	714	357.0	
1307	chr1	23102935	23104143	1208	604.0	
1308	chr1	23110403	23111442	1039	520.0	
1309	chr1	23114236	23114657	421	210.0	
1310	chr1	23118736	23120220	1484	742.0	
1311	chr1	23148167	23148442	275	138.0	
1312	chr1	23166032	23166280	248	124.0	
1313	chr1	23167261	23170314	3053	1526.0	
1314	chr1	23174456	23174740	284	142.0	
1315	chr1	23177324	23178235	911	456.0	
1316	chr1	23179254	23179330	76	38.0	
1317	chr1	23184222	23185105	883	442.0	
1318	chr1	23216724	23217529	805	402.0	
1319	chr1	23282778	23283399	621	310.0	
1320	chr1	23288480	23288563	83	42.0	
1321	chr1	23341988	23345274	3286	1643.0	
1322	chr1	23367559	23370107	2548	1274.0	
1323	chr1	23378126	23378710	584	292.0	
1324	chr1	23402077	23404380	2303	1152.0	
1325	chr1	23422006	23423045	1039	520.0	
1326	chr1	23423750	23425387	1637	818.0	
1327	chr1	23436546	23437097	551	276.0	
1328	chr1	23451944	23452438	494	247.0	
1329	chr1	23483195	23485263	2068	1034.0	
1330	chr1	23496811	23498234	1423	712.0	
1331	chr1	23522528	23523118	590	295.0	
1332	chr1	23524258	23526169	1911	956.0	
1333	chr1	23527396	23532007	4611	2306.0	
1334	chr1	23532926	23534043	1117	558.0	
1335	chr1	23537223	23537779	556	278.0	
1336	chr1	23539378	23540538	1160	580.0	
1337	chr1	23544460	23545307	847	424.0	
1338	chr1	23548853	23549095	242	121.0	
1339	chr1	23553822	23560444	6622	3311.0	
1340	chr1	23561120	23561185	65	32.0	
1341	chr1	23562235	23562793	558	279.0	
1342	chr1	23567065	23568788	1723	862.0	
1343	chr1	23577234	23577753	519	260.0	
1344	chr1	23585316	23586157	841	420.0	
1345	chr1	23591553	23592609	1056	528.0	
1346	chr1	23594916	23595405	489	244.0	
1347	chr1	23601002	23602655	1653	826.0	
1348	chr1	23607149	23607532	383	192.0	
1349	chr1	23611811	23614380	2569	1284.0	
1350	chr1	23617308	23617324	16	8.0	
1351	chr1	23619104	23620789	1685	842.0	
1352	chr1	23627004	23628268	1264	632.0	
1353	chr1	23628989	23629467	478	239.0	
1354	chr1	23634530	23635827	1297	648.0	
1355	chr1	23637143	23638064	921	460.0	
1356	chr1	23639411	23639795	384	192.0	
1357	chr1	23657684	23658063	379	190.0	
1358	chr1	23691353	23693042	1689	844.0	
1359	chr1	23720329	23721054	725	362.0	
1360	chr1	23723716	23724117	401	200.0	
1361	chr1	23726774	23729010	2236	1118.0	
1362	chr1	23742741	23745968	3227	1614.0	
1363	chr1	23751233	23751714	481	240.0	
1364	chr1	23772010	23772738	728	364.0	
1365	chr1	23777662	23779249	1587	794.0	
1366	chr1	23779950	23780136	186	93.0	
1367	chr1	23790379	23794152	3773	1886.0	
1368	chr1	23796683	23797144	461	230.0	
1369	chr1	23798540	23801839	3299	1650.0	
1370	chr1	23802524	23803000	476	238.0	
1371	chr1	23804312	23804880	568	284.0	
1372	chr1	23807433	23807938	505	252.0	
1373	chr1	23809490	23811420	1930	965.0	
1374	chr1	23824796	23826289	1493	746.0	
1375	chr1	23837956	23839110	1154	577.0	
1376	chr1	23865718	23865742	24	12.0	
1377	chr1	23867255	23869997	2742	1371.0	
1378	chr1	23888208	23888472	264	132.0	
1379	chr1	23889132	23889292	160	80.0	
1380	chr1	23894969	23895575	606	303.0	
1381	chr1	23896408	23897866	1458	729.0	
1382	chr1	23902688	23903261	573	286.0	
1383	chr1	23907747	23911276	3529	1764.0	
1384	chr1	23913017	23913746	729	364.0	
1385	chr1	23916039	23917279	1240	620.0	
1386	chr1	24070776	24071266	490	245.0	
1387	chr1	24112466	24112904	438	219.0	
1388	chr1	24149800	24151483	1683	842.0	
1389	chr1	24174133	24174371	238	119.0	
1390	chr1	24179553	24179738	185	92.0	
1391	chr1	24185935	24186161	226	113.0	
1392	chr1	24186859	24188079	1220	610.0	
1393	chr1	24189374	24192303	2929	1464.0	
1394	chr1	24197872	24198273	401	200.0	
1395	chr1	24199184	24199976	792	396.0	
1396	chr1	24201809	24202389	580	290.0	
1397	chr1	24294844	24295139	295	148.0	
1398	chr1	24319311	24319787	476	238.0	
1399	chr1	24321329	24323011	1682	841.0	
1400	chr1	24365128	24365750	622	311.0	
1401	chr1	24373016	24373535	519	260.0	
1402	chr1	24383976	24385572	1596	798.0	
1403	chr1	24391200	24393334	2134	1067.0	
1404	chr1	24413107	24414394	1287	644.0	
1405	chr1	24415078	24417459	2381	1190.0	
1406	chr1	24419293	24419653	360	180.0	
1407	chr1	24465641	24465988	347	174.0	
1408	chr1	24480934	24482637	1703	852.0	
1409	chr1	24483302	24483841	539	270.0	
1410	chr1	24486160	24487116	956	478.0	
1411	chr1	24498565	24499076	511	256.0	
1412	chr1	24501141	24504577	3436	1718.0	
1413	chr1	24505122	24505357	235	118.0	
1414	chr1	24506434	24507868	1434	717.0	
1415	chr1	24527157	24527586	429	214.0	
1416	chr1	24534854	24537101	2247	1124.0	
1417	chr1	24555490	24556432	942	471.0	
1418	chr1	24559054	24559689	635	318.0	
1419	chr1	24568025	24568347	322	161.0	
1420	chr1	24572340	24572624	284	142.0	
1421	chr1	24586959	24587694	735	368.0	
1422	chr1	24635152	24635668	516	258.0	
1423	chr1	24641303	24644386	3083	1542.0	
1424	chr1	24688475	24689072	597	298.0	
1425	chr1	24693910	24694727	817	408.0	
1426	chr1	24695410	24695828	418	209.0	
1427	chr1	24705178	24705809	631	316.0	
1428	chr1	24708828	24709396	568	284.0	
1429	chr1	24710026	24710282	256	128.0	
1430	chr1	24722150	24722939	789	394.0	
1431	chr1	24727285	24728068	783	392.0	
1432	chr1	24733124	24733832	708	354.0	
1433	chr1	24742181	24743775	1594	797.0	
1434	chr1	24744553	24746893	2340	1170.0	
1435	chr1	24748066	24749660	1594	797.0	
1436	chr1	24762115	24762978	863	432.0	
1437	chr1	24786173	24786610	437	218.0	
1438	chr1	24830642	24831087	445	222.0	
1439	chr1	24834924	24835319	395	198.0	
1440	chr1	24847637	24850092	2455	1228.0	
1441	chr1	24856741	24858004	1263	632.0	
1442	chr1	24870556	24871193	637	318.0	
1443	chr1	24872436	24873034	598	299.0	
1444	chr1	24893171	24893348	177	88.0	
1445	chr1	24894161	24894543	382	191.0	
1446	chr1	24895992	24907440	11448	5724.0	
1447	chr1	24908565	24919345	10780	5390.0	
1448	chr1	24920241	24931167	10926	5463.0	
1449	chr1	24931946	24933072	1126	563.0	
1450	chr1	24934571	24934654	83	42.0	
1451	chr1	24947518	24948508	990	495.0	
1452	chr1	24952313	24953063	750	375.0	
1453	chr1	24954632	24955757	1125	562.0	
1454	chr1	24956864	24957788	924	462.0	
1455	chr1	24963026	24967220	4194	2097.0	
1456	chr1	24971206	24972626	1420	710.0	
1457	chr1	24978513	24979084	571	286.0	
1458	chr1	24980983	24982139	1156	578.0	
1459	chr1	24984927	24985755	828	414.0	
1460	chr1	24988162	24988606	444	222.0	
1461	chr1	24990045	24990380	335	168.0	
1462	chr1	24990995	24993402	2407	1204.0	
1463	chr1	24997283	24998127	844	422.0	
1464	chr1	25000990	25001623	633	316.0	
1465	chr1	25007021	25008078	1057	528.0	
1466	chr1	25009816	25010231	415	208.0	
1467	chr1	25011418	25011450	32	16.0	
1468	chr1	25019243	25019803	560	280.0	
1469	chr1	25020442	25024226	3784	1892.0	enhancer
1470	chr1	25026706	25027479	773	386.0	
1471	chr1	25028455	25038158	9703	4852.0	
1472	chr1	25042096	25042272	176	88.0	
1473	chr1	25064269	25066778	2509	1254.0	
1474	chr1	25080342	25081054	712	356.0	
1475	chr1	25095545	25096286	741	370.0	
1476	chr1	25099120	25102100	2980	1490.0	
1477	chr1	25104331	25104556	225	112.0	
1478	chr1	25109439	25110878	1439	720.0	
1479	chr1	25113148	25113356	208	104.0	
1480	chr1	25131858	25132118	260	130.0	
1481	chr1	25139990	25140848	858	429.0	
1482	chr1	25148643	25149117	474	237.0	
1483	chr1	25198294	25198431	137	68.0	
1484	chr1	25204639	25205257	618	309.0	
1485	chr1	25231687	25233744	2057	1028.0	
1486	chr1	25236246	25248380	12134	6067.0	
1487	chr1	25259781	25260209	428	214.0	
1488	chr1	25266433	25268767	2334	1167.0	
1489	chr1	25308854	25309484	630	315.0	
1490	chr1	25329841	25331477	1636	818.0	
1491	chr1	25336681	25339730	3049	1524.0	
1492	chr1	25369689	25369841	152	76.0	
1493	chr1	25382982	25383646	664	332.0	
1494	chr1	25403003	25403343	340	170.0	
1495	chr1	25429674	25432404	2730	1365.0	
1496	chr1	25433591	25433751	160	80.0	
1497	chr1	25435012	25436207	1195	598.0	
1498	chr1	25456469	25456862	393	196.0	
1499	chr1	25458554	25458914	360	180.0	
1500	chr1	25473627	25474830	1203	602.0	
1501	chr1	25487573	25487966	393	196.0	
1502	chr1	25503710	25504387	677	338.0	
1503	chr1	25505272	25505624	352	176.0	
1504	chr1	25520429	25521094	665	332.0	
1505	chr1	25529648	25529799	151	76.0	
1506	chr1	25537163	25537428	265	132.0	
1507	chr1	25542966	25545099	2133	1066.0	
1508	chr1	25549185	25550618	1433	716.0	
1509	chr1	25556293	25557321	1028	514.0	
1510	chr1	25559855	25560444	589	294.0	
1511	chr1	25561376	25563411	2035	1018.0	
1512	chr1	25565054	25565816	762	381.0	
1513	chr1	25566533	25566981	448	224.0	
1514	chr1	25572691	25573169	478	239.0	
1515	chr1	25580804	25581273	469	234.0	
1516	chr1	25608332	25609035	703	352.0	
1517	chr1	25610876	25611302	426	213.0	
1518	chr1	25614459	25621181	6722	3361.0	
1519	chr1	25621834	25623106	1272	636.0	
1520	chr1	25624180	25624568	388	194.0	
1521	chr1	25629103	25629498	395	198.0	
1522	chr1	25631820	25632552	732	366.0	
1523	chr1	25642049	25643292	1243	622.0	
1524	chr1	25669010	25669231	221	110.0	
1525	chr1	25675697	25677586	1889	944.0	
1526	chr1	25679171	25679477	306	153.0	
1527	chr1	25692638	25692930	292	146.0	
1528	chr1	25704281	25704781	500	250.0	
1529	chr1	25711426	25712138	712	356.0	
1530	chr1	25730702	25731165	463	232.0	
1531	chr1	25754685	25755325	640	320.0	
1532	chr1	25771246	25771758	512	256.0	
1533	chr1	25774324	25775930	1606	803.0	
1534	chr1	25795871	25798433	2562	1281.0	
1535	chr1	25799285	25801118	1833	916.0	
1536	chr1	25802950	25803324	374	187.0	
1537	chr1	25809473	25811456	1983	992.0	
1538	chr1	25819058	25821887	2829	1414.0	
1539	chr1	25858534	25860562	2028	1014.0	
1540	chr1	25861238	25861601	363	182.0	
1541	chr1	25872911	25873040	129	64.0	
1542	chr1	25874701	25876598	1897	948.0	
1543	chr1	25894969	25896184	1215	608.0	
1544	chr1	25904831	25908059	3228	1614.0	
1545	chr1	25909208	25909296	88	44.0	
1546	chr1	25917993	25918420	427	214.0	
1547	chr1	25922215	25923925	1710	855.0	
1548	chr1	25924452	25924796	344	172.0	
1549	chr1	25927534	25927615	81	40.0	
1550	chr1	25931459	25931936	477	238.0	
1551	chr1	25971187	25971865	678	339.0	
1552	chr1	25989890	25991522	1632	816.0	
1553	chr1	25996788	25998936	2148	1074.0	
1554	chr1	26004429	26004595	166	83.0	
1555	chr1	26015269	26015896	627	314.0	
1556	chr1	26016778	26017351	573	286.0	
1557	chr1	26032967	26032986	19	10.0	
1558	chr1	26034744	26036756	2012	1006.0	
1559	chr1	26104863	26105561	698	349.0	
1560	chr1	26110486	26112818	2332	1166.0	
1561	chr1	26122120	26122640	520	260.0	
1562	chr1	26126099	26128113	2014	1007.0	
1563	chr1	26144866	26145729	863	432.0	
1564	chr1	26152525	26153003	478	239.0	
1565	chr1	26156611	26156830	219	110.0	
1566	chr1	26161328	26162409	1081	540.0	
1567	chr1	26163953	26164816	863	432.0	
1568	chr1	26166661	26167246	585	292.0	
1569	chr1	26169364	26170977	1613	806.0	
1570	chr1	26190372	26190735	363	182.0	
1571	chr1	26200999	26202325	1326	663.0	
1572	chr1	26224958	26225885	927	464.0	
1573	chr1	26230692	26231142	450	225.0	
1574	chr1	26233447	26235651	2204	1102.0	
1575	chr1	26259020	26260231	1211	606.0	
1576	chr1	26274673	26276953	2280	1140.0	
1577	chr1	26278680	26291197	12517	6258.0	
1578	chr1	26305552	26309180	3628	1814.0	
1579	chr1	26314162	26314508	346	173.0	
1580	chr1	26315037	26316368	1331	666.0	
1581	chr1	26317176	26322195	5019	2510.0	
1582	chr1	26335834	26338443	2609	1304.0	
1583	chr1	26358606	26360940	2334	1167.0	
1584	chr1	26361552	26361856	304	152.0	
1585	chr1	26363583	26364464	881	440.0	
1586	chr1	26370551	26371024	473	236.0	
1587	chr1	26373171	26375585	2414	1207.0	
1588	chr1	26377647	26379042	1395	698.0	
1589	chr1	26384101	26384510	409	204.0	
1590	chr1	26385589	26385896	307	154.0	
1591	chr1	26391360	26392046	686	343.0	
1592	chr1	26396187	26396706	519	260.0	
1593	chr1	26408316	26409313	997	498.0	
1594	chr1	26416940	26417536	596	298.0	
1595	chr1	26431712	26433010	1298	649.0	
1596	chr1	26469998	26473797	3799	1900.0	
1597	chr1	26477107	26477997	890	445.0	
1598	chr1	26480344	26480353	9	4.0	
1599	chr1	26499790	26501885	2095	1048.0	
1600	chr1	26529141	26531548	2407	1204.0	
1601	chr1	26535179	26535528	349	174.0	
1602	chr1	26537744	26544078	6334	3167.0	
1603	chr1	26545107	26546853	1746	873.0	
1604	chr1	26553899	26554602	703	352.0	
1605	chr1	26558364	26558664	300	150.0	
1606	chr1	26582663	26583223	560	280.0	
1607	chr1	26597510	26597998	488	244.0	
1608	chr1	26598920	26599281	361	180.0	
1609	chr1	26602278	26602829	551	276.0	
1610	chr1	26607194	26607619	425	212.0	
1611	chr1	26619522	26622144	2622	1311.0	
1612	chr1	26627868	26628477	609	304.0	
1613	chr1	26639381	26640317	936	468.0	
1614	chr1	26647761	26648766	1005	502.0	
1615	chr1	26677134	26678115	981	490.0	
1616	chr1	26682663	26683283	620	310.0	
1617	chr1	26689995	26690617	622	311.0	
1618	chr1	26692013	26694115	2102	1051.0	
1619	chr1	26694685	26698810	4125	2062.0	
1620	chr1	26699476	26700135	659	330.0	
1621	chr1	26700837	26701647	810	405.0	
1622	chr1	26702587	26702904	317	158.0	
1623	chr1	26705921	26706712	791	396.0	
1624	chr1	26707677	26707954	277	138.0	
1625	chr1	26719223	26719231	8	4.0	
1626	chr1	26721642	26722200	558	279.0	
1627	chr1	26722979	26724119	1140	570.0	"enhancer	enhancer"
1628	chr1	26724726	26724727	1	0.0	
1629	chr1	26733927	26734425	498	249.0	
1630	chr1	26739239	26739881	642	321.0	
1631	chr1	26743224	26745138	1914	957.0	
1632	chr1	26771858	26771861	3	2.0	
1633	chr1	26779080	26779431	351	176.0	
1634	chr1	26781483	26781785	302	151.0	
1635	chr1	26783940	26784917	977	488.0	
1636	chr1	26785759	26790980	5221	2610.0	
1637	chr1	26799656	26800819	1163	582.0	
1638	chr1	26809919	26811468	1549	774.0	
1639	chr1	26812270	26812427	157	78.0	
1640	chr1	26820521	26821566	1045	522.0	
1641	chr1	26825987	26829678	3691	1846.0	
1642	chr1	26831678	26834406	2728	1364.0	
1643	chr1	26838599	26839366	767	384.0	
1644	chr1	26852978	26853657	679	340.0	
1645	chr1	26862688	26863114	426	213.0	
1646	chr1	26863860	26866353	2493	1246.0	
1647	chr1	26877710	26878441	731	366.0	
1648	chr1	26887101	26887552	451	226.0	
1649	chr1	26889426	26891149	1723	862.0	
1650	chr1	26899470	26901131	1661	830.0	
1651	chr1	26920957	26922687	1730	865.0	
1652	chr1	26932450	26932988	538	269.0	
1653	chr1	26959681	26960918	1237	618.0	
1654	chr1	26966875	26967288	413	206.0	
1655	chr1	26991230	26991911	681	340.0	
1656	chr1	26992984	26994971	1987	994.0	
1657	chr1	26997401	26998453	1052	526.0	
1658	chr1	27000625	27002805	2180	1090.0	
1659	chr1	27012279	27013558	1279	640.0	
1660	chr1	27015179	27015638	459	230.0	
1661	chr1	27031616	27032061	445	222.0	
1662	chr1	27044424	27046339	1915	958.0	
1663	chr1	27067597	27068048	451	226.0	
1664	chr1	27097297	27100120	2823	1412.0	
1665	chr1	27102440	27103359	919	460.0	
1666	chr1	27105377	27105778	401	200.0	
1667	chr1	27106440	27107341	901	450.0	
1668	chr1	27109077	27109551	474	237.0	
1669	chr1	27111553	27112727	1174	587.0	
1670	chr1	27113929	27115296	1367	684.0	
1671	chr1	27116208	27118414	2206	1103.0	
1672	chr1	27119416	27120379	963	482.0	
1673	chr1	27122004	27123101	1097	548.0	
1674	chr1	27124602	27126743	2141	1070.0	
1675	chr1	27127568	27127957	389	194.0	
1676	chr1	27128973	27130054	1081	540.0	
1677	chr1	27130628	27134612	3984	1992.0	
1678	chr1	27135480	27140371	4891	2446.0	
1679	chr1	27141589	27143595	2006	1003.0	
1680	chr1	27144579	27145850	1271	636.0	
1681	chr1	27148349	27151120	2771	1386.0	
1682	chr1	27152114	27156051	3937	1968.0	
1683	chr1	27161519	27162155	636	318.0	
1684	chr1	27192038	27192434	396	198.0	
1685	chr1	27197816	27198506	690	345.0	
1686	chr1	27233234	27236234	3000	1500.0	
1687	chr1	27250363	27250804	441	220.0	
1688	chr1	27252638	27252977	339	170.0	
1689	chr1	27275675	27276123	448	224.0	
1690	chr1	27284419	27285268	849	424.0	
1691	chr1	27296600	27297274	674	337.0	
1692	chr1	27299774	27301423	1649	824.0	
1693	chr1	27321494	27323062	1568	784.0	
1694	chr1	27332566	27333370	804	402.0	
1695	chr1	27340308	27344174	3866	1933.0	
1696	chr1	27349054	27350233	1179	590.0	
1697	chr1	27355469	27358252	2783	1392.0	
1698	chr1	27359881	27361234	1353	676.0	
1699	chr1	27364048	27364294	246	123.0	
1700	chr1	27364869	27367497	2628	1314.0	
1701	chr1	27368176	27368464	288	144.0	
1702	chr1	27369058	27370326	1268	634.0	
1703	chr1	27372913	27373231	318	159.0	
1704	chr1	27383152	27383649	497	248.0	
1705	chr1	27388190	27389032	842	421.0	
1706	chr1	27391335	27393303	1968	984.0	
1707	chr1	27394363	27396174	1811	906.0	
1708	chr1	27400006	27400181	175	88.0	
1709	chr1	27401960	27404180	2220	1110.0	
1710	chr1	27404752	27405024	272	136.0	
1711	chr1	27416297	27416956	659	330.0	
1712	chr1	27418293	27418788	495	248.0	
1713	chr1	27421939	27422551	612	306.0	
1714	chr1	27427303	27429914	2611	1306.0	
1715	chr1	27430808	27431739	931	466.0	
1716	chr1	27435393	27437156	1763	882.0	
1717	chr1	27438693	27439185	492	246.0	
1718	chr1	27455420	27455846	426	213.0	
1719	chr1	27471787	27471790	3	2.0	
1720	chr1	27487914	27491050	3136	1568.0	
1721	chr1	27491613	27492532	919	460.0	
1722	chr1	27513409	27514362	953	476.0	
1723	chr1	27521204	27524346	3142	1571.0	
1724	chr1	27525214	27528784	3570	1785.0	
1725	chr1	27555857	27557948	2091	1046.0	
1726	chr1	27563904	27564684	780	390.0	
1727	chr1	27567915	27569987	2072	1036.0	
1728	chr1	27575297	27576842	1545	772.0	
1729	chr1	27579245	27579331	86	43.0	
1730	chr1	27594849	27598215	3366	1683.0	
1731	chr1	27598974	27604851	5877	2938.0	
1732	chr1	27605788	27610457	4669	2334.0	
1733	chr1	27615857	27616132	275	138.0	
1734	chr1	27617543	27619143	1600	800.0	
1735	chr1	27621067	27621533	466	233.0	
1736	chr1	27622905	27624171	1266	633.0	
1737	chr1	27624674	27627530	2856	1428.0	
1738	chr1	27628553	27629495	942	471.0	
1739	chr1	27630690	27637472	6782	3391.0	
1740	chr1	27640445	27640820	375	188.0	
1741	chr1	27643608	27644498	890	445.0	
1742	chr1	27650183	27651170	987	494.0	
1743	chr1	27652547	27652764	217	108.0	
1744	chr1	27655609	27656559	950	475.0	
1745	chr1	27658507	27661003	2496	1248.0	
1746	chr1	27662274	27663887	1613	806.0	
1747	chr1	27666645	27667922	1277	638.0	
1748	chr1	27668909	27672958	4049	2024.0	
1749	chr1	27719550	27719945	395	198.0	
1750	chr1	27724979	27727499	2520	1260.0	
1751	chr1	27771973	27774469	2496	1248.0	
1752	chr1	27779094	27780250	1156	578.0	
1753	chr1	27780922	27781361	439	220.0	
1754	chr1	27789487	27790117	630	315.0	
1755	chr1	27830075	27831616	1541	770.0	
1756	chr1	27857780	27859340	1560	780.0	
1757	chr1	27862664	27864794	2130	1065.0	
1758	chr1	27865458	27865668	210	105.0	
1759	chr1	27868526	27870177	1651	826.0	
1760	chr1	27871905	27875808	3903	1952.0	
1761	chr1	27876794	27877254	460	230.0	
1762	chr1	27877904	27878468	564	282.0	
1763	chr1	27882090	27882671	581	290.0	
1764	chr1	27883506	27888902	5396	2698.0	
1765	chr1	27889686	27889773	87	44.0	
1766	chr1	27890385	27892288	1903	952.0	
1767	chr1	27904160	27905084	924	462.0	
1768	chr1	27913821	27915592	1771	886.0	
1769	chr1	27931597	27932073	476	238.0	
1770	chr1	27934794	27935349	555	278.0	
1771	chr1	27940044	27940926	882	441.0	
1772	chr1	27943000	27944479	1479	740.0	
1773	chr1	27947574	27947893	319	160.0	
1774	chr1	27959219	27962020	2801	1400.0	
1775	chr1	27979344	27980068	724	362.0	
1776	chr1	27990875	27991326	451	226.0	
1777	chr1	27992167	27992719	552	276.0	
1778	chr1	27993285	27993636	351	176.0	
1779	chr1	28056143	28056704	561	280.0	
1780	chr1	28062739	28063190	451	226.0	
1781	chr1	28087583	28089425	1842	921.0	
1782	chr1	28090934	28091747	813	406.0	
1783	chr1	28107980	28108398	418	209.0	
1784	chr1	28110602	28111919	1317	658.0	
1785	chr1	28112486	28113502	1016	508.0	
1786	chr1	28115047	28115922	875	438.0	
1787	chr1	28123326	28124037	711	356.0	
1788	chr1	28126490	28128148	1658	829.0	
1789	chr1	28132820	28133149	329	164.0	
1790	chr1	28135263	28136037	774	387.0	
1791	chr1	28139156	28139797	641	320.0	
1792	chr1	28144493	28144942	449	224.0	
1793	chr1	28153216	28153486	270	135.0	
1794	chr1	28154924	28154999	75	38.0	
1795	chr1	28156777	28157257	480	240.0	
1796	chr1	28159281	28160072	791	396.0	
1797	chr1	28161813	28162139	326	163.0	
1798	chr1	28169121	28170263	1142	571.0	
1799	chr1	28171268	28173504	2236	1118.0	
1800	chr1	28174432	28177037	2605	1302.0	
1801	chr1	28190369	28191038	669	334.0	
1802	chr1	28194718	28194915	197	98.0	
1803	chr1	28197171	28197215	44	22.0	
1804	chr1	28199162	28200383	1221	610.0	
1805	chr1	28208797	28209299	502	251.0	
1806	chr1	28232286	28233330	1044	522.0	
1807	chr1	28235232	28237335	2103	1052.0	
1808	chr1	28243739	28249871	6132	3066.0	
1809	chr1	28250650	28251140	490	245.0	
1810	chr1	28255873	28257010	1137	568.0	
1811	chr1	28258509	28261803	3294	1647.0	
1812	chr1	28265061	28265209	148	74.0	
1813	chr1	28281474	28281488	14	7.0	
1814	chr1	28282375	28283774	1399	700.0	
1815	chr1	28284756	28285336	580	290.0	
1816	chr1	28286062	28286403	341	170.0	
1817	chr1	28286941	28287778	837	418.0	
1818	chr1	28313905	28315669	1764	882.0	
1819	chr1	28326509	28330423	3914	1957.0	
1820	chr1	28359598	28360095	497	248.0	
1821	chr1	28365870	28366441	571	286.0	
1822	chr1	28369183	28370789	1606	803.0	
1823	chr1	28378497	28378788	291	146.0	
1824	chr1	28409700	28410209	509	254.0	
1825	chr1	28417380	28417828	448	224.0	
1826	chr1	28428140	28428298	158	79.0	
1827	chr1	28437449	28438326	877	438.0	
1828	chr1	28505254	28507966	2712	1356.0	
1829	chr1	28509120	28511904	2784	1392.0	
1830	chr1	28513986	28513989	3	2.0	
1831	chr1	28515210	28516140	930	465.0	
1832	chr1	28516858	28519565	2707	1354.0	
1833	chr1	28552219	28554030	1811	906.0	
1834	chr1	28575007	28575404	397	198.0	
1835	chr1	28575934	28583263	7329	3664.0	
1836	chr1	28590017	28590550	533	266.0	
1837	chr1	28591746	28592909	1163	582.0	
1838	chr1	28602832	28603211	379	190.0	
1839	chr1	28635429	28635534	105	52.0	
1840	chr1	28640760	28641171	411	206.0	
1841	chr1	28641701	28644470	2769	1384.0	
1842	chr1	28647557	28650420	2863	1432.0	
1843	chr1	28652391	28652694	303	152.0	
1844	chr1	28653905	28654208	303	152.0	
1845	chr1	28668108	28670437	2329	1164.0	
1846	chr1	28715070	28715501	431	216.0	
1847	chr1	28736158	28738231	2073	1036.0	
1848	chr1	28748240	28749862	1622	811.0	
1849	chr1	28774879	28775834	955	478.0	
1850	chr1	28779996	28780479	483	242.0	
1851	chr1	28784814	28785959	1145	572.0	
1852	chr1	28853166	28853189	23	12.0	
1853	chr1	28875067	28875612	545	272.0	
1854	chr1	28876957	28877769	812	406.0	
1855	chr1	28881923	28882682	759	380.0	
1856	chr1	28883916	28888519	4603	2302.0	
1857	chr1	28889140	28889816	676	338.0	
1858	chr1	28893731	28894092	361	180.0	
1859	chr1	28898358	28899622	1264	632.0	
1860	chr1	28913757	28915882	2125	1062.0	
1861	chr1	28926486	28928811	2325	1162.0	
1862	chr1	28933527	28933758	231	116.0	
1863	chr1	28943559	28943962	403	202.0	
1864	chr1	28986364	28986689	325	162.0	
1865	chr1	29033798	29034283	485	242.0	
1866	chr1	29120917	29125189	4272	2136.0	
1867	chr1	29177644	29178153	509	254.0	
1868	chr1	29179495	29182813	3318	1659.0	
1869	chr1	29197454	29197916	462	231.0	
1870	chr1	29202115	29203467	1352	676.0	
1871	chr1	29230337	29231580	1243	622.0	
1872	chr1	29235955	29238637	2682	1341.0	
1873	chr1	29259319	29260357	1038	519.0	
1874	chr1	29282973	29283852	879	440.0	
1875	chr1	29443151	29443406	255	128.0	
1876	chr1	29698057	29698284	227	114.0	
1877	chr1	29706986	29707340	354	177.0	
1878	chr1	29712025	29712669	644	322.0	
1879	chr1	29793096	29793346	250	125.0	
1880	chr1	29849073	29849399	326	163.0	
1881	chr1	29897047	29897400	353	176.0	
1882	chr1	29985007	29985408	401	200.0	
1883	chr1	30043744	30044076	332	166.0	
1884	chr1	30085941	30086305	364	182.0	
1885	chr1	30130478	30130995	517	258.0	
1886	chr1	30190970	30191987	1017	508.0	
1887	chr1	30380163	30380784	621	310.0	
1888	chr1	30685127	30685966	839	420.0	
1889	chr1	30707869	30708560	691	346.0	
1890	chr1	30715245	30715504	259	130.0	
1891	chr1	30717038	30720227	3189	1594.0	
1892	chr1	30723773	30724318	545	272.0	
1893	chr1	30727505	30727892	387	194.0	
1894	chr1	30729206	30736050	6844	3422.0	
1895	chr1	30737239	30737249	10	5.0	
1896	chr1	30737967	30761887	23920	11960.0	
1897	chr1	30762515	30763752	1237	618.0	
1898	chr1	30765961	30766073	112	56.0	
1899	chr1	30768983	30769475	492	246.0	
1900	chr1	30778628	30778629	1	0.0	
1901	chr1	30779179	30780990	1811	906.0	
1902	chr1	30782223	30784205	1982	991.0	
1903	chr1	30790746	30791288	542	271.0	
1904	chr1	30801474	30802332	858	429.0	
1905	chr1	30823141	30824925	1784	892.0	
1906	chr1	30830496	30831025	529	264.0	
1907	chr1	30840857	30841331	474	237.0	
1908	chr1	30847309	30847858	549	274.0	
1909	chr1	30853930	30854733	803	402.0	
1910	chr1	30877418	30877957	539	270.0	
1911	chr1	30881410	30881625	215	108.0	
1912	chr1	30891633	30892135	502	251.0	
1913	chr1	30907498	30911803	4305	2152.0	
1914	chr1	30912801	30913515	714	357.0	
1915	chr1	30918975	30919746	771	386.0	
1916	chr1	30928931	30930227	1296	648.0	
1917	chr1	30930770	30930805	35	18.0	
1918	chr1	30976150	30976322	172	86.0	
1919	chr1	30982865	30983382	517	258.0	
1920	chr1	31010121	31010465	344	172.0	
1921	chr1	31013554	31013712	158	79.0	
1922	chr1	31028041	31028582	541	270.0	
1923	chr1	31049589	31050072	483	242.0	
1924	chr1	31062776	31066413	3637	1818.0	
1925	chr1	31100499	31100898	399	200.0	
1926	chr1	31109098	31109929	831	416.0	
1927	chr1	31152405	31152779	374	187.0	
1928	chr1	31154470	31155931	1461	730.0	
1929	chr1	31162507	31163299	792	396.0	
1930	chr1	31170655	31171243	588	294.0	
1931	chr1	31181383	31182831	1448	724.0	
1932	chr1	31184019	31184322	303	152.0	
1933	chr1	31208639	31208907	268	134.0	
1934	chr1	31296126	31298284	2158	1079.0	
1935	chr1	31300116	31300697	581	290.0	
1936	chr1	31373115	31374041	926	463.0	
1937	chr1	31394382	31395370	988	494.0	
1938	chr1	31412727	31414302	1575	788.0	
1939	chr1	31422465	31424023	1558	779.0	
1940	chr1	31482870	31484036	1166	583.0	
1941	chr1	31487111	31487617	506	253.0	
1942	chr1	31505967	31506419	452	226.0	
1943	chr1	31523579	31525016	1437	718.0	
1944	chr1	31535803	31536483	680	340.0	
1945	chr1	31548606	31550130	1524	762.0	
1946	chr1	31563999	31564505	506	253.0	
1947	chr1	31586877	31587061	184	92.0	
1948	chr1	31587733	31588151	418	209.0	
1949	chr1	31593887	31594410	523	262.0	
1950	chr1	31605712	31606516	804	402.0	
1951	chr1	31617692	31618560	868	434.0	
1952	chr1	31624307	31624740	433	216.0	
1953	chr1	31633161	31633474	313	156.0	
1954	chr1	31639238	31640271	1033	516.0	
1955	chr1	31643876	31646383	2507	1254.0	
1956	chr1	31663585	31664463	878	439.0	
1957	chr1	31669937	31670555	618	309.0	
1958	chr1	31699320	31699785	465	232.0	
1959	chr1	31701300	31701351	51	26.0	
1960	chr1	31705010	31705684	674	337.0	
1961	chr1	31714296	31716050	1754	877.0	
1962	chr1	31736679	31736945	266	133.0	
1963	chr1	31739148	31739797	649	324.0	
1964	chr1	31744464	31744939	475	238.0	
1965	chr1	31745567	31746062	495	248.0	
1966	chr1	31750646	31751574	928	464.0	
1967	chr1	31760296	31761547	1251	626.0	
1968	chr1	31762326	31765543	3217	1608.0	
1969	chr1	31768965	31769648	683	342.0	
1970	chr1	31771629	31773028	1399	700.0	
1971	chr1	31784819	31785569	750	375.0	
1972	chr1	31787617	31789983	2366	1183.0	
1973	chr1	31801557	31801800	243	122.0	
1974	chr1	31815525	31816391	866	433.0	
1975	chr1	31816986	31817276	290	145.0	
1976	chr1	31826700	31827860	1160	580.0	
1977	chr1	31848178	31849212	1034	517.0	
1978	chr1	31872771	31873361	590	295.0	
1979	chr1	31886896	31887194	298	149.0	
1980	chr1	31888822	31890034	1212	606.0	
1981	chr1	31901917	31902318	401	200.0	
1982	chr1	31904067	31905622	1555	778.0	
1983	chr1	31910975	31911283	308	154.0	
1984	chr1	31920834	31921462	628	314.0	
1985	chr1	31922316	31923218	902	451.0	
1986	chr1	31925126	31927916	2790	1395.0	
1987	chr1	31928420	31929144	724	362.0	
1988	chr1	31930039	31933814	3775	1888.0	
1989	chr1	31934662	31935771	1109	554.0	
1990	chr1	31936521	31940891	4370	2185.0	
1991	chr1	31942015	31945336	3321	1660.0	
1992	chr1	31953393	31953892	499	250.0	
1993	chr1	31954500	31956859	2359	1180.0	"enhancer	sequence_feature"
1994	chr1	31957476	31958346	870	435.0	
1995	chr1	31959999	31960333	334	167.0	
1996	chr1	31961499	31961999	500	250.0	
1997	chr1	31963976	31964707	731	366.0	
1998	chr1	31977849	31978063	214	107.0	
1999	chr1	31980892	31982641	1749	874.0	
2000	chr1	31984703	31985885	1182	591.0	
2001	chr1	32003483	32004000	517	258.0	
2002	chr1	32005345	32005923	578	289.0	
2003	chr1	32012876	32016634	3758	1879.0	
2004	chr1	32020205	32020921	716	358.0	
2005	chr1	32045680	32046354	674	337.0	
2006	chr1	32063206	32063847	641	320.0	
2007	chr1	32065960	32067011	1051	526.0	
2008	chr1	32072090	32073931	1841	920.0	
2009	chr1	32075661	32076207	546	273.0	
2010	chr1	32107005	32109921	2916	1458.0	
2011	chr1	32111263	32111885	622	311.0	
2012	chr1	32112947	32113120	173	86.0	
2013	chr1	32178607	32181365	2758	1379.0	
2014	chr1	32195894	32196471	577	288.0	
2015	chr1	32197239	32197281	42	21.0	
2016	chr1	32199729	32202228	2499	1250.0	
2017	chr1	32205029	32206476	1447	724.0	
2018	chr1	32208428	32209132	704	352.0	
2019	chr1	32215513	32216230	717	358.0	
2020	chr1	32221582	32223227	1645	822.0	
2021	chr1	32240114	32241844	1730	865.0	
2022	chr1	32242396	32242774	378	189.0	
2023	chr1	32247779	32257336	9557	4778.0	
2024	chr1	32263659	32264357	698	349.0	
2025	chr1	32266881	32267400	519	260.0	
2026	chr1	32272293	32274845	2552	1276.0	
2027	chr1	32290516	32293134	2618	1309.0	
2028	chr1	32316429	32317210	781	390.0	
2029	chr1	32319796	32320470	674	337.0	
2030	chr1	32321420	32322989	1569	784.0	
2031	chr1	32329775	32329793	18	9.0	
2032	chr1	32330611	32338461	7850	3925.0	
2033	chr1	32339269	32340152	883	442.0	
2034	chr1	32342369	32342739	370	185.0	
2035	chr1	32348938	32349813	875	438.0	
2036	chr1	32350539	32352529	1990	995.0	
2037	chr1	32359849	32360348	499	250.0	
2038	chr1	32361561	32362569	1008	504.0	
2039	chr1	32371905	32372843	938	469.0	
2040	chr1	32393393	32395431	2038	1019.0	
2041	chr1	32400598	32401314	716	358.0	
2042	chr1	32413723	32414383	660	330.0	
2043	chr1	32448298	32448725	427	214.0	
2044	chr1	32464863	32465189	326	163.0	
2045	chr1	32500310	32501204	894	447.0	
2046	chr1	32520355	32521117	762	381.0	
2047	chr1	32536135	32536476	341	170.0	
2048	chr1	32539437	32540206	769	384.0	
2049	chr1	32611893	32612833	940	470.0	
2050	chr1	32623329	32623421	92	46.0	
2051	chr1	32623936	32623938	2	1.0	
2052	chr1	32627429	32628366	937	468.0	
2053	chr1	32637121	32637755	634	317.0	
2054	chr1	32649662	32652039	2377	1188.0	
2055	chr1	32702404	32703584	1180	590.0	
2056	chr1	32711198	32712852	1654	827.0	
2057	chr1	32716680	32717026	346	173.0	
2058	chr1	32725102	32725564	462	231.0	
2059	chr1	32731553	32731606	53	26.0	
2060	chr1	32741333	32743207	1874	937.0	
2061	chr1	32753448	32754989	1541	770.0	
2062	chr1	32772899	32773679	780	390.0	
2063	chr1	32798799	32799856	1057	528.0	
2064	chr1	32801048	32801757	709	354.0	
2065	chr1	32815895	32819489	3594	1797.0	
2066	chr1	32822485	32822731	246	123.0	
2067	chr1	32870508	32871353	845	422.0	
2068	chr1	32872431	32873076	645	322.0	
2069	chr1	32876570	32877102	532	266.0	
2070	chr1	32886218	32886973	755	378.0	
2071	chr1	32892786	32893692	906	453.0	
2072	chr1	32901032	32901738	706	353.0	
2073	chr1	32924714	32926190	1476	738.0	
2074	chr1	32928252	32938581	10329	5164.0	
2075	chr1	32939431	32940440	1009	504.0	
2076	chr1	32941288	32944572	3284	1642.0	
2077	chr1	32945899	32945984	85	42.0	
2078	chr1	32948169	32948693	524	262.0	
2079	chr1	32949502	32949910	408	204.0	
2080	chr1	32950703	32950813	110	55.0	
2081	chr1	32951446	32951885	439	220.0	
2082	chr1	32952475	32954012	1537	768.0	
2083	chr1	32955497	32955976	479	240.0	
2084	chr1	32956780	32959264	2484	1242.0	
2085	chr1	32960073	32965431	5358	2679.0	
2086	chr1	32969768	32969788	20	10.0	
2087	chr1	32972707	32973419	712	356.0	
2088	chr1	32980462	32981955	1493	746.0	
2089	chr1	32983291	32983292	1	0.0	
2090	chr1	32984290	32985343	1053	526.0	
2091	chr1	32988974	32989935	961	480.0	
2092	chr1	32991782	32993672	1890	945.0	
2093	chr1	32997625	32998725	1100	550.0	
2094	chr1	33007147	33007661	514	257.0	
2095	chr1	33024707	33025278	571	286.0	
2096	chr1	33031427	33032623	1196	598.0	
2097	chr1	33034930	33037516	2586	1293.0	
2098	chr1	33039535	33040307	772	386.0	
2099	chr1	33045289	33046463	1174	587.0	
2100	chr1	33049322	33050988	1666	833.0	
2101	chr1	33055057	33056059	1002	501.0	
2102	chr1	33058219	33058721	502	251.0	
2103	chr1	33060856	33060988	132	66.0	
2104	chr1	33080511	33082265	1754	877.0	
2105	chr1	33086112	33086789	677	338.0	
2106	chr1	33088476	33088891	415	208.0	
2107	chr1	33094969	33095388	419	210.0	
2108	chr1	33098336	33100092	1756	878.0	
2109	chr1	33126643	33128913	2270	1135.0	
2110	chr1	33137888	33138080	192	96.0	
2111	chr1	33180271	33183307	3036	1518.0	
2112	chr1	33218705	33219106	401	200.0	
2113	chr1	33237505	33238029	524	262.0	
2114	chr1	33255328	33257557	2229	1114.0	
2115	chr1	33273383	33273860	477	238.0	
2116	chr1	33295053	33296011	958	479.0	
2117	chr1	33298419	33299136	717	358.0	
2118	chr1	33302456	33302648	192	96.0	
2119	chr1	33307148	33307162	14	7.0	
2120	chr1	33326686	33327410	724	362.0	
2121	chr1	33328050	33328178	128	64.0	
2122	chr1	33334909	33335529	620	310.0	
2123	chr1	33338534	33339669	1135	568.0	
2124	chr1	33346688	33347461	773	386.0	
2125	chr1	33348571	33350881	2310	1155.0	
2126	chr1	33361632	33361995	363	182.0	
2127	chr1	33367477	33368379	902	451.0	
2128	chr1	33377036	33377425	389	194.0	
2129	chr1	33382086	33382136	50	25.0	
2130	chr1	33384491	33384870	379	190.0	
2131	chr1	33421097	33421650	553	276.0	
2132	chr1	33430211	33431814	1603	802.0	
2133	chr1	33433509	33434296	787	394.0	
2134	chr1	33455496	33456239	743	372.0	
2135	chr1	33460675	33461772	1097	548.0	
2136	chr1	33470383	33471121	738	369.0	
2137	chr1	33472000	33473249	1249	624.0	
2138	chr1	33633029	33633450	421	210.0	
2139	chr1	34742691	34743012	321	160.0	
2140	chr1	34786371	34786899	528	264.0	
2141	chr1	34852492	34853363	871	436.0	
2142	chr1	34858413	34860413	2000	1000.0	
2143	chr1	34863308	34863899	591	296.0	
2144	chr1	34864700	34867951	3251	1626.0	
2145	chr1	34885342	34886363	1021	510.0	
2146	chr1	34918830	34919577	747	374.0	
2147	chr1	34924768	34925239	471	236.0	
2148	chr1	34928771	34930177	1406	703.0	
2149	chr1	34968403	34968702	299	150.0	
2150	chr1	34983916	34985938	2022	1011.0	
2151	chr1	35030239	35032482	2243	1122.0	
2152	chr1	35062175	35062859	684	342.0	
2153	chr1	35078797	35080276	1479	740.0	
2154	chr1	35115830	35116194	364	182.0	
2155	chr1	35120731	35121124	393	196.0	
2156	chr1	35162214	35162694	480	240.0	
2157	chr1	35169539	35169614	75	38.0	
2158	chr1	35170160	35170872	712	356.0	
2159	chr1	35171432	35177707	6275	3138.0	
2160	chr1	35178212	35183539	5327	2664.0	
2161	chr1	35184438	35185492	1054	527.0	
2162	chr1	35186044	35193984	7940	3970.0	
2163	chr1	35202007	35202565	558	279.0	
2164	chr1	35221011	35221354	343	172.0	
2165	chr1	35243718	35244239	521	260.0	
2166	chr1	35264993	35265082	89	44.0	
2167	chr1	35268183	35269856	1673	836.0	
2168	chr1	35286338	35286611	273	136.0	
2169	chr1	35298446	35298961	515	258.0	
2170	chr1	35345304	35346172	868	434.0	
2171	chr1	35364623	35365321	698	349.0	
2172	chr1	35411325	35412130	805	402.0	
2173	chr1	35429372	35429818	446	223.0	
2174	chr1	35442534	35443199	665	332.0	
2175	chr1	35447293	35447712	419	210.0	
2176	chr1	35448358	35448883	525	262.0	
2177	chr1	35450844	35452585	1741	870.0	
2178	chr1	35454129	35455003	874	437.0	
2179	chr1	35457519	35458248	729	364.0	
2180	chr1	35499653	35500114	461	230.0	
2181	chr1	35505786	35507472	1686	843.0	
2182	chr1	35538510	35540357	1847	924.0	
2183	chr1	35544726	35545500	774	387.0	
2184	chr1	35556613	35560331	3718	1859.0	
2185	chr1	35561293	35561776	483	242.0	
2186	chr1	35564366	35565213	847	424.0	
2187	chr1	35568689	35569515	826	413.0	
2188	chr1	35573090	35573778	688	344.0	
2189	chr1	35575231	35578705	3474	1737.0	
2190	chr1	35637287	35637810	523	262.0	
2191	chr1	35640930	35642843	1913	956.0	
2192	chr1	35646024	35646233	209	104.0	
2193	chr1	35707102	35708879	1777	888.0	
2194	chr1	35715234	35716106	872	436.0	
2195	chr1	35717740	35719567	1827	914.0	
2196	chr1	35726744	35727465	721	360.0	
2197	chr1	35768873	35770523	1650	825.0	
2198	chr1	35774596	35775241	645	322.0	
2199	chr1	35779498	35780158	660	330.0	
2200	chr1	35797456	35798332	876	438.0	
2201	chr1	35800012	35800926	914	457.0	
2202	chr1	35804416	35804922	506	253.0	
2203	chr1	35807298	35809675	2377	1188.0	
2204	chr1	35810721	35811955	1234	617.0	
2205	chr1	35848101	35848559	458	229.0	
2206	chr1	35860614	35861148	534	267.0	
2207	chr1	35864716	35865216	500	250.0	
2208	chr1	35866971	35867411	440	220.0	
2209	chr1	35882520	35884337	1817	908.0	
2210	chr1	35884930	35885377	447	224.0	
2211	chr1	35886044	35887503	1459	730.0	
2212	chr1	35893790	35894823	1033	516.0	
2213	chr1	35899272	35899944	672	336.0	
2214	chr1	35930016	35932196	2180	1090.0	
2215	chr1	35937133	35937144	11	6.0	
2216	chr1	35942698	35943272	574	287.0	
2217	chr1	36034698	36035231	533	266.0	
2218	chr1	36051775	36052264	489	244.0	
2219	chr1	36055600	36056078	478	239.0	
2220	chr1	36083855	36084627	772	386.0	
2221	chr1	36088214	36090208	1994	997.0	
2222	chr1	36095706	36096286	580	290.0	
2223	chr1	36099348	36100438	1090	545.0	
2224	chr1	36108949	36109511	562	281.0	
2225	chr1	36115787	36116447	660	330.0	
2226	chr1	36119540	36120632	1092	546.0	
2227	chr1	36122754	36124074	1320	660.0	
2228	chr1	36124924	36125721	797	398.0	
2229	chr1	36134591	36135192	601	300.0	
2230	chr1	36148560	36152560	4000	2000.0	
2231	chr1	36155079	36158679	3600	1800.0	
2232	chr1	36159588	36163074	3486	1743.0	
2233	chr1	36166221	36166501	280	140.0	
2234	chr1	36175161	36175862	701	350.0	
2235	chr1	36183421	36183796	375	188.0	
2236	chr1	36187676	36188759	1083	542.0	
2237	chr1	36203250	36204107	857	428.0	
2238	chr1	36209276	36209733	457	228.0	
2239	chr1	36212858	36213088	230	115.0	
2240	chr1	36218145	36218570	425	212.0	
2241	chr1	36223072	36225419	2347	1174.0	
2242	chr1	36232644	36233050	406	203.0	
2243	chr1	36248221	36248983	762	381.0	
2244	chr1	36285352	36286100	748	374.0	
2245	chr1	36299792	36300961	1169	584.0	
2246	chr1	36304455	36308009	3554	1777.0	
2247	chr1	36319484	36324586	5102	2551.0	
2248	chr1	36328817	36329060	243	122.0	
2249	chr1	36339168	36339352	184	92.0	
2250	chr1	36342603	36343323	720	360.0	
2251	chr1	36349132	36349697	565	282.0	
2252	chr1	36350481	36351761	1280	640.0	
2253	chr1	36365436	36367547	2111	1056.0	
2254	chr1	36368734	36369765	1031	516.0	
2255	chr1	36371097	36371954	857	428.0	
2256	chr1	36373402	36375332	1930	965.0	
2257	chr1	36377652	36379009	1357	678.0	
2258	chr1	36384353	36388064	3711	1856.0	
2259	chr1	36389973	36390859	886	443.0	
2260	chr1	36397038	36398584	1546	773.0	
2261	chr1	36400422	36401971	1549	774.0	
2262	chr1	36411736	36412477	741	370.0	
2263	chr1	36420358	36421441	1083	542.0	
2264	chr1	36446328	36447131	803	402.0	
2265	chr1	36449830	36451306	1476	738.0	
2266	chr1	36457652	36458217	565	282.0	
2267	chr1	36458718	36459303	585	292.0	
2268	chr1	36463623	36465082	1459	730.0	
2269	chr1	36474179	36474521	342	171.0	
2270	chr1	36481793	36483513	1720	860.0	
2271	chr1	36485880	36487421	1541	770.0	
2272	chr1	36516325	36516763	438	219.0	
2273	chr1	36553787	36554247	460	230.0	
2274	chr1	36576072	36576447	375	188.0	
2275	chr1	36606882	36607018	136	68.0	
2276	chr1	36609249	36609619	370	185.0	
2277	chr1	36650443	36650866	423	212.0	
2278	chr1	36663900	36664099	199	100.0	
2279	chr1	36665520	36665830	310	155.0	
2280	chr1	36703646	36704129	483	242.0	
2281	chr1	37288796	37289348	552	276.0	
2282	chr1	37368934	37369256	322	161.0	
2283	chr1	37434253	37434738	485	242.0	
2284	chr1	37449834	37450481	647	324.0	
2285	chr1	37454579	37455636	1057	528.0	
2286	chr1	37471515	37488294	16779	8390.0	
2287	chr1	37488834	37489013	179	90.0	
2288	chr1	37513691	37515572	1881	940.0	
2289	chr1	37518768	37519958	1190	595.0	
2290	chr1	37534425	37534840	415	208.0	
2291	chr1	37545076	37545244	168	84.0	
2292	chr1	37553671	37554810	1139	570.0	
2293	chr1	37556663	37557140	477	238.0	
2294	chr1	37561739	37562182	443	222.0	
2295	chr1	37594720	37596694	1974	987.0	
2296	chr1	37603073	37603559	486	243.0	
2297	chr1	37606291	37606982	691	346.0	
2298	chr1	37634603	37634845	242	121.0	
2299	chr1	37673701	37674488	787	394.0	
2300	chr1	37676386	37676434	48	24.0	
2301	chr1	37682145	37682967	822	411.0	
2302	chr1	37689552	37693168	3616	1808.0	
2303	chr1	37752615	37753239	624	312.0	
2304	chr1	37793605	37794635	1030	515.0	
2305	chr1	37795309	37795807	498	249.0	
2306	chr1	37807202	37809349	2147	1074.0	
2307	chr1	37810937	37811537	600	300.0	
2308	chr1	37819733	37820247	514	257.0	
2309	chr1	37823147	37823574	427	214.0	
2310	chr1	37825464	37825917	453	226.0	
2311	chr1	37845492	37847176	1684	842.0	
2312	chr1	37850482	37852417	1935	968.0	
2313	chr1	37858778	37860739	1961	980.0	
2314	chr1	37890371	37890819	448	224.0	
2315	chr1	37901231	37902010	779	390.0	
2316	chr1	37922711	37923316	605	302.0	
2317	chr1	37925974	37926569	595	298.0	
2318	chr1	37930480	37932411	1931	966.0	
2319	chr1	37945976	37947818	1842	921.0	
2320	chr1	37975193	37975389	196	98.0	
2321	chr1	37989073	37990795	1722	861.0	
2322	chr1	37994916	37997188	2272	1136.0	
2323	chr1	37999183	38001961	2778	1389.0	
2324	chr1	38003814	38006841	3027	1514.0	
2325	chr1	38009006	38009912	906	453.0	
2326	chr1	38011632	38013564	1932	966.0	
2327	chr1	38018843	38019374	531	266.0	
2328	chr1	38026696	38026971	275	138.0	
2329	chr1	38028034	38028646	612	306.0	
2330	chr1	38029889	38030620	731	366.0	
2331	chr1	38044778	38047812	3034	1517.0	
2332	chr1	38052947	38053482	535	268.0	
2333	chr1	38071889	38072239	350	175.0	
2334	chr1	38173100	38173501	401	200.0	
2335	chr1	38474661	38475694	1033	516.0	
2336	chr1	38489872	38490055	183	92.0	
2337	chr1	38527156	38527799	643	322.0	
2338	chr1	38557508	38557511	3	2.0	
2339	chr1	38558580	38560318	1738	869.0	
2340	chr1	38587008	38587442	434	217.0	
2341	chr1	38818084	38818576	492	246.0	
2342	chr1	38835160	38835659	499	250.0	
2343	chr1	38847984	38848563	579	290.0	
2344	chr1	38858430	38860718	2288	1144.0	
2345	chr1	38872393	38874148	1755	878.0	
2346	chr1	38964198	38964324	126	63.0	
2347	chr1	38977350	38978433	1083	542.0	
2348	chr1	38990399	38993507	3108	1554.0	
2349	chr1	38996283	38997773	1490	745.0	
2350	chr1	39025550	39027381	1831	916.0	
2351	chr1	39034074	39034735	661	330.0	
2352	chr1	39043614	39043901	287	144.0	
2353	chr1	39044829	39044933	104	52.0	
2354	chr1	39063794	39064091	297	148.0	
2355	chr1	39064645	39065133	488	244.0	
2356	chr1	39081151	39082065	914	457.0	
2357	chr1	39092102	39092762	660	330.0	
2358	chr1	39098217	39099174	957	478.0	
2359	chr1	39102357	39103644	1287	644.0	
2360	chr1	39104256	39106623	2367	1184.0	
2361	chr1	39183381	39184760	1379	690.0	
2362	chr1	39191536	39194365	2829	1414.0	
2363	chr1	39195664	39197789	2125	1062.0	
2364	chr1	39204264	39206442	2178	1089.0	
2365	chr1	39214614	39216236	1622	811.0	
2366	chr1	39216757	39216840	83	42.0	
2367	chr1	39230645	39231456	811	406.0	
2368	chr1	39258375	39259250	875	438.0	
2369	chr1	39268099	39268635	536	268.0	
2370	chr1	39269602	39270172	570	285.0	
2371	chr1	39272153	39272525	372	186.0	
2372	chr1	39328015	39328773	758	379.0	
2373	chr1	39360730	39361229	499	250.0	
2374	chr1	39394580	39395823	1243	622.0	
2375	chr1	39398370	39399156	786	393.0	
2376	chr1	39407173	39409860	2687	1344.0	
2377	chr1	39410799	39411352	553	276.0	
2378	chr1	39489049	39490003	954	477.0	
2379	chr1	39490605	39492430	1825	912.0	
2380	chr1	39509011	39509927	916	458.0	
2381	chr1	39525435	39526375	940	470.0	
2382	chr1	39530214	39530514	300	150.0	
2383	chr1	39538953	39539675	722	361.0	
2384	chr1	39540374	39541820	1446	723.0	
2385	chr1	39544347	39544755	408	204.0	
2386	chr1	39558878	39560628	1750	875.0	
2387	chr1	39564346	39564777	431	216.0	
2388	chr1	39566047	39566480	433	216.0	
2389	chr1	39572753	39572788	35	18.0	
2390	chr1	39573783	39577511	3728	1864.0	
2391	chr1	39605916	39606622	706	353.0	
2392	chr1	39609527	39610028	501	250.0	
2393	chr1	39639277	39640240	963	482.0	
2394	chr1	39653449	39653996	547	274.0	
2395	chr1	39657963	39658451	488	244.0	
2396	chr1	39671787	39672977	1190	595.0	
2397	chr1	39683611	39684551	940	470.0	
2398	chr1	39690741	39692917	2176	1088.0	
2399	chr1	39694099	39694241	142	71.0	
2400	chr1	39695152	39695386	234	117.0	
2401	chr1	39701808	39702250	442	221.0	
2402	chr1	39719980	39720471	491	246.0	
2403	chr1	39737382	39739532	2150	1075.0	
2404	chr1	39788115	39789943	1828	914.0	
2405	chr1	39798742	39800270	1528	764.0	
2406	chr1	39803965	39804362	397	198.0	
2407	chr1	39816384	39817948	1564	782.0	
2408	chr1	39825295	39825798	503	252.0	
2409	chr1	39833492	39834358	866	433.0	
2410	chr1	39842833	39843891	1058	529.0	
2411	chr1	39845285	39846514	1229	614.0	
2412	chr1	39875324	39876558	1234	617.0	
2413	chr1	39882880	39884017	1137	568.0	
2414	chr1	39890178	39891010	832	416.0	
2415	chr1	39892807	39893226	419	210.0	
2416	chr1	39898974	39899276	302	151.0	
2417	chr1	39900698	39902845	2147	1074.0	
2418	chr1	39907394	39908064	670	335.0	
2419	chr1	39919427	39919973	546	273.0	
2420	chr1	39925671	39926652	981	490.0	
2421	chr1	39927538	39927852	314	157.0	
2422	chr1	39933872	39935063	1191	596.0	
2423	chr1	39936478	39937421	943	472.0	
2424	chr1	39940178	39941054	876	438.0	
2425	chr1	39954217	39956377	2160	1080.0	
2426	chr1	39958730	39958812	82	41.0	
2427	chr1	39960150	39961209	1059	530.0	
2428	chr1	39964990	39965446	456	228.0	
2429	chr1	39969851	39970247	396	198.0	
2430	chr1	39973408	39973925	517	258.0	
2431	chr1	39992007	39992681	674	337.0	
2432	chr1	39995845	39996396	551	276.0	
2433	chr1	40014144	40014813	669	334.0	
2434	chr1	40032216	40032760	544	272.0	
2435	chr1	40034021	40035406	1385	692.0	
2436	chr1	40036587	40036995	408	204.0	
2437	chr1	40038650	40041732	3082	1541.0	
2438	chr1	40042257	40043145	888	444.0	
2439	chr1	40043646	40044409	763	382.0	
2440	chr1	40049341	40050098	757	378.0	
2441	chr1	40050789	40051534	745	372.0	
2442	chr1	40058843	40060874	2031	1016.0	
2443	chr1	40064643	40065535	892	446.0	
2444	chr1	40075188	40075724	536	268.0	
2445	chr1	40076830	40077254	424	212.0	
2446	chr1	40078448	40079008	560	280.0	
2447	chr1	40079958	40080506	548	274.0	
2448	chr1	40081816	40082230	414	207.0	
2449	chr1	40084636	40085284	648	324.0	
2450	chr1	40093275	40093523	248	124.0	
2451	chr1	40094241	40094914	673	336.0	
2452	chr1	40095803	40097908	2105	1052.0	
2453	chr1	40143797	40144583	786	393.0	
2454	chr1	40152944	40154128	1184	592.0	
2455	chr1	40155143	40155616	473	236.0	
2456	chr1	40160678	40163651	2973	1486.0	
2457	chr1	40164378	40164488	110	55.0	
2458	chr1	40182954	40183330	376	188.0	
2459	chr1	40185881	40186917	1036	518.0	
2460	chr1	40227354	40227491	137	68.0	
2461	chr1	40232394	40232852	458	229.0	
2462	chr1	40241267	40242445	1178	589.0	
2463	chr1	40257143	40258857	1714	857.0	
2464	chr1	40312335	40313803	1468	734.0	
2465	chr1	40314833	40317482	2649	1324.0	
2466	chr1	40338446	40340419	1973	986.0	
2467	chr1	40341635	40342641	1006	503.0	
2468	chr1	40344374	40345037	663	332.0	
2469	chr1	40352107	40352592	485	242.0	
2470	chr1	40353111	40353304	193	96.0	
2471	chr1	40356577	40356978	401	200.0	
2472	chr1	40361296	40361617	321	160.0	
2473	chr1	40363795	40364037	242	121.0	
2474	chr1	40372260	40372263	3	2.0	
2475	chr1	40373001	40375877	2876	1438.0	
2476	chr1	40379406	40379431	25	12.0	
2477	chr1	40380904	40382667	1763	882.0	
2478	chr1	40383224	40390677	7453	3726.0	
2479	chr1	40391567	40392060	493	246.0	
2480	chr1	40393049	40393801	752	376.0	
2481	chr1	40394435	40397588	3153	1576.0	
2482	chr1	40400047	40400722	675	338.0	
2483	chr1	40401613	40401831	218	109.0	
2484	chr1	40404350	40405277	927	464.0	
2485	chr1	40413855	40414690	835	418.0	
2486	chr1	40421270	40422365	1095	548.0	
2487	chr1	40422984	40423858	874	437.0	
2488	chr1	40425164	40425538	374	187.0	
2489	chr1	40438393	40438860	467	234.0	
2490	chr1	40449556	40451623	2067	1034.0	
2491	chr1	40476783	40478144	1361	680.0	
2492	chr1	40508218	40509499	1281	640.0	
2493	chr1	40530923	40533267	2344	1172.0	
2494	chr1	40539247	40539823	576	288.0	
2495	chr1	40574779	40575220	441	220.0	
2496	chr1	40592176	40592591	415	208.0	
2497	chr1	40608127	40608252	125	62.0	
2498	chr1	40612197	40612888	691	346.0	
2499	chr1	40628399	40628859	460	230.0	
2500	chr1	40629534	40630862	1328	664.0	
2501	chr1	40640650	40640783	133	66.0	
2502	chr1	40650004	40650350	346	173.0	
2503	chr1	40663021	40664316	1295	648.0	
2504	chr1	40665029	40666434	1405	702.0	
2505	chr1	40668608	40669325	717	358.0	
2506	chr1	40690363	40692973	2610	1305.0	
2507	chr1	40694301	40694815	514	257.0	
2508	chr1	40698901	40699568	667	334.0	
2509	chr1	40708362	40709783	1421	710.0	
2510	chr1	40711752	40712001	249	124.0	
2511	chr1	40712810	40713724	914	457.0	
2512	chr1	40755229	40755329	100	50.0	
2513	chr1	40774086	40774613	527	264.0	
2514	chr1	40783195	40784436	1241	620.0	
2515	chr1	40795202	40796032	830	415.0	
2516	chr1	40797561	40797599	38	19.0	
2517	chr1	40801666	40804470	2804	1402.0	
2518	chr1	40805065	40805613	548	274.0	
2519	chr1	40809035	40809956	921	460.0	
2520	chr1	40817716	40819423	1707	854.0	
2521	chr1	40820422	40820616	194	97.0	
2522	chr1	40825300	40825818	518	259.0	
2523	chr1	40841068	40841161	93	46.0	
2524	chr1	40845074	40845586	512	256.0	
2525	chr1	40848523	40848896	373	186.0	
2526	chr1	40849603	40850465	862	431.0	
2527	chr1	40860556	40863212	2656	1328.0	
2528	chr1	40875586	40876193	607	304.0	
2529	chr1	40877562	40878090	528	264.0	
2530	chr1	40898306	40898812	506	253.0	
2531	chr1	40905090	40905543	453	226.0	
2532	chr1	40936999	40937052	53	26.0	
2533	chr1	40939762	40940028	266	133.0	
2534	chr1	40948681	40949369	688	344.0	
2535	chr1	40952424	40952920	496	248.0	
2536	chr1	40956404	40956798	394	197.0	
2537	chr1	40971897	40972414	517	258.0	
2538	chr1	40978857	40981331	2474	1237.0	
2539	chr1	41003261	41004359	1098	549.0	
2540	chr1	41013783	41014311	528	264.0	
2541	chr1	41014993	41015142	149	74.0	
2542	chr1	41053246	41053647	401	200.0	
2543	chr1	41104036	41104047	11	6.0	
2544	chr1	41109269	41110334	1065	532.0	
2545	chr1	41240101	41242992	2891	1446.0	
2546	chr1	41268099	41268611	512	256.0	
2547	chr1	41274546	41275533	987	494.0	
2548	chr1	41278035	41278440	405	202.0	
2549	chr1	41282644	41283077	433	216.0	
2550	chr1	41305757	41306196	439	220.0	
2551	chr1	41308510	41308916	406	203.0	
2552	chr1	41313616	41313994	378	189.0	
2553	chr1	41322845	41323266	421	210.0	
2554	chr1	41344281	41344790	509	254.0	
2555	chr1	41353891	41354042	151	76.0	
2556	chr1	41358239	41359167	928	464.0	
2557	chr1	41360230	41364273	4043	2022.0	
2558	chr1	41365372	41368611	3239	1620.0	
2559	chr1	41372156	41372617	461	230.0	
2560	chr1	41380427	41383950	3523	1762.0	
2561	chr1	41395562	41396003	441	220.0	
2562	chr1	41404279	41404666	387	194.0	
2563	chr1	41417016	41417514	498	249.0	
2564	chr1	41428339	41428974	635	318.0	
2565	chr1	41432611	41433354	743	372.0	
2566	chr1	41496195	41496520	325	162.0	
2567	chr1	41515977	41517039	1062	531.0	
2568	chr1	41521382	41521691	309	154.0	
2569	chr1	41573866	41574709	843	422.0	
2570	chr1	41623358	41623385	27	14.0	
2571	chr1	41639439	41640525	1086	543.0	
2572	chr1	41650183	41650566	383	192.0	
2573	chr1	41656110	41656523	413	206.0	
2574	chr1	41658105	41658969	864	432.0	
2575	chr1	41661131	41665352	4221	2110.0	
2576	chr1	41666926	41667720	794	397.0	
2577	chr1	41672503	41674576	2073	1036.0	
2578	chr1	41675711	41675994	283	142.0	
2579	chr1	41678427	41679052	625	312.0	
2580	chr1	41682938	41684657	1719	860.0	
2581	chr1	41689707	41690061	354	177.0	
2582	chr1	41692062	41692366	304	152.0	
2583	chr1	41698927	41699847	920	460.0	
2584	chr1	41709271	41709769	498	249.0	
2585	chr1	41715408	41716133	725	362.0	
2586	chr1	41720830	41721460	630	315.0	
2587	chr1	41723764	41724205	441	220.0	
2588	chr1	41726455	41730031	3576	1788.0	
2589	chr1	41730824	41731225	401	200.0	
2590	chr1	41734715	41735043	328	164.0	
2591	chr1	41738425	41741740	3315	1658.0	
2592	chr1	41745145	41745347	202	101.0	
2593	chr1	41750931	41752820	1889	944.0	
2594	chr1	41753893	41754807	914	457.0	
2595	chr1	41764541	41765631	1090	545.0	
2596	chr1	41766405	41767176	771	386.0	
2597	chr1	41768129	41769210	1081	540.0	
2598	chr1	41771662	41771663	1	0.0	
2599	chr1	41776773	41777126	353	176.0	
2600	chr1	41789535	41790066	531	266.0	
2601	chr1	41791602	41792695	1093	546.0	
2602	chr1	41799766	41800974	1208	604.0	
2603	chr1	41802574	41804582	2008	1004.0	
2604	chr1	41805941	41807530	1589	794.0	
2605	chr1	41809675	41812452	2777	1388.0	
2606	chr1	41851620	41851947	327	164.0	
2607	chr1	41868262	41868887	625	312.0	
2608	chr1	41888590	41889110	520	260.0	
2609	chr1	41890867	41893368	2501	1250.0	
2610	chr1	41894759	41895355	596	298.0	
2611	chr1	41897802	41898934	1132	566.0	
2612	chr1	41901625	41902001	376	188.0	
2613	chr1	41902603	41903002	399	200.0	
2614	chr1	41914463	41914963	500	250.0	
2615	chr1	41915741	41918581	2840	1420.0	
2616	chr1	41919217	41920974	1757	878.0	
2617	chr1	42031215	42031462	247	124.0	
2618	chr1	42034403	42036766	2363	1182.0	
2619	chr1	42053019	42053526	507	254.0	
2620	chr1	42145680	42145695	15	8.0	
2621	chr1	42146804	42147281	477	238.0	
2622	chr1	42157640	42158061	421	210.0	
2623	chr1	42168226	42168716	490	245.0	
2624	chr1	42173140	42173794	654	327.0	
2625	chr1	42176930	42177312	382	191.0	
2626	chr1	42214551	42214677	126	63.0	
2627	chr1	42298532	42298828	296	148.0	
2628	chr1	42314451	42314818	367	184.0	
2629	chr1	42319590	42320457	867	434.0	
2630	chr1	42324435	42324788	353	176.0	
2631	chr1	42333843	42336232	2389	1194.0	
2632	chr1	42344226	42344701	475	238.0	
2633	chr1	42380311	42381246	935	468.0	
2634	chr1	42455560	42457449	1889	944.0	
2635	chr1	42462599	42463966	1367	684.0	
2636	chr1	42529631	42530248	617	308.0	
2637	chr1	42551163	42551602	439	220.0	
2638	chr1	42577902	42578327	425	212.0	
2639	chr1	42657470	42659231	1761	880.0	
2640	chr1	42681018	42685161	4143	2072.0	
2641	chr1	42686456	42689429	2973	1486.0	
2642	chr1	42690516	42691578	1062	531.0	
2643	chr1	42692825	42693348	523	262.0	
2644	chr1	42694995	42695501	506	253.0	
2645	chr1	42700377	42700661	284	142.0	
2646	chr1	42702759	42705583	2824	1412.0	
2647	chr1	42706642	42707027	385	192.0	
2648	chr1	42708436	42708889	453	226.0	
2649	chr1	42736290	42736447	157	78.0	
2650	chr1	42737116	42737669	553	276.0	
2651	chr1	42747093	42747537	444	222.0	
2652	chr1	42748783	42749263	480	240.0	
2653	chr1	42756905	42757410	505	252.0	
2654	chr1	42764257	42764596	339	170.0	
2655	chr1	42765750	42768069	2319	1160.0	
2656	chr1	42777845	42778239	394	197.0	
2657	chr1	42784954	42786046	1092	546.0	
2658	chr1	42815992	42818059	2067	1034.0	
2659	chr1	42834046	42834341	295	148.0	
2660	chr1	42837783	42837846	63	32.0	
2661	chr1	42838390	42838922	532	266.0	
2662	chr1	42845845	42847714	1869	934.0	
2663	chr1	42913286	42914084	798	399.0	
2664	chr1	42916375	42916383	8	4.0	
2665	chr1	42919557	42919799	242	121.0	
2666	chr1	42922659	42925948	3289	1644.0	
2667	chr1	42928222	42928989	767	384.0	
2668	chr1	42929678	42933093	3415	1708.0	
2669	chr1	42933676	42939346	5670	2835.0	
2670	chr1	42940889	42947272	6383	3192.0	
2671	chr1	42949233	42950615	1382	691.0	
2672	chr1	42951233	42959796	8563	4282.0	
2673	chr1	42980323	42980869	546	273.0	
2674	chr1	42993753	42994284	531	266.0	
2675	chr1	43034771	43035140	369	184.0	
2676	chr1	43068068	43068686	618	309.0	
2677	chr1	43073379	43074239	860	430.0	
2678	chr1	43147721	43147969	248	124.0	
2679	chr1	43171663	43173144	1481	740.0	
2680	chr1	43221152	43221681	529	264.0	
2681	chr1	43227153	43227680	527	264.0	
2682	chr1	43239389	43240019	630	315.0	
2683	chr1	43274290	43274806	516	258.0	
2684	chr1	43330161	43330635	474	237.0	
2685	chr1	43348670	43350122	1452	726.0	
2686	chr1	43357961	43359698	1737	868.0	
2687	chr1	43360308	43360311	3	2.0	
2688	chr1	43366369	43369058	2689	1344.0	
2689	chr1	43381395	43382027	632	316.0	
2690	chr1	43389213	43390520	1307	654.0	
2691	chr1	43414539	43415077	538	269.0	
2692	chr1	43450424	43450433	9	4.0	
2693	chr1	43451201	43451209	8	4.0	
2694	chr1	43452891	43455129	2238	1119.0	
2695	chr1	43460846	43461713	867	434.0	
2696	chr1	43529060	43529778	718	359.0	
2697	chr1	43530549	43531902	1353	676.0	
2698	chr1	43565582	43566183	601	300.0	
2699	chr1	43648352	43651267	2915	1458.0	
2700	chr1	43704888	43708308	3420	1710.0	
2701	chr1	43711001	43711441	440	220.0	
2702	chr1	43763362	43763987	625	312.0	
2703	chr1	43781372	43782080	708	354.0	
2704	chr1	43783785	43783999	214	107.0	
2705	chr1	43814456	43814684	228	114.0	
2706	chr1	43831797	43832405	608	304.0	
2707	chr1	43833096	43835260	2164	1082.0	
2708	chr1	43836371	43836952	581	290.0	
2709	chr1	43853267	43854031	764	382.0	
2710	chr1	43865954	43865969	15	8.0	
2711	chr1	43867847	43868599	752	376.0	
2712	chr1	43930782	43930809	27	14.0	
2713	chr1	43933246	43935221	1975	988.0	
2714	chr1	43936159	43936862	703	352.0	
2715	chr1	43945844	43947825	1981	990.0	
2716	chr1	43968359	43968717	358	179.0	
2717	chr1	43969281	43970649	1368	684.0	
2718	chr1	43974024	43976351	2327	1164.0	
2719	chr1	43977829	43981376	3547	1774.0	
2720	chr1	43982714	43983343	629	314.0	
2721	chr1	43990767	43992490	1723	862.0	
2722	chr1	43994875	43995164	289	144.0	
2723	chr1	44005545	44006240	695	348.0	
2724	chr1	44029403	44031799	2396	1198.0	
2725	chr1	44032784	44032919	135	68.0	
2726	chr1	44036356	44037021	665	332.0	enhancer
2727	chr1	44047607	44048304	697	348.0	
2728	chr1	44067760	44067762	2	1.0	
2729	chr1	44068572	44068959	387	194.0	
2730	chr1	44212544	44214258	1714	857.0	
2731	chr1	44217467	44218331	864	432.0	
2732	chr1	44227133	44227659	526	263.0	
2733	chr1	44238041	44238785	744	372.0	
2734	chr1	44261875	44262396	521	260.0	
2735	chr1	44263476	44264254	778	389.0	
2736	chr1	44306205	44306429	224	112.0	
2737	chr1	44318234	44318682	448	224.0	
2738	chr1	44354654	44356010	1356	678.0	
2739	chr1	44378170	44378594	424	212.0	
2740	chr1	44404902	44409239	4337	2168.0	
2741	chr1	44417259	44418511	1252	626.0	
2742	chr1	44423893	44424105	212	106.0	
2743	chr1	44460431	44460863	432	216.0	
2744	chr1	44472637	44472934	297	148.0	
2745	chr1	44484384	44484568	184	92.0	
2746	chr1	44485457	44486330	873	436.0	
2747	chr1	44499118	44499786	668	334.0	
2748	chr1	44519264	44519747	483	242.0	
2749	chr1	44543404	44543767	363	182.0	
2750	chr1	44572086	44572415	329	164.0	
2751	chr1	44595053	44595570	517	258.0	
2752	chr1	44631124	44633248	2124	1062.0	
2753	chr1	44652246	44653494	1248	624.0	
2754	chr1	44655541	44655929	388	194.0	
2755	chr1	44664680	44665093	413	206.0	
2756	chr1	44671964	44675290	3326	1663.0	
2757	chr1	44676235	44677595	1360	680.0	
2758	chr1	44684592	44685013	421	210.0	
2759	chr1	44694923	44695213	290	145.0	
2760	chr1	44696697	44697331	634	317.0	
2761	chr1	44698119	44698664	545	272.0	
2762	chr1	44707673	44708533	860	430.0	
2763	chr1	44713408	44713705	297	148.0	
2764	chr1	44714541	44715750	1209	604.0	
2765	chr1	44719636	44725055	5419	2710.0	
2766	chr1	44729013	44732052	3039	1520.0	
2767	chr1	44738407	44740531	2124	1062.0	
2768	chr1	44774833	44779463	4630	2315.0	
2769	chr1	44783758	44787273	3515	1758.0	
2770	chr1	44793423	44794913	1490	745.0	
2771	chr1	44796660	44797437	777	388.0	
2772	chr1	44798591	44816296	17705	8852.0	
2773	chr1	44817338	44824670	7332	3666.0	
2774	chr1	44826085	44827473	1388	694.0	
2775	chr1	44828001	44828684	683	342.0	
2776	chr1	44829380	44830493	1113	556.0	
2777	chr1	44831392	44832078	686	343.0	
2778	chr1	44833872	44834368	496	248.0	
2779	chr1	44835629	44836470	841	420.0	
2780	chr1	44842788	44843697	909	454.0	
2781	chr1	44973666	44974007	341	170.0	
2782	chr1	44985841	44987307	1466	733.0	
2783	chr1	45000880	45001588	708	354.0	
2784	chr1	45010346	45013156	2810	1405.0	
2785	chr1	45014038	45015203	1165	582.0	
2786	chr1	45018559	45019218	659	330.0	
2787	chr1	45051073	45051607	534	267.0	
2788	chr1	45052988	45053282	294	147.0	
2789	chr1	45205446	45207081	1635	818.0	
2790	chr1	45300162	45300702	540	270.0	
2791	chr1	45303013	45305021	2008	1004.0	
2792	chr1	45326291	45327834	1543	772.0	
2793	chr1	45334298	45334683	385	192.0	
2794	chr1	45339089	45341530	2441	1220.0	
2795	chr1	45342427	45342828	401	200.0	
2796	chr1	45359769	45360408	639	320.0	
2797	chr1	45393471	45394862	1391	696.0	
2798	chr1	45407865	45408223	358	179.0	
2799	chr1	45409302	45409610	308	154.0	
2800	chr1	45412876	45413296	420	210.0	
2801	chr1	45483371	45483906	535	268.0	
2802	chr1	45489485	45493658	4173	2086.0	
2803	chr1	45499327	45501779	2452	1226.0	
2804	chr1	45507113	45509704	2591	1296.0	
2805	chr1	45510228	45510309	81	40.0	
2806	chr1	45512490	45513030	540	270.0	
2807	chr1	45520487	45522752	2265	1132.0	
2808	chr1	45541256	45541523	267	134.0	
2809	chr1	45542546	45545799	3253	1626.0	
2810	chr1	45550255	45551839	1584	792.0	
2811	chr1	45569645	45570686	1041	520.0	
2812	chr1	45582399	45587359	4960	2480.0	
2813	chr1	45589689	45590061	372	186.0	
2814	chr1	45593905	45594262	357	178.0	
2815	chr1	45595059	45595309	250	125.0	
2816	chr1	45599373	45599823	450	225.0	
2817	chr1	45602755	45603122	367	184.0	
2818	chr1	45607231	45609288	2057	1028.0	
2819	chr1	45610231	45611163	932	466.0	
2820	chr1	45613175	45613749	574	287.0	
2821	chr1	45616061	45616468	407	204.0	
2822	chr1	45617590	45617904	314	157.0	
2823	chr1	45619099	45622570	3471	1736.0	
2824	chr1	45623548	45624095	547	274.0	
2825	chr1	45647421	45647858	437	218.0	
2826	chr1	45677042	45677527	485	242.0	
2827	chr1	45685363	45688951	3588	1794.0	
2828	chr1	45722803	45723192	389	194.0	
2829	chr1	45748730	45751311	2581	1290.0	
2830	chr1	45785488	45786038	550	275.0	
2831	chr1	45787948	45788293	345	172.0	
2832	chr1	45802496	45804691	2195	1098.0	
2833	chr1	46003258	46003747	489	244.0	
2834	chr1	46017880	46018492	612	306.0	
2835	chr1	46036816	46037653	837	418.0	
2836	chr1	46043388	46044061	673	336.0	
2837	chr1	46057236	46057375	139	70.0	
2838	chr1	46062557	46063031	474	237.0	
2839	chr1	46065321	46065894	573	286.0	
2840	chr1	46070147	46070934	787	394.0	
2841	chr1	46131596	46133881	2285	1142.0	
2842	chr1	46134909	46135001	92	46.0	
2843	chr1	46166397	46167627	1230	615.0	
2844	chr1	46179278	46180167	889	444.0	
2845	chr1	46183870	46184478	608	304.0	
2846	chr1	46197766	46199122	1356	678.0	
2847	chr1	46202814	46203747	933	466.0	
2848	chr1	46223394	46224064	670	335.0	
2849	chr1	46244880	46245372	492	246.0	
2850	chr1	46246650	46248617	1967	984.0	
2851	chr1	46264957	46265202	245	122.0	
2852	chr1	46300603	46304491	3888	1944.0	
2853	chr1	46333449	46334115	666	333.0	
2854	chr1	46339769	46343039	3270	1635.0	
2855	chr1	46347799	46348750	951	476.0	
2856	chr1	46369707	46370508	801	400.0	
2857	chr1	46373524	46374426	902	451.0	
2858	chr1	46393996	46394881	885	442.0	
2859	chr1	46401666	46402756	1090	545.0	
2860	chr1	46404731	46405243	512	256.0	
2861	chr1	46406088	46406826	738	369.0	
2862	chr1	46413587	46414114	527	264.0	
2863	chr1	46422439	46422835	396	198.0	
2864	chr1	46425155	46425339	184	92.0	
2865	chr1	46442220	46443443	1223	612.0	
2866	chr1	46446798	46447279	481	240.0	
2867	chr1	46448471	46448852	381	190.0	
2868	chr1	46466327	46466971	644	322.0	
2869	chr1	46477314	46477892	578	289.0	
2870	chr1	46489088	46490203	1115	558.0	
2871	chr1	46527780	46528469	689	344.0	
2872	chr1	46532567	46533828	1261	630.0	
2873	chr1	46535078	46535457	379	190.0	
2874	chr1	46547935	46548432	497	248.0	
2875	chr1	46549507	46550446	939	470.0	
2876	chr1	46556861	46557016	155	78.0	
2877	chr1	46580529	46582382	1853	926.0	
2878	chr1	46583107	46583263	156	78.0	
2879	chr1	46586910	46587566	656	328.0	
2880	chr1	46594073	46595951	1878	939.0	
2881	chr1	46603251	46605857	2606	1303.0	
2882	chr1	46613414	46614674	1260	630.0	
2883	chr1	46615271	46617610	2339	1170.0	
2884	chr1	46618775	46618926	151	76.0	
2885	chr1	46667648	46669358	1710	855.0	
2886	chr1	46675526	46676367	841	420.0	
2887	chr1	46699551	46700185	634	317.0	
2888	chr1	46718289	46720219	1930	965.0	
2889	chr1	46724958	46725716	758	379.0	
2890	chr1	46735710	46736111	401	200.0	
2891	chr1	47175250	47175788	538	269.0	
2892	chr1	47179032	47179783	751	376.0	
2893	chr1	47192817	47193377	560	280.0	
2894	chr1	47211808	47212297	489	244.0	
2895	chr1	47224656	47225009	353	176.0	
2896	chr1	47225587	47226207	620	310.0	
2897	chr1	47228764	47228841	77	38.0	
2898	chr1	47230650	47232685	2035	1018.0	
2899	chr1	47235340	47235671	331	166.0	
2900	chr1	47237628	47237783	155	78.0	
2901	chr1	47262833	47263217	384	192.0	
2902	chr1	47289255	47289740	485	242.0	
2903	chr1	47313173	47315157	1984	992.0	
2904	chr1	47332947	47335158	2211	1106.0	
2905	chr1	47388740	47389141	401	200.0	
2906	chr1	47424446	47424755	309	154.0	
2907	chr1	47432057	47434384	2327	1164.0	
2908	chr1	47436066	47439825	3759	1880.0	
2909	chr1	47444311	47445414	1103	552.0	
2910	chr1	47449950	47450295	345	172.0	
2911	chr1	47508095	47508453	358	179.0	
2912	chr1	47709494	47711091	1597	798.0	
2913	chr1	47726212	47726676	464	232.0	
2914	chr1	47997519	47998007	488	244.0	
2915	chr1	48061910	48062078	168	84.0	
2916	chr1	48093650	48094107	457	228.0	
2917	chr1	48120738	48120841	103	52.0	
2918	chr1	48196198	48196628	430	215.0	
2919	chr1	48202094	48202593	499	250.0	
2920	chr1	48227477	48228382	905	452.0	
2921	chr1	48229239	48229762	523	262.0	
2922	chr1	48236792	48237270	478	239.0	
2923	chr1	48242109	48242462	353	176.0	
2924	chr1	48244958	48245750	792	396.0	
2925	chr1	48246676	48247237	561	280.0	
2926	chr1	48469929	48472933	3004	1502.0	
2927	chr1	48498075	48498903	828	414.0	
2928	chr1	48677327	48677688	361	180.0	
2929	chr1	48750049	48750606	557	278.0	
2930	chr1	48767912	48768377	465	232.0	
2931	chr1	48775871	48777603	1732	866.0	
2932	chr1	48789885	48790012	127	64.0	
2933	chr1	48793740	48794367	627	314.0	
2934	chr1	50023835	50024016	181	90.0	
2935	chr1	50109625	50110588	963	482.0	
2936	chr1	50332920	50333980	1060	530.0	
2937	chr1	50348698	50349111	413	206.0	
2938	chr1	50368460	50368787	327	164.0	
2939	chr1	50424077	50424378	301	150.0	
2940	chr1	50450905	50451319	414	207.0	
2941	chr1	50458567	50458900	333	166.0	
2942	chr1	50704085	50704411	326	163.0	
2943	chr1	50724327	50725046	719	360.0	
2944	chr1	50774785	50775147	362	181.0	
2945	chr1	50873285	50874000	715	358.0	
2946	chr1	50959094	50960970	1876	938.0	
2947	chr1	50967583	50970701	3118	1559.0	
2948	chr1	50976288	50979109	2821	1410.0	
2949	chr1	50998758	50999041	283	142.0	
2950	chr1	51170253	51170828	575	288.0	
2951	chr1	51175108	51175839	731	366.0	
2952	chr1	51189369	51189836	467	234.0	
2953	chr1	51190875	51191351	476	238.0	
2954	chr1	51192177	51192627	450	225.0	
2955	chr1	51214658	51215306	648	324.0	
2956	chr1	51234321	51238369	4048	2024.0	
2957	chr1	51240245	51240249	4	2.0	
2958	chr1	51241221	51241291	70	35.0	
2959	chr1	51246993	51247388	395	198.0	
2960	chr1	51265557	51265958	401	200.0	
2961	chr1	51267669	51268721	1052	526.0	
2962	chr1	51284713	51285242	529	264.0	
2963	chr1	51295098	51295131	33	16.0	
2964	chr1	51296419	51297479	1060	530.0	
2965	chr1	51303619	51304312	693	346.0	
2966	chr1	51330354	51331730	1376	688.0	
2967	chr1	51421943	51422417	474	237.0	
2968	chr1	51429970	51429980	10	5.0	
2969	chr1	51433632	51434106	474	237.0	
2970	chr1	51442631	51442739	108	54.0	
2971	chr1	51473819	51474119	300	150.0	
2972	chr1	51490351	51492023	1672	836.0	
2973	chr1	51501138	51501757	619	310.0	
2974	chr1	51504916	51505478	562	281.0	
2975	chr1	51512702	51513012	310	155.0	
2976	chr1	51514452	51521438	6986	3493.0	
2977	chr1	51534910	51535416	506	253.0	
2978	chr1	51548952	51549428	476	238.0	
2979	chr1	51551106	51551422	316	158.0	
2980	chr1	51564130	51564486	356	178.0	
2981	chr1	51569128	51570635	1507	754.0	
2982	chr1	51578313	51578840	527	264.0	
2983	chr1	51606072	51606782	710	355.0	
2984	chr1	51607720	51608075	355	178.0	
2985	chr1	51616722	51618194	1472	736.0	
2986	chr1	51622375	51622902	527	264.0	
2987	chr1	51648281	51648820	539	270.0	
2988	chr1	51666413	51667160	747	374.0	
2989	chr1	51690514	51691140	626	313.0	
2990	chr1	51726591	51727051	460	230.0	
2991	chr1	51728868	51730586	1718	859.0	
2992	chr1	51768910	51769383	473	236.0	
2993	chr1	51863276	51863826	550	275.0	
2994	chr1	51875711	51875715	4	2.0	
2995	chr1	51877346	51879873	2527	1264.0	
2996	chr1	51883261	51883700	439	220.0	
2997	chr1	51896782	51897291	509	254.0	
2998	chr1	51990155	51991042	887	444.0	
2999	chr1	52002076	52002721	645	322.0	
3000	chr1	52032292	52034293	2001	1000.0	
3001	chr1	52054327	52057736	3409	1704.0	
3002	chr1	52071546	52072007	461	230.0	
3003	chr1	52096133	52096609	476	238.0	
3004	chr1	52127378	52128023	645	322.0	
3005	chr1	52139675	52143085	3410	1705.0	
3006	chr1	52145409	52145431	22	11.0	
3007	chr1	52239622	52240023	401	200.0	
3008	chr1	52268376	52268776	400	200.0	
3009	chr1	52296327	52296619	292	146.0	
3010	chr1	52364875	52367099	2224	1112.0	
3011	chr1	52368265	52368981	716	358.0	
3012	chr1	52403364	52405404	2040	1020.0	
3013	chr1	52407059	52407191	132	66.0	
3014	chr1	52419460	52419639	179	90.0	
3015	chr1	52423661	52425236	1575	788.0	
3016	chr1	52523372	52523756	384	192.0	
3017	chr1	52529903	52530276	373	186.0	
3018	chr1	52532682	52533253	571	286.0	
3019	chr1	52533754	52534090	336	168.0	
3020	chr1	52551446	52555275	3829	1914.0	
3021	chr1	52569354	52570036	682	341.0	
3022	chr1	52571835	52572226	391	196.0	
3023	chr1	52588481	52588976	495	248.0	
3024	chr1	52592756	52592995	239	120.0	
3025	chr1	52601580	52604460	2880	1440.0	
3026	chr1	52604978	52605213	235	118.0	
3027	chr1	52631423	52638258	6835	3418.0	
3028	chr1	52641190	52641722	532	266.0	
3029	chr1	52666288	52666735	447	224.0	
3030	chr1	52685943	52686892	949	474.0	
3031	chr1	52697329	52699085	1756	878.0	
3032	chr1	52700844	52701308	464	232.0	
3033	chr1	52702636	52703926	1290	645.0	
3034	chr1	52707006	52708367	1361	680.0	
3035	chr1	52725884	52727596	1712	856.0	
3036	chr1	52842365	52843800	1435	718.0	
3037	chr1	52904841	52905292	451	226.0	
3038	chr1	52919285	52919759	474	237.0	
3039	chr1	52921009	52922259	1250	625.0	
3040	chr1	52926827	52928404	1577	788.0	
3041	chr1	53014600	53015489	889	444.0	
3042	chr1	53062112	53062451	339	170.0	
3043	chr1	53084489	53084929	440	220.0	
3044	chr1	53090789	53091227	438	219.0	
3045	chr1	53106430	53106962	532	266.0	
3046	chr1	53110576	53110867	291	146.0	
3047	chr1	53127421	53127879	458	229.0	
3048	chr1	53135357	53136271	914	457.0	
3049	chr1	53172841	53173242	401	200.0	
3050	chr1	53181914	53182646	732	366.0	
3051	chr1	53185470	53186132	662	331.0	
3052	chr1	53196096	53198697	2601	1300.0	
3053	chr1	53219653	53221275	1622	811.0	
3054	chr1	53237629	53239250	1621	810.0	
3055	chr1	53278132	53278831	699	350.0	
3056	chr1	53292921	53292927	6	3.0	
3057	chr1	53294449	53294888	439	220.0	
3058	chr1	53316110	53316182	72	36.0	
3059	chr1	53325435	53329159	3724	1862.0	
3060	chr1	53330644	53331244	600	300.0	
3061	chr1	53334771	53335242	471	236.0	
3062	chr1	53365847	53366343	496	248.0	
3063	chr1	53367548	53369027	1479	740.0	
3064	chr1	53390164	53390751	587	294.0	
3065	chr1	53393232	53393770	538	269.0	
3066	chr1	53401857	53402203	346	173.0	
3067	chr1	53409765	53410578	813	406.0	
3068	chr1	53412918	53414087	1169	584.0	
3069	chr1	53485447	53485871	424	212.0	
3070	chr1	53509306	53509637	331	166.0	
3071	chr1	53562227	53562691	464	232.0	
3072	chr1	53575060	53575449	389	194.0	
3073	chr1	53581972	53582846	874	437.0	
3074	chr1	53585083	53585761	678	339.0	
3075	chr1	53600079	53600955	876	438.0	
3076	chr1	53738649	53739701	1052	526.0	
3077	chr1	53754769	53754839	70	35.0	
3078	chr1	53765650	53766476	826	413.0	
3079	chr1	53837122	53839254	2132	1066.0	
3080	chr1	53860810	53861497	687	344.0	
3081	chr1	53869661	53869797	136	68.0	
3082	chr1	53889108	53890704	1596	798.0	
3083	chr1	53892644	53893517	873	436.0	
3084	chr1	53944725	53947144	2419	1210.0	
3085	chr1	53948996	53949467	471	236.0	
3086	chr1	53959591	53960103	512	256.0	
3087	chr1	53981978	53982797	819	410.0	
3088	chr1	54047705	54047739	34	17.0	
3089	chr1	54051921	54054782	2861	1430.0	
3090	chr1	54069805	54070512	707	354.0	
3091	chr1	54081591	54082081	490	245.0	
3092	chr1	54095816	54096550	734	367.0	
3093	chr1	54121482	54122143	661	330.0	
3094	chr1	54181717	54182078	361	180.0	
3095	chr1	54199342	54200840	1498	749.0	
3096	chr1	54220278	54221436	1158	579.0	
3097	chr1	54226959	54227711	752	376.0	
3098	chr1	54230678	54231489	811	406.0	
3099	chr1	54238209	54239049	840	420.0	
3100	chr1	54263836	54264061	225	112.0	
3101	chr1	54280671	54280952	281	140.0	
3102	chr1	54282807	54283705	898	449.0	
3103	chr1	54285057	54285633	576	288.0	
3104	chr1	54287100	54287966	866	433.0	
3105	chr1	54289867	54289910	43	22.0	
3106	chr1	54290578	54291177	599	300.0	
3107	chr1	54312797	54313062	265	132.0	
3108	chr1	54356079	54357189	1110	555.0	
3109	chr1	54372992	54373321	329	164.0	
3110	chr1	54376521	54376995	474	237.0	
3111	chr1	54380433	54380936	503	252.0	
3112	chr1	54400587	54400724	137	68.0	
3113	chr1	54403652	54409919	6267	3134.0	
3114	chr1	54413345	54413715	370	185.0	
3115	chr1	54417274	54417620	346	173.0	
3116	chr1	54459680	54460903	1223	612.0	enhancer
3117	chr1	54463872	54465042	1170	585.0	
3118	chr1	54474222	54477871	3649	1824.0	
3119	chr1	54480007	54482075	2068	1034.0	
3120	chr1	54485309	54490776	5467	2734.0	
3121	chr1	54499191	54500033	842	421.0	
3122	chr1	54541764	54543371	1607	804.0	
3123	chr1	54546886	54548299	1413	706.0	
3124	chr1	54567987	54568402	415	208.0	
3125	chr1	54604615	54604853	238	119.0	
3126	chr1	54671945	54672528	583	292.0	
3127	chr1	54715025	54716673	1648	824.0	
3128	chr1	54763852	54765307	1455	728.0	
3129	chr1	54767605	54767964	359	180.0	
3130	chr1	54791883	54792302	419	210.0	
3131	chr1	54798966	54799838	872	436.0	
3132	chr1	54800574	54802022	1448	724.0	
3133	chr1	54804600	54805095	495	248.0	
3134	chr1	54806927	54807969	1042	521.0	
3135	chr1	54810240	54810911	671	336.0	
3136	chr1	54861489	54861705	216	108.0	
3137	chr1	54886010	54888027	2017	1008.0	
3138	chr1	54945039	54945908	869	434.0	
3139	chr1	54948144	54949388	1244	622.0	
3140	chr1	54950564	54951199	635	318.0	
3141	chr1	54959342	54959629	287	144.0	
3142	chr1	54965516	54966513	997	498.0	
3143	chr1	54971182	54971753	571	286.0	
3144	chr1	54995631	54997269	1638	819.0	
3145	chr1	55021950	55022504	554	277.0	
3146	chr1	55035901	55036275	374	187.0	
3147	chr1	55053274	55053556	282	141.0	
3148	chr1	55127819	55129008	1189	594.0	
3149	chr1	55138746	55139161	415	208.0	
3150	chr1	55140452	55141008	556	278.0	
3151	chr1	55150922	55151883	961	480.0	
3152	chr1	55155554	55155909	355	178.0	
3153	chr1	55194785	55196814	2029	1014.0	
3154	chr1	55209227	55209716	489	244.0	
3155	chr1	55210956	55216642	5686	2843.0	
3156	chr1	55217395	55218136	741	370.0	
3157	chr1	55244363	55245207	844	422.0	
3158	chr1	55257810	55258608	798	399.0	
3159	chr1	55260019	55260657	638	319.0	
3160	chr1	55277232	55278030	798	399.0	
3161	chr1	55288273	55288706	433	216.0	
3162	chr1	55338136	55338442	306	153.0	
3163	chr1	55375685	55375910	225	112.0	
3164	chr1	55474190	55474487	297	148.0	
3165	chr1	56249053	56249760	707	354.0	
3166	chr1	56255919	56256357	438	219.0	
3167	chr1	56328975	56329238	263	132.0	
3168	chr1	56330168	56330821	653	326.0	
3169	chr1	56424601	56425676	1075	538.0	
3170	chr1	56433065	56433472	407	204.0	
3171	chr1	56470020	56470088	68	34.0	
3172	chr1	56472791	56473336	545	272.0	
3173	chr1	56477621	56477975	354	177.0	
3174	chr1	56496834	56496932	98	49.0	
3175	chr1	56502523	56503049	526	263.0	
3176	chr1	56506576	56506720	144	72.0	
3177	chr1	56507458	56507543	85	42.0	
3178	chr1	56508430	56508991	561	280.0	
3179	chr1	56511431	56511798	367	184.0	
3180	chr1	56516306	56517476	1170	585.0	
3181	chr1	56525394	56526054	660	330.0	
3182	chr1	56526722	56527172	450	225.0	
3183	chr1	56578475	56579588	1113	556.0	
3184	chr1	56584917	56585284	367	184.0	
3185	chr1	56645218	56645483	265	132.0	
3186	chr1	56774170	56774554	384	192.0	
3187	chr1	56821017	56821441	424	212.0	
3188	chr1	56831846	56832299	453	226.0	
3189	chr1	57307104	57308135	1031	516.0	
3190	chr1	57423981	57424141	160	80.0	
3191	chr1	57986538	57986716	178	89.0	
3192	chr1	58391947	58392750	803	402.0	
3193	chr1	58497487	58497843	356	178.0	
3194	chr1	58515781	58516336	555	278.0	
3195	chr1	58531884	58532168	284	142.0	
3196	chr1	58545367	58547468	2101	1050.0	
3197	chr1	58573730	58574168	438	219.0	
3198	chr1	58576020	58577054	1034	517.0	
3199	chr1	58583472	58583950	478	239.0	
3200	chr1	58584539	58584768	229	114.0	
3201	chr1	58618144	58618940	796	398.0	
3202	chr1	58621397	58621845	448	224.0	
3203	chr1	58652491	58653039	548	274.0	
3204	chr1	58670207	58670598	391	196.0	
3205	chr1	58699143	58700603	1460	730.0	
3206	chr1	58710712	58711030	318	159.0	
3207	chr1	58717925	58718926	1001	500.0	
3208	chr1	58738828	58740452	1624	812.0	
3209	chr1	58754313	58756063	1750	875.0	
3210	chr1	58769221	58769645	424	212.0	
3211	chr1	58773272	58774368	1096	548.0	
3212	chr1	58774886	58787442	12556	6278.0	
3213	chr1	58806159	58806453	294	147.0	
3214	chr1	58812576	58813816	1240	620.0	
3215	chr1	58814849	58817103	2254	1127.0	
3216	chr1	58819892	58820485	593	296.0	
3217	chr1	58833178	58833254	76	38.0	
3218	chr1	58841455	58841885	430	215.0	
3219	chr1	58845991	58846306	315	158.0	
3220	chr1	58854478	58854928	450	225.0	
3221	chr1	58857702	58858614	912	456.0	
3222	chr1	58861541	58861860	319	160.0	
3223	chr1	58881448	58881934	486	243.0	
3224	chr1	58883036	58884318	1282	641.0	
3225	chr1	58884959	58886436	1477	738.0	
3226	chr1	58895299	58897060	1761	880.0	
3227	chr1	58898697	58900351	1654	827.0	
3228	chr1	58903043	58904479	1436	718.0	
3229	chr1	58919927	58920405	478	239.0	
3230	chr1	58922228	58922895	667	334.0	
3231	chr1	58932807	58933316	509	254.0	
3232	chr1	58941444	58943087	1643	822.0	
3233	chr1	58968204	58969059	855	428.0	
3234	chr1	58979197	58979553	356	178.0	
3235	chr1	58987346	58987806	460	230.0	
3236	chr1	59004745	59005921	1176	588.0	
3237	chr1	59013268	59013668	400	200.0	
3238	chr1	59018421	59018902	481	240.0	
3239	chr1	59019859	59021045	1186	593.0	
3240	chr1	59045315	59045716	401	200.0	
3241	chr1	59046449	59047288	839	420.0	
3242	chr1	59057305	59057607	302	151.0	enhancer
3243	chr1	59061769	59062313	544	272.0	
3244	chr1	59063555	59064025	470	235.0	
3245	chr1	59094005	59094296	291	146.0	
3246	chr1	59125076	59125640	564	282.0	
3247	chr1	59138499	59138711	212	106.0	
3248	chr1	59142991	59143425	434	217.0	
3249	chr1	59146415	59147510	1095	548.0	
3250	chr1	59150869	59151308	439	220.0	
3251	chr1	59204048	59204082	34	17.0	
3252	chr1	59266248	59266969	721	360.0	
3253	chr1	59272492	59272885	393	196.0	
3254	chr1	59290142	59290895	753	376.0	
3255	chr1	59292263	59293689	1426	713.0	
3256	chr1	59296069	59297930	1861	930.0	
3257	chr1	59316563	59317259	696	348.0	
3258	chr1	59333806	59334019	213	106.0	
3259	chr1	59367494	59368385	891	446.0	
3260	chr1	59453624	59453941	317	158.0	
3261	chr1	59494296	59494532	236	118.0	
3262	chr1	59498692	59499092	400	200.0	
3263	chr1	59501050	59501260	210	105.0	
3264	chr1	59506871	59507566	695	348.0	
3265	chr1	59549861	59550611	750	375.0	
3266	chr1	59551991	59552422	431	216.0	
3267	chr1	59570403	59570987	584	292.0	
3268	chr1	59580172	59580932	760	380.0	
3269	chr1	59633900	59634124	224	112.0	
3270	chr1	59672871	59675189	2318	1159.0	
3271	chr1	59682552	59683111	559	280.0	
3272	chr1	59688993	59689342	349	174.0	
3273	chr1	59692471	59693915	1444	722.0	
3274	chr1	59696551	59697772	1221	610.0	
3275	chr1	59699200	59699662	462	231.0	
3276	chr1	59718060	59718446	386	193.0	
3277	chr1	59743203	59744164	961	480.0	
3278	chr1	59759157	59759914	757	378.0	
3279	chr1	59814065	59815621	1556	778.0	
3280	chr1	59926250	59927130	880	440.0	
3281	chr1	59947287	59947739	452	226.0	
3282	chr1	59971367	59971754	387	194.0	
3283	chr1	59976820	59977149	329	164.0	
3284	chr1	60573734	60573992	258	129.0	
3285	chr1	60575617	60575843	226	113.0	
3286	chr1	60866856	60867460	604	302.0	
3287	chr1	60890687	60890835	148	74.0	
3288	chr1	60919786	60920167	381	190.0	
3289	chr1	60922351	60922864	513	256.0	
3290	chr1	60943143	60943605	462	231.0	
3291	chr1	60978936	60979363	427	214.0	
3292	chr1	61004171	61004692	521	260.0	
3293	chr1	61017985	61018481	496	248.0	
3294	chr1	61042655	61043766	1111	556.0	
3295	chr1	61049595	61051408	1813	906.0	
3296	chr1	61052244	61054462	2218	1109.0	
3297	chr1	61056714	61058962	2248	1124.0	
3298	chr1	61076356	61080317	3961	1980.0	
3299	chr1	61081002	61084048	3046	1523.0	
3300	chr1	61132232	61133139	907	454.0	
3301	chr1	61139356	61139863	507	254.0	
3302	chr1	61253296	61255712	2416	1208.0	
3303	chr1	61341506	61341758	252	126.0	
3304	chr1	61403855	61404252	397	198.0	
3305	chr1	61452931	61454034	1103	552.0	enhancer
3306	chr1	61588672	61589084	412	206.0	enhancer
3307	chr1	61612589	61612996	407	204.0	
3308	chr1	61638944	61639244	300	150.0	
3309	chr1	61641026	61642173	1147	574.0	
3310	chr1	61670002	61670469	467	234.0	
3311	chr1	61724370	61725880	1510	755.0	
3312	chr1	61736145	61736784	639	320.0	
3313	chr1	61741715	61743525	1810	905.0	
3314	chr1	61744824	61744846	22	11.0	
3315	chr1	61782553	61783213	660	330.0	
3316	chr1	61852070	61852520	450	225.0	
3317	chr1	62131158	62131504	346	173.0	
3318	chr1	62175554	62175959	405	202.0	
3319	chr1	62194051	62195009	958	479.0	
3320	chr1	62209868	62210692	824	412.0	
3321	chr1	62217460	62217773	313	156.0	
3322	chr1	62228166	62228491	325	162.0	
3323	chr1	62271812	62272656	844	422.0	
3324	chr1	62295938	62296339	401	200.0	
3325	chr1	62335656	62336025	369	184.0	
3326	chr1	62352369	62352980	611	306.0	
3327	chr1	62356331	62356980	649	324.0	
3328	chr1	62391602	62391725	123	62.0	
3329	chr1	62407386	62407805	419	210.0	
3330	chr1	62435465	62438616	3151	1576.0	
3331	chr1	62514811	62515407	596	298.0	
3332	chr1	62528035	62528359	324	162.0	
3333	chr1	62676685	62676973	288	144.0	
3334	chr1	62687252	62689061	1809	904.0	
3335	chr1	62716420	62716674	254	127.0	
3336	chr1	62722775	62723226	451	226.0	
3337	chr1	62746522	62746913	391	196.0	
3338	chr1	62759391	62759855	464	232.0	
3339	chr1	62775275	62775514	239	120.0	
3340	chr1	62783265	62784960	1695	848.0	
3341	chr1	62796298	62796624	326	163.0	
3342	chr1	62800255	62801419	1164	582.0	
3343	chr1	62841568	62842007	439	220.0	
3344	chr1	62869725	62870053	328	164.0	
3345	chr1	63314203	63314439	236	118.0	
3346	chr1	63316845	63317806	961	480.0	
3347	chr1	63320044	63320687	643	322.0	
3348	chr1	63321876	63324197	2321	1160.0	
3349	chr1	63327516	63328044	528	264.0	
3350	chr1	63329660	63330553	893	446.0	
3351	chr1	63366920	63368601	1681	840.0	
3352	chr1	63441565	63442178	613	306.0	
3353	chr1	63463086	63463720	634	317.0	
3354	chr1	63522483	63524178	1695	848.0	
3355	chr1	63557426	63557750	324	162.0	
3356	chr1	63575263	63575683	420	210.0	
3357	chr1	63592687	63595039	2352	1176.0	
3358	chr1	63615627	63616235	608	304.0	
3359	chr1	63640545	63641174	629	314.0	
3360	chr1	63651066	63651817	751	376.0	
3361	chr1	63691929	63692278	349	174.0	
3362	chr1	63773692	63774208	516	258.0	
3363	chr1	63891043	63891555	512	256.0	
3364	chr1	63892840	63893532	692	346.0	
3365	chr1	63915160	63915454	294	147.0	
3366	chr1	64019843	64020170	327	164.0	
3367	chr1	64137104	64137479	375	188.0	
3368	chr1	64171709	64172110	401	200.0	
3369	chr1	64243610	64243706	96	48.0	
3370	chr1	64246546	64246662	116	58.0	
3371	chr1	64269060	64269482	422	211.0	
3372	chr1	64320371	64320886	515	258.0	
3373	chr1	64469744	64471658	1914	957.0	
3374	chr1	64505164	64506654	1490	745.0	
3375	chr1	64511004	64511476	472	236.0	
3376	chr1	64512106	64512784	678	339.0	
3377	chr1	64515545	64515746	201	100.0	
3378	chr1	64527291	64527372	81	40.0	
3379	chr1	64540517	64540521	4	2.0	
3380	chr1	64545118	64545544	426	213.0	
3381	chr1	64550541	64550904	363	182.0	
3382	chr1	64686709	64688043	1334	667.0	
3383	chr1	64744198	64746693	2495	1248.0	
3384	chr1	64823980	64824658	678	339.0	
3385	chr1	64826562	64827653	1091	546.0	
3386	chr1	64828835	64829394	559	280.0	
3387	chr1	64842546	64842548	2	1.0	
3388	chr1	64850388	64850412	24	12.0	
3389	chr1	64856564	64856942	378	189.0	
3390	chr1	64861550	64862062	512	256.0	
3391	chr1	64863830	64865717	1887	944.0	
3392	chr1	64876902	64877977	1075	538.0	
3393	chr1	64882457	64883473	1016	508.0	
3394	chr1	64891300	64892006	706	353.0	
3395	chr1	64892527	64893170	643	322.0	
3396	chr1	64895337	64896053	716	358.0	
3397	chr1	64897868	64898774	906	453.0	
3398	chr1	64910628	64910931	303	152.0	
3399	chr1	64917193	64917985	792	396.0	
3400	chr1	64921248	64923819	2571	1286.0	
3401	chr1	64924872	64925849	977	488.0	
3402	chr1	64928130	64928701	571	286.0	
3403	chr1	64933019	64935068	2049	1024.0	
3404	chr1	64939713	64940418	705	352.0	
3405	chr1	64947262	64947277	15	8.0	
3406	chr1	64949159	64949597	438	219.0	
3407	chr1	64950714	64950757	43	22.0	
3408	chr1	64952121	64952435	314	157.0	
3409	chr1	64955133	64957608	2475	1238.0	
3410	chr1	64960175	64963150	2975	1488.0	
3411	chr1	64963697	64968039	4342	2171.0	
3412	chr1	64987291	64988046	755	378.0	
3413	chr1	65001024	65003718	2694	1347.0	
3414	chr1	65010068	65010253	185	92.0	
3415	chr1	65012037	65012242	205	102.0	
3416	chr1	65020846	65021127	281	140.0	
3417	chr1	65041003	65041880	877	438.0	
3418	chr1	65049801	65050587	786	393.0	
3419	chr1	65055671	65056789	1118	559.0	
3420	chr1	65059889	65060370	481	240.0	
3421	chr1	65063037	65063427	390	195.0	
3422	chr1	65064431	65069682	5251	2626.0	
3423	chr1	65075085	65076018	933	466.0	
3424	chr1	65084301	65084416	115	58.0	
3425	chr1	65096942	65097570	628	314.0	
3426	chr1	65147166	65149584	2418	1209.0	
3427	chr1	65163145	65163707	562	281.0	
3428	chr1	65165484	65166054	570	285.0	
3429	chr1	65166897	65167167	270	135.0	
3430	chr1	65170417	65171102	685	342.0	
3431	chr1	65174477	65174971	494	247.0	
3432	chr1	65208638	65209687	1049	524.0	
3433	chr1	65215538	65216065	527	264.0	
3434	chr1	65235868	65236279	411	206.0	
3435	chr1	65243652	65243717	65	32.0	
3436	chr1	65248864	65250185	1321	660.0	
3437	chr1	65253703	65255577	1874	937.0	
3438	chr1	65264430	65264813	383	192.0	
3439	chr1	65265481	65266414	933	466.0	
3440	chr1	65309719	65310127	408	204.0	
3441	chr1	65419453	65422260	2807	1404.0	
3442	chr1	65423942	65424348	406	203.0	
3443	chr1	65431068	65431512	444	222.0	
3444	chr1	65459387	65459653	266	133.0	
3445	chr1	65687620	65688283	663	332.0	
3446	chr1	65765693	65765986	293	146.0	
3447	chr1	65791298	65792062	764	382.0	
3448	chr1	65792590	65794075	1485	742.0	
3449	chr1	65811824	65812610	786	393.0	
3450	chr1	65821025	65821773	748	374.0	
3451	chr1	65845692	65845905	213	106.0	
3452	chr1	65958576	65959290	714	357.0	
3453	chr1	66182601	66182864	263	132.0	
3454	chr1	66214911	66215344	433	216.0	
3455	chr1	66242577	66243146	569	284.0	
3456	chr1	66246858	66248021	1163	582.0	
3457	chr1	66250369	66250948	579	290.0	
3458	chr1	66251476	66252098	622	311.0	
3459	chr1	66253231	66253745	514	257.0	
3460	chr1	66270537	66271699	1162	581.0	
3461	chr1	66274609	66276734	2125	1062.0	
3462	chr1	66278201	66278762	561	280.0	
3463	chr1	66282059	66282915	856	428.0	
3464	chr1	66283733	66283936	203	102.0	
3465	chr1	66295965	66296741	776	388.0	
3466	chr1	66300863	66301663	800	400.0	
3467	chr1	66302758	66303212	454	227.0	
3468	chr1	66315643	66316061	418	209.0	
3469	chr1	66316692	66317308	616	308.0	
3470	chr1	66327548	66328680	1132	566.0	
3471	chr1	66330135	66337784	7649	3824.0	
3472	chr1	66339988	66340312	324	162.0	
3473	chr1	66342525	66343213	688	344.0	
3474	chr1	66345878	66346070	192	96.0	
3475	chr1	66346935	66347134	199	100.0	
3476	chr1	66349245	66350786	1541	770.0	
3477	chr1	66351430	66352727	1297	648.0	
3478	chr1	66356022	66356028	6	3.0	
3479	chr1	66357442	66358131	689	344.0	
3480	chr1	66367447	66367780	333	166.0	
3481	chr1	66370349	66371585	1236	618.0	
3482	chr1	66372439	66375288	2849	1424.0	
3483	chr1	66380072	66380916	844	422.0	
3484	chr1	66383533	66384007	474	237.0	
3485	chr1	66393456	66394332	876	438.0	
3486	chr1	66395045	66397668	2623	1312.0	
3487	chr1	66402050	66402632	582	291.0	
3488	chr1	66411353	66411751	398	199.0	
3489	chr1	66415753	66416694	941	470.0	
3490	chr1	66420219	66420627	408	204.0	
3491	chr1	66436365	66436929	564	282.0	
3492	chr1	66438868	66439680	812	406.0	
3493	chr1	66445380	66447005	1625	812.0	
3494	chr1	66533337	66534038	701	350.0	
3495	chr1	66564162	66564796	634	317.0	
3496	chr1	66648863	66649298	435	218.0	
3497	chr1	66725819	66726467	648	324.0	
3498	chr1	66732667	66733250	583	292.0	
3499	chr1	66739362	66739707	345	172.0	
3500	chr1	66751930	66752984	1054	527.0	
3501	chr1	66758214	66758509	295	148.0	
3502	chr1	66761219	66761620	401	200.0	
3503	chr1	66764942	66765427	485	242.0	
3504	chr1	66769504	66770057	553	276.0	
3505	chr1	66788588	66788885	297	148.0	
3506	chr1	66840964	66841221	257	128.0	
3507	chr1	66923952	66926111	2159	1080.0	
3508	chr1	66929213	66932112	2899	1450.0	
3509	chr1	66933865	66934800	935	468.0	
3510	chr1	66981249	66982270	1021	510.0	
3511	chr1	66995948	66996505	557	278.0	
3512	chr1	67052665	67054893	2228	1114.0	
3513	chr1	67110386	67110637	251	126.0	
3514	chr1	67112459	67112839	380	190.0	
3515	chr1	67134786	67135138	352	176.0	
3516	chr1	67142834	67143319	485	242.0	
3517	chr1	67144728	67145155	427	214.0	
3518	chr1	67148751	67149606	855	428.0	
3519	chr1	67163026	67163246	220	110.0	
3520	chr1	67166107	67166675	568	284.0	
3521	chr1	67170578	67172489	1911	956.0	
3522	chr1	67194093	67195168	1075	538.0	
3523	chr1	67211519	67212439	920	460.0	
3524	chr1	67214350	67214763	413	206.0	
3525	chr1	67226519	67227156	637	318.0	
3526	chr1	67233940	67234389	449	224.0	
3527	chr1	67261681	67262079	398	199.0	
3528	chr1	67274594	67275119	525	262.0	
3529	chr1	67294890	67295262	372	186.0	
3530	chr1	67307084	67308458	1374	687.0	
3531	chr1	67312670	67313003	333	166.0	
3532	chr1	67317951	67318122	171	86.0	
3533	chr1	67323140	67323448	308	154.0	
3534	chr1	67332661	67333712	1051	526.0	
3535	chr1	67336146	67337320	1174	587.0	
3536	chr1	67338635	67339041	406	203.0	
3537	chr1	67341980	67342721	741	370.0	
3538	chr1	67347718	67348042	324	162.0	
3539	chr1	67359628	67359942	314	157.0	
3540	chr1	67427474	67427675	201	100.0	
3541	chr1	67428623	67431841	3218	1609.0	
3542	chr1	67433841	67434344	503	252.0	
3543	chr1	67446060	67446360	300	150.0	
3544	chr1	67489918	67489971	53	26.0	
3545	chr1	67500321	67501041	720	360.0	
3546	chr1	67532382	67532807	425	212.0	
3547	chr1	67535355	67535831	476	238.0	
3548	chr1	67560716	67562114	1398	699.0	
3549	chr1	67590371	67590618	247	124.0	
3550	chr1	67635192	67635706	514	257.0	
3551	chr1	67674180	67675124	944	472.0	
3552	chr1	67683306	67687130	3824	1912.0	
3553	chr1	67687920	67687935	15	8.0	
3554	chr1	67688699	67689280	581	290.0	
3555	chr1	67695133	67695152	19	10.0	
3556	chr1	67736024	67736723	699	350.0	
3557	chr1	67760166	67760695	529	264.0	
3558	chr1	67766077	67766884	807	404.0	
3559	chr1	67832021	67832323	302	151.0	
3560	chr1	67833276	67833626	350	175.0	
3561	chr1	68116659	68117017	358	179.0	
3562	chr1	68120155	68120571	416	208.0	
3563	chr1	68213764	68214253	489	244.0	
3564	chr1	68228960	68229332	372	186.0	
3565	chr1	68231042	68232968	1926	963.0	
3566	chr1	68269106	68269248	142	71.0	
3567	chr1	68270732	68271432	700	350.0	
3568	chr1	68338074	68338758	684	342.0	
3569	chr1	68339531	68339873	342	171.0	
3570	chr1	68342711	68343118	407	204.0	
3571	chr1	68347333	68347867	534	267.0	
3572	chr1	68361363	68361762	399	200.0	
3573	chr1	68384393	68384761	368	184.0	
3574	chr1	68429353	68429885	532	266.0	
3575	chr1	68443027	68443470	443	222.0	
3576	chr1	68496094	68497749	1655	828.0	
3577	chr1	69567090	69567491	401	200.0	
3578	chr1	69688172	69688636	464	232.0	
3579	chr1	69911035	69911827	792	396.0	
3580	chr1	70132889	70133383	494	247.0	
3581	chr1	70204739	70206431	1692	846.0	
3582	chr1	70219953	70220297	344	172.0	
3583	chr1	70220855	70222355	1500	750.0	
3584	chr1	70223297	70223610	313	156.0	
3585	chr1	70227488	70227877	389	194.0	
3586	chr1	70353470	70356368	2898	1449.0	
3587	chr1	70410192	70412872	2680	1340.0	
3588	chr1	70487881	70488269	388	194.0	
3589	chr1	70509997	70510475	478	239.0	
3590	chr1	70528822	70529073	251	126.0	
3591	chr1	70685258	70685745	487	244.0	
3592	chr1	70948670	70948937	267	134.0	
3593	chr1	70979853	70980280	427	214.0	
3594	chr1	71046397	71048432	2035	1018.0	
3595	chr1	71049920	71050429	509	254.0	
3596	chr1	71080111	71081833	1722	861.0	
3597	chr1	71414069	71414485	416	208.0	
3598	chr1	72281117	72285494	4377	2188.0	
3599	chr1	72366464	72366865	401	200.0	
3600	chr1	72623222	72623784	562	281.0	
3601	chr1	72635641	72636213	572	286.0	
3602	chr1	73516466	73516849	383	192.0	
3603	chr1	73593625	73593699	74	37.0	
3604	chr1	74010237	74010522	285	142.0	
3605	chr1	74197364	74199905	2541	1270.0	
3606	chr1	74579434	74579768	334	167.0	
3607	chr1	74652797	74653132	335	168.0	
3608	chr1	74689862	74690195	333	166.0	
3609	chr1	74732317	74734326	2009	1004.0	
3610	chr1	74771933	74772265	332	166.0	
3611	chr1	75233388	75233556	168	84.0	
3612	chr1	75614796	75614826	30	15.0	
3613	chr1	75615532	75616018	486	243.0	
3614	chr1	75723869	75725347	1478	739.0	
3615	chr1	75726859	75727043	184	92.0	
3616	chr1	75745167	75745839	672	336.0	
3617	chr1	75784209	75787908	3699	1850.0	
3618	chr1	75790738	75791382	644	322.0	
3619	chr1	75991500	75991943	443	222.0	
3620	chr1	76074097	76076540	2443	1222.0	
3621	chr1	76154027	76155255	1228	614.0	
3622	chr1	76267635	76268114	479	240.0	
3623	chr1	76270288	76270933	645	322.0	
3624	chr1	76285810	76286149	339	170.0	
3625	chr1	76294428	76294975	547	274.0	
3626	chr1	76330982	76331390	408	204.0	
3627	chr1	76868357	76868401	44	22.0	
3628	chr1	76901171	76901555	384	192.0	
3629	chr1	76906396	76906495	99	50.0	
3630	chr1	77048242	77048694	452	226.0	
3631	chr1	77059983	77060287	304	152.0	
3632	chr1	77126191	77126616	425	212.0	
3633	chr1	77148271	77148519	248	124.0	
3634	chr1	77218626	77219874	1248	624.0	
3635	chr1	77238558	77238762	204	102.0	
3636	chr1	77279913	77280377	464	232.0	
3637	chr1	77281585	77283213	1628	814.0	
3638	chr1	77309252	77309362	110	55.0	
3639	chr1	77312485	77312772	287	144.0	
3640	chr1	77313459	77314071	612	306.0	
3641	chr1	77350398	77350632	234	117.0	
3642	chr1	77388680	77389152	472	236.0	
3643	chr1	77412086	77412723	637	318.0	
3644	chr1	77413295	77414221	926	463.0	
3645	chr1	77415420	77416136	716	358.0	
3646	chr1	77421501	77421928	427	214.0	
3647	chr1	77430863	77432183	1320	660.0	
3648	chr1	77476358	77477012	654	327.0	
3649	chr1	77482716	77483114	398	199.0	
3650	chr1	77496997	77497336	339	170.0	
3651	chr1	77505019	77505347	328	164.0	
3652	chr1	77515424	77515746	322	161.0	
3653	chr1	77533620	77534890	1270	635.0	
3654	chr1	77681589	77684207	2618	1309.0	
3655	chr1	77687531	77688195	664	332.0	
3656	chr1	77748409	77748833	424	212.0	
3657	chr1	77756330	77756394	64	32.0	
3658	chr1	77758785	77760384	1599	800.0	
3659	chr1	77761978	77762403	425	212.0	
3660	chr1	77779063	77780413	1350	675.0	
3661	chr1	77825079	77825769	690	345.0	
3662	chr1	77888648	77889400	752	376.0	
3663	chr1	77926591	77927071	480	240.0	
3664	chr1	77970810	77970833	23	12.0	
3665	chr1	77971796	77971798	2	1.0	
3666	chr1	77972352	77972832	480	240.0	
3667	chr1	77973975	77974251	276	138.0	
3668	chr1	77975299	77980547	5248	2624.0	
3669	chr1	78003274	78006063	2789	1394.0	
3670	chr1	78045735	78046610	875	438.0	
3671	chr1	78114131	78114830	699	350.0	
3672	chr1	78130774	78131150	376	188.0	
3673	chr1	78142938	78143607	669	334.0	
3674	chr1	78145035	78145459	424	212.0	
3675	chr1	78608056	78608086	30	15.0	
3676	chr1	78617260	78618175	915	458.0	
3677	chr1	78619355	78621054	1699	850.0	
3678	chr1	78645677	78646196	519	260.0	
3679	chr1	78648422	78648613	191	96.0	
3680	chr1	78649363	78651836	2473	1236.0	
3681	chr1	78676349	78676776	427	214.0	
3682	chr1	78912022	78912306	284	142.0	
3683	chr1	79052866	79053253	387	194.0	
3684	chr1	79711123	79711242	119	60.0	
3685	chr1	80925169	80925874	705	352.0	
3686	chr1	81121292	81121723	431	216.0	
3687	chr1	81125584	81126158	574	287.0	
3688	chr1	81208310	81208931	621	310.0	
3689	chr1	82225327	82226230	903	452.0	
3690	chr1	83508285	83508899	614	307.0	
3691	chr1	83692641	83693152	511	256.0	
3692	chr1	83760799	83761551	752	376.0	
3693	chr1	83810265	83810448	183	92.0	
3694	chr1	83818555	83819619	1064	532.0	
3695	chr1	83860318	83861374	1056	528.0	
3696	chr1	83931641	83932090	449	224.0	
3697	chr1	83998429	83999728	1299	650.0	
3698	chr1	84077240	84079050	1810	905.0	
3699	chr1	84090289	84091317	1028	514.0	
3700	chr1	84103427	84103723	296	148.0	
3701	chr1	84122817	84123214	397	198.0	
3702	chr1	84141168	84141577	409	204.0	
3703	chr1	84143976	84145625	1649	824.0	
3704	chr1	84146620	84146743	123	62.0	
3705	chr1	84147967	84148234	267	134.0	
3706	chr1	84152406	84153098	692	346.0	
3707	chr1	84156138	84156697	559	280.0	
3708	chr1	84159565	84159966	401	200.0	
3709	chr1	84164703	84164864	161	80.0	
3710	chr1	84247424	84247827	403	202.0	
3711	chr1	84271338	84271996	658	329.0	
3712	chr1	84298055	84299671	1616	808.0	
3713	chr1	84301204	84301837	633	316.0	
3714	chr1	84302389	84303569	1180	590.0	
3715	chr1	84365678	84366170	492	246.0	
3716	chr1	84379373	84379519	146	73.0	
3717	chr1	84388789	84389285	496	248.0	
3718	chr1	84403346	84403746	400	200.0	
3719	chr1	84425440	84425918	478	239.0	
3720	chr1	84433280	84436068	2788	1394.0	
3721	chr1	84437200	84437766	566	283.0	
3722	chr1	84442111	84443629	1518	759.0	
3723	chr1	84450825	84451352	527	264.0	
3724	chr1	84459923	84460494	571	286.0	
3725	chr1	84478827	84480269	1442	721.0	
3726	chr1	84503662	84507319	3657	1828.0	
3727	chr1	84538759	84538941	182	91.0	
3728	chr1	84572809	84575198	2389	1194.0	
3729	chr1	84583255	84583577	322	161.0	
3730	chr1	84611723	84612073	350	175.0	
3731	chr1	84619579	84619679	100	50.0	
3732	chr1	84620430	84621570	1140	570.0	
3733	chr1	84668184	84668585	401	200.0	
3734	chr1	84688662	84691503	2841	1420.0	
3735	chr1	84692621	84693741	1120	560.0	
3736	chr1	84700024	84700504	480	240.0	
3737	chr1	84704920	84705224	304	152.0	
3738	chr1	84724276	84724785	509	254.0	
3739	chr1	84753344	84753977	633	316.0	
3740	chr1	84758966	84759486	520	260.0	
3741	chr1	84772098	84772943	845	422.0	
3742	chr1	84779822	84780449	627	314.0	
3743	chr1	84782179	84782922	743	372.0	
3744	chr1	84847210	84847595	385	192.0	
3745	chr1	84853760	84855054	1294	647.0	
3746	chr1	84861469	84861939	470	235.0	
3747	chr1	84862612	84863455	843	422.0	
3748	chr1	84876150	84876784	634	317.0	
3749	chr1	84889219	84889851	632	316.0	
3750	chr1	84892535	84893602	1067	534.0	
3751	chr1	84930409	84930585	176	88.0	
3752	chr1	84935971	84936683	712	356.0	
3753	chr1	84944409	84946235	1826	913.0	
3754	chr1	84959293	84959802	509	254.0	
3755	chr1	84972017	84972935	918	459.0	
3756	chr1	84973526	84974299	773	386.0	
3757	chr1	84975038	84975322	284	142.0	
3758	chr1	84988540	84989119	579	290.0	
3759	chr1	84991344	84992038	694	347.0	
3760	chr1	84995236	84999492	4256	2128.0	
3761	chr1	85027151	85028192	1041	520.0	
3762	chr1	85047345	85049064	1719	860.0	
3763	chr1	85049619	85050114	495	248.0	
3764	chr1	85050652	85051219	567	284.0	
3765	chr1	85058061	85058665	604	302.0	
3766	chr1	85061699	85062913	1214	607.0	
3767	chr1	85091835	85092014	179	90.0	
3768	chr1	85109351	85109798	447	224.0	
3769	chr1	85179473	85179976	503	252.0	
3770	chr1	85200005	85202376	2371	1186.0	
3771	chr1	85254716	85255173	457	228.0	
3772	chr1	85258590	85260365	1775	888.0	
3773	chr1	85274799	85277613	2814	1407.0	
3774	chr1	85278668	85279694	1026	513.0	
3775	chr1	85297797	85298790	993	496.0	
3776	chr1	85308038	85308582	544	272.0	
3777	chr1	85464496	85465185	689	344.0	
3778	chr1	85576778	85577357	579	290.0	
3779	chr1	85707428	85709173	1745	872.0	
3780	chr1	86061637	86062052	415	208.0	
3781	chr1	86137275	86137988	713	356.0	
3782	chr1	86155198	86157122	1924	962.0	
3783	chr1	86324117	86324518	401	200.0	
3784	chr1	86339274	86339863	589	294.0	
3785	chr1	86365904	86366261	357	178.0	
3786	chr1	86380195	86380765	570	285.0	
3787	chr1	86382957	86383316	359	180.0	
3788	chr1	86389217	86389947	730	365.0	
3789	chr1	86395178	86397366	2188	1094.0	
3790	chr1	86419245	86419911	666	333.0	
3791	chr1	86429699	86430448	749	374.0	
3792	chr1	86441603	86441899	296	148.0	
3793	chr1	86474019	86474472	453	226.0	
3794	chr1	86499929	86500460	531	266.0	
3795	chr1	86501844	86504352	2508	1254.0	
3796	chr1	86507953	86508425	472	236.0	
3797	chr1	86616810	86617421	611	306.0	
3798	chr1	86703530	86706526	2996	1498.0	
3799	chr1	86714351	86714711	360	180.0	
3800	chr1	86739704	86740549	845	422.0	
3801	chr1	86741950	86742364	414	207.0	
3802	chr1	86755846	86755961	115	58.0	
3803	chr1	86768262	86768596	334	167.0	
3804	chr1	86773270	86775116	1846	923.0	
3805	chr1	86778461	86778615	154	77.0	
3806	chr1	86780958	86781292	334	167.0	
3807	chr1	86787704	86789261	1557	778.0	
3808	chr1	86833504	86834051	547	274.0	
3809	chr1	86846347	86846386	39	20.0	
3810	chr1	86866060	86866670	610	305.0	
3811	chr1	86913316	86916125	2809	1404.0	
3812	chr1	86965264	86965428	164	82.0	
3813	chr1	87044569	87046384	1815	908.0	
3814	chr1	87057610	87058185	575	288.0	
3815	chr1	87061863	87062159	296	148.0	
3816	chr1	87084282	87084649	367	184.0	
3817	chr1	87131643	87132749	1106	553.0	
3818	chr1	87147325	87147560	235	118.0	
3819	chr1	87148604	87149141	537	268.0	
3820	chr1	87151421	87152482	1061	530.0	
3821	chr1	87176151	87176901	750	375.0	
3822	chr1	87180129	87180327	198	99.0	
3823	chr1	87203027	87203157	130	65.0	
3824	chr1	87219683	87219986	303	152.0	
3825	chr1	87226185	87226674	489	244.0	
3826	chr1	87231763	87232371	608	304.0	
3827	chr1	87286935	87287383	448	224.0	
3828	chr1	87292895	87293312	417	208.0	
3829	chr1	87296181	87296668	487	244.0	
3830	chr1	87299699	87300016	317	158.0	
3831	chr1	87301519	87301778	259	130.0	
3832	chr1	87305029	87305597	568	284.0	
3833	chr1	87314034	87314606	572	286.0	
3834	chr1	87318041	87318492	451	226.0	
3835	chr1	87325868	87326599	731	366.0	
3836	chr1	87327612	87332582	4970	2485.0	enhancer
3837	chr1	87333449	87335979	2530	1265.0	
3838	chr1	87336529	87336917	388	194.0	
3839	chr1	87404243	87404681	438	219.0	
3840	chr1	87423428	87424382	954	477.0	
3841	chr1	87449367	87449952	585	292.0	
3842	chr1	87588663	87588763	100	50.0	
3843	chr1	87826561	87827104	543	272.0	
3844	chr1	87830357	87830955	598	299.0	
3845	chr1	87864662	87865108	446	223.0	
3846	chr1	87869477	87870291	814	407.0	
3847	chr1	87902702	87903426	724	362.0	
3848	chr1	87953715	87954185	470	235.0	
3849	chr1	88180479	88180926	447	224.0	
3850	chr1	88191889	88192277	388	194.0	
3851	chr1	88595382	88595681	299	150.0	
3852	chr1	88608279	88608493	214	107.0	
3853	chr1	88655683	88656030	347	174.0	
3854	chr1	88682917	88685633	2716	1358.0	
3855	chr1	88700350	88702245	1895	948.0	
3856	chr1	88726818	88727111	293	146.0	
3857	chr1	88730078	88730682	604	302.0	
3858	chr1	88736582	88737083	501	250.0	
3859	chr1	88800354	88800842	488	244.0	
3860	chr1	88801814	88802235	421	210.0	
3861	chr1	88847784	88849416	1632	816.0	
3862	chr1	88851002	88852504	1502	751.0	
3863	chr1	88857897	88857921	24	12.0	
3864	chr1	88862266	88863072	806	403.0	
3865	chr1	88866044	88867075	1031	516.0	
3866	chr1	88867840	88870183	2343	1172.0	
3867	chr1	88870856	88871680	824	412.0	
3868	chr1	88873408	88874772	1364	682.0	
3869	chr1	88875375	88875876	501	250.0	
3870	chr1	88877312	88881480	4168	2084.0	
3871	chr1	88882005	88884258	2253	1126.0	
3872	chr1	88885004	88885397	393	196.0	
3873	chr1	88888601	88893133	4532	2266.0	
3874	chr1	88935911	88936344	433	216.0	
3875	chr1	88973494	88974098	604	302.0	
3876	chr1	88974850	88974955	105	52.0	
3877	chr1	88983597	88984674	1077	538.0	
3878	chr1	88991339	88994566	3227	1614.0	
3879	chr1	88998612	88999190	578	289.0	
3880	chr1	89021254	89023353	2099	1050.0	
3881	chr1	89034030	89034358	328	164.0	
3882	chr1	89041349	89041371	22	11.0	
3883	chr1	89046789	89047117	328	164.0	
3884	chr1	89049855	89050129	274	137.0	
3885	chr1	89064014	89065930	1916	958.0	
3886	chr1	89069903	89070729	826	413.0	
3887	chr1	89080933	89081375	442	221.0	
3888	chr1	89085764	89086194	430	215.0	
3889	chr1	89124550	89130023	5473	2736.0	
3890	chr1	89197738	89201731	3993	1996.0	
3891	chr1	89206574	89206641	67	34.0	
3892	chr1	89257046	89257407	361	180.0	
3893	chr1	89259141	89260414	1273	636.0	
3894	chr1	89269238	89269636	398	199.0	
3895	chr1	89271577	89275053	3476	1738.0	
3896	chr1	89277665	89279882	2217	1108.0	
3897	chr1	89285475	89287734	2259	1130.0	
3898	chr1	89295187	89295624	437	218.0	
3899	chr1	89310466	89310991	525	262.0	
3900	chr1	89311685	89312162	477	238.0	
3901	chr1	89351270	89352576	1306	653.0	
3902	chr1	89354169	89355269	1100	550.0	
3903	chr1	89358201	89358974	773	386.0	
3904	chr1	89407334	89408199	865	432.0	
3905	chr1	89429058	89429518	460	230.0	
3906	chr1	89451250	89451255	5	2.0	
3907	chr1	89454916	89455591	675	338.0	
3908	chr1	89460300	89460701	401	200.0	
3909	chr1	89464077	89464400	323	162.0	
3910	chr1	89465434	89465718	284	142.0	
3911	chr1	89466260	89466902	642	321.0	
3912	chr1	89483184	89483709	525	262.0	
3913	chr1	89489014	89489566	552	276.0	
3914	chr1	89519736	89520228	492	246.0	
3915	chr1	89523705	89526453	2748	1374.0	
3916	chr1	89538264	89538641	377	188.0	
3917	chr1	89552522	89553235	713	356.0	
3918	chr1	89557161	89557456	295	148.0	
3919	chr1	89566638	89567304	666	333.0	
3920	chr1	89592720	89593306	586	293.0	
3921	chr1	89598976	89599619	643	322.0	
3922	chr1	89606396	89612160	5764	2882.0	
3923	chr1	89615889	89616372	483	242.0	
3924	chr1	89620801	89620946	145	72.0	
3925	chr1	89622890	89623277	387	194.0	
3926	chr1	89626753	89627298	545	272.0	
3927	chr1	89629853	89634646	4793	2396.0	
3928	chr1	89635348	89636459	1111	556.0	
3929	chr1	89657508	89658425	917	458.0	
3930	chr1	89659368	89660349	981	490.0	
3931	chr1	89669176	89671016	1840	920.0	
3932	chr1	89681061	89681510	449	224.0	
3933	chr1	89692543	89695038	2495	1248.0	
3934	chr1	89696088	89696665	577	288.0	
3935	chr1	89698685	89699879	1194	597.0	
3936	chr1	89706419	89707124	705	352.0	
3937	chr1	89719403	89720313	910	455.0	
3938	chr1	89721232	89721789	557	278.0	
3939	chr1	89723825	89726005	2180	1090.0	
3940	chr1	89728486	89728513	27	14.0	
3941	chr1	89739243	89740270	1027	514.0	
3942	chr1	89753792	89755018	1226	613.0	
3943	chr1	89755597	89755989	392	196.0	
3944	chr1	89757069	89758351	1282	641.0	
3945	chr1	89760466	89760895	429	214.0	
3946	chr1	89762364	89764003	1639	820.0	
3947	chr1	89780664	89781092	428	214.0	
3948	chr1	89781686	89782198	512	256.0	
3949	chr1	89799424	89799918	494	247.0	
3950	chr1	89804402	89805207	805	402.0	
3951	chr1	89812933	89813236	303	152.0	
3952	chr1	89815475	89816282	807	404.0	
3953	chr1	89820273	89824200	3927	1964.0	
3954	chr1	89831782	89831877	95	48.0	
3955	chr1	89832805	89832864	59	30.0	
3956	chr1	89842703	89845270	2567	1284.0	
3957	chr1	89846348	89846624	276	138.0	
3958	chr1	89847164	89847630	466	233.0	
3959	chr1	89854430	89856248	1818	909.0	
3960	chr1	89863202	89863650	448	224.0	
3961	chr1	89870890	89871283	393	196.0	
3962	chr1	89890493	89891185	692	346.0	
3963	chr1	89904211	89904544	333	166.0	
3964	chr1	89906596	89907047	451	226.0	
3965	chr1	89908567	89909498	931	466.0	
3966	chr1	89940976	89941572	596	298.0	
3967	chr1	89942493	89943522	1029	514.0	
3968	chr1	89953146	89953547	401	200.0	
3969	chr1	89957054	89957435	381	190.0	
3970	chr1	89966639	89967036	397	198.0	
3971	chr1	89975169	89976062	893	446.0	
3972	chr1	89987071	89987829	758	379.0	
3973	chr1	89994464	89996189	1725	862.0	
3974	chr1	90000891	90001387	496	248.0	
3975	chr1	90027400	90027725	325	162.0	
3976	chr1	90325045	90325741	696	348.0	
3977	chr1	90706930	90707101	171	86.0	
3978	chr1	90717537	90718271	734	367.0	
3979	chr1	90721357	90721822	465	232.0	
3980	chr1	90723205	90723978	773	386.0	
3981	chr1	90730266	90730985	719	360.0	
3982	chr1	90834703	90836696	1993	996.0	
3983	chr1	90850553	90852244	1691	846.0	
3984	chr1	90959612	90960013	401	200.0	
3985	chr1	90983701	90984211	510	255.0	
3986	chr1	90989760	90990697	937	468.0	
3987	chr1	91006195	91006480	285	142.0	
3988	chr1	91011751	91012596	845	422.0	
3989	chr1	91013301	91013542	241	120.0	
3990	chr1	91015351	91016391	1040	520.0	
3991	chr1	91017799	91019910	2111	1056.0	
3992	chr1	91020620	91022955	2335	1168.0	
3993	chr1	91024326	91024932	606	303.0	
3994	chr1	91054705	91055337	632	316.0	
3995	chr1	91063396	91063807	411	206.0	
3996	chr1	91099959	91100468	509	254.0	
3997	chr1	91116710	91117093	383	192.0	
3998	chr1	91124924	91125421	497	248.0	
3999	chr1	91165174	91166495	1321	660.0	
4000	chr1	91282701	91283109	408	204.0	
4001	chr1	91404112	91404989	877	438.0	
4002	chr1	91499845	91501964	2119	1060.0	
4003	chr1	91502868	91503149	281	140.0	
4004	chr1	91511372	91511789	417	208.0	
4005	chr1	91513171	91513512	341	170.0	
4006	chr1	91523387	91523783	396	198.0	
4007	chr1	91529918	91530247	329	164.0	
4008	chr1	91533801	91534152	351	176.0	
4009	chr1	91541881	91542118	237	118.0	
4010	chr1	91547865	91549902	2037	1018.0	
4011	chr1	91550865	91551473	608	304.0	
4012	chr1	91555246	91557600	2354	1177.0	
4013	chr1	91559988	91560712	724	362.0	
4014	chr1	91569257	91570367	1110	555.0	
4015	chr1	91571814	91572654	840	420.0	
4016	chr1	91582389	91582749	360	180.0	
4017	chr1	91591167	91592258	1091	546.0	
4018	chr1	91647178	91647307	129	64.0	
4019	chr1	91684557	91685367	810	405.0	
4020	chr1	91697346	91698039	693	346.0	
4021	chr1	91712949	91714077	1128	564.0	
4022	chr1	91729675	91732971	3296	1648.0	
4023	chr1	91734936	91734940	4	2.0	
4024	chr1	91753646	91754654	1008	504.0	
4025	chr1	91769208	91769506	298	149.0	
4026	chr1	91791576	91792259	683	342.0	
4027	chr1	91803099	91806103	3004	1502.0	
4028	chr1	91870410	91870564	154	77.0	
4029	chr1	91872482	91872989	507	254.0	
4030	chr1	91875875	91876579	704	352.0	
4031	chr1	91883172	91887129	3957	1978.0	
4032	chr1	91891944	91892320	376	188.0	
4033	chr1	91927208	91927716	508	254.0	
4034	chr1	91941878	91942003	125	62.0	
4035	chr1	91947993	91949558	1565	782.0	
4036	chr1	91997633	91997956	323	162.0	
4037	chr1	92016662	92017093	431	216.0	
4038	chr1	92029681	92030716	1035	518.0	
4039	chr1	92079855	92081179	1324	662.0	
4040	chr1	92095833	92097110	1277	638.0	
4041	chr1	92202016	92202354	338	169.0	
4042	chr1	92291402	92291770	368	184.0	
4043	chr1	92298158	92299946	1788	894.0	
4044	chr1	92310056	92310513	457	228.0	
4045	chr1	92315604	92316533	929	464.0	
4046	chr1	92317774	92318312	538	269.0	
4047	chr1	92365653	92366172	519	260.0	
4048	chr1	92410715	92411064	349	174.0	
4049	chr1	92459685	92460492	807	404.0	
4050	chr1	92461669	92462171	502	251.0	
4051	chr1	92463655	92463790	135	68.0	
4052	chr1	92464748	92465008	260	130.0	
4053	chr1	92466909	92467181	272	136.0	
4054	chr1	92473560	92474514	954	477.0	
4055	chr1	92475787	92476797	1010	505.0	
4056	chr1	92478490	92479430	940	470.0	
4057	chr1	92482107	92487698	5591	2796.0	
4058	chr1	92488488	92488569	81	40.0	
4059	chr1	92502184	92502616	432	216.0	
4060	chr1	92536623	92539044	2421	1210.0	
4061	chr1	92563591	92563793	202	101.0	
4062	chr1	92583780	92584617	837	418.0	
4063	chr1	92599481	92599507	26	13.0	
4064	chr1	92623255	92623582	327	164.0	
4065	chr1	92728750	92729062	312	156.0	
4066	chr1	92743264	92743520	256	128.0	
4067	chr1	92748989	92749466	477	238.0	
4068	chr1	92783821	92786761	2940	1470.0	
4069	chr1	92804625	92805128	503	252.0	
4070	chr1	92818124	92818791	667	334.0	
4071	chr1	92831332	92834974	3642	1821.0	
4072	chr1	92837899	92837920	21	10.0	
4073	chr1	92839797	92839813	16	8.0	
4074	chr1	92840323	92840954	631	316.0	
4075	chr1	92853243	92853780	537	268.0	
4076	chr1	92854396	92854805	409	204.0	
4077	chr1	92858582	92859795	1213	606.0	
4078	chr1	92877413	92878154	741	370.0	
4079	chr1	92882735	92883489	754	377.0	
4080	chr1	92927864	92928169	305	152.0	
4081	chr1	92945247	92945563	316	158.0	
4082	chr1	92949957	92950259	302	151.0	
4083	chr1	92950941	92951726	785	392.0	
4084	chr1	92953257	92953996	739	370.0	
4085	chr1	92957057	92957435	378	189.0	
4086	chr1	92959900	92963386	3486	1743.0	
4087	chr1	92964518	92965606	1088	544.0	
4088	chr1	92968105	92968881	776	388.0	
4089	chr1	92973110	92973941	831	416.0	
4090	chr1	92975097	92976085	988	494.0	
4091	chr1	92980496	92981845	1349	674.0	
4092	chr1	92990482	92991308	826	413.0	
4093	chr1	92993848	92994611	763	382.0	
4094	chr1	93014227	93014302	75	38.0	
4095	chr1	93021522	93022022	500	250.0	
4096	chr1	93029176	93029850	674	337.0	
4097	chr1	93033642	93034202	560	280.0	
4098	chr1	93042003	93043187	1184	592.0	
4099	chr1	93062146	93062652	506	253.0	
4100	chr1	93076301	93076714	413	206.0	
4101	chr1	93078197	93082207	4010	2005.0	
4102	chr1	93111909	93111949	40	20.0	
4103	chr1	93164536	93165127	591	296.0	
4104	chr1	93170598	93171792	1194	597.0	
4105	chr1	93177361	93178511	1150	575.0	
4106	chr1	93179081	93181908	2827	1414.0	
4107	chr1	93186682	93187011	329	164.0	
4108	chr1	93219506	93219913	407	204.0	
4109	chr1	93304591	93305051	460	230.0	
4110	chr1	93317157	93317725	568	284.0	
4111	chr1	93344946	93347667	2721	1360.0	
4112	chr1	93358262	93358614	352	176.0	
4113	chr1	93364556	93364804	248	124.0	
4114	chr1	93437943	93438426	483	242.0	
4115	chr1	93446643	93449560	2917	1458.0	
4116	chr1	93559084	93559197	113	56.0	
4117	chr1	93591785	93592149	364	182.0	
4118	chr1	93615299	93616004	705	352.0	
4119	chr1	93629421	93630065	644	322.0	
4120	chr1	93642567	93642736	169	84.0	
4121	chr1	93672094	93672528	434	217.0	
4122	chr1	93680647	93682239	1592	796.0	
4123	chr1	93693045	93693655	610	305.0	
4124	chr1	93695564	93696029	465	232.0	
4125	chr1	93703895	93704620	725	362.0	
4126	chr1	93707847	93708419	572	286.0	
4127	chr1	93709165	93709484	319	160.0	
4128	chr1	93749367	93750124	757	378.0	
4129	chr1	93750966	93751426	460	230.0	
4130	chr1	93758549	93759600	1051	526.0	
4131	chr1	93813931	93814444	513	256.0	
4132	chr1	93816897	93818732	1835	918.0	
4133	chr1	93839264	93839746	482	241.0	
4134	chr1	93843854	93844867	1013	506.0	
4135	chr1	93845588	93848483	2895	1448.0	
4136	chr1	93850478	93851162	684	342.0	
4137	chr1	93873987	93874497	510	255.0	
4138	chr1	93876322	93876650	328	164.0	
4139	chr1	93878077	93879901	1824	912.0	
4140	chr1	93904116	93904720	604	302.0	
4141	chr1	93908367	93910391	2024	1012.0	
4142	chr1	93988783	93989224	441	220.0	
4143	chr1	93991291	93991633	342	171.0	
4144	chr1	94004951	94005236	285	142.0	
4145	chr1	94017187	94018013	826	413.0	
4146	chr1	94020975	94021445	470	235.0	
4147	chr1	94039484	94039890	406	203.0	
4148	chr1	94045528	94046065	537	268.0	
4149	chr1	94061394	94061856	462	231.0	
4150	chr1	94092342	94092538	196	98.0	
4151	chr1	94094567	94094811	244	122.0	
4152	chr1	94102154	94102489	335	168.0	
4153	chr1	94236297	94236433	136	68.0	
4154	chr1	94236967	94238014	1047	524.0	
4155	chr1	94247196	94248071	875	438.0	
4156	chr1	94285796	94286120	324	162.0	
4157	chr1	94302531	94303606	1075	538.0	
4158	chr1	94339538	94340084	546	273.0	
4159	chr1	94345317	94345661	344	172.0	
4160	chr1	94384656	94385276	620	310.0	
4161	chr1	94411167	94411638	471	236.0	
4162	chr1	94417525	94419457	1932	966.0	
4163	chr1	94463697	94464073	376	188.0	
4164	chr1	94481410	94481892	482	241.0	
4165	chr1	94504596	94504958	362	181.0	
4166	chr1	94514211	94514442	231	116.0	
4167	chr1	94541207	94543301	2094	1047.0	
4168	chr1	94597811	94597845	34	17.0	
4169	chr1	94599090	94599565	475	238.0	
4170	chr1	94601999	94603152	1153	576.0	
4171	chr1	94612620	94612930	310	155.0	
4172	chr1	94614356	94615445	1089	544.0	
4173	chr1	94626296	94626330	34	17.0	
4174	chr1	94713358	94714226	868	434.0	
4175	chr1	94717033	94717127	94	47.0	
4176	chr1	94719847	94721782	1935	968.0	
4177	chr1	94735425	94735637	212	106.0	
4178	chr1	94737649	94737650	1	0.0	
4179	chr1	94741382	94742026	644	322.0	
4180	chr1	94755528	94756112	584	292.0	
4181	chr1	94767802	94768540	738	369.0	
4182	chr1	94792397	94792980	583	292.0	
4183	chr1	94795503	94795871	368	184.0	
4184	chr1	94798437	94798855	418	209.0	
4185	chr1	94801887	94802437	550	275.0	
4186	chr1	94805771	94806265	494	247.0	
4187	chr1	94820001	94820717	716	358.0	
4188	chr1	94831591	94832100	509	254.0	
4189	chr1	94854138	94855344	1206	603.0	
4190	chr1	94883548	94884070	522	261.0	
4191	chr1	94925414	94927868	2454	1227.0	
4192	chr1	94962722	94963361	639	320.0	
4193	chr1	94979230	94979442	212	106.0	
4194	chr1	95038257	95038638	381	190.0	
4195	chr1	95043131	95044049	918	459.0	
4196	chr1	95072070	95073798	1728	864.0	
4197	chr1	95084529	95085015	486	243.0	
4198	chr1	95095801	95096202	401	200.0	
4199	chr1	95098182	95098449	267	134.0	
4200	chr1	95116632	95118211	1579	790.0	
4201	chr1	95176932	95177222	290	145.0	
4202	chr1	95216593	95216640	47	24.0	
4203	chr1	95227521	95228058	537	268.0	
4204	chr1	95233255	95234949	1694	847.0	
4205	chr1	96308375	96308669	294	147.0	
4206	chr1	96309780	96310141	361	180.0	
4207	chr1	96361182	96361733	551	276.0	
4208	chr1	96362517	96363170	653	326.0	
4209	chr1	96560056	96560607	551	276.0	
4210	chr1	96682148	96682397	249	124.0	
4211	chr1	96684062	96684172	110	55.0	
4212	chr1	96715924	96716251	327	164.0	
4213	chr1	96720969	96723132	2163	1082.0	
4214	chr1	96845691	96845796	105	52.0	
4215	chr1	96966519	96966934	415	208.0	
4216	chr1	97138274	97138639	365	182.0	
4217	chr1	97163989	97164697	708	354.0	
4218	chr1	97489921	97490180	259	130.0	
4219	chr1	97525554	97525940	386	193.0	
4220	chr1	97610744	97611179	435	218.0	
4221	chr1	97674629	97674821	192	96.0	
4222	chr1	97833891	97834282	391	196.0	
4223	chr1	97847976	97848754	778	389.0	
4224	chr1	97849372	97850393	1021	510.0	
4225	chr1	97900930	97901639	709	354.0	
4226	chr1	97904441	97904942	501	250.0	
4227	chr1	97906744	97908339	1595	798.0	
4228	chr1	97909219	97909686	467	234.0	
4229	chr1	97911779	97912198	419	210.0	
4230	chr1	97919336	97922027	2691	1346.0	
4231	chr1	97937937	97938629	692	346.0	
4232	chr1	98044902	98046233	1331	666.0	
4233	chr1	98047978	98048813	835	418.0	
4234	chr1	98051028	98051509	481	240.0	
4235	chr1	98053389	98054739	1350	675.0	
4236	chr1	98323364	98324550	1186	593.0	
4237	chr1	98387982	98388881	899	450.0	
4238	chr1	98661382	98662252	870	435.0	
4239	chr1	98766239	98766661	422	211.0	
4240	chr1	98794210	98794718	508	254.0	
4241	chr1	98797512	98797926	414	207.0	
4242	chr1	98850040	98850236	196	98.0	
4243	chr1	98854136	98854567	431	216.0	
4244	chr1	98870944	98872217	1273	636.0	
4245	chr1	99004496	99004827	331	166.0	
4246	chr1	99180232	99180703	471	236.0	
4247	chr1	99374308	99374332	24	12.0	
4248	chr1	99685673	99686135	462	231.0	
4249	chr1	99699936	99700566	630	315.0	
4250	chr1	99704287	99704632	345	172.0	
4251	chr1	99707494	99707969	475	238.0	
4252	chr1	99758118	99759593	1475	738.0	
4253	chr1	99766219	99766895	676	338.0	
4254	chr1	99784801	99785285	484	242.0	
4255	chr1	99793846	99794335	489	244.0	
4256	chr1	99808415	99809274	859	430.0	
4257	chr1	99820511	99820993	482	241.0	
4258	chr1	99849393	99850898	1505	752.0	
4259	chr1	99918968	99919646	678	339.0	
4260	chr1	99969157	99970858	1701	850.0	
4261	chr1	100028497	100029423	926	463.0	
4262	chr1	100034443	100034888	445	222.0	
4263	chr1	100036019	100039880	3861	1930.0	
4264	chr1	100046299	100047731	1432	716.0	
4265	chr1	100048514	100049078	564	282.0	
4266	chr1	100051516	100051869	353	176.0	
4267	chr1	100064863	100065701	838	419.0	
4268	chr1	100132292	100133832	1540	770.0	
4269	chr1	100152310	100152639	329	164.0	
4270	chr1	100184530	100184962	432	216.0	
4271	chr1	100248832	100250512	1680	840.0	
4272	chr1	100265469	100267013	1544	772.0	
4273	chr1	100277915	100278242	327	164.0	
4274	chr1	100350768	100356224	5456	2728.0	
4275	chr1	100356907	100357619	712	356.0	
4276	chr1	100358185	100360612	2427	1214.0	
4277	chr1	100361409	100361714	305	152.0	
4278	chr1	100362801	100363355	554	277.0	
4279	chr1	100364808	100365781	973	486.0	
4280	chr1	100377780	100378343	563	282.0	
4281	chr1	100380488	100381064	576	288.0	
4282	chr1	100382713	100383096	383	192.0	
4283	chr1	100386310	100387006	696	348.0	
4284	chr1	100387982	100388648	666	333.0	
4285	chr1	100391634	100392215	581	290.0	
4286	chr1	100394058	100394784	726	363.0	
4287	chr1	100396403	100398513	2110	1055.0	
4288	chr1	100400241	100401167	926	463.0	
4289	chr1	100403342	100403758	416	208.0	
4290	chr1	100405999	100406202	203	102.0	
4291	chr1	100413391	100413475	84	42.0	
4292	chr1	100414566	100415213	647	324.0	
4293	chr1	100423869	100424322	453	226.0	
4294	chr1	100439888	100442129	2241	1120.0	
4295	chr1	100443778	100446251	2473	1236.0	
4296	chr1	100452370	100453220	850	425.0	
4297	chr1	100455472	100456070	598	299.0	
4298	chr1	100458933	100460165	1232	616.0	
4299	chr1	100463646	100464488	842	421.0	
4300	chr1	100511025	100511518	493	246.0	
4301	chr1	100522918	100523701	783	392.0	
4302	chr1	100530535	100531544	1009	504.0	
4303	chr1	100534995	100536594	1599	800.0	
4304	chr1	100538791	100540372	1581	790.0	
4305	chr1	100543609	100544108	499	250.0	
4306	chr1	100614239	100614339	100	50.0	
4307	chr1	100627078	100627562	484	242.0	
4308	chr1	100712846	100713773	927	464.0	
4309	chr1	100814867	100815282	415	208.0	
4310	chr1	100835056	100835392	336	168.0	
4311	chr1	100866410	100866797	387	194.0	
4312	chr1	100868355	100868765	410	205.0	
4313	chr1	100882526	100883248	722	361.0	
4314	chr1	100894429	100897604	3175	1588.0	
4315	chr1	100898169	100898439	270	135.0	
4316	chr1	100921058	100921509	451	226.0	
4317	chr1	100926877	100928499	1622	811.0	
4318	chr1	100930503	100930939	436	218.0	
4319	chr1	100942998	100943065	67	34.0	
4320	chr1	100949054	100950229	1175	588.0	
4321	chr1	101002475	101003049	574	287.0	
4322	chr1	101004018	101004995	977	488.0	
4323	chr1	101025099	101026747	1648	824.0	
4324	chr1	101051768	101052270	502	251.0	
4325	chr1	101065823	101065930	107	54.0	
4326	chr1	101081454	101081986	532	266.0	
4327	chr1	101111593	101112886	1293	646.0	
4328	chr1	101122446	101123136	690	345.0	
4329	chr1	101128019	101129284	1265	632.0	
4330	chr1	101130004	101130381	377	188.0	
4331	chr1	101136704	101137926	1222	611.0	
4332	chr1	101145075	101145330	255	128.0	
4333	chr1	101178643	101179573	930	465.0	
4334	chr1	101221861	101222285	424	212.0	
4335	chr1	101234529	101240630	6101	3050.0	
4336	chr1	101241553	101242021	468	234.0	
4337	chr1	101245544	101245783	239	120.0	
4338	chr1	101246483	101246697	214	107.0	
4339	chr1	101247616	101248292	676	338.0	
4340	chr1	101257506	101258562	1056	528.0	
4341	chr1	101259603	101260310	707	354.0	
4342	chr1	101262506	101263217	711	356.0	
4343	chr1	101264466	101265223	757	378.0	
4344	chr1	101278523	101279341	818	409.0	
4345	chr1	101281710	101282161	451	226.0	
4346	chr1	101283292	101284942	1650	825.0	
4347	chr1	101287975	101289024	1049	524.0	
4348	chr1	101290810	101292370	1560	780.0	
4349	chr1	101293360	101294127	767	384.0	
4350	chr1	101307792	101313116	5324	2662.0	
4351	chr1	101338614	101339248	634	317.0	
4352	chr1	101344984	101345082	98	49.0	
4353	chr1	101346425	101346826	401	200.0	
4354	chr1	101357129	101357974	845	422.0	
4355	chr1	101371160	101371630	470	235.0	
4356	chr1	101380019	101380290	271	136.0	
4357	chr1	101388989	101389390	401	200.0	
4358	chr1	101407668	101408215	547	274.0	
4359	chr1	101435982	101436502	520	260.0	
4360	chr1	101506555	101506951	396	198.0	
4361	chr1	101520259	101520638	379	190.0	
4362	chr1	101567589	101568002	413	206.0	
4363	chr1	103509276	103509684	408	204.0	
4364	chr1	103514864	103515439	575	288.0	
4365	chr1	103524732	103526728	1996	998.0	
4366	chr1	103561714	103562318	604	302.0	
4367	chr1	104057284	104057617	333	166.0	
4368	chr1	105874706	105874973	267	134.0	
4369	chr1	107056131	107058303	2172	1086.0	
4370	chr1	107140086	107140344	258	129.0	
4371	chr1	107140935	107141795	860	430.0	
4372	chr1	107409755	107410103	348	174.0	
4373	chr1	107430688	107430835	147	74.0	
4374	chr1	107450838	107451594	756	378.0	
4375	chr1	107529581	107529956	375	188.0	
4376	chr1	107533511	107533525	14	7.0	
4377	chr1	107535135	107535438	303	152.0	
4378	chr1	107590909	107591295	386	193.0	
4379	chr1	107648942	107649343	401	200.0	
4380	chr1	107739000	107739597	597	298.0	
4381	chr1	107777477	107777535	58	29.0	
4382	chr1	107782140	107782811	671	336.0	
4383	chr1	107785344	107787614	2270	1135.0	
4384	chr1	107790517	107790805	288	144.0	
4385	chr1	107795559	107795606	47	24.0	
4386	chr1	107804091	107804552	461	230.0	
4387	chr1	107821398	107821712	314	157.0	
4388	chr1	107829073	107829837	764	382.0	
4389	chr1	107840315	107841211	896	448.0	
4390	chr1	107842173	107842696	523	262.0	
4391	chr1	107843928	107845115	1187	594.0	
4392	chr1	107872012	107872091	79	40.0	
4393	chr1	107877075	107878152	1077	538.0	
4394	chr1	107895840	107896188	348	174.0	
4395	chr1	107897106	107897982	876	438.0	
4396	chr1	107900007	107900523	516	258.0	
4397	chr1	107914109	107914800	691	346.0	
4398	chr1	107926725	107926995	270	135.0	
4399	chr1	107934987	107937660	2673	1336.0	
4400	chr1	107940737	107942177	1440	720.0	
4401	chr1	107942862	107944146	1284	642.0	
4402	chr1	107950469	107950517	48	24.0	
4403	chr1	107953036	107953379	343	172.0	
4404	chr1	107954548	107955176	628	314.0	
4405	chr1	107962976	107966151	3175	1588.0	
4406	chr1	108041591	108042176	585	292.0	
4407	chr1	108043644	108044173	529	264.0	
4408	chr1	108049274	108051718	2444	1222.0	
4409	chr1	108053287	108053623	336	168.0	
4410	chr1	108057537	108058001	464	232.0	
4411	chr1	108063655	108064166	511	256.0	
4412	chr1	108072099	108072637	538	269.0	
4413	chr1	108074884	108075545	661	330.0	
4414	chr1	108077937	108078462	525	262.0	
4415	chr1	108079537	108080874	1337	668.0	
4416	chr1	108082743	108083375	632	316.0	
4417	chr1	108107652	108108073	421	210.0	
4418	chr1	108114197	108114631	434	217.0	
4419	chr1	108125393	108126019	626	313.0	
4420	chr1	108130758	108131240	482	241.0	
4421	chr1	108141028	108142088	1060	530.0	
4422	chr1	108152616	108153255	639	320.0	
4423	chr1	108199067	108201303	2236	1118.0	
4424	chr1	108214666	108215069	403	202.0	
4425	chr1	108504868	108505849	981	490.0	
4426	chr1	108512434	108512879	445	222.0	
4427	chr1	108551306	108551968	662	331.0	
4428	chr1	108556102	108557869	1767	884.0	
4429	chr1	108559188	108562516	3328	1664.0	
4430	chr1	108570051	108570610	559	280.0	
4431	chr1	108583931	108586728	2797	1398.0	
4432	chr1	108590386	108592542	2156	1078.0	
4433	chr1	108639875	108640640	765	382.0	
4434	chr1	108642969	108647729	4760	2380.0	
4435	chr1	108653400	108653918	518	259.0	
4436	chr1	108660636	108662086	1450	725.0	
4437	chr1	108678655	108679161	506	253.0	
4438	chr1	108691395	108694525	3130	1565.0	
4439	chr1	108695525	108695898	373	186.0	
4440	chr1	108699682	108700403	721	360.0	
4441	chr1	108703032	108704734	1702	851.0	
4442	chr1	108705315	108705621	306	153.0	
4443	chr1	108708930	108709648	718	359.0	
4444	chr1	108745924	108748696	2772	1386.0	
4445	chr1	108828041	108828542	501	250.0	
4446	chr1	108830768	108830792	24	12.0	
4447	chr1	108852539	108852901	362	181.0	
4448	chr1	108862731	108863472	741	370.0	
4449	chr1	108876342	108878305	1963	982.0	
4450	chr1	108889178	108889663	485	242.0	
4451	chr1	108896328	108896539	211	106.0	
4452	chr1	108898061	108898545	484	242.0	
4453	chr1	108956164	108957446	1282	641.0	
4454	chr1	108961130	108961661	531	266.0	
4455	chr1	108962486	108964554	2068	1034.0	
4456	chr1	109010610	109010619	9	4.0	
4457	chr1	109024708	109025825	1117	558.0	
4458	chr1	109040256	109042935	2679	1340.0	
4459	chr1	109072648	109072755	107	54.0	
4460	chr1	109075186	109076757	1571	786.0	
4461	chr1	109090056	109092303	2247	1124.0	
4462	chr1	109099472	109101908	2436	1218.0	
4463	chr1	109104818	109105095	277	138.0	
4464	chr1	109111427	109114690	3263	1632.0	
4465	chr1	109133733	109134317	584	292.0	
4466	chr1	109161901	109163039	1138	569.0	
4467	chr1	109184631	109185315	684	342.0	
4468	chr1	109193602	109194160	558	279.0	
4469	chr1	109199672	109200127	455	228.0	
4470	chr1	109201139	109201553	414	207.0	
4471	chr1	109213326	109215212	1886	943.0	
4472	chr1	109239353	109240013	660	330.0	
4473	chr1	109240726	109241244	518	259.0	
4474	chr1	109248897	109250382	1485	742.0	
4475	chr1	109253474	109253775	301	150.0	enhancer
4476	chr1	109263144	109264314	1170	585.0	
4477	chr1	109277322	109277987	665	332.0	
4478	chr1	109281332	109284160	2828	1414.0	
4479	chr1	109291048	109291577	529	264.0	
4480	chr1	109294523	109294924	401	200.0	
4481	chr1	109307355	109308001	646	323.0	
4482	chr1	109313038	109313320	282	141.0	
4483	chr1	109368739	109369597	858	429.0	
4484	chr1	109370920	109371907	987	494.0	
4485	chr1	109389621	109390288	667	334.0	
4486	chr1	109391647	109392163	516	258.0	
4487	chr1	109392946	109393600	654	327.0	
4488	chr1	109395937	109398499	2562	1281.0	
4489	chr1	109399302	109399797	495	248.0	
4490	chr1	109404871	109405281	410	205.0	
4491	chr1	109424492	109427467	2975	1488.0	
4492	chr1	109466246	109467452	1206	603.0	
4493	chr1	109477801	109478182	381	190.0	
4494	chr1	109478791	109479218	427	214.0	
4495	chr1	109482743	109484938	2195	1098.0	
4496	chr1	109490380	109491221	841	420.0	
4497	chr1	109493521	109494913	1392	696.0	
4498	chr1	109498249	109498745	496	248.0	
4499	chr1	109499849	109500365	516	258.0	
4500	chr1	109501726	109503243	1517	758.0	
4501	chr1	109503981	109504321	340	170.0	
4502	chr1	109508663	109510659	1996	998.0	
4503	chr1	109531343	109531349	6	3.0	
4504	chr1	109531998	109533422	1424	712.0	
4505	chr1	109546010	109549604	3594	1797.0	
4506	chr1	109555588	109556315	727	364.0	
4507	chr1	109563238	109563475	237	118.0	
4508	chr1	109568869	109569506	637	318.0	
4509	chr1	109573581	109574361	780	390.0	
4510	chr1	109603287	109603556	269	134.0	
4511	chr1	109607159	109607779	620	310.0	
4512	chr1	109615500	109617946	2446	1223.0	
4513	chr1	109618824	109622223	3399	1700.0	
4514	chr1	109622724	109626501	3777	1888.0	
4515	chr1	109628663	109629070	407	204.0	
4516	chr1	109629592	109630811	1219	610.0	
4517	chr1	109634335	109635375	1040	520.0	
4518	chr1	109636361	109636762	401	200.0	
4519	chr1	109639809	109640838	1029	514.0	
4520	chr1	109643050	109643964	914	457.0	
4521	chr1	109655440	109656778	1338	669.0	
4522	chr1	109667662	109670303	2641	1320.0	
4523	chr1	109687218	109688564	1346	673.0	
4524	chr1	109712106	109712270	164	82.0	
4525	chr1	109739682	109740996	1314	657.0	
4526	chr1	109762872	109763588	716	358.0	
4527	chr1	109773423	109774323	900	450.0	
4528	chr1	109776554	109777469	915	458.0	
4529	chr1	109788087	109789570	1483	742.0	
4530	chr1	109790361	109791418	1057	528.0	
4531	chr1	109793162	109794321	1159	580.0	
4532	chr1	109801774	109803185	1411	706.0	
4533	chr1	109813171	109813420	249	124.0	
4534	chr1	109816035	109817016	981	490.0	
4535	chr1	109819792	109820289	497	248.0	
4536	chr1	109821015	109823058	2043	1022.0	
4537	chr1	109863899	109864690	791	396.0	
4538	chr1	109873626	109873635	9	4.0	
4539	chr1	109886574	109888339	1765	882.0	
4540	chr1	109892628	109892855	227	114.0	
4541	chr1	109895410	109896486	1076	538.0	
4542	chr1	109897228	109897702	474	237.0	
4543	chr1	109899888	109900839	951	476.0	
4544	chr1	109901818	109902023	205	102.0	
4545	chr1	109905738	109906885	1147	574.0	
4546	chr1	109910045	109911646	1601	800.0	
4547	chr1	109969547	109969823	276	138.0	
4548	chr1	109980731	109981032	301	150.0	
4549	chr1	109983964	109986086	2122	1061.0	
4550	chr1	109989793	109990621	828	414.0	
4551	chr1	109991349	109991811	462	231.0	
4552	chr1	110003778	110004364	586	293.0	
4553	chr1	110011406	110012612	1206	603.0	
4554	chr1	110029468	110031692	2224	1112.0	
4555	chr1	110033826	110035644	1818	909.0	
4556	chr1	110053422	110054251	829	414.0	
4557	chr1	110057880	110058297	417	208.0	
4558	chr1	110059870	110060540	670	335.0	
4559	chr1	110067854	110070627	2773	1386.0	
4560	chr1	110083233	110085225	1992	996.0	
4561	chr1	110088002	110088505	503	252.0	
4562	chr1	110102095	110102436	341	170.0	
4563	chr1	110106028	110106596	568	284.0	
4564	chr1	110116411	110116851	440	220.0	
4565	chr1	110155956	110156261	305	152.0	
4566	chr1	110196833	110197499	666	333.0	
4567	chr1	110202720	110203763	1043	522.0	
4568	chr1	110207351	110208424	1073	536.0	
4569	chr1	110209295	110212891	3596	1798.0	
4570	chr1	110235687	110236265	578	289.0	
4571	chr1	110237769	110238145	376	188.0	
4572	chr1	110239882	110240265	383	192.0	
4573	chr1	110243570	110243945	375	188.0	
4574	chr1	110259729	110260180	451	226.0	
4575	chr1	110262395	110263185	790	395.0	
4576	chr1	110267725	110268389	664	332.0	
4577	chr1	110312351	110313201	850	425.0	
4578	chr1	110337497	110340619	3122	1561.0	
4579	chr1	110380610	110381325	715	358.0	
4580	chr1	110383525	110385527	2002	1001.0	
4581	chr1	110407034	110408386	1352	676.0	
4582	chr1	110412288	110413125	837	418.0	
4583	chr1	110421064	110421632	568	284.0	
4584	chr1	110433393	110434315	922	461.0	
4585	chr1	110460173	110460761	588	294.0	
4586	chr1	110495932	110496464	532	266.0	
4587	chr1	110502361	110502905	544	272.0	
4588	chr1	110507948	110508428	480	240.0	
4589	chr1	110524432	110524886	454	227.0	
4590	chr1	110555182	110555868	686	343.0	
4591	chr1	110606256	110608178	1922	961.0	
4592	chr1	110615685	110616202	517	258.0	
4593	chr1	110619085	110620818	1733	866.0	
4594	chr1	110627665	110628432	767	384.0	
4595	chr1	110630506	110632173	1667	834.0	
4596	chr1	110634308	110636597	2289	1144.0	
4597	chr1	110637571	110638152	581	290.0	
4598	chr1	110639705	110640696	991	496.0	
4599	chr1	110641388	110642229	841	420.0	
4600	chr1	110643708	110644467	759	380.0	
4601	chr1	110645871	110648026	2155	1078.0	
4602	chr1	110667797	110669079	1282	641.0	
4603	chr1	110671259	110676583	5324	2662.0	
4604	chr1	110680413	110680750	337	168.0	
4605	chr1	110686169	110686578	409	204.0	
4606	chr1	110690850	110691054	204	102.0	
4607	chr1	110707252	110707710	458	229.0	
4608	chr1	110709017	110709476	459	230.0	
4609	chr1	110726665	110727275	610	305.0	
4610	chr1	110746630	110747099	469	234.0	
4611	chr1	110765941	110766513	572	286.0	
4612	chr1	110780618	110781473	855	428.0	
4613	chr1	110783056	110783782	726	363.0	
4614	chr1	110786815	110788325	1510	755.0	
4615	chr1	110829757	110830406	649	324.0	
4616	chr1	110868822	110868920	98	49.0	
4617	chr1	110872121	110876118	3997	1998.0	
4618	chr1	110876957	110878420	1463	732.0	
4619	chr1	110879465	110882014	2549	1274.0	
4620	chr1	110887601	110888427	826	413.0	
4621	chr1	110890523	110891585	1062	531.0	
4622	chr1	110892995	110893215	220	110.0	
4623	chr1	110893881	110894305	424	212.0	
4624	chr1	110895997	110896668	671	336.0	
4625	chr1	110898658	110899526	868	434.0	
4626	chr1	110901684	110902091	407	204.0	
4627	chr1	110902858	110904731	1873	936.0	
4628	chr1	110916783	110917273	490	245.0	
4629	chr1	110962844	110964801	1957	978.0	
4630	chr1	110982230	110982847	617	308.0	
4631	chr1	110992331	110992774	443	222.0	
4632	chr1	111030435	111030924	489	244.0	
4633	chr1	111032281	111032731	450	225.0	
4634	chr1	111127909	111128731	822	411.0	
4635	chr1	111132417	111132930	513	256.0	
4636	chr1	111139167	111141008	1841	920.0	
4637	chr1	111141699	111141792	93	46.0	
4638	chr1	111184631	111185029	398	199.0	
4639	chr1	111190139	111191388	1249	624.0	
4640	chr1	111192141	111194063	1922	961.0	
4641	chr1	111194757	111194968	211	106.0	
4642	chr1	111197141	111198262	1121	560.0	
4643	chr1	111198956	111206397	7441	3720.0	
4644	chr1	111212942	111217972	5030	2515.0	
4645	chr1	111218792	111220379	1587	794.0	
4646	chr1	111221304	111223604	2300	1150.0	
4647	chr1	111225542	111227871	2329	1164.0	
4648	chr1	111229521	111230311	790	395.0	
4649	chr1	111251727	111251930	203	102.0	
4650	chr1	111274787	111275185	398	199.0	
4651	chr1	111334101	111334594	493	246.0	
4652	chr1	111335175	111335919	744	372.0	
4653	chr1	111345925	111347211	1286	643.0	
4654	chr1	111399864	111400177	313	156.0	
4655	chr1	111406213	111406839	626	313.0	
4656	chr1	111441436	111442006	570	285.0	
4657	chr1	111447414	111450149	2735	1368.0	
4658	chr1	111470192	111471834	1642	821.0	
4659	chr1	111473580	111474383	803	402.0	
4660	chr1	111475450	111477702	2252	1126.0	
4661	chr1	111480659	111482088	1429	714.0	
4662	chr1	111489575	111490122	547	274.0	
4663	chr1	111497587	111498065	478	239.0	
4664	chr1	111503261	111504107	846	423.0	
4665	chr1	111505313	111506561	1248	624.0	
4666	chr1	111507188	111509026	1838	919.0	
4667	chr1	111511356	111511757	401	200.0	
4668	chr1	111514919	111516817	1898	949.0	
4669	chr1	111517451	111517989	538	269.0	
4670	chr1	111570693	111571092	399	200.0	
4671	chr1	111592286	111593579	1293	646.0	
4672	chr1	111596399	111597003	604	302.0	
4673	chr1	111598352	111599159	807	404.0	
4674	chr1	111602322	111602645	323	162.0	
4675	chr1	111603764	111604620	856	428.0	
4676	chr1	111606397	111606739	342	171.0	
4677	chr1	111615606	111617132	1526	763.0	
4678	chr1	111619076	111622722	3646	1823.0	
4679	chr1	111624350	111626594	2244	1122.0	
4680	chr1	111628580	111628981	401	200.0	
4681	chr1	111647749	111648369	620	310.0	
4682	chr1	111653706	111654128	422	211.0	
4683	chr1	111656344	111656792	448	224.0	
4684	chr1	111660241	111660987	746	373.0	
4685	chr1	111664148	111664541	393	196.0	
4686	chr1	111689516	111689820	304	152.0	
4687	chr1	111714502	111715502	1000	500.0	
4688	chr1	111720640	111721041	401	200.0	
4689	chr1	111723256	111723976	720	360.0	
4690	chr1	111732962	111734574	1612	806.0	
4691	chr1	111738034	111740917	2883	1442.0	
4692	chr1	111747120	111747752	632	316.0	
4693	chr1	111754747	111756732	1985	992.0	
4694	chr1	111769431	111769963	532	266.0	
4695	chr1	111809083	111809347	264	132.0	
4696	chr1	112336973	112337347	374	187.0	
4697	chr1	112344756	112345087	331	166.0	
4698	chr1	112358754	112359203	449	224.0	
4699	chr1	112369563	112370159	596	298.0	
4700	chr1	112390537	112391581	1044	522.0	
4701	chr1	112393751	112394892	1141	570.0	
4702	chr1	112395506	112397160	1654	827.0	
4703	chr1	112399625	112399649	24	12.0	
4704	chr1	112431081	112431348	267	134.0	
4705	chr1	112465797	112467034	1237	618.0	
4706	chr1	112470876	112471426	550	275.0	
4707	chr1	112501673	112502620	947	474.0	
4708	chr1	112507792	112509708	1916	958.0	
4709	chr1	112607080	112607442	362	181.0	
4710	chr1	112614430	112614883	453	226.0	
4711	chr1	112617429	112623125	5696	2848.0	
4712	chr1	112624376	112625174	798	399.0	
4713	chr1	112625681	112626148	467	234.0	
4714	chr1	112627637	112628099	462	231.0	
4715	chr1	112629653	112630069	416	208.0	
4716	chr1	112635386	112636056	670	335.0	
4717	chr1	112636603	112637614	1011	506.0	
4718	chr1	112668565	112669237	672	336.0	
4719	chr1	112673297	112676947	3650	1825.0	
4720	chr1	112699947	112701605	1658	829.0	
4721	chr1	112704346	112708147	3801	1900.0	
4722	chr1	112713649	112716892	3243	1622.0	
4723	chr1	112718459	112719302	843	422.0	
4724	chr1	112722670	112723660	990	495.0	
4725	chr1	112804149	112804624	475	238.0	
4726	chr1	112809130	112809800	670	335.0	
4727	chr1	112819039	112819771	732	366.0	
4728	chr1	112840533	112841166	633	316.0	
4729	chr1	112841788	112842358	570	285.0	
4730	chr1	112874261	112874384	123	62.0	
4731	chr1	112880830	112881395	565	282.0	
4732	chr1	112882576	112883647	1071	536.0	
4733	chr1	112953714	112954180	466	233.0	
4734	chr1	112954917	112958197	3280	1640.0	
4735	chr1	112981239	112981878	639	320.0	
4736	chr1	112983392	112984133	741	370.0	
4737	chr1	113042546	113043200	654	327.0	
4738	chr1	113046179	113047113	934	467.0	
4739	chr1	113072296	113074152	1856	928.0	
4740	chr1	113132828	113133613	785	392.0	
4741	chr1	113140459	113141398	939	470.0	
4742	chr1	113192317	113192621	304	152.0	
4743	chr1	113388547	113392284	3737	1868.0	
4744	chr1	113415232	113415829	597	298.0	
4745	chr1	113663141	113663588	447	224.0	
4746	chr1	113665162	113665357	195	98.0	
4747	chr1	113677890	113678237	347	174.0	
4748	chr1	113692372	113692760	388	194.0	
4749	chr1	113742560	113742917	357	178.0	
4750	chr1	113757941	113760500	2559	1280.0	
4751	chr1	113769250	113769651	401	200.0	
4752	chr1	113780501	113781310	809	404.0	
4753	chr1	113783125	113784788	1663	832.0	
4754	chr1	113792387	113793030	643	322.0	
4755	chr1	113804829	113805070	241	120.0	
4756	chr1	113808617	113809452	835	418.0	
4757	chr1	113811047	113813335	2288	1144.0	
4758	chr1	113835662	113836097	435	218.0	
4759	chr1	113850052	113850536	484	242.0	
4760	chr1	113855853	113855976	123	62.0	
4761	chr1	113858352	113860282	1930	965.0	
4762	chr1	113861725	113862081	356	178.0	
4763	chr1	113868312	113868805	493	246.0	
4764	chr1	113869317	113873168	3851	1926.0	
4765	chr1	113873997	113874988	991	496.0	
4766	chr1	113875684	113876003	319	160.0	
4767	chr1	113879012	113879436	424	212.0	
4768	chr1	113880514	113881163	649	324.0	
4769	chr1	113898280	113898681	401	200.0	
4770	chr1	113903368	113906033	2665	1332.0	
4771	chr1	113906758	113907129	371	186.0	
4772	chr1	113928026	113935153	7127	3564.0	
4773	chr1	113935803	113936398	595	298.0	
4774	chr1	113937304	113941470	4166	2083.0	
4775	chr1	113942975	113943507	532	266.0	
4776	chr1	113944730	113945077	347	174.0	
4777	chr1	113946096	113949535	3439	1720.0	
4778	chr1	113963534	113963861	327	164.0	
4779	chr1	113975441	113976048	607	304.0	
4780	chr1	113976619	113977282	663	332.0	
4781	chr1	113978692	113979661	969	484.0	
4782	chr1	113982569	113983016	447	224.0	
4783	chr1	114040183	114040981	798	399.0	
4784	chr1	114081432	114081885	453	226.0	
4785	chr1	114108616	114109137	521	260.0	
4786	chr1	114113352	114114959	1607	804.0	
4787	chr1	114126406	114127195	789	394.0	
4788	chr1	114131118	114131565	447	224.0	
4789	chr1	114152506	114155245	2739	1370.0	
4790	chr1	114234794	114235135	341	170.0	
4791	chr1	114282562	114283251	689	344.0	
4792	chr1	114330429	114330893	464	232.0	
4793	chr1	114334311	114334723	412	206.0	
4794	chr1	114340813	114343058	2245	1122.0	
4795	chr1	114345889	114347209	1320	660.0	
4796	chr1	114353334	114353657	323	162.0	
4797	chr1	114369873	114370228	355	178.0	
4798	chr1	114458098	114458708	610	305.0	
4799	chr1	114467505	114467510	5	2.0	
4800	chr1	114482407	114483244	837	418.0	
4801	chr1	114490408	114490463	55	28.0	
4802	chr1	114505212	114505798	586	293.0	
4803	chr1	114509590	114512512	2922	1461.0	
4804	chr1	114548176	114548592	416	208.0	
4805	chr1	114558561	114559778	1217	608.0	
4806	chr1	114571192	114571470	278	139.0	
4807	chr1	114572897	114573063	166	83.0	
4808	chr1	114578461	114578591	130	65.0	
4809	chr1	114580901	114582394	1493	746.0	
4810	chr1	114669156	114671859	2703	1352.0	
4811	chr1	114715943	114717419	1476	738.0	
4812	chr1	114751639	114752192	553	276.0	
4813	chr1	114753687	114758933	5246	2623.0	
4814	chr1	114764764	114764851	87	44.0	
4815	chr1	114779901	114781392	1491	746.0	
4816	chr1	114979288	114979724	436	218.0	
4817	chr1	115051879	115052945	1066	533.0	
4818	chr1	115056321	115056688	367	184.0	
4819	chr1	115061360	115063874	2514	1257.0	
4820	chr1	115084817	115085670	853	426.0	
4821	chr1	115086188	115086830	642	321.0	
4822	chr1	115088720	115090667	1947	974.0	
4823	chr1	115091503	115092179	676	338.0	
4824	chr1	115098524	115100215	1691	846.0	
4825	chr1	115105772	115106257	485	242.0	
4826	chr1	115107536	115108526	990	495.0	
4827	chr1	115112568	115113412	844	422.0	
4828	chr1	115138845	115139480	635	318.0	
4829	chr1	115282722	115283160	438	219.0	
4830	chr1	115333064	115333673	609	304.0	
4831	chr1	115373299	115373690	391	196.0	
4832	chr1	115595836	115596173	337	168.0	
4833	chr1	115608172	115608534	362	181.0	
4834	chr1	115641645	115643145	1500	750.0	
4835	chr1	115706866	115707152	286	143.0	
4836	chr1	115717549	115717865	316	158.0	
4837	chr1	115727636	115728659	1023	512.0	
4838	chr1	115729769	115730132	363	182.0	
4839	chr1	115732212	115732811	599	300.0	
4840	chr1	115771800	115772294	494	247.0	
4841	chr1	115807711	115808161	450	225.0	
4842	chr1	115813670	115814209	539	270.0	
4843	chr1	115826159	115826523	364	182.0	
4844	chr1	115827658	115829744	2086	1043.0	
4845	chr1	115838373	115839577	1204	602.0	
4846	chr1	115865571	115866133	562	281.0	
4847	chr1	115975749	115978977	3228	1614.0	
4848	chr1	115981174	115981819	645	322.0	
4849	chr1	115982422	115982783	361	180.0	
4850	chr1	116003765	116004232	467	234.0	
4851	chr1	116006144	116007305	1161	580.0	
4852	chr1	116008120	116008502	382	191.0	
4853	chr1	116020658	116021109	451	226.0	
4854	chr1	116128743	116128997	254	127.0	
4855	chr1	116138579	116139685	1106	553.0	
4856	chr1	116151090	116152763	1673	836.0	
4857	chr1	116164897	116165405	508	254.0	
4858	chr1	116167827	116169222	1395	698.0	
4859	chr1	116174329	116174742	413	206.0	
4860	chr1	116232872	116233313	441	220.0	
4861	chr1	116325565	116326674	1109	554.0	
4862	chr1	116345698	116346349	651	326.0	
4863	chr1	116346984	116347422	438	219.0	
4864	chr1	116352330	116352737	407	204.0	
4865	chr1	116360759	116361164	405	202.0	
4866	chr1	116371721	116379452	7731	3866.0	
4867	chr1	116380060	116381496	1436	718.0	
4868	chr1	116383431	116384596	1165	582.0	
4869	chr1	116388095	116388134	39	20.0	
4870	chr1	116388852	116391278	2426	1213.0	
4871	chr1	116392443	116395862	3419	1710.0	
4872	chr1	116396554	116413720	17166	8583.0	
4873	chr1	116417936	116419572	1636	818.0	
4874	chr1	116436017	116436238	221	110.0	
4875	chr1	116485009	116485750	741	370.0	
4876	chr1	116496425	116496632	207	104.0	
4877	chr1	116497593	116498264	671	336.0	
4878	chr1	116498791	116499508	717	358.0	
4879	chr1	116503468	116505439	1971	986.0	
4880	chr1	116508618	116509668	1050	525.0	
4881	chr1	116514793	116517428	2635	1318.0	
4882	chr1	116532687	116533536	849	424.0	
4883	chr1	116537357	116538990	1633	816.0	
4884	chr1	116539974	116540657	683	342.0	
4885	chr1	116544713	116545030	317	158.0	
4886	chr1	116553328	116553813	485	242.0	
4887	chr1	116555755	116557252	1497	748.0	
4888	chr1	116558298	116558581	283	142.0	
4889	chr1	116559454	116559567	113	56.0	
4890	chr1	116560701	116561102	401	200.0	
4891	chr1	116562398	116562953	555	278.0	
4892	chr1	116568443	116572045	3602	1801.0	
4893	chr1	116574513	116575087	574	287.0	
4894	chr1	116587723	116588250	527	264.0	
4895	chr1	116595987	116597197	1210	605.0	
4896	chr1	116605714	116606543	829	414.0	
4897	chr1	116666340	116668100	1760	880.0	
4898	chr1	116672564	116672919	355	178.0	
4899	chr1	116680775	116681127	352	176.0	
4900	chr1	116724676	116725171	495	248.0	
4901	chr1	116727131	116727520	389	194.0	
4902	chr1	116736996	116739754	2758	1379.0	
4903	chr1	116740749	116741185	436	218.0	
4904	chr1	116751137	116751974	837	418.0	promoter
4905	chr1	116753440	116756152	2712	1356.0	"promoter	promoter	region	protein_binding_site"
4906	chr1	116756759	116757336	577	288.0	
4907	chr1	116758130	116758751	621	310.0	
4908	chr1	116762684	116767729	5045	2522.0	
4909	chr1	116768468	116771179	2711	1356.0	"enhancer	enhancer	enhancer	locus_control_region	locus_control_region	region	enhancer	region	protein_binding_site	region	region	protein_binding_site	region	region	region	protein_binding_site"
4910	chr1	116790096	116790160	64	32.0	
4911	chr1	116794443	116795539	1096	548.0	
4912	chr1	116799207	116801040	1833	916.0	
4913	chr1	116801901	116802244	343	172.0	
4914	chr1	116804649	116805147	498	249.0	
4915	chr1	116805968	116809575	3607	1804.0	
4916	chr1	116810325	116810805	480	240.0	
4917	chr1	116816365	116818131	1766	883.0	
4918	chr1	116827178	116827491	313	156.0	
4919	chr1	116847835	116848034	199	100.0	
4920	chr1	116853874	116854286	412	206.0	
4921	chr1	116877447	116879491	2044	1022.0	
4922	chr1	116881787	116882573	786	393.0	
4923	chr1	116909740	116910974	1234	617.0	
4924	chr1	116933505	116934184	679	340.0	
4925	chr1	116934896	116935288	392	196.0	
4926	chr1	116986559	116987804	1245	622.0	
4927	chr1	116990389	116991908	1519	760.0	
4928	chr1	116993346	116993578	232	116.0	
4929	chr1	117001248	117002084	836	418.0	
4930	chr1	117003091	117004072	981	490.0	
4931	chr1	117007072	117007672	600	300.0	
4932	chr1	117008739	117009562	823	412.0	
4933	chr1	117048897	117050222	1325	662.0	
4934	chr1	117051195	117052041	846	423.0	
4935	chr1	117055273	117055821	548	274.0	
4936	chr1	117058937	117061123	2186	1093.0	
4937	chr1	117061886	117062327	441	220.0	
4938	chr1	117067726	117068217	491	246.0	
4939	chr1	117093963	117094370	407	204.0	
4940	chr1	117120494	117122693	2199	1100.0	
4941	chr1	117128578	117128981	403	202.0	
4942	chr1	117312483	117312622	139	70.0	
4943	chr1	117339972	117340357	385	192.0	
4944	chr1	117359846	117360142	296	148.0	
4945	chr1	117365788	117369124	3336	1668.0	
4946	chr1	117512690	117513129	439	220.0	
4947	chr1	117534782	117535620	838	419.0	
4948	chr1	117558540	117558850	310	155.0	
4949	chr1	117572522	117573007	485	242.0	
4950	chr1	117595993	117596476	483	242.0	
4951	chr1	117604935	117617311	12376	6188.0	
4952	chr1	117617880	117619452	1572	786.0	
4953	chr1	117620542	117624499	3957	1978.0	
4954	chr1	117625937	117634956	9019	4510.0	
4955	chr1	117635823	117637444	1621	810.0	
4956	chr1	117638134	117638823	689	344.0	
4957	chr1	117644582	117645099	517	258.0	
4958	chr1	117653982	117657374	3392	1696.0	
4959	chr1	117658270	117659989	1719	860.0	
4960	chr1	117660560	117661835	1275	638.0	
4961	chr1	117663871	117665396	1525	762.0	
4962	chr1	117665903	117666046	143	72.0	
4963	chr1	117674276	117675022	746	373.0	
4964	chr1	117734269	117735819	1550	775.0	
4965	chr1	117754043	117754511	468	234.0	
4966	chr1	117758393	117759446	1053	526.0	
4967	chr1	117895498	117895964	466	233.0	
4968	chr1	117925975	117926381	406	203.0	
4969	chr1	117928695	117930966	2271	1136.0	
4970	chr1	118038779	118039714	935	468.0	
4971	chr1	118185001	118185333	332	166.0	
4972	chr1	119001978	119002380	402	201.0	
4973	chr1	119007691	119009037	1346	673.0	
4974	chr1	119139288	119141583	2295	1148.0	
4975	chr1	119275420	119275718	298	149.0	
4976	chr1	119327885	119327989	104	52.0	
4977	chr1	119549590	119550061	471	236.0	
4978	chr1	119552729	119552982	253	126.0	
4979	chr1	119564491	119566181	1690	845.0	
4980	chr1	119569160	119569404	244	122.0	
4981	chr1	119569926	119570434	508	254.0	
4982	chr1	119573909	119574206	297	148.0	
4983	chr1	119582764	119583232	468	234.0	
4984	chr1	119585719	119586221	502	251.0	
4985	chr1	119590354	119590813	459	230.0	
4986	chr1	119593821	119594205	384	192.0	
4987	chr1	119607207	119607447	240	120.0	
4988	chr1	119611580	119612016	436	218.0	
4989	chr1	119613715	119614208	493	246.0	
4990	chr1	119616809	119617115	306	153.0	
4991	chr1	119631570	119631902	332	166.0	
4992	chr1	119645729	119648777	3048	1524.0	
4993	chr1	119663179	119663531	352	176.0	
4994	chr1	119674760	119675982	1222	611.0	
4995	chr1	119711626	119712967	1341	670.0	
4996	chr1	119744048	119744494	446	223.0	
4997	chr1	119808933	119809386	453	226.0	
4998	chr1	119859621	119859991	370	185.0	
4999	chr1	119870857	119871387	530	265.0	
5000	chr1	119882414	119883078	664	332.0	
5001	chr1	119886132	119886569	437	218.0	
5002	chr1	119907437	119907850	413	206.0	
5003	chr1	119948546	119949103	557	278.0	
5004	chr1	119967910	119968642	732	366.0	
5005	chr1	119974974	119975448	474	237.0	
5006	chr1	119986978	119989163	2185	1092.0	
5007	chr1	119990428	119990849	421	210.0	
5008	chr1	119996747	119997038	291	146.0	
5009	chr1	120015671	120016195	524	262.0	
5010	chr1	120019189	120019628	439	220.0	
5011	chr1	120051937	120052349	412	206.0	
5012	chr1	120068519	120069936	1417	708.0	
5013	chr1	120081433	120081966	533	266.0	
5014	chr1	120087933	120088371	438	219.0	
5015	chr1	120092429	120092483	54	27.0	
5016	chr1	120093581	120094019	438	219.0	
5017	chr1	120123794	120124240	446	223.0	
5018	chr1	120130658	120131004	346	173.0	
5019	chr1	120142774	120143315	541	270.0	
5020	chr1	120145786	120146221	435	218.0	
5021	chr1	121262262	121262607	345	172.0	
5022	chr1	121260277	121260564	287	144.0	
5023	chr1	143971825	143973238	1413	706.0	
5024	chr1	143884435	143885564	1129	564.0	
5025	chr1	143880039	143880444	405	202.0	
5026	chr1	121362440	121362856	416	208.0	
5027	chr1	121395732	121397343	1611	806.0	
5028	chr1	121408297	121408783	486	243.0	
5029	chr1	121458387	121459122	735	368.0	
5030	chr1	121511224	121512404	1180	590.0	
5031	chr1	121515954	121517289	1335	668.0	
5032	chr1	121518565	121520270	1705	852.0	
5033	chr1	121551536	121551908	372	186.0	
5034	chr1	121607525	121607844	319	160.0	
5035	chr1	121609955	121610688	733	366.0	
5036	chr1	121611834	121615395	3561	1780.0	
5037	chr1	121616013	121616406	393	196.0	
5038	chr1	121644334	121644683	349	174.0	
5039	chr1	121736642	121737095	453	226.0	
5040	chr1	121741162	121743636	2474	1237.0	
5041	chr4_GL000008v2_random	0	4356	4356	2178.0	
5042	chr4_GL000008v2_random	4926	5387	461	230.0	
5043	chr4_GL000008v2_random	6988	7170	182	91.0	
5044	chr4_GL000008v2_random	118484	118861	377	188.0	
5045	chr1	148481156	148481557	401	200.0	
5046	chr1	143971861	143973165	1304	652.0	
5047	chr1	143989749	143990076	327	164.0	
5048	chr1	145008261	145008741	480	240.0	
5049	chr1	144997498	144999325	1827	914.0	
5050	chr1	144995959	144996658	699	350.0	
5051	chr1	144940050	144940521	471	236.0	
5052	chr1	149165730	149167630	1900	950.0	
5053	chr1	149162268	149163524	1256	628.0	
5054	chr1	149160447	149161136	689	344.0	
5055	chr1	148929295	148929628	333	166.0	
5056	chr1	149013535	149014018	483	242.0	
5057	chr1	149012540	149013017	477	238.0	
5058	chr1	148996441	148996891	450	225.0	
5059	chr1	148975488	148976657	1169	584.0	
5060	chr1	148965965	148966573	608	304.0	
5061	chr1	148959238	148959357	119	60.0	
5062	chr1	148958123	148958487	364	182.0	
5063	chr1	148956624	148957265	641	320.0	
5064	chr1	148951102	148955356	4254	2127.0	
5065	chr1	148948557	148949285	728	364.0	
5066	chr1	148935532	148935821	289	144.0	
5067	chr1	148911345	148911608	263	132.0	
5068	chr1	148894331	148895507	1176	588.0	
5069	chr1	148892314	148892485	171	86.0	
5070	chr1	148891349	148891364	15	8.0	
5071	chr1	148885142	148885849	707	354.0	
5072	chr1	148883443	148884119	676	338.0	
5073	chr1	148879833	148880241	408	204.0	
5074	chr1	148874602	148875213	611	306.0	
5075	chr1	148873857	148874079	222	111.0	
5076	chr1	148869391	148870072	681	340.0	
5077	chr1	148861838	148863238	1400	700.0	
5078	chr1	148859995	148860127	132	66.0	
5079	chr1	148856155	148856185	30	15.0	
5080	chr1	148853847	148854668	821	410.0	
5081	chr1	148843007	148845657	2650	1325.0	
5082	chr1	148841306	148841451	145	72.0	
5083	chr1	148829084	148829410	326	163.0	
5084	chr1	148824643	148825852	1209	604.0	
5085	chr1	148815807	148815947	140	70.0	
5086	chr1	148808157	148809410	1253	626.0	
5087	chr1	148795281	148795946	665	332.0	
5088	chr1	148793489	148794266	777	388.0	
5089	chr1	148791479	148792502	1023	512.0	
5090	chr1	148786867	148787735	868	434.0	
5091	chr1	148785535	148785680	145	72.0	
5092	chr1	148777563	148778706	1143	572.0	
5093	chr1	148771468	148774573	3105	1552.0	
5094	chr1	148769533	148770526	993	496.0	
5095	chr1	148758097	148760110	2013	1006.0	
5096	chr1	148748246	148749726	1480	740.0	
5097	chr1	148735545	148736039	494	247.0	
5098	chr1	148729068	148729507	439	220.0	
5099	chr1	146248696	146249096	400	200.0	
5100	chr1	146242073	146242322	249	124.0	
5101	chr1	146237311	146237579	268	134.0	
5102	chr1	146227614	146229422	1808	904.0	
5103	chr1	146213624	146213734	110	55.0	
5104	chr1	146211180	146211975	795	398.0	
5105	chr1	146206379	146206517	138	69.0	
5106	chr1	146190304	146190705	401	200.0	
5107	chr1	146184199	146184724	525	262.0	
5108	chr1	146175139	146175670	531	266.0	
5109	chr1	146156153	146156622	469	234.0	
5110	chr1	146147136	146148687	1551	776.0	
5111	chr1	146144405	146146478	2073	1036.0	
5112	chr1	146051112	146053207	2095	1048.0	
5113	chr1	146035213	146040024	4811	2406.0	
5114	chr1	146032557	146033213	656	328.0	
5115	chr1	146019327	146020134	807	404.0	
5116	chr1	146012950	146013610	660	330.0	
5117	chr1	146006786	146007739	953	476.0	
5118	chr1	146001170	146001706	536	268.0	
5119	chr1	145999297	146000316	1019	510.0	
5120	chr1	145993864	145998784	4920	2460.0	
5121	chr1	145987708	145992924	5216	2608.0	
5122	chr1	145984410	145986947	2537	1268.0	
5123	chr1	145983048	145983653	605	302.0	
5124	chr1	145977222	145981560	4338	2169.0	"enhancer	sequence_feature"
5125	chr1	145956579	145965362	8783	4392.0	enhancer
5126	chr1	145932410	145933289	879	440.0	
5127	chr1	145926401	145928414	2013	1006.0	
5128	chr1	145917843	145920097	2254	1127.0	
5129	chr1	145909940	145910455	515	258.0	
5130	chr1	145891703	145892331	628	314.0	
5131	chr1	145885271	145886717	1446	723.0	
5132	chr1	145871783	145872966	1183	592.0	
5133	chr1	145858004	145860491	2487	1244.0	
5134	chr1	145849300	145849740	440	220.0	
5135	chr1	145844768	145846754	1986	993.0	
5136	chr1	145823387	145824956	1569	784.0	
5137	chr1	145720511	145721784	1273	636.0	
5138	chr1	145719174	145719727	553	276.0	
5139	chr1	145696362	145696685	323	162.0	
5140	chr1	145689424	145691375	1951	976.0	
5141	chr1	145607626	145608589	963	482.0	
5142	chr1	145505710	145506229	519	260.0	
5143	chr1	146937485	146937812	327	164.0	
5144	chr1	147079710	147080613	903	452.0	
5145	chr1	147084015	147085398	1383	692.0	
5146	chr1	147171234	147173666	2432	1216.0	
5147	chr1	147204140	147204485	345	172.0	
5148	chr1	147224960	147226052	1092	546.0	
5149	chr1	147241940	147244145	2205	1102.0	
5150	chr1	147245719	147246012	293	146.0	
5151	chr1	147247263	147247684	421	210.0	
5152	chr1	147273708	147274145	437	218.0	
5153	chr1	147494923	147495589	666	333.0	
5154	chr1	147515375	147515757	382	191.0	
5155	chr1	147528167	147528394	227	114.0	
5156	chr1	147540056	147542917	2861	1430.0	
5157	chr1	147544734	147545754	1020	510.0	
5158	chr1	147580101	147580641	540	270.0	
5159	chr1	147598549	147601118	2569	1284.0	
5160	chr1	147618015	147618591	576	288.0	
5161	chr1	147625595	147625744	149	74.0	
5162	chr1	147627407	147627918	511	256.0	
5163	chr1	147628468	147629656	1188	594.0	
5164	chr1	147634689	147636062	1373	686.0	
5165	chr1	147640529	147641416	887	444.0	
5166	chr1	147641922	147642411	489	244.0	
5167	chr1	147647965	147649364	1399	700.0	
5168	chr1	147669269	147671203	1934	967.0	
5169	chr1	147688550	147688865	315	158.0	
5170	chr1	147699875	147700556	681	340.0	
5171	chr1	147890207	147890611	404	202.0	
5172	chr1	147892694	147893111	417	208.0	
5173	chr1	147928025	147928998	973	486.0	
5174	chr1	148081172	148081620	448	224.0	
5175	chr1	148152061	148152472	411	206.0	
5176	chr1	148254856	148255207	351	176.0	
5177	chr1	148262641	148264367	1726	863.0	
5178	chr1	148279916	148281169	1253	626.0	
5179	chr1	148303038	148303887	849	424.0	
5180	chr1	148307372	148308068	696	348.0	
5181	chr1	148315386	148315872	486	243.0	
5182	chr1	148317915	148319233	1318	659.0	
5183	chr1	148333842	148336839	2997	1498.0	
5184	chr1	148345600	148346078	478	239.0	
5185	chr1	120844092	120845008	916	458.0	
5186	chr1	148514363	148514686	323	162.0	
5187	chr1	144460483	144461962	1479	740.0	
5188	chr1	144418615	144419415	800	400.0	
5189	chr1	144412367	144413506	1139	570.0	
5190	chr1	143497027	143499027	2000	1000.0	
5191	chr1	143424498	143425028	530	265.0	
5192	chr1	143540270	143540640	370	185.0	
5193	chr1	143698094	143698359	265	132.0	
5194	chr1	143699718	143700148	430	215.0	
5195	chr1	143709394	143710428	1034	517.0	
5196	chr1	143710956	143712301	1345	672.0	
5197	chr1	143720006	143721670	1664	832.0	
5198	chr1	143727628	143730719	3091	1546.0	
5199	chr1	143778127	143778550	423	212.0	
5200	chr1	143791683	143792902	1219	610.0	
5201	chr1	143799456	143800425	969	484.0	
5202	chr1	143803117	143804622	1505	752.0	
5203	chr1	143867594	143868060	466	233.0	
5204	chr1	143884536	143885398	862	431.0	
5205	chr1	120850721	120851122	401	200.0	
5206	chr1	149636060	149636946	886	443.0	
5207	chr1	149686607	149687281	674	337.0	
5208	chr1	149740120	149740714	594	297.0	
5209	chr1	149746795	149747253	458	229.0	
5210	chr1	149775573	149775917	344	172.0	
5211	chr1	149792368	149793523	1155	578.0	
5212	chr1	149811027	149811111	84	42.0	
5213	chr1	149811815	149814028	2213	1106.0	
5214	chr1	149843258	149844561	1303	652.0	
5215	chr1	149845231	149846163	932	466.0	
5216	chr1	149847167	149850559	3392	1696.0	
5217	chr1	149879493	149879965	472	236.0	
5218	chr1	149882071	149882504	433	216.0	
5219	chr1	149883815	149883829	14	7.0	
5220	chr1	149884449	149889213	4764	2382.0	
5221	chr1	149898927	149900532	1605	802.0	
5222	chr1	149916085	149918658	2573	1286.0	
5223	chr1	149927086	149930421	3335	1668.0	
5224	chr1	149931072	149931890	818	409.0	
5225	chr1	149938966	149939753	787	394.0	
5226	chr1	149961941	149962681	740	370.0	
5227	chr1	149997306	149998110	804	402.0	
5228	chr1	150009601	150011303	1702	851.0	
5229	chr1	150050553	150050992	439	220.0	
5230	chr1	150053789	150054584	795	398.0	
5231	chr1	150066720	150068322	1602	801.0	
5232	chr1	150072940	150073402	462	231.0	
5233	chr1	150089929	150090612	683	342.0	
5234	chr1	150106328	150106789	461	230.0	
5235	chr1	150109337	150110724	1387	694.0	
5236	chr1	150147096	150147505	409	204.0	
5237	chr1	150148799	150153142	4343	2172.0	
5238	chr1	150157847	150164665	6818	3409.0	
5239	chr1	150165857	150166424	567	284.0	
5240	chr1	150168877	150169443	566	283.0	
5241	chr1	150176590	150177100	510	255.0	
5242	chr1	150178500	150178946	446	223.0	
5243	chr1	150180469	150180940	471	236.0	
5244	chr1	150182998	150183967	969	484.0	
5245	chr1	150186086	150187920	1834	917.0	
5246	chr1	150213218	150214498	1280	640.0	
5247	chr1	150221556	150221963	407	204.0	
5248	chr1	150225541	150225744	203	102.0	
5249	chr1	150233048	150236908	3860	1930.0	
5250	chr1	150255251	150256629	1378	689.0	
5251	chr1	150267735	150269911	2176	1088.0	
5252	chr1	150281139	150283566	2427	1214.0	
5253	chr1	150293243	150294709	1466	733.0	
5254	chr1	150320788	150322904	2116	1058.0	
5255	chr1	150362917	150367208	4291	2146.0	
5256	chr1	150409555	150409873	318	159.0	
5257	chr1	150464253	150464813	560	280.0	
5258	chr1	150477243	150478154	911	456.0	
5259	chr1	150484887	150485213	326	163.0	
5260	chr1	150486804	150488223	1419	710.0	
5261	chr1	150507866	150508198	332	166.0	
5262	chr1	150514935	150517627	2692	1346.0	
5263	chr1	150532471	150533003	532	266.0	
5264	chr1	150545520	150545807	287	144.0	
5265	chr1	150548444	150580634	32190	16095.0	
5266	chr1	150581327	150581494	167	84.0	
5267	chr1	150592402	150592803	401	200.0	
5268	chr1	150596504	150596897	393	196.0	
5269	chr1	150604424	150605190	766	383.0	
5270	chr1	150610735	150616294	5559	2780.0	
5271	chr1	150619575	150620332	757	378.0	
5272	chr1	150621228	150622154	926	463.0	
5273	chr1	150627766	150630908	3142	1571.0	
5274	chr1	150631693	150631705	12	6.0	
5275	chr1	150683932	150684341	409	204.0	
5276	chr1	150696228	150697913	1685	842.0	
5277	chr1	150759990	150760433	443	222.0	
5278	chr1	150761796	150762239	443	222.0	
5279	chr1	150763647	150766311	2664	1332.0	
5280	chr1	150770759	150771791	1032	516.0	
5281	chr1	150775351	150775437	86	43.0	
5282	chr1	150777477	150777897	420	210.0	
5283	chr1	150780479	150780867	388	194.0	
5284	chr1	150787746	150788458	712	356.0	
5285	chr1	150789222	150789925	703	352.0	
5286	chr1	150791315	150792221	906	453.0	
5287	chr1	150793159	150793699	540	270.0	
5288	chr1	150796420	150796821	401	200.0	
5289	chr1	150807216	150807538	322	161.0	
5290	chr1	150813049	150813516	467	234.0	
5291	chr1	150841700	150842107	407	204.0	
5292	chr1	150852265	150853211	946	473.0	
5293	chr1	150874531	150874995	464	232.0	
5294	chr1	150875729	150877683	1954	977.0	
5295	chr1	150881508	150882130	622	311.0	
5296	chr1	150890021	150890344	323	162.0	
5297	chr1	150922270	150922966	696	348.0	
5298	chr1	150925014	150928076	3062	1531.0	
5299	chr1	150970283	150971542	1259	630.0	
5300	chr1	150972055	150975628	3573	1786.0	
5301	chr1	150976861	150978071	1210	605.0	
5302	chr1	150978916	150980159	1243	622.0	
5303	chr1	150995675	150996497	822	411.0	
5304	chr1	150999096	150999630	534	267.0	
5305	chr1	151001474	151003652	2178	1089.0	
5306	chr1	151005501	151010007	4506	2253.0	
5307	chr1	151024263	151025165	902	451.0	
5308	chr1	151045420	151046034	614	307.0	
5309	chr1	151047217	151050798	3581	1790.0	
5310	chr1	151051395	151052200	805	402.0	
5311	chr1	151055467	151061160	5693	2846.0	
5312	chr1	151069905	151071931	2026	1013.0	
5313	chr1	151099726	151100209	483	242.0	
5314	chr1	151130897	151131914	1017	508.0	
5315	chr1	151145562	151147537	1975	988.0	
5316	chr1	151155765	151159890	4125	2062.0	
5317	chr1	151165100	151166893	1793	896.0	
5318	chr1	151175915	151176370	455	228.0	
5319	chr1	151189444	151190544	1100	550.0	
5320	chr1	151196254	151196914	660	330.0	
5321	chr1	151197773	151200589	2816	1408.0	
5322	chr1	151237919	151238320	401	200.0	
5323	chr1	151251464	151252163	699	350.0	
5324	chr1	151254068	151255653	1585	792.0	
5325	chr1	151264624	151264942	318	159.0	
5326	chr1	151275356	151275769	413	206.0	
5327	chr1	151277024	151278061	1037	518.0	
5328	chr1	151280741	151284452	3711	1856.0	
5329	chr1	151289107	151290086	979	490.0	
5330	chr1	151290587	151291309	722	361.0	
5331	chr1	151292288	151293351	1063	532.0	
5332	chr1	151300661	151301464	803	402.0	
5333	chr1	151311228	151312414	1186	593.0	
5334	chr1	151325246	151325854	608	304.0	
5335	chr1	151326624	151328484	1860	930.0	
5336	chr1	151340667	151341755	1088	544.0	
5337	chr1	151345555	151348041	2486	1243.0	
5338	chr1	151371620	151371756	136	68.0	
5339	chr1	151398347	151400463	2116	1058.0	
5340	chr1	151436978	151437459	481	240.0	
5341	chr1	151443761	151444310	549	274.0	
5342	chr1	151456939	151460101	3162	1581.0	
5343	chr1	151472872	151473814	942	471.0	
5344	chr1	151510257	151512512	2255	1128.0	
5345	chr1	151534616	151535132	516	258.0	
5346	chr1	151539408	151541661	2253	1126.0	
5347	chr1	151547586	151547701	115	58.0	
5348	chr1	151559239	151559254	15	8.0	
5349	chr1	151562086	151562170	84	42.0	
5350	chr1	151568666	151569213	547	274.0	
5351	chr1	151593662	151594622	960	480.0	
5352	chr1	151606572	151606644	72	36.0	
5353	chr1	151608305	151608733	428	214.0	
5354	chr1	151611090	151613560	2470	1235.0	
5355	chr1	151619661	151620791	1130	565.0	
5356	chr1	151653464	151654701	1237	618.0	
5357	chr1	151661647	151662198	551	276.0	
5358	chr1	151690989	151691098	109	54.0	
5359	chr1	151692118	151692648	530	265.0	
5360	chr1	151716720	151717332	612	306.0	
5361	chr1	151720529	151721929	1400	700.0	
5362	chr1	151734960	151735492	532	266.0	
5363	chr1	151762635	151764161	1526	763.0	
5364	chr1	151789858	151791757	1899	950.0	
5365	chr1	151815507	151816556	1049	524.0	
5366	chr1	151817257	151817823	566	283.0	
5367	chr1	151820861	151821511	650	325.0	
5368	chr1	151822350	151822622	272	136.0	
5369	chr1	151825890	151826605	715	358.0	
5370	chr1	151827641	151831477	3836	1918.0	
5371	chr1	151833468	151834323	855	428.0	
5372	chr1	151836181	151840537	4356	2178.0	
5373	chr1	151867710	151868309	599	300.0	
5374	chr1	151888988	151889362	374	187.0	
5375	chr1	151898085	151899352	1267	634.0	
5376	chr1	151904884	151906119	1235	618.0	
5377	chr1	151908991	151910662	1671	836.0	
5378	chr1	151920114	151920525	411	206.0	
5379	chr1	151921431	151921983	552	276.0	
5380	chr1	151933922	151934486	564	282.0	
5381	chr1	151939703	151940136	433	216.0	
5382	chr1	151940923	151941984	1061	530.0	
5383	chr1	151944295	151947040	2745	1372.0	
5384	chr1	151959054	151959102	48	24.0	
5385	chr1	151967708	151968587	879	440.0	
5386	chr1	151972806	151973346	540	270.0	
5387	chr1	151984171	151985026	855	428.0	
5388	chr1	151987047	151987463	416	208.0	
5389	chr1	151988558	151990667	2109	1054.0	
5390	chr1	151991851	151994966	3115	1558.0	
5391	chr1	151995836	151996111	275	138.0	
5392	chr1	151996738	151997407	669	334.0	
5393	chr1	152000701	152002163	1462	731.0	
5394	chr1	152013612	152014069	457	228.0	
5395	chr1	152029065	152030701	1636	818.0	
5396	chr1	152034124	152038737	4613	2306.0	
5397	chr1	152046454	152046658	204	102.0	
5398	chr1	152047384	152048917	1533	766.0	
5399	chr1	152049591	152050151	560	280.0	"sequence_feature	enhancer"
5400	chr1	152050794	152051671	877	438.0	
5401	chr1	152052305	152053319	1014	507.0	
5402	chr1	152108054	152108609	555	278.0	
5403	chr1	152110295	152112716	2421	1210.0	
5404	chr1	152142014	152142323	309	154.0	
5405	chr1	152160451	152161062	611	306.0	
5406	chr1	152165261	152166034	773	386.0	
5407	chr1	152167912	152168156	244	122.0	
5408	chr1	152169493	152169705	212	106.0	
5409	chr1	152170482	152170939	457	228.0	
5410	chr1	152182419	152182831	412	206.0	
5411	chr1	152185326	152186023	697	348.0	
5412	chr1	152188517	152190251	1734	867.0	
5413	chr1	152347153	152347500	347	174.0	
5414	chr1	152392778	152393244	466	233.0	
5415	chr1	152440612	152441310	698	349.0	
5416	chr1	152458136	152459014	878	439.0	
5417	chr1	152459674	152460751	1077	538.0	
5418	chr1	152461473	152462011	538	269.0	
5419	chr1	152479801	152480547	746	373.0	
5420	chr1	152519835	152520291	456	228.0	
5421	chr1	152654143	152654330	187	94.0	
5422	chr1	152869848	152870166	318	159.0	
5423	chr1	153223065	153223366	301	150.0	
5424	chr1	153231677	153232932	1255	628.0	
5425	chr1	153260657	153261830	1173	586.0	
5426	chr1	153277887	153278205	318	159.0	
5427	chr1	153288962	153288978	16	8.0	
5428	chr1	153344697	153345125	428	214.0	
5429	chr1	153346372	153346484	112	56.0	
5430	chr1	153352401	153352870	469	234.0	
5431	chr1	153355414	153355937	523	262.0	
5432	chr1	153357036	153358520	1484	742.0	
5433	chr1	153360212	153360578	366	183.0	
5434	chr1	153361104	153362322	1218	609.0	
5435	chr1	153364225	153364491	266	133.0	
5436	chr1	153365220	153365654	434	217.0	
5437	chr1	153368485	153368886	401	200.0	
5438	chr1	153373991	153374510	519	260.0	
5439	chr1	153375366	153375966	600	300.0	
5440	chr1	153384962	153385370	408	204.0	
5441	chr1	153386291	153387138	847	424.0	
5442	chr1	153389965	153391871	1906	953.0	
5443	chr1	153404648	153405171	523	262.0	
5444	chr1	153422415	153422885	470	235.0	
5445	chr1	153465686	153466163	477	238.0	
5446	chr1	153490739	153491100	361	180.0	
5447	chr1	153494853	153495381	528	264.0	
5448	chr1	153509612	153510177	565	282.0	
5449	chr1	153510824	153511393	569	284.0	
5450	chr1	153514867	153516347	1480	740.0	
5451	chr1	153518549	153519028	479	240.0	
5452	chr1	153531848	153534427	2579	1290.0	
5453	chr1	153535058	153537383	2325	1162.0	
5454	chr1	153540400	153542448	2048	1024.0	
5455	chr1	153544426	153546528	2102	1051.0	
5456	chr1	153550993	153551560	567	284.0	
5457	chr1	153553931	153554101	170	85.0	
5458	chr1	153565494	153567175	1681	840.0	
5459	chr1	153568155	153569188	1033	516.0	
5460	chr1	153572423	153573744	1321	660.0	
5461	chr1	153598541	153599359	818	409.0	
5462	chr1	153610967	153611208	241	120.0	
5463	chr1	153617490	153618061	571	286.0	
5464	chr1	153623080	153623646	566	283.0	
5465	chr1	153627069	153627831	762	381.0	
5466	chr1	153633137	153635986	2849	1424.0	
5467	chr1	153646578	153647499	921	460.0	
5468	chr1	153649424	153650191	767	384.0	
5469	chr1	153652978	153653463	485	242.0	
5470	chr1	153658041	153659499	1458	729.0	
5471	chr1	153670236	153672635	2399	1200.0	
5472	chr1	153677596	153680405	2809	1404.0	
5473	chr1	153690779	153691220	441	220.0	
5474	chr1	153697910	153698553	643	322.0	
5475	chr1	153727177	153729230	2053	1026.0	
5476	chr1	153734529	153735285	756	378.0	
5477	chr1	153744039	153744092	53	26.0	
5478	chr1	153749250	153749927	677	338.0	
5479	chr1	153769012	153769657	645	322.0	
5480	chr1	153772926	153776764	3838	1919.0	
5481	chr1	153777506	153777520	14	7.0	
5482	chr1	153782928	153784447	1519	760.0	
5483	chr1	153789555	153792210	2655	1328.0	
5484	chr1	153796255	153797840	1585	792.0	
5485	chr1	153803493	153803862	369	184.0	
5486	chr1	153804928	153806743	1815	908.0	
5487	chr1	153821267	153821751	484	242.0	
5488	chr1	153849307	153849955	648	324.0	
5489	chr1	153854176	153854691	515	258.0	
5490	chr1	153880838	153881370	532	266.0	
5491	chr1	153888796	153888828	32	16.0	
5492	chr1	153920112	153924340	4228	2114.0	
5493	chr1	153943900	153947549	3649	1824.0	
5494	chr1	153955397	153959659	4262	2131.0	
5495	chr1	153962266	153964484	2218	1109.0	
5496	chr1	153965870	153969675	3805	1902.0	
5497	chr1	153976523	153978520	1997	998.0	
5498	chr1	153985257	153987623	2366	1183.0	
5499	chr1	153990074	153997005	6931	3466.0	
5500	chr1	154115131	154115546	415	208.0	
5501	chr1	154129376	154129700	324	162.0	
5502	chr1	154148867	154149241	374	187.0	
5503	chr1	154153594	154155570	1976	988.0	
5504	chr1	154157301	154159387	2086	1043.0	
5505	chr1	154162604	154162891	287	144.0	
5506	chr1	154170896	154171197	301	150.0	
5507	chr1	154176289	154181179	4890	2445.0	
5508	chr1	154181689	154183919	2230	1115.0	
5509	chr1	154185978	154186545	567	284.0	
5510	chr1	154192091	154192690	599	300.0	
5511	chr1	154194345	154194469	124	62.0	
5512	chr1	154198957	154199712	755	378.0	
5513	chr1	154206224	154206524	300	150.0	
5514	chr1	154219162	154222228	3066	1533.0	
5515	chr1	154265503	154266043	540	270.0	
5516	chr1	154270853	154273683	2830	1415.0	
5517	chr1	154276808	154277128	320	160.0	
5518	chr1	154324178	154331119	6941	3470.0	
5519	chr1	154334432	154335775	1343	672.0	
5520	chr1	154337322	154337991	669	334.0	
5521	chr1	154342028	154343797	1769	884.0	
5522	chr1	154344921	154345814	893	446.0	
5523	chr1	154346317	154346781	464	232.0	
5524	chr1	154352217	154354024	1807	904.0	
5525	chr1	154374014	154374286	272	136.0	
5526	chr1	154385444	154387284	1840	920.0	
5527	chr1	154400358	154400876	518	259.0	
5528	chr1	154402391	154408826	6435	3218.0	
5529	chr1	154410142	154410598	456	228.0	
5530	chr1	154418879	154420674	1795	898.0	
5531	chr1	154423625	154423962	337	168.0	
5532	chr1	154431349	154433884	2535	1268.0	
5533	chr1	154439436	154440419	983	492.0	
5534	chr1	154441239	154441637	398	199.0	
5535	chr1	154442322	154442694	372	186.0	
5536	chr1	154444990	154445491	501	250.0	
5537	chr1	154453089	154454033	944	472.0	
5538	chr1	154454679	154455162	483	242.0	
5539	chr1	154456042	154457196	1154	577.0	
5540	chr1	154463166	154464238	1072	536.0	
5541	chr1	154464834	154465524	690	345.0	
5542	chr1	154467142	154467191	49	24.0	
5543	chr1	154467752	154468143	391	196.0	
5544	chr1	154478581	154479026	445	222.0	
5545	chr1	154479725	154480299	574	287.0	
5546	chr1	154490226	154490677	451	226.0	
5547	chr1	154492226	154492627	401	200.0	
5548	chr1	154493139	154493720	581	290.0	
5549	chr1	154496976	154497364	388	194.0	
5550	chr1	154501507	154502944	1437	718.0	
5551	chr1	154546365	154546875	510	255.0	
5552	chr1	154557226	154560121	2895	1448.0	
5553	chr1	154567492	154568575	1083	542.0	
5554	chr1	154577169	154577349	180	90.0	
5555	chr1	154578036	154578064	28	14.0	
5556	chr1	154607013	154610298	3285	1642.0	
5557	chr1	154623271	154623807	536	268.0	
5558	chr1	154626752	154628472	1720	860.0	
5559	chr1	154657556	154657939	383	192.0	
5560	chr1	154669582	154670161	579	290.0	
5561	chr1	154714235	154716392	2157	1078.0	
5562	chr1	154719565	154719989	424	212.0	
5563	chr1	154720599	154721373	774	387.0	
5564	chr1	154726546	154726804	258	129.0	
5565	chr1	154747688	154748661	973	486.0	
5566	chr1	154751510	154752235	725	362.0	
5567	chr1	154759205	154761039	1834	917.0	
5568	chr1	154766006	154766332	326	163.0	
5569	chr1	154772765	154772910	145	72.0	
5570	chr1	154784745	154785640	895	448.0	
5571	chr1	154790953	154792324	1371	686.0	
5572	chr1	154807173	154807250	77	38.0	
5573	chr1	154819642	154820555	913	456.0	
5574	chr1	154859863	154860896	1033	516.0	
5575	chr1	154863632	154863957	325	162.0	
5576	chr1	154867165	154867457	292	146.0	
5577	chr1	154869911	154870834	923	462.0	
5578	chr1	154878391	154878937	546	273.0	
5579	chr1	154925859	154926090	231	116.0	
5580	chr1	154935962	154938427	2465	1232.0	
5581	chr1	154939000	154939424	424	212.0	
5582	chr1	154940218	154945572	5354	2677.0	
5583	chr1	154948191	154948924	733	366.0	
5584	chr1	154950642	154957025	6383	3192.0	
5585	chr1	154960597	154962748	2151	1076.0	
5586	chr1	154970404	154971745	1341	670.0	
5587	chr1	154972881	154976396	3515	1758.0	
5588	chr1	154982668	154984543	1875	938.0	
5589	chr1	154988077	154988480	403	202.0	
5590	chr1	154995670	154996069	399	200.0	
5591	chr1	154997303	154997781	478	239.0	
5592	chr1	154998738	155011137	12399	6200.0	
5593	chr1	155011773	155014194	2421	1210.0	
5594	chr1	155015804	155018332	2528	1264.0	
5595	chr1	155028628	155029148	520	260.0	
5596	chr1	155035925	155036237	312	156.0	
5597	chr1	155044659	155045519	860	430.0	
5598	chr1	155050017	155053420	3403	1702.0	
5599	chr1	155061066	155064717	3651	1826.0	
5600	chr1	155069720	155071988	2268	1134.0	
5601	chr1	155077472	155083178	5706	2853.0	
5602	chr1	155083994	155086798	2804	1402.0	
5603	chr1	155091141	155092055	914	457.0	
5604	chr1	155094364	155094840	476	238.0	
5605	chr1	155101978	155102804	826	413.0	
5606	chr1	155126404	155129515	3111	1556.0	
5607	chr1	155134490	155137309	2819	1410.0	
5608	chr1	155139587	155141163	1576	788.0	
5609	chr1	155149699	155150092	393	196.0	
5610	chr1	155166419	155168506	2087	1044.0	
5611	chr1	155172450	155177272	4822	2411.0	
5612	chr1	155178758	155179304	546	273.0	
5613	chr1	155185039	155186034	995	498.0	
5614	chr1	155192391	155197634	5243	2622.0	
5615	chr1	155206575	155211159	4584	2292.0	
5616	chr1	155218839	155220679	1840	920.0	
5617	chr1	155222992	155223411	419	210.0	
5618	chr1	155224600	155225183	583	292.0	
5619	chr1	155226213	155228350	2137	1068.0	
5620	chr1	155240726	155242376	1650	825.0	
5621	chr1	155243323	155245467	2144	1072.0	
5622	chr1	155250071	155251509	1438	719.0	
5623	chr1	155254751	155256842	2091	1046.0	
5624	chr1	155261360	155263160	1800	900.0	
5625	chr1	155272581	155274178	1597	798.0	
5626	chr1	155276717	155279700	2983	1492.0	
5627	chr1	155307429	155310106	2677	1338.0	
5628	chr1	155320322	155321330	1008	504.0	
5629	chr1	155322547	155328155	5608	2804.0	
5630	chr1	155466280	155466716	436	218.0	
5631	chr1	155485866	155486421	555	278.0	
5632	chr1	155499794	155500562	768	384.0	
5633	chr1	155504218	155504619	401	200.0	
5634	chr1	155513497	155513924	427	214.0	
5635	chr1	155527641	155528130	489	244.0	
5636	chr1	155529848	155530271	423	212.0	
5637	chr1	155536041	155536902	861	430.0	
5638	chr1	155558618	155558772	154	77.0	
5639	chr1	155560555	155560757	202	101.0	
5640	chr1	155561771	155564450	2679	1340.0	
5641	chr1	155591721	155592281	560	280.0	
5642	chr1	155598773	155599343	570	285.0	
5643	chr1	155609532	155610481	949	474.0	
5644	chr1	155622331	155622465	134	67.0	
5645	chr1	155636819	155638227	1408	704.0	
5646	chr1	155648342	155650586	2244	1122.0	
5647	chr1	155675794	155676023	229	114.0	
5648	chr1	155687685	155690026	2341	1170.0	
5649	chr1	155717057	155717360	303	152.0	
5650	chr1	155729036	155729522	486	243.0	
5651	chr1	155745013	155746056	1043	522.0	
5652	chr1	155763382	155764371	989	494.0	
5653	chr1	155836427	155836735	308	154.0	
5654	chr1	155856629	155857886	1257	628.0	
5655	chr1	155858556	155861128	2572	1286.0	
5656	chr1	155893414	155894227	813	406.0	
5657	chr1	155909683	155912230	2547	1274.0	
5658	chr1	155931326	155931670	344	172.0	
5659	chr1	155933476	155935262	1786	893.0	
5660	chr1	155938066	155938619	553	276.0	
5661	chr1	155940231	155941663	1432	716.0	
5662	chr1	155942331	155942710	379	190.0	
5663	chr1	155944322	155947033	2711	1356.0	
5664	chr1	155961106	155962454	1348	674.0	
5665	chr1	155966516	155968307	1791	896.0	
5666	chr1	155969256	155969850	594	297.0	
5667	chr1	155970354	155971322	968	484.0	
5668	chr1	155972115	155972367	252	126.0	
5669	chr1	155974455	155980395	5940	2970.0	
5670	chr1	155981066	155981967	901	450.0	
5671	chr1	155983703	155984106	403	202.0	
5672	chr1	155988950	155991521	2571	1286.0	
5673	chr1	156004766	156005521	755	378.0	
5674	chr1	156020123	156021474	1351	676.0	
5675	chr1	156025849	156026368	519	260.0	
5676	chr1	156052744	156056116	3372	1686.0	
5677	chr1	156066094	156066786	692	346.0	
5678	chr1	156076649	156077121	472	236.0	
5679	chr1	156080695	156083444	2749	1374.0	
5680	chr1	156089923	156091328	1405	702.0	
5681	chr1	156096161	156099334	3173	1586.0	
5682	chr1	156100588	156100672	84	42.0	
5683	chr1	156102252	156102467	215	108.0	
5684	chr1	156102972	156107443	4471	2236.0	enhancer
5685	chr1	156109020	156109644	624	312.0	
5686	chr1	156113369	156121808	8439	4220.0	
5687	chr1	156122552	156131045	8493	4246.0	
5688	chr1	156132689	156133080	391	196.0	
5689	chr1	156133596	156142153	8557	4278.0	
5690	chr1	156145705	156149859	4154	2077.0	
5691	chr1	156150656	156151926	1270	635.0	
5692	chr1	156153916	156156270	2354	1177.0	
5693	chr1	156157523	156157899	376	188.0	
5694	chr1	156160440	156161813	1373	686.0	
5695	chr1	156165019	156165514	495	248.0	
5696	chr1	156178268	156178579	311	156.0	
5697	chr1	156193304	156194819	1515	758.0	
5698	chr1	156212292	156214505	2213	1106.0	
5699	chr1	156217448	156218630	1182	591.0	
5700	chr1	156225161	156225899	738	369.0	
5701	chr1	156245252	156247042	1790	895.0	
5702	chr1	156247853	156248546	693	346.0	
5703	chr1	156276447	156277607	1160	580.0	
5704	chr1	156281175	156283596	2421	1210.0	
5705	chr1	156284742	156285199	457	228.0	
5706	chr1	156291128	156291953	825	412.0	
5707	chr1	156295078	156296110	1032	516.0	
5708	chr1	156336604	156336610	6	3.0	
5709	chr1	156337186	156339342	2156	1078.0	
5710	chr1	156356788	156357528	740	370.0	
5711	chr1	156368964	156369635	671	336.0	
5712	chr1	156371496	156372032	536	268.0	
5713	chr1	156376105	156376587	482	241.0	
5714	chr1	156377527	156377894	367	184.0	
5715	chr1	156382881	156383399	518	259.0	
5716	chr1	156385378	156386370	992	496.0	
5717	chr1	156395028	156395412	384	192.0	
5718	chr1	156398263	156398737	474	237.0	
5719	chr1	156419624	156423042	3418	1709.0	
5720	chr1	156433002	156433091	89	44.0	
5721	chr1	156433690	156433884	194	97.0	
5722	chr1	156434693	156436818	2125	1062.0	
5723	chr1	156437604	156437920	316	158.0	
5724	chr1	156438615	156439090	475	238.0	
5725	chr1	156441001	156441248	247	124.0	
5726	chr1	156444413	156444816	403	202.0	
5727	chr1	156445418	156446382	964	482.0	
5728	chr1	156452932	156453297	365	182.0	
5729	chr1	156456047	156458397	2350	1175.0	
5730	chr1	156460493	156462624	2131	1066.0	
5731	chr1	156463147	156463548	401	200.0	
5732	chr1	156465295	156466866	1571	786.0	
5733	chr1	156467998	156468426	428	214.0	
5734	chr1	156472167	156472510	343	172.0	
5735	chr1	156473463	156473806	343	172.0	
5736	chr1	156474603	156476455	1852	926.0	
5737	chr1	156479864	156485455	5591	2796.0	
5738	chr1	156486914	156506154	19240	9620.0	
5739	chr1	156507872	156509271	1399	700.0	
5740	chr1	156511613	156512200	587	294.0	
5741	chr1	156515874	156516431	557	278.0	
5742	chr1	156524089	156525650	1561	780.0	
5743	chr1	156551759	156553553	1794	897.0	
5744	chr1	156554967	156555384	417	208.0	
5745	chr1	156572122	156572919	797	398.0	
5746	chr1	156581547	156583216	1669	834.0	
5747	chr1	156583732	156584487	755	378.0	
5748	chr1	156591075	156592701	1626	813.0	
5749	chr1	156599704	156603148	3444	1722.0	
5750	chr1	156607337	156609497	2160	1080.0	
5751	chr1	156619350	156619727	377	188.0	
5752	chr1	156623289	156626279	2990	1495.0	
5753	chr1	156627371	156627875	504	252.0	
5754	chr1	156639738	156639823	85	42.0	
5755	chr1	156641644	156642404	760	380.0	
5756	chr1	156643635	156644261	626	313.0	
5757	chr1	156652100	156652176	76	38.0	
5758	chr1	156656617	156658364	1747	874.0	
5759	chr1	156659002	156662584	3582	1791.0	enhancer
5760	chr1	156664889	156665327	438	219.0	enhancer
5761	chr1	156677824	156678469	645	322.0	
5762	chr1	156684203	156684573	370	185.0	
5763	chr1	156688975	156690119	1144	572.0	
5764	chr1	156691855	156693159	1304	652.0	
5765	chr1	156704879	156708074	3195	1598.0	
5766	chr1	156725351	156730524	5173	2586.0	
5767	chr1	156731866	156732043	177	88.0	
5768	chr1	156740314	156742035	1721	860.0	
5769	chr1	156743712	156744014	302	151.0	
5770	chr1	156745942	156752705	6763	3382.0	
5771	chr1	156753221	156753255	34	17.0	
5772	chr1	156765634	156768795	3161	1580.0	
5773	chr1	156797209	156797741	532	266.0	
5774	chr1	156801284	156802158	874	437.0	
5775	chr1	156802691	156806216	3525	1762.0	
5776	chr1	156807036	156810129	3093	1546.0	
5777	chr1	156811139	156811601	462	231.0	
5778	chr1	156812528	156812537	9	4.0	
5779	chr1	156813322	156817578	4256	2128.0	
5780	chr1	156821784	156822171	387	194.0	
5781	chr1	156833759	156833991	232	116.0	
5782	chr1	156835980	156836579	599	300.0	
5783	chr1	156838781	156839678	897	448.0	
5784	chr1	156844969	156846061	1092	546.0	
5785	chr1	156848490	156849535	1045	522.0	
5786	chr1	156858997	156861336	2339	1170.0	
5787	chr1	156863180	156863218	38	19.0	
5788	chr1	156889917	156890582	665	332.0	
5789	chr1	156891800	156894098	2298	1149.0	
5790	chr1	156898163	156898641	478	239.0	
5791	chr1	156905722	156905940	218	109.0	
5792	chr1	156907282	156907856	574	287.0	
5793	chr1	156910174	156910857	683	342.0	
5794	chr1	156920311	156920844	533	266.0	
5795	chr1	156923795	156924433	638	319.0	
5796	chr1	156926269	156926605	336	168.0	
5797	chr1	156927445	156928225	780	390.0	
5798	chr1	156931213	156931926	713	356.0	
5799	chr1	156961695	156962116	421	210.0	
5800	chr1	156963016	156964215	1199	600.0	
5801	chr1	157045108	157047111	2003	1002.0	
5802	chr1	157055700	157056052	352	176.0	
5803	chr1	157074166	157074677	511	256.0	
5804	chr1	157085367	157085899	532	266.0	
5805	chr1	157089894	157090582	688	344.0	
5806	chr1	157099263	157100010	747	374.0	
5807	chr1	157105980	157107203	1223	612.0	
5808	chr1	157112855	157113585	730	365.0	
5809	chr1	157117374	157117864	490	245.0	
5810	chr1	157119014	157119353	339	170.0	
5811	chr1	157124840	157125234	394	197.0	
5812	chr1	157127597	157128333	736	368.0	
5813	chr1	157129759	157130534	775	388.0	
5814	chr1	157131354	157131411	57	28.0	
5815	chr1	157132121	157141671	9550	4775.0	
5816	chr1	157142195	157142596	401	200.0	
5817	chr1	157147824	157148591	767	384.0	
5818	chr1	157154690	157156646	1956	978.0	
5819	chr1	157163548	157164100	552	276.0	
5820	chr1	157170926	157171118	192	96.0	
5821	chr1	157193810	157193957	147	74.0	
5822	chr1	157249434	157249598	164	82.0	
5823	chr1	157269622	157270095	473	236.0	
5824	chr1	157335120	157335385	265	132.0	
5825	chr1	157369914	157370292	378	189.0	
5826	chr1	157377223	157377657	434	217.0	
5827	chr1	157380697	157380710	13	6.0	
5828	chr1	157399994	157400442	448	224.0	
5829	chr1	157403206	157404446	1240	620.0	
5830	chr1	157408171	157408564	393	196.0	
5831	chr1	157437092	157437746	654	327.0	
5832	chr1	157489313	157489758	445	222.0	
5833	chr1	157490530	157490962	432	216.0	
5834	chr1	157496020	157496459	439	220.0	
5835	chr1	157505630	157506031	401	200.0	
5836	chr1	157552369	157552664	295	148.0	
5837	chr1	157566416	157567121	705	352.0	
5838	chr1	157575906	157575909	3	2.0	
5839	chr1	157580212	157580622	410	205.0	
5840	chr1	157585892	157586380	488	244.0	
5841	chr1	157595331	157595723	392	196.0	
5842	chr1	157628729	157629173	444	222.0	
5843	chr1	157645844	157646480	636	318.0	
5844	chr1	157652939	157653591	652	326.0	
5845	chr1	157695395	157696013	618	309.0	
5846	chr1	157697207	157698143	936	468.0	
5847	chr1	157700280	157701243	963	482.0	
5848	chr1	157704934	157705250	316	158.0	
5849	chr1	157723016	157723557	541	270.0	
5850	chr1	157725153	157725551	398	199.0	
5851	chr1	157726665	157727290	625	312.0	
5852	chr1	157734280	157734708	428	214.0	
5853	chr1	157773667	157774403	736	368.0	
5854	chr1	157782895	157783296	401	200.0	
5855	chr1	157783859	157784111	252	126.0	
5856	chr1	157803912	157804181	269	134.0	
5857	chr1	157806621	157807295	674	337.0	
5858	chr1	157819911	157820369	458	229.0	
5859	chr1	157844079	157844602	523	262.0	
5860	chr1	157849203	157849958	755	378.0	
5861	chr1	157870795	157870798	3	2.0	
5862	chr1	157882563	157882945	382	191.0	
5863	chr1	157921042	157921068	26	13.0	
5864	chr1	157937798	157938131	333	166.0	
5865	chr1	157944608	157945117	509	254.0	
5866	chr1	157948531	157948937	406	203.0	
5867	chr1	157955809	157957124	1315	658.0	
5868	chr1	157963627	157964055	428	214.0	
5869	chr1	157991937	157992394	457	228.0	
5870	chr1	157993156	157993801	645	322.0	
5871	chr1	158087322	158087706	384	192.0	
5872	chr1	158095723	158096165	442	221.0	
5873	chr1	158113116	158113966	850	425.0	
5874	chr1	158115225	158115475	250	125.0	
5875	chr1	158117733	158118412	679	340.0	
5876	chr1	158124895	158125446	551	276.0	
5877	chr1	158147743	158151015	3272	1636.0	
5878	chr1	158153824	158154138	314	157.0	
5879	chr1	158162718	158163708	990	495.0	
5880	chr1	158176479	158176758	279	140.0	
5881	chr1	158177654	158178219	565	282.0	
5882	chr1	158179390	158181753	2363	1182.0	
5883	chr1	158185602	158186246	644	322.0	
5884	chr1	158203672	158204422	750	375.0	
5885	chr1	158247978	158249210	1232	616.0	
5886	chr1	158283728	158284411	683	342.0	
5887	chr1	158285517	158287258	1741	870.0	
5888	chr1	158289927	158290917	990	495.0	
5889	chr1	158333478	158333551	73	36.0	
5890	chr1	158353712	158354613	901	450.0	
5891	chr1	158394639	158395071	432	216.0	
5892	chr1	158430189	158430561	372	186.0	
5893	chr1	158434798	158435089	291	146.0	
5894	chr1	158440681	158440987	306	153.0	
5895	chr1	158506364	158506780	416	208.0	
5896	chr1	158644223	158644914	691	346.0	
5897	chr1	158646324	158647015	691	346.0	
5898	chr1	158654598	158654942	344	172.0	
5899	chr1	158681645	158681900	255	128.0	
5900	chr1	158793563	158794075	512	256.0	
5901	chr1	158800601	158801995	1394	697.0	
5902	chr1	158809033	158810717	1684	842.0	
5903	chr1	158813163	158813591	428	214.0	
5904	chr1	158818509	158820001	1492	746.0	
5905	chr1	158830821	158831798	977	488.0	
5906	chr1	158833294	158833606	312	156.0	
5907	chr1	158924226	158925158	932	466.0	
5908	chr1	158930302	158932629	2327	1164.0	
5909	chr1	158933625	158933985	360	180.0	
5910	chr1	158952404	158952802	398	199.0	
5911	chr1	158978626	158979237	611	306.0	
5912	chr1	158996231	158996856	625	312.0	
5913	chr1	158998261	158999153	892	446.0	
5914	chr1	159005707	159006123	416	208.0	
5915	chr1	159007773	159007956	183	92.0	
5916	chr1	159008462	159011367	2905	1452.0	
5917	chr1	159012364	159013504	1140	570.0	
5918	chr1	159014214	159014529	315	158.0	
5919	chr1	159015335	159016216	881	440.0	
5920	chr1	159046426	159046941	515	258.0	
5921	chr1	159055289	159056456	1167	584.0	
5922	chr1	159067634	159069325	1691	846.0	
5923	chr1	159071919	159072444	525	262.0	
5924	chr1	159076236	159077961	1725	862.0	
5925	chr1	159084597	159085322	725	362.0	
5926	chr1	159088119	159089612	1493	746.0	
5927	chr1	159091479	159092531	1052	526.0	
5928	chr1	159132283	159132720	437	218.0	
5929	chr1	159160935	159161478	543	272.0	
5930	chr1	159162544	159162905	361	180.0	
5931	chr1	159172912	159173264	352	176.0	
5932	chr1	159177287	159177638	351	176.0	
5933	chr1	159188380	159188818	438	219.0	
5934	chr1	159197920	159198406	486	243.0	
5935	chr1	159201715	159201983	268	134.0	
5936	chr1	159211526	159211907	381	190.0	
5937	chr1	159214170	159214543	373	186.0	
5938	chr1	159291588	159292504	916	458.0	
5939	chr1	159315461	159315701	240	120.0	
5940	chr1	159343120	159343377	257	128.0	
5941	chr1	159431018	159431346	328	164.0	
5942	chr1	159436494	159436753	259	130.0	
5943	chr1	159441460	159441700	240	120.0	
5944	chr1	159646630	159647175	545	272.0	
5945	chr1	159664293	159664630	337	168.0	
5946	chr1	159756432	159756739	307	154.0	
5947	chr1	159780266	159782138	1872	936.0	
5948	chr1	159790286	159790687	401	200.0	
5949	chr1	159798737	159800757	2020	1010.0	
5950	chr1	159802157	159802441	284	142.0	
5951	chr1	159803924	159804303	379	190.0	
5952	chr1	159821219	159821396	177	88.0	
5953	chr1	159825849	159828075	2226	1113.0	
5954	chr1	159828690	159829689	999	500.0	
5955	chr1	159849829	159850472	643	322.0	
5956	chr1	159853715	159855467	1752	876.0	
5957	chr1	159869270	159869442	172	86.0	
5958	chr1	159879943	159880798	855	428.0	
5959	chr1	159881845	159882915	1070	535.0	
5960	chr1	159889427	159890599	1172	586.0	
5961	chr1	159891308	159892075	767	384.0	
5962	chr1	159896047	159896544	497	248.0	
5963	chr1	159897900	159898933	1033	516.0	
5964	chr1	159899917	159900462	545	272.0	
5965	chr1	159901609	159901671	62	31.0	
5966	chr1	159907228	159907570	342	171.0	
5967	chr1	159909626	159928592	18966	9483.0	
5968	chr1	159935644	159938830	3186	1593.0	
5969	chr1	159945201	159946329	1128	564.0	
5970	chr1	159953866	159954668	802	401.0	
5971	chr1	159991508	159992010	502	251.0	
5972	chr1	160006275	160006732	457	228.0	
5973	chr1	160007576	160008010	434	217.0	
5974	chr1	160030812	160032883	2071	1036.0	
5975	chr1	160046446	160047528	1082	541.0	
5976	chr1	160063152	160063539	387	194.0	
5977	chr1	160069541	160071087	1546	773.0	
5978	chr1	160074755	160076348	1593	796.0	
5979	chr1	160077425	160077883	458	229.0	
5980	chr1	160078394	160079131	737	368.0	
5981	chr1	160083639	160084671	1032	516.0	
5982	chr1	160085521	160086225	704	352.0	
5983	chr1	160096221	160101840	5619	2810.0	
5984	chr1	160102804	160103389	585	292.0	
5985	chr1	160104485	160105036	551	276.0	
5986	chr1	160108895	160109344	449	224.0	
5987	chr1	160134798	160135242	444	222.0	
5988	chr1	160143639	160144109	470	235.0	
5989	chr1	160154795	160155203	408	204.0	
5990	chr1	160162248	160163307	1059	530.0	
5991	chr1	160166198	160166847	649	324.0	
5992	chr1	160169483	160169931	448	224.0	
5993	chr1	160192976	160193848	872	436.0	
5994	chr1	160204065	160207433	3368	1684.0	
5995	chr1	160251641	160252367	726	363.0	
5996	chr1	160260950	160263874	2924	1462.0	
5997	chr1	160284037	160285717	1680	840.0	
5998	chr1	160291085	160292205	1120	560.0	
5999	chr1	160338395	160339164	769	384.0	
6000	chr1	160341030	160341039	9	4.0	
6001	chr1	160341985	160344130	2145	1072.0	
6002	chr1	160346370	160347822	1452	726.0	
6003	chr1	160354372	160354792	420	210.0	
6004	chr1	160375211	160376957	1746	873.0	
6005	chr1	160400200	160401572	1372	686.0	
6006	chr1	160428570	160430313	1743	872.0	
6007	chr1	160432255	160433200	945	472.0	
6008	chr1	160437424	160438932	1508	754.0	
6009	chr1	160443532	160444077	545	272.0	
6010	chr1	160453520	160453648	128	64.0	
6011	chr1	160460296	160461072	776	388.0	
6012	chr1	160474561	160474676	115	58.0	
6013	chr1	160480709	160481242	533	266.0	
6014	chr1	160488367	160488752	385	192.0	
6015	chr1	160499647	160499971	324	162.0	
6016	chr1	160519180	160523492	4312	2156.0	
6017	chr1	160539832	160541067	1235	618.0	
6018	chr1	160544614	160545145	531	266.0	
6019	chr1	160546663	160547546	883	442.0	
6020	chr1	160549350	160549733	383	192.0	
6021	chr1	160550431	160550864	433	216.0	
6022	chr1	160558571	160561200	2629	1314.0	
6023	chr1	160564773	160565045	272	136.0	
6024	chr1	160567471	160568884	1413	706.0	
6025	chr1	160569884	160569920	36	18.0	
6026	chr1	160574811	160580858	6047	3024.0	
6027	chr1	160606816	160607784	968	484.0	
6028	chr1	160618695	160619318	623	312.0	
6029	chr1	160621460	160621984	524	262.0	
6030	chr1	160623043	160624246	1203	602.0	
6031	chr1	160625771	160627485	1714	857.0	
6032	chr1	160628660	160630958	2298	1149.0	
6033	chr1	160632144	160632573	429	214.0	
6034	chr1	160633098	160634034	936	468.0	
6035	chr1	160636555	160636936	381	190.0	
6036	chr1	160637648	160642141	4493	2246.0	
6037	chr1	160645397	160647766	2369	1184.0	
6038	chr1	160652140	160652589	449	224.0	
6039	chr1	160653691	160653998	307	154.0	
6040	chr1	160657585	160657818	233	116.0	
6041	chr1	160662878	160663416	538	269.0	
6042	chr1	160664417	160666442	2025	1012.0	
6043	chr1	160672851	160676220	3369	1684.0	
6044	chr1	160681209	160683979	2770	1385.0	
6045	chr1	160685340	160685424	84	42.0	
6046	chr1	160692284	160692859	575	288.0	
6047	chr1	160702092	160702565	473	236.0	
6048	chr1	160703737	160710019	6282	3141.0	
6049	chr1	160710524	160713631	3107	1554.0	
6050	chr1	160714222	160714719	497	248.0	
6051	chr1	160718287	160718560	273	136.0	
6052	chr1	160722727	160723087	360	180.0	
6053	chr1	160726173	160727643	1470	735.0	
6054	chr1	160732047	160732458	411	206.0	
6055	chr1	160733640	160734368	728	364.0	
6056	chr1	160738237	160744949	6712	3356.0	
6057	chr1	160748247	160749300	1053	526.0	
6058	chr1	160751342	160752004	662	331.0	
6059	chr1	160755681	160757304	1623	812.0	
6060	chr1	160766876	160768944	2068	1034.0	
6061	chr1	160776160	160776594	434	217.0	
6062	chr1	160777406	160778070	664	332.0	
6063	chr1	160780050	160780456	406	203.0	
6064	chr1	160781976	160782763	787	394.0	
6065	chr1	160789388	160790757	1369	684.0	
6066	chr1	160795385	160798547	3162	1581.0	
6067	chr1	160800618	160801455	837	418.0	
6068	chr1	160806204	160806468	264	132.0	
6069	chr1	160830304	160831027	723	362.0	
6070	chr1	160834862	160835543	681	340.0	
6071	chr1	160836485	160839333	2848	1424.0	
6072	chr1	160844894	160845151	257	128.0	
6073	chr1	160850581	160850929	348	174.0	
6074	chr1	160855114	160856208	1094	547.0	
6075	chr1	160858360	160858418	58	29.0	
6076	chr1	160859148	160859525	377	188.0	
6077	chr1	160861018	160861189	171	86.0	
6078	chr1	160861851	160864218	2367	1184.0	
6079	chr1	160867669	160868508	839	420.0	
6080	chr1	160875505	160876041	536	268.0	
6081	chr1	160876929	160877601	672	336.0	
6082	chr1	160951099	160951836	737	368.0	
6083	chr1	160954130	160954638	508	254.0	
6084	chr1	160981886	160982555	669	334.0	
6085	chr1	160989844	160990904	1060	530.0	
6086	chr1	160993615	160993974	359	180.0	
6087	chr1	160997232	160997781	549	274.0	
6088	chr1	161013066	161014712	1646	823.0	
6089	chr1	161016769	161016783	14	7.0	
6090	chr1	161018036	161022046	4010	2005.0	
6091	chr1	161037707	161039802	2095	1048.0	
6092	chr1	161041207	161042306	1099	550.0	
6093	chr1	161044318	161048735	4417	2208.0	
6094	chr1	161054817	161055146	329	164.0	
6095	chr1	161063902	161064316	414	207.0	
6096	chr1	161066414	161070872	4458	2229.0	
6097	chr1	161071776	161072462	686	343.0	
6098	chr1	161080986	161081085	99	50.0	
6099	chr1	161082977	161084267	1290	645.0	
6100	chr1	161088646	161089581	935	468.0	
6101	chr1	161096325	161099179	2854	1427.0	
6102	chr1	161111263	161111896	633	316.0	
6103	chr1	161115273	161115660	387	194.0	
6104	chr1	161117280	161120365	3085	1542.0	
6105	chr1	161121240	161122461	1221	610.0	
6106	chr1	161127698	161128111	413	206.0	
6107	chr1	161131336	161133804	2468	1234.0	
6108	chr1	161138283	161138719	436	218.0	
6109	chr1	161139716	161140215	499	250.0	
6110	chr1	161153177	161155220	2043	1022.0	
6111	chr1	161158524	161160269	1745	872.0	
6112	chr1	161165081	161167450	2369	1184.0	
6113	chr1	161176190	161178293	2103	1052.0	
6114	chr1	161180639	161181012	373	186.0	
6115	chr1	161181854	161187753	5899	2950.0	
6116	chr1	161192265	161193257	992	496.0	
6117	chr1	161194961	161195773	812	406.0	
6118	chr1	161200067	161202982	2915	1458.0	
6119	chr1	161209569	161210424	855	428.0	
6120	chr1	161213961	161215860	1899	950.0	
6121	chr1	161216387	161218929	2542	1271.0	
6122	chr1	161225060	161228372	3312	1656.0	
6123	chr1	161241662	161242673	1011	506.0	
6124	chr1	161258425	161259324	899	450.0	
6125	chr1	161267366	161267782	416	208.0	
6126	chr1	161291322	161292085	763	382.0	
6127	chr1	161297234	161297525	291	146.0	
6128	chr1	161298150	161298431	281	140.0	
6129	chr1	161305083	161307831	2748	1374.0	
6130	chr1	161308334	161308496	162	81.0	
6131	chr1	161313531	161315178	1647	824.0	
6132	chr1	161324058	161324368	310	155.0	
6133	chr1	161359358	161359726	368	184.0	
6134	chr1	161367573	161368411	838	419.0	
6135	chr1	161382073	161382742	669	334.0	
6136	chr1	161386198	161387081	883	442.0	
6137	chr1	161389241	161391041	1800	900.0	
6138	chr1	161398619	161400766	2147	1074.0	
6139	chr1	161409675	161410481	806	403.0	
6140	chr1	161421872	161422435	563	282.0	
6141	chr1	161439818	161441073	1255	628.0	
6142	chr1	161484617	161485043	426	213.0	
6143	chr1	161486953	161487562	609	304.0	
6144	chr1	161491379	161491844	465	232.0	
6145	chr1	161499398	161500191	793	396.0	
6146	chr1	161505050	161507259	2209	1104.0	
6147	chr1	161523339	161525717	2378	1189.0	
6148	chr1	161529419	161531730	2311	1156.0	
6149	chr1	161532698	161533190	492	246.0	
6150	chr1	161539574	161541111	1537	768.0	
6151	chr1	161541732	161542592	860	430.0	
6152	chr1	161543171	161543442	271	136.0	
6153	chr1	161545067	161545756	689	344.0	
6154	chr1	161549546	161550275	729	364.0	
6155	chr1	161554913	161555435	522	261.0	
6156	chr1	161561077	161561804	727	364.0	
6157	chr1	161562471	161562482	11	6.0	
6158	chr1	161566124	161566599	475	238.0	
6159	chr1	161611797	161613290	1493	746.0	
6160	chr1	161621068	161622584	1516	758.0	
6161	chr1	161623272	161624020	748	374.0	
6162	chr1	161626098	161627169	1071	536.0	
6163	chr1	161642612	161644188	1576	788.0	
6164	chr1	161647517	161647959	442	221.0	
6165	chr1	161705442	161705902	460	230.0	
6166	chr1	161706764	161707445	681	340.0	
6167	chr1	161709525	161709531	6	3.0	
6168	chr1	161718721	161719283	562	281.0	
6169	chr1	161721884	161722407	523	262.0	
6170	chr1	161725599	161728121	2522	1261.0	
6171	chr1	161729980	161730669	689	344.0	
6172	chr1	161738502	161741908	3406	1703.0	
6173	chr1	161749244	161750602	1358	679.0	
6174	chr1	161763413	161764137	724	362.0	
6175	chr1	161765015	161767148	2133	1066.0	
6176	chr1	161771134	161773125	1991	996.0	
6177	chr1	161792594	161793097	503	252.0	
6178	chr1	161905317	161905634	317	158.0	
6179	chr1	161934062	161934630	568	284.0	
6180	chr1	161962357	161962847	490	245.0	
6181	chr1	161988511	161988810	299	150.0	
6182	chr1	161989672	161990293	621	310.0	
6183	chr1	161999257	161999724	467	234.0	
6184	chr1	162003351	162004166	815	408.0	
6185	chr1	162023432	162024630	1198	599.0	
6186	chr1	162026984	162027214	230	115.0	
6187	chr1	162028602	162029325	723	362.0	
6188	chr1	162036884	162037378	494	247.0	
6189	chr1	162055926	162056424	498	249.0	
6190	chr1	162069059	162070877	1818	909.0	
6191	chr1	162152285	162152754	469	234.0	
6192	chr1	162229628	162230255	627	314.0	
6193	chr1	162235091	162235545	454	227.0	
6194	chr1	162236583	162236984	401	200.0	
6195	chr1	162255066	162255546	480	240.0	
6196	chr1	162297281	162297500	219	110.0	
6197	chr1	162310186	162310914	728	364.0	
6198	chr1	162327101	162328245	1144	572.0	
6199	chr1	162351842	162352242	400	200.0	
6200	chr1	162357755	162358018	263	132.0	
6201	chr1	162392088	162392411	323	162.0	
6202	chr1	162400981	162401045	64	32.0	
6203	chr1	162411956	162412389	433	216.0	
6204	chr1	162413873	162414243	370	185.0	
6205	chr1	162422905	162423455	550	275.0	
6206	chr1	162443935	162444439	504	252.0	
6207	chr1	162497202	162498972	1770	885.0	
6208	chr1	162530235	162531014	779	390.0	
6209	chr1	162548123	162548662	539	270.0	
6210	chr1	162560579	162563823	3244	1622.0	
6211	chr1	162564643	162566224	1581	790.0	
6212	chr1	162569080	162569394	314	157.0	
6213	chr1	162570863	162571354	491	246.0	
6214	chr1	162577282	162577567	285	142.0	
6215	chr1	162583014	162583303	289	144.0	
6216	chr1	162590932	162591155	223	112.0	
6217	chr1	162613649	162614026	377	188.0	
6218	chr1	162790129	162791194	1065	532.0	
6219	chr1	162822402	162822939	537	268.0	
6220	chr1	162847820	162848229	409	204.0	
6221	chr1	162854200	162854624	424	212.0	
6222	chr1	162877997	162878401	404	202.0	
6223	chr1	162892855	162893739	884	442.0	
6224	chr1	162918949	162919414	465	232.0	
6225	chr1	162922240	162922612	372	186.0	
6226	chr1	163072009	163072076	67	34.0	
6227	chr1	163315776	163316159	383	192.0	
6228	chr1	163320942	163322739	1797	898.0	
6229	chr1	164558548	164560038	1490	745.0	
6230	chr1	164651408	164651911	503	252.0	enhancer
6231	chr1	164660335	164660893	558	279.0	
6232	chr1	164708929	164709578	649	324.0	
6233	chr1	164716877	164717642	765	382.0	
6234	chr1	164719939	164721118	1179	590.0	
6235	chr1	164775180	164775731	551	276.0	
6236	chr1	164787263	164787708	445	222.0	
6237	chr1	165367335	165367810	475	238.0	
6238	chr1	165369204	165369670	466	233.0	
6239	chr1	165375965	165376957	992	496.0	
6240	chr1	165392610	165393724	1114	557.0	
6241	chr1	165403789	165404290	501	250.0	
6242	chr1	165424230	165425078	848	424.0	
6243	chr1	165537255	165537907	652	326.0	
6244	chr1	165592683	165593738	1055	528.0	
6245	chr1	165597480	165598918	1438	719.0	
6246	chr1	165600848	165602235	1387	694.0	
6247	chr1	165629122	165629519	397	198.0	
6248	chr1	165630119	165632903	2784	1392.0	
6249	chr1	165646035	165646203	168	84.0	
6250	chr1	165671507	165671995	488	244.0	
6251	chr1	165686134	165687056	922	461.0	
6252	chr1	165695942	165695978	36	18.0	
6253	chr1	165697641	165699250	1609	804.0	
6254	chr1	165717895	165718277	382	191.0	
6255	chr1	165768258	165769925	1667	834.0	
6256	chr1	165826911	165829329	2418	1209.0	
6257	chr1	165842766	165843217	451	226.0	
6258	chr1	165849423	165849424	1	0.0	
6259	chr1	165851024	165851449	425	212.0	
6260	chr1	165853860	165854712	852	426.0	
6261	chr1	165855239	165855654	415	208.0	
6262	chr1	165856921	165857726	805	402.0	
6263	chr1	165862422	165862889	467	234.0	
6264	chr1	165871011	165871872	861	430.0	
6265	chr1	165875181	165875580	399	200.0	
6266	chr1	165877845	165878579	734	367.0	
6267	chr1	165884338	165885113	775	388.0	
6268	chr1	165913941	165914811	870	435.0	
6269	chr1	165924628	165925126	498	249.0	
6270	chr1	165928027	165928456	429	214.0	
6271	chr1	166166485	166167397	912	456.0	
6272	chr1	166479016	166479441	425	212.0	
6273	chr1	166489346	166491003	1657	828.0	
6274	chr1	166509433	166509825	392	196.0	
6275	chr1	166511697	166512250	553	276.0	
6276	chr1	166838707	166841399	2692	1346.0	
6277	chr1	166875336	166877013	1677	838.0	
6278	chr1	166884010	166885148	1138	569.0	
6279	chr1	166902110	166903629	1519	760.0	
6280	chr1	166907829	166908128	299	150.0	
6281	chr1	166910319	166910878	559	280.0	
6282	chr1	166924874	166924946	72	36.0	
6283	chr1	166947727	166947845	118	59.0	
6284	chr1	166969359	166969423	64	32.0	
6285	chr1	166974787	166976264	1477	738.0	
6286	chr1	167043563	167044578	1015	508.0	
6287	chr1	167057210	167057574	364	182.0	
6288	chr1	167058882	167059772	890	445.0	
6289	chr1	167066352	167067093	741	370.0	
6290	chr1	167076141	167076481	340	170.0	
6291	chr1	167082613	167083096	483	242.0	
6292	chr1	167090135	167091226	1091	546.0	
6293	chr1	167104211	167104579	368	184.0	
6294	chr1	167105110	167105849	739	370.0	
6295	chr1	167109036	167109424	388	194.0	
6296	chr1	167110604	167110931	327	164.0	
6297	chr1	167120897	167121953	1056	528.0	
6298	chr1	167124004	167124446	442	221.0	
6299	chr1	167219601	167222985	3384	1692.0	
6300	chr1	167229540	167230224	684	342.0	
6301	chr1	167263959	167264511	552	276.0	
6302	chr1	167267520	167268293	773	386.0	
6303	chr1	167283161	167283531	370	185.0	
6304	chr1	167293219	167293418	199	100.0	
6305	chr1	167294556	167294918	362	181.0	
6306	chr1	167297153	167297827	674	337.0	
6307	chr1	167328710	167329595	885	442.0	enhancer
6308	chr1	167342923	167343207	284	142.0	
6309	chr1	167401215	167401731	516	258.0	
6310	chr1	167425465	167425782	317	158.0	
6311	chr1	167428151	167432655	4504	2252.0	
6312	chr1	167435691	167435727	36	18.0	
6313	chr1	167436593	167436990	397	198.0	
6314	chr1	167437975	167440606	2631	1316.0	
6315	chr1	167441686	167443306	1620	810.0	
6316	chr1	167445518	167448954	3436	1718.0	
6317	chr1	167450576	167457762	7186	3593.0	
6318	chr1	167460579	167461412	833	416.0	
6319	chr1	167462382	167462650	268	134.0	
6320	chr1	167465062	167465392	330	165.0	
6321	chr1	167467589	167467718	129	64.0	
6322	chr1	167471581	167472061	480	240.0	
6323	chr1	167472925	167474994	2069	1034.0	
6324	chr1	167478035	167478424	389	194.0	
6325	chr1	167479218	167479985	767	384.0	
6326	chr1	167481073	167490768	9695	4848.0	
6327	chr1	167491537	167493092	1555	778.0	
6328	chr1	167499164	167502441	3277	1638.0	
6329	chr1	167505612	167505910	298	149.0	
6330	chr1	167509143	167511249	2106	1053.0	
6331	chr1	167512370	167512942	572	286.0	
6332	chr1	167514263	167514705	442	221.0	
6333	chr1	167515251	167519215	3964	1982.0	
6334	chr1	167533542	167534258	716	358.0	
6335	chr1	167535987	167536233	246	123.0	
6336	chr1	167540120	167540960	840	420.0	
6337	chr1	167542240	167542801	561	280.0	
6338	chr1	167548272	167549664	1392	696.0	
6339	chr1	167551259	167551878	619	310.0	
6340	chr1	167552903	167554590	1687	844.0	
6341	chr1	167555860	167556724	864	432.0	
6342	chr1	167563371	167564235	864	432.0	
6343	chr1	167564736	167565105	369	184.0	
6344	chr1	167588007	167588693	686	343.0	
6345	chr1	167599690	167602164	2474	1237.0	
6346	chr1	167603044	167604336	1292	646.0	
6347	chr1	167605561	167605986	425	212.0	
6348	chr1	167612495	167613080	585	292.0	
6349	chr1	167617013	167618242	1229	614.0	
6350	chr1	167627212	167633078	5866	2933.0	
6351	chr1	167633950	167634153	203	102.0	
6352	chr1	167636868	167638199	1331	666.0	
6353	chr1	167642131	167642532	401	200.0	
6354	chr1	167648376	167651716	3340	1670.0	
6355	chr1	167654000	167654398	398	199.0	
6356	chr1	167658570	167658946	376	188.0	
6357	chr1	167668125	167668524	399	200.0	
6358	chr1	167679667	167680143	476	238.0	
6359	chr1	167687206	167688413	1207	604.0	
6360	chr1	167697824	167698222	398	199.0	
6361	chr1	167708895	167709567	672	336.0	
6362	chr1	167713094	167717102	4008	2004.0	
6363	chr1	167719790	167720014	224	112.0	
6364	chr1	167720760	167722904	2144	1072.0	
6365	chr1	167753033	167753753	720	360.0	
6366	chr1	167767721	167768273	552	276.0	
6367	chr1	167791560	167792327	767	384.0	
6368	chr1	167797063	167797417	354	177.0	
6369	chr1	167803178	167804104	926	463.0	
6370	chr1	167805119	167805678	559	280.0	
6371	chr1	167819934	167820565	631	316.0	
6372	chr1	167911339	167911611	272	136.0	
6373	chr1	167934817	167937971	3154	1577.0	
6374	chr1	168081241	168082704	1463	732.0	
6375	chr1	168084673	168085338	665	332.0	
6376	chr1	168135764	168137800	2036	1018.0	
6377	chr1	168145403	168146302	899	450.0	
6378	chr1	168148877	168149330	453	226.0	
6379	chr1	168163748	168164071	323	162.0	
6380	chr1	168178229	168180338	2109	1054.0	
6381	chr1	168225298	168227659	2361	1180.0	
6382	chr1	168228772	168229463	691	346.0	
6383	chr1	168235186	168235709	523	262.0	
6384	chr1	168287204	168287431	227	114.0	
6385	chr1	168341024	168341564	540	270.0	
6386	chr1	168342395	168343357	962	481.0	
6387	chr1	168348063	168348787	724	362.0	
6388	chr1	168362761	168363742	981	490.0	
6389	chr1	168365678	168366117	439	220.0	
6390	chr1	168386804	168387697	893	446.0	
6391	chr1	168392020	168392668	648	324.0	
6392	chr1	168399009	168399324	315	158.0	
6393	chr1	168408796	168410992	2196	1098.0	
6394	chr1	168421309	168421929	620	310.0	
6395	chr1	168439288	168440365	1077	538.0	
6396	chr1	168443883	168444333	450	225.0	
6397	chr1	168444882	168445209	327	164.0	
6398	chr1	168466257	168467621	1364	682.0	
6399	chr1	168469694	168470051	357	178.0	
6400	chr1	168476638	168477025	387	194.0	
6401	chr1	168483429	168483935	506	253.0	
6402	chr1	168485035	168485542	507	254.0	
6403	chr1	168503593	168504863	1270	635.0	
6404	chr1	168509238	168510902	1664	832.0	
6405	chr1	168512775	168514837	2062	1031.0	
6406	chr1	168518232	168518604	372	186.0	
6407	chr1	168519739	168522048	2309	1154.0	
6408	chr1	168529754	168529771	17	8.0	
6409	chr1	168531552	168532135	583	292.0	
6410	chr1	168535417	168536142	725	362.0	
6411	chr1	168543794	168544295	501	250.0	
6412	chr1	168554089	168554621	532	266.0	
6413	chr1	168555276	168555278	2	1.0	
6414	chr1	168557595	168558153	558	279.0	
6415	chr1	168574272	168574634	362	181.0	
6416	chr1	168576291	168576755	464	232.0	
6417	chr1	168603438	168603938	500	250.0	
6418	chr1	168626263	168626789	526	263.0	
6419	chr1	168833943	168834030	87	44.0	
6420	chr1	169041327	169041887	560	280.0	
6421	chr1	169043991	169045294	1303	652.0	
6422	chr1	169048146	169048458	312	156.0	
6423	chr1	169052676	169053114	438	219.0	
6424	chr1	169060858	169061302	444	222.0	
6425	chr1	169098379	169098713	334	167.0	
6426	chr1	169104758	169110434	5676	2838.0	
6427	chr1	169111018	169111580	562	281.0	
6428	chr1	169112125	169112658	533	266.0	
6429	chr1	169115925	169116787	862	431.0	
6430	chr1	169133253	169133277	24	12.0	
6431	chr1	169134216	169134310	94	47.0	
6432	chr1	169161542	169161859	317	158.0	
6433	chr1	169217701	169218060	359	180.0	
6434	chr1	169259872	169260886	1014	507.0	
6435	chr1	169271184	169271405	221	110.0	
6436	chr1	169309080	169309951	871	436.0	
6437	chr1	169312037	169312649	612	306.0	
6438	chr1	169348416	169348880	464	232.0	
6439	chr1	169363539	169363677	138	69.0	
6440	chr1	169367114	169368903	1789	894.0	
6441	chr1	169371631	169371725	94	47.0	
6442	chr1	169392540	169392790	250	125.0	
6443	chr1	169426995	169427739	744	372.0	
6444	chr1	169460042	169460796	754	377.0	
6445	chr1	169466279	169466608	329	164.0	
6446	chr1	169478201	169478479	278	139.0	
6447	chr1	169484739	169486879	2140	1070.0	
6448	chr1	169513219	169513660	441	220.0	
6449	chr1	169546176	169546855	679	340.0	
6450	chr1	169550205	169550696	491	246.0	
6451	chr1	169584669	169585562	893	446.0	
6452	chr1	169586178	169587058	880	440.0	
6453	chr1	169601022	169601867	845	422.0	
6454	chr1	169602485	169602545	60	30.0	
6455	chr1	169604428	169605579	1151	576.0	
6456	chr1	169608146	169608753	607	304.0	
6457	chr1	169610870	169611221	351	176.0	
6458	chr1	169658764	169659162	398	199.0	
6459	chr1	169666906	169668240	1334	667.0	
6460	chr1	169675907	169676451	544	272.0	
6461	chr1	169680563	169681125	562	281.0	
6462	chr1	169692126	169695370	3244	1622.0	
6463	chr1	169696269	169696961	692	346.0	
6464	chr1	169697693	169698395	702	351.0	
6465	chr1	169699041	169699357	316	158.0	
6466	chr1	169701122	169701848	726	363.0	
6467	chr1	169704622	169704729	107	54.0	
6468	chr1	169706701	169707416	715	358.0	
6469	chr1	169707953	169709079	1126	563.0	
6470	chr1	169711077	169712491	1414	707.0	
6471	chr1	169794054	169796021	1967	984.0	
6472	chr1	169809558	169810014	456	228.0	
6473	chr1	169890749	169891743	994	497.0	
6474	chr1	169892484	169894950	2466	1233.0	
6475	chr1	169895999	169896467	468	234.0	
6476	chr1	169908549	169909176	627	314.0	
6477	chr1	169928855	169929311	456	228.0	
6478	chr1	170073986	170075518	1532	766.0	
6479	chr1	170531225	170533554	2329	1164.0	
6480	chr1	170929777	170930136	359	180.0	
6481	chr1	171188640	171189062	422	211.0	
6482	chr1	171212898	171213381	483	242.0	
6483	chr1	171224324	171224629	305	152.0	
6484	chr1	171226772	171227141	369	184.0	
6485	chr1	171245483	171245830	347	174.0	
6486	chr1	171251326	171251957	631	316.0	
6487	chr1	171252478	171252904	426	213.0	
6488	chr1	171286312	171286670	358	179.0	
6489	chr1	171313355	171314774	1419	710.0	
6490	chr1	171357618	171357705	87	44.0	
6491	chr1	171366119	171366455	336	168.0	
6492	chr1	171434612	171435468	856	428.0	
6493	chr1	171479474	171479853	379	190.0	
6494	chr1	171482795	171483134	339	170.0	
6495	chr1	171483763	171487298	3535	1768.0	
6496	chr1	171487850	171489177	1327	664.0	
6497	chr1	171491122	171491582	460	230.0	
6498	chr1	171493422	171493787	365	182.0	
6499	chr1	171495742	171497064	1322	661.0	
6500	chr1	171506854	171508588	1734	867.0	
6501	chr1	171517575	171517809	234	117.0	
6502	chr1	171644840	171645369	529	264.0	
6503	chr1	171655436	171655914	478	239.0	
6504	chr1	171736210	171736584	374	187.0	
6505	chr1	171739655	171740188	533	266.0	
6506	chr1	171740934	171743801	2867	1434.0	
6507	chr1	171744876	171745469	593	296.0	
6508	chr1	171780552	171782694	2142	1071.0	
6509	chr1	171794073	171794441	368	184.0	
6510	chr1	171801392	171801855	463	232.0	
6511	chr1	171805368	171806187	819	410.0	
6512	chr1	171840685	171842837	2152	1076.0	
6513	chr1	171984863	171985252	389	194.0	
6514	chr1	172002770	172003082	312	156.0	
6515	chr1	172090160	172090635	475	238.0	
6516	chr1	172117739	172118244	505	252.0	
6517	chr1	172135071	172135440	369	184.0	
6518	chr1	172180668	172182101	1433	716.0	
6519	chr1	172185164	172185616	452	226.0	
6520	chr1	172344475	172344541	66	33.0	
6521	chr1	172357993	172359437	1444	722.0	
6522	chr1	172380503	172381385	882	441.0	
6523	chr1	172390756	172391402	646	323.0	
6524	chr1	172393402	172395100	1698	849.0	
6525	chr1	172399240	172399927	687	344.0	
6526	chr1	172426990	172427724	734	367.0	
6527	chr1	172429093	172429959	866	433.0	
6528	chr1	172431846	172432319	473	236.0	
6529	chr1	172443333	172444637	1304	652.0	
6530	chr1	172449585	172451277	1692	846.0	
6531	chr1	172473262	172473790	528	264.0	
6532	chr1	172498822	172499806	984	492.0	
6533	chr1	172515833	172516418	585	292.0	
6534	chr1	172531616	172534365	2749	1374.0	
6535	chr1	172536110	172536641	531	266.0	
6536	chr1	172544492	172545995	1503	752.0	
6537	chr1	172588709	172589203	494	247.0	
6538	chr1	172609502	172609936	434	217.0	
6539	chr1	172625288	172625846	558	279.0	
6540	chr1	172627854	172627948	94	47.0	
6541	chr1	172629758	172630075	317	158.0	
6542	chr1	172638440	172640286	1846	923.0	
6543	chr1	172643237	172644275	1038	519.0	
6544	chr1	172646889	172647634	745	372.0	
6545	chr1	172658666	172659759	1093	546.0	
6546	chr1	172661053	172661536	483	242.0	
6547	chr1	172662303	172663877	1574	787.0	
6548	chr1	172670243	172671295	1052	526.0	
6549	chr1	172674732	172675876	1144	572.0	
6550	chr1	172682982	172683160	178	89.0	
6551	chr1	172697020	172700113	3093	1546.0	
6552	chr1	172703942	172704848	906	453.0	
6553	chr1	172708341	172709070	729	364.0	
6554	chr1	172719457	172720103	646	323.0	
6555	chr1	172724512	172725445	933	466.0	
6556	chr1	172726700	172727334	634	317.0	
6557	chr1	172727903	172728494	591	296.0	
6558	chr1	172733845	172734159	314	157.0	
6559	chr1	172742540	172743231	691	346.0	
6560	chr1	172744879	172747147	2268	1134.0	
6561	chr1	172764364	172764824	460	230.0	
6562	chr1	172766385	172766958	573	286.0	
6563	chr1	172770127	172770444	317	158.0	
6564	chr1	172778738	172779181	443	222.0	
6565	chr1	172818204	172819887	1683	842.0	
6566	chr1	172825961	172826851	890	445.0	
6567	chr1	172838261	172838949	688	344.0	
6568	chr1	172845366	172845816	450	225.0	
6569	chr1	172867377	172867842	465	232.0	
6570	chr1	172894837	172895577	740	370.0	
6571	chr1	172900366	172900779	413	206.0	
6572	chr1	172906757	172907591	834	417.0	
6573	chr1	172933842	172934476	634	317.0	
6574	chr1	172947121	172947556	435	218.0	
6575	chr1	173009533	173010119	586	293.0	
6576	chr1	173014202	173014547	345	172.0	
6577	chr1	173015494	173016150	656	328.0	
6578	chr1	173020169	173020869	700	350.0	
6579	chr1	173038773	173039309	536	268.0	
6580	chr1	173048289	173049363	1074	537.0	
6581	chr1	173050789	173051251	462	231.0	
6582	chr1	173058023	173058393	370	185.0	
6583	chr1	173111921	173112652	731	366.0	
6584	chr1	173117365	173117455	90	45.0	
6585	chr1	173122459	173123800	1341	670.0	
6586	chr1	173149882	173150283	401	200.0	
6587	chr1	173175783	173175995	212	106.0	
6588	chr1	173190648	173191448	800	400.0	
6589	chr1	173193446	173194113	667	334.0	
6590	chr1	173195779	173196117	338	169.0	
6591	chr1	173202018	173202759	741	370.0	
6592	chr1	173205383	173207543	2160	1080.0	
6593	chr1	173255465	173255552	87	44.0	
6594	chr1	173295941	173296563	622	311.0	
6595	chr1	173331029	173331677	648	324.0	
6596	chr1	173406684	173407230	546	273.0	
6597	chr1	173409564	173411400	1836	918.0	
6598	chr1	173411903	173412356	453	226.0	
6599	chr1	173414096	173414560	464	232.0	
6600	chr1	173418234	173418406	172	86.0	
6601	chr1	173420102	173420854	752	376.0	
6602	chr1	173422241	173422992	751	376.0	
6603	chr1	173429375	173430358	983	492.0	
6604	chr1	173431114	173431793	679	340.0	
6605	chr1	173444850	173445119	269	134.0	
6606	chr1	173455232	173455314	82	41.0	
6607	chr1	173475750	173478693	2943	1472.0	
6608	chr1	173532284	173532593	309	154.0	
6609	chr1	173550687	173551327	640	320.0	
6610	chr1	173603266	173603397	131	66.0	
6611	chr1	173714381	173716020	1639	820.0	
6612	chr1	173823627	173825500	1873	936.0	
6613	chr1	173854971	173855214	243	122.0	
6614	chr1	173857099	173857782	683	342.0	
6615	chr1	173859305	173859331	26	13.0	
6616	chr1	173860835	173869552	8717	4358.0	
6617	chr1	173870092	173871224	1132	566.0	
6618	chr1	174008287	174009389	1102	551.0	
6619	chr1	174020564	174024019	3455	1728.0	
6620	chr1	174114675	174115310	635	318.0	
6621	chr1	174133891	174134206	315	158.0	
6622	chr1	174153098	174153961	863	432.0	
6623	chr1	174156417	174156543	126	63.0	
6624	chr1	174157203	174157572	369	184.0	
6625	chr1	174158369	174160677	2308	1154.0	
6626	chr1	174161245	174161997	752	376.0	
6627	chr1	174165440	174166031	591	296.0	
6628	chr1	174166899	174167100	201	100.0	
6629	chr1	174172177	174172564	387	194.0	
6630	chr1	174191392	174191541	149	74.0	
6631	chr1	174204579	174205341	762	381.0	
6632	chr1	174206378	174206911	533	266.0	
6633	chr1	174217681	174218139	458	229.0	
6634	chr1	174258049	174258521	472	236.0	
6635	chr1	174262663	174263080	417	208.0	
6636	chr1	174740573	174740611	38	19.0	
6637	chr1	174743062	174743231	169	84.0	
6638	chr1	174743870	174744399	529	264.0	
6639	chr1	174769942	174770427	485	242.0	
6640	chr1	174786930	174787140	210	105.0	
6641	chr1	174797388	174797799	411	206.0	
6642	chr1	174799198	174800881	1683	842.0	
6643	chr1	174815367	174815461	94	47.0	
6644	chr1	174874209	174874982	773	386.0	
6645	chr1	174938262	174939146	884	442.0	
6646	chr1	174942527	174943401	874	437.0	
6647	chr1	174953727	174954102	375	188.0	
6648	chr1	174954635	174955319	684	342.0	
6649	chr1	174957845	174957982	137	68.0	
6650	chr1	174964132	174970360	6228	3114.0	
6651	chr1	174971948	174972354	406	203.0	
6652	chr1	174983092	174983635	543	272.0	
6653	chr1	174990268	174991029	761	380.0	
6654	chr1	174998114	175001625	3511	1756.0	
6655	chr1	175022584	175024252	1668	834.0	
6656	chr1	175029273	175030341	1068	534.0	
6657	chr1	175072380	175073502	1122	561.0	
6658	chr1	175124791	175125710	919	460.0	
6659	chr1	175127382	175128540	1158	579.0	
6660	chr1	175141944	175142320	376	188.0	
6661	chr1	175146478	175147008	530	265.0	
6662	chr1	175151795	175152624	829	414.0	
6663	chr1	175154658	175155483	825	412.0	
6664	chr1	175174696	175175101	405	202.0	
6665	chr1	175188685	175189665	980	490.0	
6666	chr1	175190987	175193774	2787	1394.0	
6667	chr1	175195702	175196103	401	200.0	
6668	chr1	175197450	175198003	553	276.0	
6669	chr1	175208659	175210103	1444	722.0	
6670	chr1	175225444	175225947	503	252.0	
6671	chr1	175237443	175237714	271	136.0	
6672	chr1	175297288	175297704	416	208.0	
6673	chr1	175317440	175317529	89	44.0	
6674	chr1	175319364	175320068	704	352.0	
6675	chr1	175338447	175338914	467	234.0	
6676	chr1	175511602	175511853	251	126.0	
6677	chr1	175514582	175515001	419	210.0	
6678	chr1	175599170	175599518	348	174.0	
6679	chr1	175601034	175601048	14	7.0	
6680	chr1	175888011	175888013	2	1.0	
6681	chr1	176052231	176052287	56	28.0	
6682	chr1	176073532	176073957	425	212.0	
6683	chr1	176183775	176183874	99	50.0	
6684	chr1	176205290	176208404	3114	1557.0	
6685	chr1	176211139	176211854	715	358.0	
6686	chr1	176241397	176241775	378	189.0	
6687	chr1	176375054	176375284	230	115.0	
6688	chr1	177948369	177948719	350	175.0	
6689	chr1	178031780	178032226	446	223.0	
6690	chr1	178037382	178038306	924	462.0	
6691	chr1	178055162	178056614	1452	726.0	
6692	chr1	178066957	178067589	632	316.0	
6693	chr1	178086846	178087190	344	172.0	
6694	chr1	178093188	178094784	1596	798.0	
6695	chr1	178119613	178120037	424	212.0	
6696	chr1	178192541	178193147	606	303.0	
6697	chr1	178275537	178275870	333	166.0	
6698	chr1	178278096	178278578	482	241.0	
6699	chr1	178283025	178283893	868	434.0	
6700	chr1	178299895	178300270	375	188.0	
6701	chr1	178310568	178311140	572	286.0	
6702	chr1	178344427	178344893	466	233.0	
6703	chr1	178501680	178502143	463	232.0	
6704	chr1	178532039	178532733	694	347.0	
6705	chr1	178541520	178543694	2174	1087.0	
6706	chr1	178575684	178576216	532	266.0	
6707	chr1	178579483	178580039	556	278.0	
6708	chr1	178581241	178581765	524	262.0	
6709	chr1	178605628	178606612	984	492.0	
6710	chr1	178608127	178609087	960	480.0	
6711	chr1	178664204	178664744	540	270.0	
6712	chr1	178724456	178726943	2487	1244.0	
6713	chr1	178753384	178753715	331	166.0	
6714	chr1	178768327	178768767	440	220.0	
6715	chr1	178796082	178796310	228	114.0	
6716	chr1	178932082	178932517	435	218.0	
6717	chr1	178934437	178934917	480	240.0	
6718	chr1	179002452	179003445	993	496.0	
6719	chr1	179004089	179004558	469	234.0	
6720	chr1	179016714	179017480	766	383.0	
6721	chr1	179021886	179022317	431	216.0	
6722	chr1	179025177	179027327	2150	1075.0	
6723	chr1	179034490	179035228	738	369.0	
6724	chr1	179036995	179037462	467	234.0	
6725	chr1	179078910	179079759	849	424.0	
6726	chr1	179080776	179083903	3127	1564.0	
6727	chr1	179088524	179089404	880	440.0	
6728	chr1	179091898	179092075	177	88.0	
6729	chr1	179121021	179121538	517	258.0	
6730	chr1	179129226	179130600	1374	687.0	
6731	chr1	179141212	179142199	987	494.0	
6732	chr1	179142852	179143337	485	242.0	
6733	chr1	179175131	179176124	993	496.0	
6734	chr1	179190802	179191400	598	299.0	
6735	chr1	179195469	179195704	235	118.0	
6736	chr1	179217880	179218603	723	362.0	
6737	chr1	179228399	179230665	2266	1133.0	
6738	chr1	179251756	179252084	328	164.0	
6739	chr1	179292220	179295644	3424	1712.0	
6740	chr1	179296923	179297567	644	322.0	
6741	chr1	179298693	179299537	844	422.0	
6742	chr1	179310878	179311041	163	82.0	
6743	chr1	179317473	179317921	448	224.0	
6744	chr1	179318575	179318782	207	104.0	
6745	chr1	179326881	179328235	1354	677.0	
6746	chr1	179340850	179341372	522	261.0	
6747	chr1	179365100	179366666	1566	783.0	
6748	chr1	179369666	179370348	682	341.0	
6749	chr1	179706328	179706755	427	214.0	
6750	chr1	179709599	179710370	771	386.0	
6751	chr1	179809432	179810450	1018	509.0	
6752	chr1	179814307	179815976	1669	834.0	
6753	chr1	179831804	179832667	863	432.0	
6754	chr1	179857013	179857350	337	168.0	
6755	chr1	179867496	179868204	708	354.0	
6756	chr1	179877230	179878345	1115	558.0	
6757	chr1	179881533	179884234	2701	1350.0	
6758	chr1	179887795	179888481	686	343.0	
6759	chr1	179950600	179951146	546	273.0	
6760	chr1	179951712	179952659	947	474.0	
6761	chr1	179953372	179956152	2780	1390.0	
6762	chr1	179969253	179969277	24	12.0	
6763	chr1	179973778	179974049	271	136.0	
6764	chr1	180108884	180109283	399	200.0	
6765	chr1	180117243	180117776	533	266.0	
6766	chr1	180119591	180119936	345	172.0	
6767	chr1	180127462	180128076	614	307.0	
6768	chr1	180131115	180132327	1212	606.0	
6769	chr1	180150765	180151505	740	370.0	
6770	chr1	180153885	180156943	3058	1529.0	
6771	chr1	180158372	180158824	452	226.0	
6772	chr1	180160236	180160779	543	272.0	
6773	chr1	180162989	180163475	486	243.0	
6774	chr1	180168626	180169112	486	243.0	
6775	chr1	180174221	180174354	133	66.0	
6776	chr1	180176967	180177016	49	24.0	
6777	chr1	180177603	180177669	66	33.0	
6778	chr1	180178571	180179437	866	433.0	
6779	chr1	180181285	180181338	53	26.0	
6780	chr1	180188128	180188535	407	204.0	
6781	chr1	180189934	180190613	679	340.0	
6782	chr1	180192161	180192632	471	236.0	
6783	chr1	180208198	180208688	490	245.0	
6784	chr1	180213400	180213931	531	266.0	
6785	chr1	180228790	180232295	3505	1752.0	
6786	chr1	180234501	180235079	578	289.0	
6787	chr1	180252517	180253077	560	280.0	
6788	chr1	180269863	180270321	458	229.0	
6789	chr1	180278729	180279559	830	415.0	
6790	chr1	180392076	180392312	236	118.0	
6791	chr1	180397062	180397634	572	286.0	
6792	chr1	180401968	180403110	1142	571.0	
6793	chr1	180415457	180416386	929	464.0	
6794	chr1	180428826	180429705	879	440.0	
6795	chr1	180478218	180478547	329	164.0	
6796	chr1	180482389	180483082	693	346.0	
6797	chr1	180501898	180503662	1764	882.0	
6798	chr1	180515749	180516281	532	266.0	
6799	chr1	180533444	180533937	493	246.0	
6800	chr1	180609791	180610048	257	128.0	
6801	chr1	180611276	180611657	381	190.0	
6802	chr1	180618000	180618134	134	67.0	
6803	chr1	180631134	180633134	2000	1000.0	
6804	chr1	180633941	180634010	69	34.0	
6805	chr1	180858082	180858732	650	325.0	
6806	chr1	180863173	180863569	396	198.0	
6807	chr1	180881912	180882240	328	164.0	
6808	chr1	180912449	180913156	707	354.0	
6809	chr1	180935441	180935884	443	222.0	
6810	chr1	180953443	180954863	1420	710.0	
6811	chr1	180969371	180969977	606	303.0	
6812	chr1	180970765	180970783	18	9.0	
6813	chr1	180981583	180982031	448	224.0	
6814	chr1	181013035	181013726	691	346.0	
6815	chr1	181014531	181015771	1240	620.0	
6816	chr1	181019062	181019482	420	210.0	
6817	chr1	181020633	181020694	61	30.0	
6818	chr1	181021377	181024096	2719	1360.0	
6819	chr1	181032845	181034784	1939	970.0	
6820	chr1	181036149	181036858	709	354.0	
6821	chr1	181038186	181039057	871	436.0	
6822	chr1	181042827	181043549	722	361.0	
6823	chr1	181044273	181045148	875	438.0	
6824	chr1	181061907	181063363	1456	728.0	
6825	chr1	181064049	181064394	345	172.0	
6826	chr1	181084016	181084894	878	439.0	
6827	chr1	181086744	181094248	7504	3752.0	
6828	chr1	181094796	181097526	2730	1365.0	
6829	chr1	181098377	181098594	217	108.0	
6830	chr1	181099466	181100958	1492	746.0	
6831	chr1	181101577	181102290	713	356.0	
6832	chr1	181102812	181103468	656	328.0	
6833	chr1	181103984	181106670	2686	1343.0	
6834	chr1	181112398	181112925	527	264.0	
6835	chr1	181124017	181125004	987	494.0	
6836	chr1	181128692	181129961	1269	634.0	
6837	chr1	181131187	181132112	925	462.0	
6838	chr1	181134054	181136493	2439	1220.0	
6839	chr1	181141084	181143087	2003	1002.0	
6840	chr1	181149291	181150316	1025	512.0	
6841	chr1	181152824	181153564	740	370.0	enhancer
6842	chr1	181159355	181162005	2650	1325.0	
6843	chr1	181166192	181167017	825	412.0	
6844	chr1	181180063	181180202	139	70.0	
6845	chr1	181189673	181190655	982	491.0	
6846	chr1	181395979	181396902	923	462.0	
6847	chr1	181397920	181398301	381	190.0	
6848	chr1	181423593	181423664	71	36.0	
6849	chr1	181424654	181425517	863	432.0	
6850	chr1	181479157	181479493	336	168.0	
6851	chr1	181482612	181482844	232	116.0	
6852	chr1	181504590	181505451	861	430.0	
6853	chr1	181937006	181937429	423	212.0	
6854	chr1	182028986	182030635	1649	824.0	
6855	chr1	182051056	182051400	344	172.0	
6856	chr1	182054693	182055111	418	209.0	
6857	chr1	182068948	182069359	411	206.0	
6858	chr1	182080968	182081428	460	230.0	
6859	chr1	182084353	182085553	1200	600.0	
6860	chr1	182087284	182088358	1074	537.0	
6861	chr1	182143084	182144858	1774	887.0	
6862	chr1	182145373	182145878	505	252.0	
6863	chr1	182147026	182147887	861	430.0	
6864	chr1	182148961	182150115	1154	577.0	
6865	chr1	182169345	182169746	401	200.0	
6866	chr1	182170630	182171588	958	479.0	
6867	chr1	182175186	182175886	700	350.0	
6868	chr1	182185231	182185481	250	125.0	
6869	chr1	182193769	182194552	783	392.0	
6870	chr1	182197793	182198372	579	290.0	
6871	chr1	182258989	182260289	1300	650.0	
6872	chr1	182268691	182269106	415	208.0	
6873	chr1	182278671	182279056	385	192.0	
6874	chr1	182286211	182286572	361	180.0	
6875	chr1	182299928	182300468	540	270.0	
6876	chr1	182380620	182381076	456	228.0	
6877	chr1	182382444	182382618	174	87.0	
6878	chr1	182389073	182392704	3631	1816.0	
6879	chr1	182393950	182394826	876	438.0	
6880	chr1	182396584	182397195	611	306.0	
6881	chr1	182420544	182420882	338	169.0	
6882	chr1	182426827	182427183	356	178.0	
6883	chr1	182430605	182431140	535	268.0	
6884	chr1	182445972	182446475	503	252.0	
6885	chr1	182460095	182460923	828	414.0	
6886	chr1	182484440	182485081	641	320.0	
6887	chr1	182493108	182493430	322	161.0	
6888	chr1	182586464	182586720	256	128.0	
6889	chr1	182588031	182589888	1857	928.0	
6890	chr1	182594572	182595084	512	256.0	
6891	chr1	182595603	182596129	526	263.0	
6892	chr1	182598401	182599768	1367	684.0	
6893	chr1	182601069	182602151	1082	541.0	
6894	chr1	182602808	182605067	2259	1130.0	
6895	chr1	182614297	182616990	2693	1346.0	
6896	chr1	182617896	182618359	463	232.0	
6897	chr1	182629519	182630226	707	354.0	
6898	chr1	182632612	182632787	175	88.0	
6899	chr1	182633697	182634098	401	200.0	
6900	chr1	182645031	182645172	141	70.0	
6901	chr1	182782085	182782810	725	362.0	
6902	chr1	182784555	182784999	444	222.0	
6903	chr1	182786648	182787106	458	229.0	
6904	chr1	182788874	182790340	1466	733.0	
6905	chr1	182794766	182796227	1461	730.0	
6906	chr1	182838615	182841798	3183	1592.0	
6907	chr1	182889898	182890457	559	280.0	
6908	chr1	182962480	182962937	457	228.0	
6909	chr1	183022253	183024942	2689	1344.0	
6910	chr1	183033292	183033500	208	104.0	
6911	chr1	183036052	183036275	223	112.0	
6912	chr1	183048662	183049099	437	218.0	
6913	chr1	183102075	183102287	212	106.0	
6914	chr1	183105539	183105724	185	92.0	
6915	chr1	183209570	183209931	361	180.0	
6916	chr1	183218852	183219516	664	332.0	
6917	chr1	183227996	183228348	352	176.0	
6918	chr1	183243700	183244052	352	176.0	
6919	chr1	183279506	183280635	1129	564.0	
6920	chr1	183281140	183281955	815	408.0	
6921	chr1	183363571	183364543	972	486.0	
6922	chr1	183416745	183417161	416	208.0	
6923	chr1	183461192	183461871	679	340.0	
6924	chr1	183466790	183467162	372	186.0	
6925	chr1	183469810	183473649	3839	1920.0	
6926	chr1	183478107	183478770	663	332.0	
6927	chr1	183480892	183481597	705	352.0	
6928	chr1	183487413	183488106	693	346.0	
6929	chr1	183498499	183498675	176	88.0	
6930	chr1	183543546	183544031	485	242.0	
6931	chr1	183548249	183548484	235	118.0	
6932	chr1	183567400	183569051	1651	826.0	
6933	chr1	183579917	183580882	965	482.0	
6934	chr1	183583198	183583998	800	400.0	
6935	chr1	183585089	183585287	198	99.0	
6936	chr1	183588911	183591490	2579	1290.0	
6937	chr1	183592969	183593929	960	480.0	
6938	chr1	183598515	183598860	345	172.0	
6939	chr1	183600064	183600631	567	284.0	
6940	chr1	183603876	183605410	1534	767.0	
6941	chr1	183609142	183609786	644	322.0	
6942	chr1	183623139	183623673	534	267.0	
6943	chr1	183632931	183637117	4186	2093.0	
6944	chr1	183646706	183647154	448	224.0	
6945	chr1	183652125	183652870	745	372.0	
6946	chr1	183655416	183656090	674	337.0	
6947	chr1	183685072	183685542	470	235.0	
6948	chr1	183804876	183805736	860	430.0	
6949	chr1	183807426	183808143	717	358.0	
6950	chr1	183810184	183810559	375	188.0	
6951	chr1	183832450	183832772	322	161.0	
6952	chr1	183842532	183842859	327	164.0	
6953	chr1	183873717	183874078	361	180.0	
6954	chr1	183882342	183882827	485	242.0	
6955	chr1	183888220	183888590	370	185.0	
6956	chr1	183892439	183892562	123	62.0	
6957	chr1	183896342	183897209	867	434.0	
6958	chr1	183901855	183902337	482	241.0	
6959	chr1	183911197	183911898	701	350.0	
6960	chr1	183915700	183916568	868	434.0	
6961	chr1	183956228	183957338	1110	555.0	
6962	chr1	183967906	183968320	414	207.0	
6963	chr1	184017375	184017776	401	200.0	
6964	chr1	184035988	184038094	2106	1053.0	
6965	chr1	184051023	184052430	1407	704.0	
6966	chr1	184075430	184075813	383	192.0	
6967	chr1	184110310	184110973	663	332.0	
6968	chr1	184152261	184153410	1149	574.0	
6969	chr1	184158707	184159381	674	337.0	
6970	chr1	184160085	184160714	629	314.0	
6971	chr1	184161263	184161774	511	256.0	
6972	chr1	184165231	184165664	433	216.0	
6973	chr1	184222540	184222972	432	216.0	
6974	chr1	184380327	184380968	641	320.0	
6975	chr1	184386236	184389361	3125	1562.0	
6976	chr1	184399391	184399606	215	108.0	
6977	chr1	184417987	184419407	1420	710.0	
6978	chr1	184455930	184456664	734	367.0	
6979	chr1	184483255	184483637	382	191.0	
6980	chr1	184491305	184492437	1132	566.0	
6981	chr1	184532995	184533467	472	236.0	
6982	chr1	184548082	184548450	368	184.0	
6983	chr1	184615293	184615777	484	242.0	
6984	chr1	184637918	184638185	267	134.0	
6985	chr1	184649326	184649727	401	200.0	
6986	chr1	184663905	184664408	503	252.0	
6987	chr1	184735014	184735349	335	168.0	
6988	chr1	184742992	184743537	545	272.0	
6989	chr1	184745826	184746317	491	246.0	
6990	chr1	184747254	184747733	479	240.0	
6991	chr1	184752639	184756158	3519	1760.0	
6992	chr1	184786569	184787052	483	242.0	
6993	chr1	184792325	184793166	841	420.0	
6994	chr1	184805494	184807046	1552	776.0	
6995	chr1	184824717	184826064	1347	674.0	
6996	chr1	184838589	184838992	403	202.0	
6997	chr1	184840370	184841179	809	404.0	
6998	chr1	184843594	184844308	714	357.0	
6999	chr1	184866826	184868265	1439	720.0	
7000	chr1	184875951	184876484	533	266.0	
7001	chr1	184885456	184885666	210	105.0	
7002	chr1	184889963	184891487	1524	762.0	
7003	chr1	184892125	184892916	791	396.0	
7004	chr1	184895239	184895467	228	114.0	
7005	chr1	184904789	184905573	784	392.0	
7006	chr1	184917302	184917837	535	268.0	
7007	chr1	184930645	184930868	223	112.0	
7008	chr1	184944990	184946520	1530	765.0	
7009	chr1	184947550	184947854	304	152.0	
7010	chr1	184970514	184971229	715	358.0	
7011	chr1	184972242	184975913	3671	1836.0	
7012	chr1	184981908	184982594	686	343.0	
7013	chr1	185017379	185017667	288	144.0	
7014	chr1	185040936	185041535	599	300.0	
7015	chr1	185042989	185043196	207	104.0	
7016	chr1	185043872	185046720	2848	1424.0	
7017	chr1	185050870	185051271	401	200.0	
7018	chr1	185062996	185063380	384	192.0	
7019	chr1	185155651	185158446	2795	1398.0	
7020	chr1	185170151	185170837	686	343.0	
7021	chr1	185238440	185238841	401	200.0	
7022	chr1	185241187	185241486	299	150.0	
7023	chr1	185280989	185281906	917	458.0	
7024	chr1	185284849	185285250	401	200.0	
7025	chr1	185287539	185287866	327	164.0	
7026	chr1	185288421	185298710	10289	5144.0	
7027	chr1	185300321	185301749	1428	714.0	
7028	chr1	185302277	185304390	2113	1056.0	
7029	chr1	185305403	185308475	3072	1536.0	
7030	chr1	185309622	185310710	1088	544.0	
7031	chr1	185311641	185319264	7623	3812.0	
7032	chr1	185328199	185328600	401	200.0	
7033	chr1	185336954	185337698	744	372.0	
7034	chr1	185338574	185339854	1280	640.0	
7035	chr1	185345833	185346706	873	436.0	
7036	chr1	185373700	185374595	895	448.0	
7037	chr1	185375412	185376195	783	392.0	
7038	chr1	185376831	185377774	943	472.0	
7039	chr1	185405183	185405388	205	102.0	
7040	chr1	185408861	185409053	192	96.0	
7041	chr1	185420423	185421827	1404	702.0	
7042	chr1	185439285	185440964	1679	840.0	
7043	chr1	185474500	185474735	235	118.0	
7044	chr1	185483716	185484579	863	432.0	
7045	chr1	185495050	185495347	297	148.0	
7046	chr1	185512440	185512751	311	156.0	
7047	chr1	185520363	185520986	623	312.0	
7048	chr1	185526550	185527050	500	250.0	
7049	chr1	185534727	185535171	444	222.0	
7050	chr1	185559606	185562295	2689	1344.0	
7051	chr1	185566538	185569147	2609	1304.0	
7052	chr1	185573732	185574064	332	166.0	
7053	chr1	185595838	185596491	653	326.0	
7054	chr1	185598314	185598853	539	270.0	
7055	chr1	185603096	185603685	589	294.0	
7056	chr1	185608180	185608602	422	211.0	
7057	chr1	185632594	185633412	818	409.0	
7058	chr1	185670135	185670773	638	319.0	
7059	chr1	185672884	185673324	440	220.0	
7060	chr1	185674010	185674640	630	315.0	
7061	chr1	185680466	185681449	983	492.0	
7062	chr1	185693743	185694661	918	459.0	
7063	chr1	185733786	185734541	755	378.0	
7064	chr1	186082209	186082670	461	230.0	
7065	chr1	186288735	186289159	424	212.0	
7066	chr1	186304017	186304324	307	154.0	
7067	chr1	186304950	186305354	404	202.0	
7068	chr1	186325296	186325583	287	144.0	
7069	chr1	186374233	186376427	2194	1097.0	
7070	chr1	186404432	186404955	523	262.0	
7071	chr1	186442777	186442923	146	73.0	
7072	chr1	186482667	186483054	387	194.0	
7073	chr1	186511929	186512465	536	268.0	
7074	chr1	186536321	186536648	327	164.0	
7075	chr1	186605705	186606199	494	247.0	
7076	chr1	186611237	186611450	213	106.0	
7077	chr1	186614894	186615007	113	56.0	
7078	chr1	186617884	186619038	1154	577.0	
7079	chr1	186620891	186621411	520	260.0	
7080	chr1	186623404	186624010	606	303.0	
7081	chr1	186633184	186633519	335	168.0	
7082	chr1	186643635	186644036	401	200.0	
7083	chr1	186653112	186653782	670	335.0	
7084	chr1	186654711	186655171	460	230.0	
7085	chr1	186655760	186656420	660	330.0	
7086	chr1	186659807	186660531	724	362.0	
7087	chr1	186679902	186681234	1332	666.0	
7088	chr1	186689383	186689793	410	205.0	
7089	chr1	186722735	186723092	357	178.0	
7090	chr1	186738985	186739326	341	170.0	
7091	chr1	186819141	186819567	426	213.0	
7092	chr1	186828456	186830462	2006	1003.0	
7093	chr1	186838712	186839363	651	326.0	
7094	chr1	186839868	186840045	177	88.0	
7095	chr1	186845489	186846019	530	265.0	
7096	chr1	186848787	186850311	1524	762.0	
7097	chr1	186974968	186975010	42	21.0	
7098	chr1	186978593	186979274	681	340.0	
7099	chr1	186983381	186983605	224	112.0	
7100	chr1	186985889	186986303	414	207.0	
7101	chr1	187072491	187073573	1082	541.0	
7102	chr1	187092081	187092468	387	194.0	
7103	chr1	190759799	190760121	322	161.0	
7104	chr1	191174392	191174503	111	56.0	
7105	chr1	191963265	191963741	476	238.0	
7106	chr1	192158055	192158701	646	323.0	
7107	chr1	192161986	192162733	747	374.0	
7108	chr1	192167996	192168356	360	180.0	
7109	chr1	192170264	192170506	242	121.0	
7110	chr1	192445836	192446247	411	206.0	
7111	chr1	192474046	192474523	477	238.0	
7112	chr1	192476919	192477981	1062	531.0	
7113	chr1	192489844	192490086	242	121.0	
7114	chr1	192512340	192513142	802	401.0	
7115	chr1	192516455	192517427	972	486.0	
7116	chr1	192520368	192520432	64	32.0	
7117	chr1	192521686	192522147	461	230.0	
7118	chr1	192530268	192531423	1155	578.0	
7119	chr1	192538693	192539935	1242	621.0	
7120	chr1	192545031	192546659	1628	814.0	
7121	chr1	192550831	192551627	796	398.0	
7122	chr1	192552770	192553193	423	212.0	
7123	chr1	192555040	192555074	34	17.0	
7124	chr1	192559620	192559636	16	8.0	
7125	chr1	192571672	192572380	708	354.0	
7126	chr1	192574157	192574301	144	72.0	
7127	chr1	192575180	192576213	1033	516.0	
7128	chr1	192577357	192578179	822	411.0	
7129	chr1	192578714	192581572	2858	1429.0	
7130	chr1	192601308	192601665	357	178.0	
7131	chr1	192604927	192605472	545	272.0	
7132	chr1	192608884	192610489	1605	802.0	
7133	chr1	192626619	192626982	363	182.0	
7134	chr1	192788202	192788487	285	142.0	
7135	chr1	192797860	192798333	473	236.0	
7136	chr1	192805724	192815381	9657	4828.0	
7137	chr1	192817384	192817689	305	152.0	
7138	chr1	192877420	192877962	542	271.0	
7139	chr1	192904592	192904748	156	78.0	
7140	chr1	192907712	192908583	871	436.0	
7141	chr1	192926676	192927154	478	239.0	
7142	chr1	192936250	192937632	1382	691.0	
7143	chr1	192940618	192941119	501	250.0	
7144	chr1	192941962	192942604	642	321.0	
7145	chr1	192945382	192945762	380	190.0	
7146	chr1	192951906	192952560	654	327.0	
7147	chr1	192954708	192955378	670	335.0	
7148	chr1	192998509	192998903	394	197.0	
7149	chr1	193010381	193010469	88	44.0	
7150	chr1	193013013	193013294	281	140.0	
7151	chr1	193019406	193019874	468	234.0	
7152	chr1	193031406	193031694	288	144.0	
7153	chr1	193058020	193061449	3429	1714.0	
7154	chr1	193069988	193071442	1454	727.0	
7155	chr1	193104120	193105995	1875	938.0	
7156	chr1	193111610	193112525	915	458.0	
7157	chr1	193120709	193123476	2767	1384.0	
7158	chr1	193182999	193183474	475	238.0	
7159	chr1	193185924	193186928	1004	502.0	
7160	chr1	193241235	193241587	352	176.0	
7161	chr1	193368601	193368649	48	24.0	
7162	chr1	193406775	193407216	441	220.0	
7163	chr1	193417353	193419109	1756	878.0	
7164	chr1	193448828	193449593	765	382.0	
7165	chr1	193457711	193459317	1606	803.0	
7166	chr1	193462620	193463072	452	226.0	
7167	chr1	193478981	193479877	896	448.0	
7168	chr1	193514398	193514743	345	172.0	
7169	chr1	193537282	193538345	1063	532.0	
7170	chr1	193539695	193540889	1194	597.0	
7171	chr1	193542784	193542986	202	101.0	
7172	chr1	193558364	193559172	808	404.0	
7173	chr1	193568459	193569029	570	285.0	
7174	chr1	193569592	193570188	596	298.0	
7175	chr1	193592218	193592758	540	270.0	
7176	chr1	193634419	193634827	408	204.0	
7177	chr1	194052486	194053054	568	284.0	
7178	chr1	194056137	194056732	595	298.0	
7179	chr1	194225823	194226219	396	198.0	
7180	chr1	194289369	194290307	938	469.0	
7181	chr1	194295470	194296151	681	340.0	
7182	chr1	195908200	195908321	121	60.0	
7183	chr1	196608713	196609242	529	264.0	
7184	chr1	196651832	196651932	100	50.0	
7185	chr1	196660909	196661278	369	184.0	
7186	chr1	197141677	197141891	214	107.0	
7187	chr1	197143328	197143677	349	174.0	
7188	chr1	197145697	197147354	1657	828.0	
7189	chr1	197179200	197179294	94	47.0	
7190	chr1	197180219	197180693	474	237.0	
7191	chr1	197200101	197202369	2268	1134.0	
7192	chr1	197285094	197285323	229	114.0	
7193	chr1	197356908	197357309	401	200.0	
7194	chr1	197391168	197392046	878	439.0	
7195	chr1	197400007	197400560	553	276.0	
7196	chr1	197481158	197481450	292	146.0	
7197	chr1	197519718	197520032	314	157.0	
7198	chr1	197521098	197521532	434	217.0	
7199	chr1	197526764	197527097	333	166.0	
7200	chr1	197615132	197615535	403	202.0	
7201	chr1	197659195	197659531	336	168.0	
7202	chr1	197675748	197676122	374	187.0	
7203	chr1	197736932	197736933	1	0.0	
7204	chr1	197762114	197762515	401	200.0	
7205	chr1	197768293	197768560	267	134.0	
7206	chr1	197774378	197777161	2783	1392.0	
7207	chr1	197778463	197779007	544	272.0	
7208	chr1	197782979	197783373	394	197.0	
7209	chr1	197806769	197807077	308	154.0	
7210	chr1	197838796	197839270	474	237.0	
7211	chr1	197842129	197842526	397	198.0	
7212	chr1	197868848	197869325	477	238.0	
7213	chr1	197902137	197904866	2729	1364.0	
7214	chr1	197908408	197920526	12118	6059.0	
7215	chr1	197921574	197921751	177	88.0	
7216	chr1	197924486	197924949	463	232.0	
7217	chr1	197928980	197929256	276	138.0	
7218	chr1	197949228	197949930	702	351.0	
7219	chr1	197974788	197975568	780	390.0	
7220	chr1	198047934	198048076	142	71.0	
7221	chr1	198088326	198088797	471	236.0	
7222	chr1	198101723	198103035	1312	656.0	
7223	chr1	198155709	198159815	4106	2053.0	
7224	chr1	198162131	198162913	782	391.0	
7225	chr1	198165561	198168603	3042	1521.0	
7226	chr1	198169995	198170160	165	82.0	
7227	chr1	198171724	198172255	531	266.0	
7228	chr1	198174160	198174826	666	333.0	
7229	chr1	198175718	198176456	738	369.0	
7230	chr1	198179370	198180043	673	336.0	
7231	chr1	198185683	198186122	439	220.0	
7232	chr1	198187658	198188826	1168	584.0	
7233	chr1	198199086	198199428	342	171.0	
7234	chr1	198202463	198202674	211	106.0	
7235	chr1	198234470	198234846	376	188.0	
7236	chr1	198238062	198238623	561	280.0	
7237	chr1	198242417	198242507	90	45.0	
7238	chr1	198253650	198254111	461	230.0	
7239	chr1	198359084	198359458	374	187.0	
7240	chr1	198465550	198465964	414	207.0	
7241	chr1	198497515	198498074	559	280.0	
7242	chr1	198519327	198521300	1973	986.0	
7243	chr1	198523049	198524476	1427	714.0	
7244	chr1	198534590	198535152	562	281.0	
7245	chr1	198543594	198544110	516	258.0	
7246	chr1	198549798	198550438	640	320.0	
7247	chr1	198553685	198554330	645	322.0	
7248	chr1	198556440	198557774	1334	667.0	
7249	chr1	198558413	198558805	392	196.0	
7250	chr1	198564676	198565139	463	232.0	
7251	chr1	198575919	198576390	471	236.0	
7252	chr1	198597616	198598116	500	250.0	
7253	chr1	198598708	198599436	728	364.0	
7254	chr1	198602423	198602835	412	206.0	
7255	chr1	198612442	198613395	953	476.0	
7256	chr1	198614129	198615122	993	496.0	
7257	chr1	198619286	198624790	5504	2752.0	
7258	chr1	198627446	198628116	670	335.0	
7259	chr1	198629578	198629979	401	200.0	
7260	chr1	198633482	198634306	824	412.0	
7261	chr1	198636435	198636981	546	273.0	
7262	chr1	198638201	198639967	1766	883.0	
7263	chr1	198641360	198642413	1053	526.0	
7264	chr1	198643755	198644017	262	131.0	
7265	chr1	198649341	198650856	1515	758.0	
7266	chr1	198651477	198652923	1446	723.0	
7267	chr1	198655373	198659538	4165	2082.0	
7268	chr1	198660388	198661189	801	400.0	
7269	chr1	198662793	198665853	3060	1530.0	
7270	chr1	198667679	198669603	1924	962.0	
7271	chr1	198671057	198673059	2002	1001.0	
7272	chr1	198673567	198673854	287	144.0	
7273	chr1	198674814	198674999	185	92.0	
7274	chr1	198676070	198684000	7930	3965.0	"enhancer	sequence_feature"
7275	chr1	198685891	198687256	1365	682.0	
7276	chr1	198689434	198689892	458	229.0	
7277	chr1	198691009	198691707	698	349.0	
7278	chr1	198693895	198694316	421	210.0	
7279	chr1	198696183	198697030	847	424.0	
7280	chr1	198699328	198699892	564	282.0	
7281	chr1	198701436	198702253	817	408.0	
7282	chr1	198708900	198709128	228	114.0	
7283	chr1	198716006	198716107	101	50.0	
7284	chr1	198717601	198717795	194	97.0	
7285	chr1	198725670	198725674	4	2.0	
7286	chr1	198746346	198747436	1090	545.0	
7287	chr1	198751816	198752035	219	110.0	
7288	chr1	198754854	198755091	237	118.0	
7289	chr1	198756079	198756303	224	112.0	
7290	chr1	198759480	198760314	834	417.0	
7291	chr1	198761199	198762478	1279	640.0	
7292	chr1	198763430	198763482	52	26.0	
7293	chr1	198776462	198777190	728	364.0	
7294	chr1	198778140	198778189	49	24.0	
7295	chr1	198788390	198789138	748	374.0	
7296	chr1	198881134	198881680	546	273.0	
7297	chr1	198889151	198889440	289	144.0	
7298	chr1	198907153	198907706	553	276.0	
7299	chr1	198918879	198920582	1703	852.0	
7300	chr1	198922520	198923325	805	402.0	
7301	chr1	198929742	198930709	967	484.0	
7302	chr1	198932750	198932877	127	64.0	
7303	chr1	198934625	198937888	3263	1632.0	
7304	chr1	198959127	198959341	214	107.0	
7305	chr1	198966768	198966852	84	42.0	
7306	chr1	198970843	198971401	558	279.0	
7307	chr1	199010491	199010920	429	214.0	
7308	chr1	199041498	199041996	498	249.0	
7309	chr1	199089466	199090250	784	392.0	
7310	chr1	199095369	199096241	872	436.0	
7311	chr1	199113205	199113682	477	238.0	
7312	chr1	199168675	199169327	652	326.0	
7313	chr1	199172566	199174062	1496	748.0	
7314	chr1	199217988	199218516	528	264.0	
7315	chr1	199226093	199226622	529	264.0	
7316	chr1	199242208	199242414	206	103.0	
7317	chr1	199243208	199243908	700	350.0	
7318	chr1	199400029	199400769	740	370.0	
7319	chr1	199498761	199499177	416	208.0	
7320	chr1	199613360	199613754	394	197.0	
7321	chr1	199684614	199685074	460	230.0	
7322	chr1	199691486	199692038	552	276.0	
7323	chr1	199742501	199743057	556	278.0	
7324	chr1	199857125	199857622	497	248.0	
7325	chr1	199859277	199860102	825	412.0	
7326	chr1	199878738	199879292	554	277.0	
7327	chr1	199931994	199932446	452	226.0	
7328	chr1	199977029	199978076	1047	524.0	
7329	chr1	200028959	200029489	530	265.0	
7330	chr1	200038750	200040070	1320	660.0	
7331	chr1	200129229	200130048	819	410.0	
7332	chr1	200130665	200130668	3	2.0	
7333	chr1	200139605	200140064	459	230.0	
7334	chr1	200153188	200154709	1521	760.0	
7335	chr1	200184167	200184662	495	248.0	
7336	chr1	200207881	200208061	180	90.0	
7337	chr1	200226239	200226616	377	188.0	
7338	chr1	200240666	200241032	366	183.0	
7339	chr1	200258458	200258805	347	174.0	
7340	chr1	200279807	200280181	374	187.0	
7341	chr1	200286039	200286457	418	209.0	
7342	chr1	200301518	200303187	1669	834.0	
7343	chr1	200306881	200307901	1020	510.0	
7344	chr1	200311265	200311645	380	190.0	
7345	chr1	200337456	200338178	722	361.0	
7346	chr1	200346606	200346953	347	174.0	
7347	chr1	200351749	200352700	951	476.0	
7348	chr1	200354071	200354862	791	396.0	
7349	chr1	200355749	200356346	597	298.0	
7350	chr1	200359754	200360213	459	230.0	
7351	chr1	200363122	200363927	805	402.0	
7352	chr1	200366701	200366947	246	123.0	
7353	chr1	200367811	200368728	917	458.0	
7354	chr1	200395534	200395619	85	42.0	
7355	chr1	200405282	200405658	376	188.0	
7356	chr1	200408876	200410975	2099	1050.0	
7357	chr1	200437786	200438266	480	240.0	
7358	chr1	200473649	200474305	656	328.0	
7359	chr1	200483532	200483890	358	179.0	
7360	chr1	200488643	200489064	421	210.0	
7361	chr1	200510077	200510545	468	234.0	
7362	chr1	200520678	200521070	392	196.0	
7363	chr1	200525647	200525747	100	50.0	
7364	chr1	200530468	200531385	917	458.0	
7365	chr1	200558916	200559041	125	62.0	
7366	chr1	200588566	200589266	700	350.0	
7367	chr1	200590056	200590271	215	108.0	
7368	chr1	200620182	200621649	1467	734.0	
7369	chr1	200622274	200622741	467	234.0	
7370	chr1	200625485	200625632	147	74.0	
7371	chr1	200627407	200629170	1763	882.0	
7372	chr1	200639862	200640447	585	292.0	
7373	chr1	200642338	200642946	608	304.0	
7374	chr1	200646522	200646880	358	179.0	
7375	chr1	200654719	200655124	405	202.0	
7376	chr1	200669152	200670795	1643	822.0	
7377	chr1	200737962	200740458	2496	1248.0	
7378	chr1	200802827	200803339	512	256.0	
7379	chr1	200862178	200863557	1379	690.0	
7380	chr1	200866524	200867139	615	308.0	
7381	chr1	200869558	200870712	1154	577.0	
7382	chr1	200872712	200874154	1442	721.0	
7383	chr1	200877932	200878509	577	288.0	
7384	chr1	200880273	200880611	338	169.0	
7385	chr1	200885690	200886078	388	194.0	
7386	chr1	200887019	200889807	2788	1394.0	
7387	chr1	200890769	200892365	1596	798.0	
7388	chr1	200905433	200906254	821	410.0	
7389	chr1	200907564	200907950	386	193.0	
7390	chr1	200938902	200939397	495	248.0	
7391	chr1	200969889	200970491	602	301.0	
7392	chr1	200971852	200972862	1010	505.0	
7393	chr1	200974254	200974604	350	175.0	
7394	chr1	200979502	200980036	534	267.0	
7395	chr1	201012891	201013690	799	400.0	
7396	chr1	201015530	201016660	1130	565.0	
7397	chr1	201017517	201017856	339	170.0	
7398	chr1	201018982	201024988	6006	3003.0	
7399	chr1	201025657	201027451	1794	897.0	
7400	chr1	201028203	201028869	666	333.0	
7401	chr1	201042645	201043451	806	403.0	
7402	chr1	201085907	201086293	386	193.0	
7403	chr1	201113663	201115342	1679	840.0	
7404	chr1	201119172	201119671	499	250.0	
7405	chr1	201153598	201155200	1602	801.0	
7406	chr1	201170262	201171878	1616	808.0	
7407	chr1	201173340	201173516	176	88.0	
7408	chr1	201222822	201223287	465	232.0	
7409	chr1	201254539	201254964	425	212.0	
7410	chr1	201404080	201404351	271	136.0	
7411	chr1	201407079	201407381	302	151.0	
7412	chr1	201408157	201408617	460	230.0	
7413	chr1	201435615	201436278	663	332.0	
7414	chr1	201448047	201448506	459	230.0	
7415	chr1	201456740	201457260	520	260.0	
7416	chr1	201468516	201469561	1045	522.0	
7417	chr1	201480176	201482817	2641	1320.0	
7418	chr1	201489217	201490152	935	468.0	
7419	chr1	201505387	201507809	2422	1211.0	
7420	chr1	201511792	201513575	1783	892.0	
7421	chr1	201530741	201531172	431	216.0	
7422	chr1	201535445	201535981	536	268.0	
7423	chr1	201538807	201540469	1662	831.0	
7424	chr1	201544446	201544491	45	22.0	
7425	chr1	201551673	201552370	697	348.0	
7426	chr1	201559550	201560191	641	320.0	
7427	chr1	201593422	201593911	489	244.0	
7428	chr1	201704132	201704628	496	248.0	
7429	chr1	201709405	201709921	516	258.0	
7430	chr1	201713227	201716544	3317	1658.0	
7431	chr1	201739535	201741220	1685	842.0	
7432	chr1	201749081	201749461	380	190.0	
7433	chr1	201792964	201793454	490	245.0	
7434	chr1	201828601	201830003	1402	701.0	
7435	chr1	201877827	201878254	427	214.0	
7436	chr1	201880969	201881290	321	160.0	
7437	chr1	201882414	201884312	1898	949.0	
7438	chr1	201888393	201889327	934	467.0	
7439	chr1	201895690	201896783	1093	546.0	
7440	chr1	201946248	201947029	781	390.0	
7441	chr1	201954466	201956192	1726	863.0	
7442	chr1	201972548	201973070	522	261.0	
7443	chr1	201982025	201983772	1747	874.0	
7444	chr1	201999565	202000029	464	232.0	
7445	chr1	202009457	202009976	519	260.0	
7446	chr1	202119024	202119264	240	120.0	
7447	chr1	202126502	202126847	345	172.0	
7448	chr1	202134932	202135990	1058	529.0	
7449	chr1	202142794	202145881	3087	1544.0	
7450	chr1	202147081	202148617	1536	768.0	
7451	chr1	202154707	202155901	1194	597.0	
7452	chr1	202158724	202166077	7353	3676.0	
7453	chr1	202170890	202171022	132	66.0	
7454	chr1	202180130	202180241	111	56.0	
7455	chr1	202183685	202185297	1612	806.0	
7456	chr1	202188829	202189512	683	342.0	
7457	chr1	202192580	202194366	1786	893.0	
7458	chr1	202197330	202199649	2319	1160.0	
7459	chr1	202201108	202201948	840	420.0	
7460	chr1	202203296	202204186	890	445.0	
7461	chr1	202214212	202214589	377	188.0	
7462	chr1	202236283	202237441	1158	579.0	
7463	chr1	202274632	202274976	344	172.0	
7464	chr1	202283437	202283836	399	200.0	
7465	chr1	202289075	202289265	190	95.0	
7466	chr1	202295330	202296211	881	440.0	
7467	chr1	202315382	202316023	641	320.0	
7468	chr1	202341371	202342713	1342	671.0	
7469	chr1	202343557	202344187	630	315.0	
7470	chr1	202347993	202350155	2162	1081.0	
7471	chr1	202353368	202353768	400	200.0	
7472	chr1	202464242	202464439	197	98.0	
7473	chr1	202468629	202469125	496	248.0	
7474	chr1	202483430	202484469	1039	520.0	
7475	chr1	202488243	202488651	408	204.0	
7476	chr1	202553541	202554016	475	238.0	
7477	chr1	202571766	202572061	295	148.0	
7478	chr1	202586530	202586544	14	7.0	
7479	chr1	202600129	202600507	378	189.0	
7480	chr1	202615826	202616853	1027	514.0	
7481	chr1	202624731	202625875	1144	572.0	
7482	chr1	202627265	202627319	54	27.0	
7483	chr1	202628852	202629935	1083	542.0	
7484	chr1	202642645	202644020	1375	688.0	
7485	chr1	202692920	202693385	465	232.0	
7486	chr1	202719509	202720026	517	258.0	
7487	chr1	202760703	202760867	164	82.0	
7488	chr1	202802934	202803330	396	198.0	
7489	chr1	202805738	202808950	3212	1606.0	
7490	chr1	202810202	202812140	1938	969.0	
7491	chr1	202835471	202836021	550	275.0	
7492	chr1	202837018	202837455	437	218.0	
7493	chr1	202852233	202852660	427	214.0	
7494	chr1	202855992	202856419	427	214.0	
7495	chr1	202860795	202862300	1505	752.0	
7496	chr1	202888145	202889825	1680	840.0	
7497	chr1	202926435	202927916	1481	740.0	
7498	chr1	202952530	202953402	872	436.0	
7499	chr1	202957464	202959264	1800	900.0	
7500	chr1	202965857	202969522	3665	1832.0	
7501	chr1	202976721	202976925	204	102.0	
7502	chr1	202983009	202983394	385	192.0	
7503	chr1	202988138	202988573	435	218.0	
7504	chr1	202999146	202999891	745	372.0	
7505	chr1	203005698	203008207	2509	1254.0	
7506	chr1	203025632	203027460	1828	914.0	
7507	chr1	203039264	203039793	529	264.0	
7508	chr1	203057905	203059965	2060	1030.0	
7509	chr1	203069077	203069730	653	326.0	
7510	chr1	203075208	203076819	1611	806.0	
7511	chr1	203082428	203083284	856	428.0	
7512	chr1	203100801	203100949	148	74.0	
7513	chr1	203117773	203118219	446	223.0	
7514	chr1	203126176	203126720	544	272.0	
7515	chr1	203128038	203128429	391	196.0	
7516	chr1	203129401	203130074	673	336.0	
7517	chr1	203133995	203134294	299	150.0	
7518	chr1	203135865	203136282	417	208.0	
7519	chr1	203162448	203162636	188	94.0	
7520	chr1	203167376	203167631	255	128.0	
7521	chr1	203172189	203172619	430	215.0	
7522	chr1	203175745	203176327	582	291.0	
7523	chr1	203200000	203200691	691	346.0	
7524	chr1	203202360	203203061	701	350.0	
7525	chr1	203214883	203215458	575	288.0	
7526	chr1	203216151	203216648	497	248.0	
7527	chr1	203217326	203217946	620	310.0	
7528	chr1	203267159	203268117	958	479.0	
7529	chr1	203268637	203269671	1034	517.0	
7530	chr1	203270668	203271669	1001	500.0	
7531	chr1	203272647	203275480	2833	1416.0	
7532	chr1	203277118	203278825	1707	854.0	
7533	chr1	203282746	203283147	401	200.0	
7534	chr1	203284633	203285073	440	220.0	
7535	chr1	203286133	203292020	5887	2944.0	
7536	chr1	203295630	203296900	1270	635.0	
7537	chr1	203299148	203301164	2016	1008.0	
7538	chr1	203302535	203318502	15967	7984.0	
7539	chr1	203319209	203328481	9272	4636.0	
7540	chr1	203338193	203339046	853	426.0	
7541	chr1	203339973	203340528	555	278.0	
7542	chr1	203342387	203342906	519	260.0	
7543	chr1	203351060	203351548	488	244.0	
7544	chr1	203361802	203362327	525	262.0	
7545	chr1	203368771	203370072	1301	650.0	
7546	chr1	203380856	203381812	956	478.0	
7547	chr1	203402454	203403071	617	308.0	
7548	chr1	203408453	203408964	511	256.0	
7549	chr1	203410285	203410736	451	226.0	
7550	chr1	203411364	203411930	566	283.0	
7551	chr1	203440874	203441135	261	130.0	
7552	chr1	203447138	203447557	419	210.0	
7553	chr1	203480740	203481249	509	254.0	
7554	chr1	203487116	203488368	1252	626.0	
7555	chr1	203504414	203505236	822	411.0	
7556	chr1	203512686	203513701	1015	508.0	
7557	chr1	203520287	203520704	417	208.0	
7558	chr1	203529144	203529813	669	334.0	
7559	chr1	203538051	203538625	574	287.0	
7560	chr1	203592652	203594075	1423	712.0	
7561	chr1	203606759	203607953	1194	597.0	
7562	chr1	203613224	203613623	399	200.0	
7563	chr1	203625230	203631189	5959	2980.0	
7564	chr1	203638733	203639403	670	335.0	
7565	chr1	203647967	203648721	754	377.0	
7566	chr1	203649305	203650977	1672	836.0	
7567	chr1	203651825	203653849	2024	1012.0	
7568	chr1	203655613	203656308	695	348.0	
7569	chr1	203657160	203657473	313	156.0	
7570	chr1	203661567	203661747	180	90.0	
7571	chr1	203663288	203663848	560	280.0	
7572	chr1	203671812	203676328	4516	2258.0	
7573	chr1	203682152	203683352	1200	600.0	
7574	chr1	203701901	203702673	772	386.0	
7575	chr1	203743889	203744689	800	400.0	
7576	chr1	203753386	203753523	137	68.0	
7577	chr1	203754297	203755033	736	368.0	
7578	chr1	203755985	203757057	1072	536.0	
7579	chr1	203764104	203766425	2321	1160.0	
7580	chr1	203768144	203768569	425	212.0	
7581	chr1	203769317	203770105	788	394.0	
7582	chr1	203776698	203777037	339	170.0	
7583	chr1	203792748	203793136	388	194.0	
7584	chr1	203795008	203796890	1882	941.0	
7585	chr1	203829350	203829603	253	126.0	
7586	chr1	203830838	203831184	346	173.0	
7587	chr1	203860957	203862323	1366	683.0	
7588	chr1	203871044	203871418	374	187.0	
7589	chr1	203889458	203890083	625	312.0	
7590	chr1	203930308	203930594	286	143.0	
7591	chr1	203955219	203955288	69	34.0	
7592	chr1	203990432	203990488	56	28.0	
7593	chr1	204072789	204074885	2096	1048.0	
7594	chr1	204102039	204103184	1145	572.0	
7595	chr1	204104202	204105211	1009	504.0	
7596	chr1	204114646	204115001	355	178.0	
7597	chr1	204123412	204123514	102	51.0	
7598	chr1	204127615	204128065	450	225.0	
7599	chr1	204128611	204129818	1207	604.0	
7600	chr1	204150742	204152810	2068	1034.0	
7601	chr1	204162368	204163066	698	349.0	"silencer	protein_binding_site"
7602	chr1	204189199	204189516	317	158.0	
7603	chr1	204190076	204190832	756	378.0	
7604	chr1	204206998	204207495	497	248.0	
7605	chr1	204213655	204214596	941	470.0	
7606	chr1	204254101	204254604	503	252.0	
7607	chr1	204258405	204258723	318	159.0	
7608	chr1	204286580	204288515	1935	968.0	
7609	chr1	204357430	204357930	500	250.0	
7610	chr1	204362980	204364252	1272	636.0	
7611	chr1	204377660	204378689	1029	514.0	
7612	chr1	204381986	204383046	1060	530.0	
7613	chr1	204386029	204388312	2283	1142.0	
7614	chr1	204390825	204391236	411	206.0	
7615	chr1	204392712	204393387	675	338.0	
7616	chr1	204394298	204412849	18551	9276.0	
7617	chr1	204413493	204414504	1011	506.0	
7618	chr1	204417306	204418822	1516	758.0	
7619	chr1	204426837	204427371	534	267.0	
7620	chr1	204431250	204431946	696	348.0	
7621	chr1	204435490	204435903	413	206.0	
7622	chr1	204445839	204447023	1184	592.0	
7623	chr1	204448579	204448969	390	195.0	
7624	chr1	204452748	204453748	1000	500.0	
7625	chr1	204461241	204462225	984	492.0	
7626	chr1	204465653	204466464	811	406.0	
7627	chr1	204475999	204476432	433	216.0	
7628	chr1	204480565	204481611	1046	523.0	
7629	chr1	204493357	204496719	3362	1681.0	
7630	chr1	204498991	204499390	399	200.0	
7631	chr1	204503007	204503794	787	394.0	
7632	chr1	204505838	204508192	2354	1177.0	
7633	chr1	204511319	204511740	421	210.0	
7634	chr1	204512859	204514051	1192	596.0	
7635	chr1	204515675	204517836	2161	1080.0	
7636	chr1	204520664	204522572	1908	954.0	
7637	chr1	204531095	204531288	193	96.0	
7638	chr1	204544201	204544872	671	336.0	
7639	chr1	204545637	204546453	816	408.0	
7640	chr1	204556683	204557037	354	177.0	
7641	chr1	204563422	204563559	137	68.0	
7642	chr1	204564675	204566406	1731	866.0	
7643	chr1	204578648	204579611	963	482.0	
7644	chr1	204584876	204585655	779	390.0	
7645	chr1	204647577	204647749	172	86.0	
7646	chr1	204746822	204747240	418	209.0	
7647	chr1	204763687	204764244	557	278.0	
7648	chr1	204791717	204792168	451	226.0	
7649	chr1	204806748	204808334	1586	793.0	
7650	chr1	204828360	204828805	445	222.0	
7651	chr1	204941761	204941850	89	44.0	
7652	chr1	204969845	204970233	388	194.0	
7653	chr1	204970996	204971290	294	147.0	
7654	chr1	204971997	204972448	451	226.0	
7655	chr1	204975600	204976055	455	228.0	
7656	chr1	204989236	204989743	507	254.0	
7657	chr1	204992094	204993123	1029	514.0	
7658	chr1	205002133	205002563	430	215.0	
7659	chr1	205061497	205061980	483	242.0	
7660	chr1	205121138	205123165	2027	1014.0	
7661	chr1	205141394	205142279	885	442.0	
7662	chr1	205171323	205171633	310	155.0	
7663	chr1	205210437	205212540	2103	1052.0	
7664	chr1	205214689	205215421	732	366.0	
7665	chr1	205227055	205230548	3493	1746.0	
7666	chr1	205237606	205238102	496	248.0	
7667	chr1	205255880	205256804	924	462.0	
7668	chr1	205261385	205261772	387	194.0	
7669	chr1	205273194	205274423	1229	614.0	
7670	chr1	205275099	205275680	581	290.0	
7671	chr1	205279859	205280532	673	336.0	
7672	chr1	205284147	205289179	5032	2516.0	
7673	chr1	205291525	205292053	528	264.0	
7674	chr1	205297813	205297879	66	33.0	
7675	chr1	205299912	205300439	527	264.0	
7676	chr1	205310896	205311963	1067	534.0	
7677	chr1	205313094	205315371	2277	1138.0	
7678	chr1	205316081	205322452	6371	3186.0	
7679	chr1	205325179	205325926	747	374.0	
7680	chr1	205335359	205336179	820	410.0	
7681	chr1	205343267	205344688	1421	710.0	
7682	chr1	205348432	205348979	547	274.0	
7683	chr1	205354242	205354698	456	228.0	
7684	chr1	205396982	205397452	470	235.0	
7685	chr1	205430436	205431240	804	402.0	
7686	chr1	205437102	205437544	442	221.0	
7687	chr1	205440281	205441826	1545	772.0	
7688	chr1	205456466	205457419	953	476.0	
7689	chr1	205479803	205482359	2556	1278.0	
7690	chr1	205485198	205485980	782	391.0	
7691	chr1	205488032	205488534	502	251.0	
7692	chr1	205493066	205493484	418	209.0	
7693	chr1	205504108	205505327	1219	610.0	
7694	chr1	205524213	205524872	659	330.0	
7695	chr1	205528688	205529587	899	450.0	
7696	chr1	205539692	205540243	551	276.0	
7697	chr1	205543312	205543966	654	327.0	
7698	chr1	205568726	205569269	543	272.0	
7699	chr1	205591374	205592524	1150	575.0	
7700	chr1	205593293	205594320	1027	514.0	
7701	chr1	205604840	205605675	835	418.0	
7702	chr1	205625940	205626700	760	380.0	
7703	chr1	205628908	205629143	235	118.0	
7704	chr1	205630250	205632773	2523	1262.0	
7705	chr1	205657461	205657988	527	264.0	
7706	chr1	205658797	205659697	900	450.0	
7707	chr1	205663434	205663868	434	217.0	
7708	chr1	205665364	205665765	401	200.0	
7709	chr1	205668964	205670174	1210	605.0	
7710	chr1	205672116	205672331	215	108.0	
7711	chr1	205679318	205680985	1667	834.0	
7712	chr1	205711033	205711736	703	352.0	
7713	chr1	205715630	205715974	344	172.0	
7714	chr1	205748370	205751012	2642	1321.0	
7715	chr1	205771343	205776113	4770	2385.0	
7716	chr1	205777955	205778453	498	249.0	
7717	chr1	205782655	205783033	378	189.0	
7718	chr1	205791502	205792166	664	332.0	
7719	chr1	205794084	205794447	363	182.0	
7720	chr1	205805314	205807536	2222	1111.0	
7721	chr1	205809995	205814587	4592	2296.0	
7722	chr1	205831415	205831710	295	148.0	
7723	chr1	205832259	205832680	421	210.0	
7724	chr1	205850020	205850378	358	179.0	
7725	chr1	205918944	205919365	421	210.0	
7726	chr1	205931012	205931317	305	152.0	
7727	chr1	205933810	205934206	396	198.0	
7728	chr1	205948058	205948349	291	146.0	
7729	chr1	205951203	205951484	281	140.0	
7730	chr1	206243287	206243762	475	238.0	
7731	chr1	206220614	206221015	401	200.0	
7732	chr1	206204941	206205366	425	212.0	
7733	chr1	206202768	206203993	1225	612.0	
7734	chr1	206128357	206128679	322	161.0	
7735	chr1	206117197	206117904	707	354.0	
7736	chr1	206106503	206107011	508	254.0	
7737	chr1	206102181	206102688	507	254.0	
7738	chr1	206098223	206098624	401	200.0	
7739	chr1	206097562	206097636	74	37.0	
7740	chr1	206081927	206082234	307	154.0	
7741	chr1	206067682	206068296	614	307.0	
7742	chr1	206066378	206066937	559	280.0	
7743	chr1	206052880	206053670	790	395.0	
7744	chr1	206050377	206051422	1045	522.0	
7745	chr1	206048499	206049018	519	260.0	
7746	chr1	206035026	206035353	327	164.0	
7747	chr1	206032423	206032733	310	155.0	
7748	chr1	206030613	206031094	481	240.0	
7749	chr1	206014651	206015052	401	200.0	
7750	chr1	206011820	206013441	1621	810.0	
7751	chr1	206357789	206358367	578	289.0	
7752	chr1	206384357	206384827	470	235.0	
7753	chr1	206456940	206457650	710	355.0	
7754	chr1	206461565	206462397	832	416.0	
7755	chr1	206464381	206465217	836	418.0	
7756	chr1	206465919	206466426	507	254.0	
7757	chr1	206467072	206473345	6273	3136.0	
7758	chr1	206479422	206480026	604	302.0	
7759	chr1	206489975	206490556	581	290.0	
7760	chr1	206496269	206496868	599	300.0	
7761	chr1	206503498	206504725	1227	614.0	
7762	chr1	206505953	206508647	2694	1347.0	
7763	chr1	206514734	206515268	534	267.0	
7764	chr1	206515934	206517059	1125	562.0	
7765	chr1	206524864	206525424	560	280.0	
7766	chr1	206544402	206545601	1199	600.0	
7767	chr1	206551564	206552665	1101	550.0	
7768	chr1	206555130	206560772	5642	2821.0	
7769	chr1	206562103	206564161	2058	1029.0	
7770	chr1	206565049	206566748	1699	850.0	
7771	chr1	206567282	206569681	2399	1200.0	
7772	chr1	206570301	206570321	20	10.0	
7773	chr1	206572451	206572465	14	7.0	
7774	chr1	206573328	206573850	522	261.0	
7775	chr1	206574536	206576766	2230	1115.0	
7776	chr1	206577631	206584414	6783	3392.0	
7777	chr1	206589836	206590857	1021	510.0	
7778	chr1	206608030	206608528	498	249.0	
7779	chr1	206611825	206613066	1241	620.0	
7780	chr1	206631022	206631474	452	226.0	
7781	chr1	206634181	206636409	2228	1114.0	
7782	chr1	206636996	206637741	745	372.0	
7783	chr1	206643639	206644265	626	313.0	
7784	chr1	206658095	206659018	923	462.0	
7785	chr1	206663233	206664783	1550	775.0	
7786	chr1	206672328	206673661	1333	666.0	
7787	chr1	206679468	206680314	846	423.0	
7788	chr1	206682411	206682417	6	3.0	
7789	chr1	206684268	206688484	4216	2108.0	
7790	chr1	206689853	206691012	1159	580.0	
7791	chr1	206691702	206695234	3532	1766.0	
7792	chr1	206696642	206697337	695	348.0	
7793	chr1	206697914	206698081	167	84.0	
7794	chr1	206698901	206701302	2401	1200.0	
7795	chr1	206702350	206704866	2516	1258.0	
7796	chr1	206706422	206708603	2181	1090.0	
7797	chr1	206710380	206710446	66	33.0	
7798	chr1	206712423	206717901	5478	2739.0	
7799	chr1	206719159	206719607	448	224.0	
7800	chr1	206722694	206724373	1679	840.0	
7801	chr1	206725332	206726888	1556	778.0	
7802	chr1	206734163	206735581	1418	709.0	
7803	chr1	206736689	206738511	1822	911.0	
7804	chr1	206739144	206740226	1082	541.0	
7805	chr1	206744743	206745109	366	183.0	
7806	chr1	206748683	206748886	203	102.0	
7807	chr1	206753188	206753434	246	123.0	
7808	chr1	206757560	206758479	919	460.0	
7809	chr1	206766005	206766942	937	468.0	
7810	chr1	206768988	206769910	922	461.0	
7811	chr1	206770450	206773018	2568	1284.0	
7812	chr1	206773986	206774633	647	324.0	
7813	chr1	206779549	206780083	534	267.0	
7814	chr1	206782417	206782903	486	243.0	
7815	chr1	206784251	206785047	796	398.0	
7816	chr1	206786456	206786819	363	182.0	
7817	chr1	206790460	206790916	456	228.0	
7818	chr1	206791473	206791958	485	242.0	
7819	chr1	206794504	206794954	450	225.0	
7820	chr1	206796761	206798519	1758	879.0	
7821	chr1	206802407	206803989	1582	791.0	
7822	chr1	206808410	206809885	1475	738.0	
7823	chr1	206814673	206815186	513	256.0	
7824	chr1	206816717	206817481	764	382.0	
7825	chr1	206824281	206824793	512	256.0	
7826	chr1	206828934	206830403	1469	734.0	
7827	chr1	206833043	206833519	476	238.0	
7828	chr1	206834548	206835359	811	406.0	
7829	chr1	206856787	206857178	391	196.0	
7830	chr1	206858895	206859657	762	381.0	
7831	chr1	206864858	206865428	570	285.0	
7832	chr1	206890379	206891253	874	437.0	
7833	chr1	206905334	206906135	801	400.0	
7834	chr1	206908956	206910122	1166	583.0	
7835	chr1	206910984	206911524	540	270.0	
7836	chr1	206912360	206913289	929	464.0	
7837	chr1	206916228	206916500	272	136.0	
7838	chr1	206918051	206918412	361	180.0	
7839	chr1	206920208	206920689	481	240.0	
7840	chr1	206921291	206925987	4696	2348.0	
7841	chr1	206927201	206927446	245	122.0	
7842	chr1	206929988	206931181	1193	596.0	
7843	chr1	206933111	206933771	660	330.0	
7844	chr1	206935416	206935903	487	244.0	
7845	chr1	206944676	206945196	520	260.0	
7846	chr1	206949243	206949527	284	142.0	
7847	chr1	206952031	206952547	516	258.0	
7848	chr1	206962134	206962823	689	344.0	
7849	chr1	206967166	206968128	962	481.0	
7850	chr1	206969108	206969380	272	136.0	
7851	chr1	206970919	206971454	535	268.0	
7852	chr1	206982035	206982560	525	262.0	
7853	chr1	207004975	207005381	406	203.0	
7854	chr1	207018110	207018503	393	196.0	
7855	chr1	207024281	207024607	326	163.0	
7856	chr1	207049823	207051727	1904	952.0	
7857	chr1	207052413	207053880	1467	734.0	
7858	chr1	207054388	207055142	754	377.0	
7859	chr1	207069172	207069393	221	110.0	
7860	chr1	207070784	207071797	1013	506.0	
7861	chr1	207077530	207078290	760	380.0	
7862	chr1	207084608	207085175	567	284.0	
7863	chr1	207089254	207089808	554	277.0	
7864	chr1	207134490	207135201	711	356.0	
7865	chr1	207145365	207145994	629	314.0	
7866	chr1	207155008	207155409	401	200.0	
7867	chr1	207156043	207156557	514	257.0	
7868	chr1	207172294	207173423	1129	564.0	
7869	chr1	207204905	207205615	710	355.0	
7870	chr1	207248721	207249418	697	348.0	
7871	chr1	207263052	207263198	146	73.0	
7872	chr1	207282145	207282254	109	54.0	
7873	chr1	207298156	207298626	470	235.0	
7874	chr1	207308406	207309134	728	364.0	
7875	chr1	207309832	207310299	467	234.0	
7876	chr1	207311245	207311657	412	206.0	
7877	chr1	207313097	207313450	353	176.0	
7878	chr1	207316529	207317285	756	378.0	
7879	chr1	207318854	207318932	78	39.0	
7880	chr1	207320587	207322904	2317	1158.0	
7881	chr1	207323446	207324541	1095	548.0	
7882	chr1	207325103	207325446	343	172.0	
7883	chr1	207326731	207331803	5072	2536.0	
7884	chr1	207332737	207337939	5202	2601.0	
7885	chr1	207340062	207340345	283	142.0	
7886	chr1	207342812	207342816	4	2.0	
7887	chr1	207343984	207344002	18	9.0	
7888	chr1	207344661	207345286	625	312.0	
7889	chr1	207345831	207348194	2363	1182.0	
7890	chr1	207349631	207349945	314	157.0	
7891	chr1	207363126	207363758	632	316.0	
7892	chr1	207404874	207405370	496	248.0	
7893	chr1	207407843	207408254	411	206.0	
7894	chr1	207414496	207415309	813	406.0	
7895	chr1	207418601	207418721	120	60.0	
7896	chr1	207453856	207455092	1236	618.0	
7897	chr1	207458954	207459462	508	254.0	
7898	chr1	207470893	207471321	428	214.0	
7899	chr1	207495277	207496812	1535	768.0	
7900	chr1	207497854	207498462	608	304.0	
7901	chr1	207499269	207499953	684	342.0	
7902	chr1	207579263	207579791	528	264.0	
7903	chr1	207620134	207620728	594	297.0	
7904	chr1	207644436	207645990	1554	777.0	
7905	chr1	207698871	207699259	388	194.0	
7906	chr1	207723948	207723981	33	16.0	
7907	chr1	207738370	207738771	401	200.0	
7908	chr1	207743148	207743549	401	200.0	
7909	chr1	207749102	207749541	439	220.0	
7910	chr1	207751403	207753231	1828	914.0	
7911	chr1	207754943	207755659	716	358.0	
7912	chr1	207797232	207797944	712	356.0	
7913	chr1	207798769	207799543	774	387.0	
7914	chr1	207805732	207806187	455	228.0	
7915	chr1	207806894	207808313	1419	710.0	
7916	chr1	207811823	207812290	467	234.0	
7917	chr1	207813164	207813526	362	181.0	
7918	chr1	207815827	207816667	840	420.0	
7919	chr1	207820824	207827257	6433	3216.0	
7920	chr1	207828143	207829152	1009	504.0	
7921	chr1	207831545	207832598	1053	526.0	
7922	chr1	207833128	207833829	701	350.0	
7923	chr1	207841301	207841692	391	196.0	
7924	chr1	207844312	207845225	913	456.0	
7925	chr1	207848098	207850038	1940	970.0	
7926	chr1	207850916	207852197	1281	640.0	
7927	chr1	207853200	207853375	175	88.0	
7928	chr1	207861633	207862249	616	308.0	
7929	chr1	207863671	207864710	1039	520.0	
7930	chr1	207866455	207869836	3381	1690.0	
7931	chr1	207870366	207870741	375	188.0	
7932	chr1	207872619	207873939	1320	660.0	
7933	chr1	207882704	207884205	1501	750.0	
7934	chr1	207884836	207885755	919	460.0	
7935	chr1	207890141	207890748	607	304.0	
7936	chr1	207958960	207959856	896	448.0	
7937	chr1	207962708	207964294	1586	793.0	
7938	chr1	207974055	207974607	552	276.0	
7939	chr1	207997758	207998202	444	222.0	
7940	chr1	208021737	208022256	519	260.0	
7941	chr1	208065859	208066351	492	246.0	
7942	chr1	208086390	208087193	803	402.0	
7943	chr1	208093779	208094667	888	444.0	
7944	chr1	208122657	208122961	304	152.0	
7945	chr1	208132121	208132561	440	220.0	
7946	chr1	208213808	208214194	386	193.0	
7947	chr1	208234698	208235082	384	192.0	
7948	chr1	208235992	208236677	685	342.0	
7949	chr1	208239018	208239469	451	226.0	
7950	chr1	208243067	208245733	2666	1333.0	
7951	chr1	208499066	208499370	304	152.0	
7952	chr1	208988668	208989205	537	268.0	
7953	chr1	209039287	209039906	619	310.0	
7954	chr1	209354333	209354654	321	160.0	
7955	chr1	209398491	209399123	632	316.0	
7956	chr1	209402738	209402999	261	130.0	
7957	chr1	209409163	209410073	910	455.0	
7958	chr1	209411316	209412093	777	388.0	
7959	chr1	209435673	209436088	415	208.0	
7960	chr1	209566007	209566505	498	249.0	
7961	chr1	209569411	209570059	648	324.0	
7962	chr1	209576632	209577159	527	264.0	
7963	chr1	209602000	209602473	473	236.0	
7964	chr1	209607267	209607896	629	314.0	
7965	chr1	209626258	209628093	1835	918.0	
7966	chr1	209633582	209633892	310	155.0	
7967	chr1	209648750	209651849	3099	1550.0	
7968	chr1	209656943	209657836	893	446.0	
7969	chr1	209659385	209660592	1207	604.0	
7970	chr1	209667710	209668196	486	243.0	
7971	chr1	209670659	209671130	471	236.0	
7972	chr1	209672815	209676230	3415	1708.0	
7973	chr1	209685893	209686351	458	229.0	
7974	chr1	209692638	209693534	896	448.0	
7975	chr1	209733574	209734290	716	358.0	
7976	chr1	209747318	209748929	1611	806.0	
7977	chr1	209749705	209750042	337	168.0	
7978	chr1	209751299	209752545	1246	623.0	
7979	chr1	209755421	209757572	2151	1076.0	
7980	chr1	209761258	209761327	69	34.0	
7981	chr1	209765875	209766494	619	310.0	
7982	chr1	209767448	209770490	3042	1521.0	
7983	chr1	209772115	209772511	396	198.0	
7984	chr1	209774609	209774933	324	162.0	
7985	chr1	209783498	209785347	1849	924.0	
7986	chr1	209805627	209806847	1220	610.0	
7987	chr1	209822990	209823702	712	356.0	
7988	chr1	209827277	209828690	1413	706.0	
7989	chr1	209860271	209860729	458	229.0	
7990	chr1	209937589	209937946	357	178.0	
7991	chr1	210250767	210251416	649	324.0	
7992	chr1	210310972	210311815	843	422.0	
7993	chr1	210328375	210329798	1423	712.0	
7994	chr1	210331986	210333357	1371	686.0	
7995	chr1	210340844	210341104	260	130.0	
7996	chr1	210343198	210343988	790	395.0	
7997	chr1	210347150	210347387	237	118.0	
7998	chr1	210360992	210361169	177	88.0	
7999	chr1	210373611	210375008	1397	698.0	
8000	chr1	210399528	210401016	1488	744.0	
8001	chr1	210407198	210407624	426	213.0	
8002	chr1	210446386	210446976	590	295.0	
8003	chr1	210582661	210582719	58	29.0	
8004	chr1	210584347	210584790	443	222.0	
8005	chr1	210597660	210598602	942	471.0	
8006	chr1	211133318	211134665	1347	674.0	
8007	chr1	211228718	211229767	1049	524.0	
8008	chr1	211257982	211261540	3558	1779.0	
8009	chr1	211323178	211323945	767	384.0	
8010	chr1	211326123	211330390	4267	2134.0	
8011	chr1	211333045	211333182	137	68.0	
8012	chr1	211334957	211336545	1588	794.0	
8013	chr1	211339581	211339938	357	178.0	
8014	chr1	211344172	211344623	451	226.0	
8015	chr1	211352840	211354428	1588	794.0	
8016	chr1	211381826	211383614	1788	894.0	
8017	chr1	211416130	211417462	1332	666.0	
8018	chr1	211470045	211470408	363	182.0	
8019	chr1	211476174	211476666	492	246.0	
8020	chr1	211513773	211516132	2359	1180.0	
8021	chr1	211551790	211551882	92	46.0	
8022	chr1	211577264	211580268	3004	1502.0	
8023	chr1	211582073	211582559	486	243.0	
8024	chr1	211583305	211583951	646	323.0	
8025	chr1	211587065	211587490	425	212.0	
8026	chr1	211590007	211590661	654	327.0	
8027	chr1	211597375	211597727	352	176.0	
8028	chr1	211605863	211607981	2118	1059.0	
8029	chr1	211610779	211611145	366	183.0	
8030	chr1	211612906	211614013	1107	554.0	
8031	chr1	211625003	211625507	504	252.0	
8032	chr1	211643442	211643792	350	175.0	
8033	chr1	211648962	211649374	412	206.0	
8034	chr1	211654963	211655670	707	354.0	
8035	chr1	211675028	211676368	1340	670.0	
8036	chr1	211677595	211678072	477	238.0	
8037	chr1	211680586	211681563	977	488.0	
8038	chr1	211687621	211688148	527	264.0	
8039	chr1	211695127	211695633	506	253.0	
8040	chr1	211697372	211699313	1941	970.0	
8041	chr1	211710841	211711172	331	166.0	
8042	chr1	211738603	211740578	1975	988.0	
8043	chr1	211815268	211816210	942	471.0	
8044	chr1	211822793	211823446	653	326.0	
8045	chr1	211827741	211828161	420	210.0	
8046	chr1	211829282	211831506	2224	1112.0	
8047	chr1	211833108	211833771	663	332.0	
8048	chr1	211842882	211843533	651	326.0	
8049	chr1	211890571	211890961	390	195.0	
8050	chr1	211895360	211895530	170	85.0	
8051	chr1	211908386	211908907	521	260.0	
8052	chr1	211910876	211911330	454	227.0	
8053	chr1	211928269	211929423	1154	577.0	
8054	chr1	211932200	211933324	1124	562.0	
8055	chr1	211935422	211935786	364	182.0	
8056	chr1	211936538	211936994	456	228.0	
8057	chr1	211938475	211939165	690	345.0	
8058	chr1	211951940	211952201	261	130.0	
8059	chr1	211965049	211965536	487	244.0	
8060	chr1	212011877	212012405	528	264.0	
8061	chr1	212034488	212036681	2193	1096.0	
8062	chr1	212037875	212038339	464	232.0	
8063	chr1	212040579	212041172	593	296.0	
8064	chr1	212062799	212063285	486	243.0	
8065	chr1	212070674	212071167	493	246.0	
8066	chr1	212089516	212089939	423	212.0	
8067	chr1	212125155	212125610	455	228.0	
8068	chr1	212131984	212132347	363	182.0	
8069	chr1	212158764	212159497	733	366.0	
8070	chr1	212162587	212162942	355	178.0	
8071	chr1	212186541	212187041	500	250.0	
8072	chr1	212225161	212226300	1139	570.0	
8073	chr1	212232101	212232232	131	66.0	
8074	chr1	212234435	212235404	969	484.0	
8075	chr1	212248982	212249590	608	304.0	
8076	chr1	212254684	212257152	2468	1234.0	
8077	chr1	212283682	212287283	3601	1800.0	
8078	chr1	212291233	212291956	723	362.0	
8079	chr1	212315860	212316348	488	244.0	
8080	chr1	212367750	212368419	669	334.0	
8081	chr1	212412347	212412759	412	206.0	
8082	chr1	212413868	212415915	2047	1024.0	
8083	chr1	212418707	212418828	121	60.0	
8084	chr1	212432420	212433697	1277	638.0	
8085	chr1	212455655	212456486	831	416.0	
8086	chr1	212457688	212458369	681	340.0	
8087	chr1	212468135	212468429	294	147.0	
8088	chr1	212476891	212478087	1196	598.0	
8089	chr1	212480646	212481530	884	442.0	
8090	chr1	212484738	212486804	2066	1033.0	
8091	chr1	212488226	212489296	1070	535.0	
8092	chr1	212491307	212491910	603	302.0	
8093	chr1	212495675	212496256	581	290.0	
8094	chr1	212513954	212515468	1514	757.0	
8095	chr1	212542597	212543413	816	408.0	
8096	chr1	212545857	212546414	557	278.0	
8097	chr1	212553731	212553991	260	130.0	
8098	chr1	212558045	212559674	1629	814.0	
8099	chr1	212565761	212567669	1908	954.0	
8100	chr1	212578100	212578138	38	19.0	
8101	chr1	212580108	212580456	348	174.0	
8102	chr1	212595626	212597003	1377	688.0	
8103	chr1	212604266	212627010	22744	11372.0	
8104	chr1	212629706	212630874	1168	584.0	
8105	chr1	212633215	212633641	426	213.0	
8106	chr1	212634807	212637443	2636	1318.0	
8107	chr1	212664948	212666019	1071	536.0	
8108	chr1	212667154	212668190	1036	518.0	
8109	chr1	212669068	212669502	434	217.0	
8110	chr1	212671091	212672084	993	496.0	
8111	chr1	212678536	212679159	623	312.0	
8112	chr1	212680977	212681476	499	250.0	
8113	chr1	212682703	212683915	1212	606.0	
8114	chr1	212698683	212703078	4395	2198.0	
8115	chr1	212727769	212728182	413	206.0	
8116	chr1	212749761	212750682	921	460.0	
8117	chr1	212752214	212753464	1250	625.0	
8118	chr1	212754128	212754774	646	323.0	
8119	chr1	212760100	212760559	459	230.0	
8120	chr1	212774555	212775028	473	236.0	
8121	chr1	212782361	212783267	906	453.0	
8122	chr1	212789756	212790238	482	241.0	
8123	chr1	212791209	212792660	1451	726.0	
8124	chr1	212794328	212795138	810	405.0	
8125	chr1	212819583	212820056	473	236.0	
8126	chr1	212831746	212832197	451	226.0	
8127	chr1	212857310	212859300	1990	995.0	
8128	chr1	212860068	212860469	401	200.0	
8129	chr1	212861010	212861020	10	5.0	
8130	chr1	212862079	212862528	449	224.0	
8131	chr1	212916631	212917034	403	202.0	
8132	chr1	212944194	212944674	480	240.0	
8133	chr1	212950204	212951081	877	438.0	
8134	chr1	212979488	212979848	360	180.0	
8135	chr1	212981727	212981989	262	131.0	
8136	chr1	212995422	212995920	498	249.0	
8137	chr1	213008549	213008941	392	196.0	
8138	chr1	213014799	213016467	1668	834.0	
8139	chr1	213050741	213052127	1386	693.0	
8140	chr1	213070328	213070870	542	271.0	
8141	chr1	213670193	213670895	702	351.0	
8142	chr1	213762039	213762476	437	218.0	
8143	chr1	213852091	213852606	515	258.0	
8144	chr1	213982995	213983207	212	106.0	
8145	chr1	213985443	213985515	72	36.0	
8146	chr1	213987561	213988356	795	398.0	
8147	chr1	213988897	213989320	423	212.0	
8148	chr1	214213938	214214420	482	241.0	
8149	chr1	214261244	214262125	881	440.0	
8150	chr1	214278425	214282327	3902	1951.0	
8151	chr1	214292290	214292723	433	216.0	
8152	chr1	214310043	214311203	1160	580.0	
8153	chr1	214328624	214329438	814	407.0	
8154	chr1	214331800	214332255	455	228.0	
8155	chr1	214332918	214333286	368	184.0	
8156	chr1	214362244	214362938	694	347.0	
8157	chr1	214427533	214428592	1059	530.0	
8158	chr1	214439434	214440028	594	297.0	
8159	chr1	214602542	214604397	1855	928.0	
8160	chr1	214628088	214628631	543	272.0	
8161	chr1	214631999	214632567	568	284.0	
8162	chr1	214637728	214638135	407	204.0	
8163	chr1	214640790	214641640	850	425.0	
8164	chr1	215530492	215531028	536	268.0	
8165	chr1	215543234	215543500	266	133.0	
8166	chr1	215566959	215568438	1479	740.0	
8167	chr1	216221228	216221536	308	154.0	
8168	chr1	216528957	216529210	253	126.0	
8169	chr1	217630417	217631949	1532	766.0	
8170	chr1	217673301	217673829	528	264.0	
8171	chr1	218284466	218285888	1422	711.0	
8172	chr1	218330004	218330464	460	230.0	
8173	chr1	218339474	218339595	121	60.0	
8174	chr1	218344903	218348076	3173	1586.0	
8175	chr1	218350074	218350329	255	128.0	
8176	chr1	218351120	218352176	1056	528.0	
8177	chr1	218377169	218377765	596	298.0	
8178	chr1	218463180	218464046	866	433.0	
8179	chr1	218468643	218469237	594	297.0	
8180	chr1	218473575	218474513	938	469.0	
8181	chr1	218498885	218499518	633	316.0	
8182	chr1	218521580	218521940	360	180.0	
8183	chr1	218874469	218874544	75	38.0	
8184	chr1	219086021	219086341	320	160.0	
8185	chr1	219088623	219089563	940	470.0	
8186	chr1	219090468	219091182	714	357.0	
8187	chr1	219120575	219121035	460	230.0	
8188	chr1	219144609	219145384	775	388.0	
8189	chr1	219173364	219175110	1746	873.0	
8190	chr1	219179287	219179704	417	208.0	
8191	chr1	219188277	219189585	1308	654.0	
8192	chr1	219204655	219204956	301	150.0	
8193	chr1	219236062	219236464	402	201.0	
8194	chr1	219416586	219417040	454	227.0	
8195	chr1	219460044	219462466	2422	1211.0	
8196	chr1	219568833	219569225	392	196.0	
8197	chr1	219582315	219582703	388	194.0	
8198	chr1	219587632	219588485	853	426.0	
8199	chr1	219660810	219661485	675	338.0	
8200	chr1	219907506	219907857	351	176.0	
8201	chr1	220037935	220038096	161	80.0	
8202	chr1	220044592	220047339	2747	1374.0	
8203	chr1	220056299	220056875	576	288.0	
8204	chr1	220086272	220086519	247	124.0	
8205	chr1	220089216	220090745	1529	764.0	
8206	chr1	220093668	220094968	1300	650.0	
8207	chr1	220113083	220113578	495	248.0	
8208	chr1	220137223	220137816	593	296.0	
8209	chr1	220271512	220273229	1717	858.0	
8210	chr1	220274328	220274782	454	227.0	
8211	chr1	220296236	220296644	408	204.0	
8212	chr1	220330230	220330732	502	251.0	
8213	chr1	220680052	220680477	425	212.0	
8214	chr1	220689830	220690932	1102	551.0	
8215	chr1	220702001	220702339	338	169.0	
8216	chr1	220711315	220711883	568	284.0	
8217	chr1	220732594	220733700	1106	553.0	
8218	chr1	220747930	220748894	964	482.0	
8219	chr1	220768120	220768680	560	280.0	
8220	chr1	220770749	220770979	230	115.0	
8221	chr1	220775283	220775608	325	162.0	
8222	chr1	220776644	220777160	516	258.0	
8223	chr1	220777943	220778688	745	372.0	
8224	chr1	220786127	220787573	1446	723.0	
8225	chr1	220789829	220790092	263	132.0	
8226	chr1	220803631	220804032	401	200.0	
8227	chr1	220810077	220810737	660	330.0	
8228	chr1	220874187	220874614	427	214.0	
8229	chr1	220876368	220883406	7038	3519.0	
8230	chr1	220887385	220888206	821	410.0	
8231	chr1	220891223	220891817	594	297.0	
8232	chr1	220893858	220894404	546	273.0	
8233	chr1	220914724	220915193	469	234.0	
8234	chr1	220926013	220926071	58	29.0	
8235	chr1	220928344	220928688	344	172.0	
8236	chr1	220957209	220957685	476	238.0	
8237	chr1	220961929	220962427	498	249.0	
8238	chr1	220999978	221001213	1235	618.0	
8239	chr1	221014333	221014668	335	168.0	
8240	chr1	221025415	221026389	974	487.0	
8241	chr1	221045803	221047087	1284	642.0	
8242	chr1	221069048	221070272	1224	612.0	
8243	chr1	221072194	221072595	401	200.0	
8244	chr1	221074314	221074824	510	255.0	
8245	chr1	221097523	221099571	2048	1024.0	
8246	chr1	221100507	221100967	460	230.0	
8247	chr1	221149162	221149494	332	166.0	
8248	chr1	221157326	221157804	478	239.0	
8249	chr1	221166576	221167792	1216	608.0	
8250	chr1	221172882	221173195	313	156.0	
8251	chr1	221174670	221174922	252	126.0	
8252	chr1	221183063	221183594	531	266.0	
8253	chr1	221188352	221188967	615	308.0	
8254	chr1	221203436	221203850	414	207.0	
8255	chr1	221435359	221435837	478	239.0	
8256	chr1	221439302	221440965	1663	832.0	
8257	chr1	221478010	221478459	449	224.0	
8258	chr1	221521637	221522069	432	216.0	
8259	chr1	221667486	221667863	377	188.0	
8260	chr1	221689141	221689617	476	238.0	
8261	chr1	221698562	221699498	936	468.0	
8262	chr1	221701794	221701898	104	52.0	
8263	chr1	221704203	221704925	722	361.0	
8264	chr1	221707858	221709817	1959	980.0	
8265	chr1	221710855	221713754	2899	1450.0	
8266	chr1	221714372	221714813	441	220.0	
8267	chr1	221715419	221716246	827	414.0	
8268	chr1	221716997	221717446	449	224.0	
8269	chr1	221719039	221719661	622	311.0	
8270	chr1	221721415	221722522	1107	554.0	
8271	chr1	221723153	221723384	231	116.0	
8272	chr1	221724687	221726749	2062	1031.0	
8273	chr1	221727308	221728465	1157	578.0	
8274	chr1	221732135	221732286	151	76.0	
8275	chr1	221732854	221735323	2469	1234.0	
8276	chr1	221736005	221736029	24	12.0	
8277	chr1	221736882	221744194	7312	3656.0	
8278	chr1	221751269	221751644	375	188.0	
8279	chr1	221754216	221755157	941	470.0	
8280	chr1	221768630	221769058	428	214.0	
8281	chr1	221776523	221779257	2734	1367.0	
8282	chr1	221780932	221781778	846	423.0	
8283	chr1	221783407	221784349	942	471.0	
8284	chr1	221793336	221794782	1446	723.0	
8285	chr1	221809158	221810083	925	462.0	
8286	chr1	221826798	221827396	598	299.0	
8287	chr1	221829266	221830207	941	470.0	
8288	chr1	221837813	221838405	592	296.0	
8289	chr1	221839485	221840404	919	460.0	
8290	chr1	221873939	221874002	63	32.0	
8291	chr1	221939555	221940004	449	224.0	
8292	chr1	221961669	221962126	457	228.0	
8293	chr1	221994109	221994591	482	241.0	
8294	chr1	222009076	222009513	437	218.0	
8295	chr1	222096105	222096584	479	240.0	
8296	chr1	222171080	222171209	129	64.0	
8297	chr1	222288028	222288485	457	228.0	
8298	chr1	222420357	222421228	871	436.0	
8299	chr1	222454795	222455846	1051	526.0	
8300	chr1	222464714	222466213	1499	750.0	
8301	chr1	222582953	222583647	694	347.0	
8302	chr1	222589147	222590609	1462	731.0	
8303	chr1	222617161	222619315	2154	1077.0	
8304	chr1	222633991	222634891	900	450.0	
8305	chr1	222643309	222645135	1826	913.0	
8306	chr1	222653590	222653887	297	148.0	
8307	chr1	222654567	222656068	1501	750.0	
8308	chr1	222711065	222714380	3315	1658.0	
8309	chr1	222732436	222732952	516	258.0	
8310	chr1	222738648	222739142	494	247.0	
8311	chr1	222750893	222751037	144	72.0	
8312	chr1	222772370	222773452	1082	541.0	
8313	chr1	222792780	222793071	291	146.0	
8314	chr1	222814210	222815704	1494	747.0	
8315	chr1	223081039	223081867	828	414.0	
8316	chr1	223090020	223090469	449	224.0	
8317	chr1	223111026	223111208	182	91.0	
8318	chr1	223123430	223124154	724	362.0	
8319	chr1	223129062	223129931	869	434.0	
8320	chr1	223133372	223134525	1153	576.0	
8321	chr1	223137218	223137859	641	320.0	
8322	chr1	223142156	223144562	2406	1203.0	
8323	chr1	223153528	223153529	1	0.0	
8324	chr1	223175287	223176153	866	433.0	
8325	chr1	223177638	223178389	751	376.0	
8326	chr1	223180468	223181648	1180	590.0	
8327	chr1	223190244	223190758	514	257.0	
8328	chr1	223198488	223199985	1497	748.0	
8329	chr1	223230065	223230855	790	395.0	
8330	chr1	223244713	223245208	495	248.0	
8331	chr1	223248366	223249460	1094	547.0	
8332	chr1	223301421	223301440	19	10.0	
8333	chr1	223363287	223365448	2161	1080.0	
8334	chr1	223515313	223515947	634	317.0	
8335	chr1	223531911	223532077	166	83.0	
8336	chr1	223550596	223550900	304	152.0	
8337	chr1	223621357	223621810	453	226.0	
8338	chr1	223628141	223628597	456	228.0	
8339	chr1	223679009	223679191	182	91.0	
8340	chr1	223684148	223684610	462	231.0	
8341	chr1	223696331	223696987	656	328.0	
8342	chr1	223697914	223698815	901	450.0	
8343	chr1	223704923	223705493	570	285.0	
8344	chr1	223711248	223711251	3	2.0	
8345	chr1	223711774	223718562	6788	3394.0	
8346	chr1	223722530	223723005	475	238.0	
8347	chr1	223726242	223727571	1329	664.0	
8348	chr1	223748356	223749739	1383	692.0	
8349	chr1	223765694	223765820	126	63.0	
8350	chr1	223775938	223776579	641	320.0	
8351	chr1	223811574	223812089	515	258.0	
8352	chr1	223824716	223827712	2996	1498.0	
8353	chr1	223831584	223836499	4915	2458.0	
8354	chr1	223842304	223843338	1034	517.0	
8355	chr1	223843898	223847121	3223	1612.0	
8356	chr1	223871083	223871746	663	332.0	
8357	chr1	223991995	223993686	1691	846.0	
8358	chr1	223999066	223999467	401	200.0	
8359	chr1	224004503	224004982	479	240.0	
8360	chr1	224050775	224051203	428	214.0	
8361	chr1	224106709	224107105	396	198.0	
8362	chr1	224113372	224116601	3229	1614.0	
8363	chr1	224168700	224169603	903	452.0	
8364	chr1	224170472	224171366	894	447.0	
8365	chr1	224175689	224175964	275	138.0	
8366	chr1	224181939	224184569	2630	1315.0	
8367	chr1	224196368	224196486	118	59.0	
8368	chr1	224203105	224203825	720	360.0	
8369	chr1	224204614	224205980	1366	683.0	
8370	chr1	224210342	224210706	364	182.0	
8371	chr1	224235699	224236220	521	260.0	
8372	chr1	224245057	224245834	777	388.0	
8373	chr1	224329459	224331000	1541	770.0	
8374	chr1	224333056	224333972	916	458.0	
8375	chr1	224340708	224341488	780	390.0	
8376	chr1	224356339	224358514	2175	1088.0	
8377	chr1	224377175	224378093	918	459.0	
8378	chr1	224378887	224380863	1976	988.0	
8379	chr1	224383488	224383606	118	59.0	
8380	chr1	224387255	224387666	411	206.0	
8381	chr1	224411771	224411984	213	106.0	
8382	chr1	224421633	224421928	295	148.0	
8383	chr1	224428833	224429076	243	122.0	
8384	chr1	224430436	224431735	1299	650.0	
8385	chr1	224432314	224435908	3594	1797.0	
8386	chr1	224456783	224458130	1347	674.0	
8387	chr1	224458998	224459215	217	108.0	
8388	chr1	224497592	224498975	1383	692.0	
8389	chr1	224503092	224504055	963	482.0	
8390	chr1	224513633	224514153	520	260.0	
8391	chr1	224542755	224543386	631	316.0	
8392	chr1	224564990	224565838	848	424.0	
8393	chr1	224592892	224593293	401	200.0	
8394	chr1	224615898	224618558	2660	1330.0	
8395	chr1	224623227	224624675	1448	724.0	
8396	chr1	224644517	224644991	474	237.0	
8397	chr1	224851526	224851838	312	156.0	
8398	chr1	225250347	225250967	620	310.0	
8399	chr1	225318987	225319331	344	172.0	
8400	chr1	225413976	225414367	391	196.0	
8401	chr1	225421967	225422528	561	280.0	
8402	chr1	225425144	225429477	4333	2166.0	
8403	chr1	225441594	225442198	604	302.0	
8404	chr1	225444273	225446017	1744	872.0	
8405	chr1	225447506	225447801	295	148.0	
8406	chr1	225450432	225451127	695	348.0	
8407	chr1	225454449	225455317	868	434.0	
8408	chr1	225458102	225458631	529	264.0	
8409	chr1	225460201	225461426	1225	612.0	
8410	chr1	225466750	225468748	1998	999.0	
8411	chr1	225473186	225473633	447	224.0	
8412	chr1	225474669	225475731	1062	531.0	
8413	chr1	225477716	225478428	712	356.0	
8414	chr1	225480616	225481312	696	348.0	
8415	chr1	225652466	225654221	1755	878.0	
8416	chr1	225660625	225660977	352	176.0	
8417	chr1	225712260	225713017	757	378.0	
8418	chr1	225723249	225723680	431	216.0	
8419	chr1	225772192	225772729	537	268.0	
8420	chr1	225776976	225779383	2407	1204.0	
8421	chr1	225780799	225781070	271	136.0	
8422	chr1	225809622	225811105	1483	742.0	
8423	chr1	225813167	225814040	873	436.0	
8424	chr1	225839525	225839622	97	48.0	
8425	chr1	225842061	225842741	680	340.0	
8426	chr1	225843300	225846497	3197	1598.0	
8427	chr1	225847798	225849035	1237	618.0	
8428	chr1	225849649	225850669	1020	510.0	
8429	chr1	225851743	225852640	897	448.0	
8430	chr1	225855622	225856400	778	389.0	
8431	chr1	225865618	225866870	1252	626.0	
8432	chr1	225872068	225872113	45	22.0	
8433	chr1	225875834	225875853	19	10.0	
8434	chr1	225877656	225878077	421	210.0	
8435	chr1	225878830	225883644	4814	2407.0	
8436	chr1	225885390	225885703	313	156.0	
8437	chr1	225896795	225898918	2123	1062.0	
8438	chr1	225911049	225911957	908	454.0	
8439	chr1	225919997	225920294	297	148.0	
8440	chr1	225923328	225925134	1806	903.0	
8441	chr1	225926827	225927031	204	102.0	
8442	chr1	225928847	225929183	336	168.0	
8443	chr1	225944667	225945368	701	350.0	
8444	chr1	225951044	225951445	401	200.0	
8445	chr1	225962317	225962805	488	244.0	
8446	chr1	225974514	225974732	218	109.0	
8447	chr1	225975686	225976603	917	458.0	
8448	chr1	225977895	225978829	934	467.0	
8449	chr1	225987440	225988192	752	376.0	
8450	chr1	225990686	225991469	783	392.0	
8451	chr1	225996004	225996054	50	25.0	
8452	chr1	225996930	225997333	403	202.0	
8453	chr1	225998048	226003205	5157	2578.0	
8454	chr1	226004388	226004828	440	220.0	
8455	chr1	226028733	226029658	925	462.0	
8456	chr1	226032022	226032683	661	330.0	
8457	chr1	226033432	226035138	1706	853.0	
8458	chr1	226042452	226043207	755	378.0	
8459	chr1	226043898	226044075	177	88.0	
8460	chr1	226051313	226051824	511	256.0	
8461	chr1	226061339	226065467	4128	2064.0	
8462	chr1	226066678	226069200	2522	1261.0	
8463	chr1	226069775	226071060	1285	642.0	
8464	chr1	226072935	226077527	4592	2296.0	
8465	chr1	226082582	226084327	1745	872.0	
8466	chr1	226085844	226086229	385	192.0	
8467	chr1	226099451	226101495	2044	1022.0	
8468	chr1	226107803	226108250	447	224.0	
8469	chr1	226109369	226111906	2537	1268.0	
8470	chr1	226119121	226119625	504	252.0	
8471	chr1	226120996	226125795	4799	2400.0	
8472	chr1	226127455	226128397	942	471.0	
8473	chr1	226132537	226132538	1	0.0	
8474	chr1	226181926	226182699	773	386.0	
8475	chr1	226185390	226187326	1936	968.0	
8476	chr1	226196909	226197462	553	276.0	
8477	chr1	226223494	226224333	839	420.0	
8478	chr1	226248116	226248399	283	142.0	
8479	chr1	226279613	226279900	287	144.0	
8480	chr1	226308210	226310064	1854	927.0	
8481	chr1	226310670	226310898	228	114.0	
8482	chr1	226333301	226333857	556	278.0	
8483	chr1	226405406	226408947	3541	1770.0	
8484	chr1	226424468	226426160	1692	846.0	
8485	chr1	226436778	226437365	587	294.0	
8486	chr1	226444725	226445480	755	378.0	
8487	chr1	226457142	226457900	758	379.0	
8488	chr1	226486277	226486533	256	128.0	
8489	chr1	226547643	226550626	2983	1492.0	
8490	chr1	226608642	226609164	522	261.0	
8491	chr1	226626051	226628289	2238	1119.0	
8492	chr1	226633034	226636952	3918	1959.0	
8493	chr1	226643003	226645611	2608	1304.0	
8494	chr1	226649754	226650682	928	464.0	
8495	chr1	226652853	226657038	4185	2092.0	
8496	chr1	226659235	226659236	1	0.0	
8497	chr1	226660181	226664225	4044	2022.0	
8498	chr1	226665380	226666172	792	396.0	
8499	chr1	226674380	226684441	10061	5030.0	
8500	chr1	226687220	226688816	1596	798.0	
8501	chr1	226690282	226691923	1641	820.0	
8502	chr1	226694624	226694694	70	35.0	
8503	chr1	226696991	226698167	1176	588.0	
8504	chr1	226701868	226704198	2330	1165.0	
8505	chr1	226708479	226714792	6313	3156.0	
8506	chr1	226716929	226718006	1077	538.0	
8507	chr1	226719614	226720258	644	322.0	
8508	chr1	226721410	226721680	270	135.0	
8509	chr1	226722238	226725862	3624	1812.0	
8510	chr1	226726643	226741467	14824	7412.0	
8511	chr1	226764982	226765457	475	238.0	
8512	chr1	226772838	226772859	21	10.0	
8513	chr1	226798247	226799624	1377	688.0	
8514	chr1	226823708	226824061	353	176.0	
8515	chr1	226827478	226828560	1082	541.0	
8516	chr1	226870020	226871347	1327	664.0	
8517	chr1	226882238	226883470	1232	616.0	
8518	chr1	226884255	226884494	239	120.0	
8519	chr1	226892287	226892333	46	23.0	
8520	chr1	226912610	226912975	365	182.0	
8521	chr1	226937874	226941090	3216	1608.0	
8522	chr1	226964051	226964461	410	205.0	
8523	chr1	226989560	226990528	968	484.0	
8524	chr1	227317965	227319010	1045	522.0	
8525	chr1	227481470	227481946	476	238.0	
8526	chr1	227540512	227541078	566	283.0	
8527	chr1	227541713	227543406	1693	846.0	
8528	chr1	227558972	227559373	401	200.0	
8529	chr1	227560841	227561210	369	184.0	
8530	chr1	227562412	227564404	1992	996.0	
8531	chr1	227727894	227730981	3087	1544.0	
8532	chr1	227734454	227736552	2098	1049.0	
8533	chr1	227748501	227748878	377	188.0	
8534	chr1	227762124	227763447	1323	662.0	
8535	chr1	227765789	227767220	1431	716.0	
8536	chr1	227773877	227774932	1055	528.0	
8537	chr1	227785403	227785872	469	234.0	
8538	chr1	227786918	227789931	3013	1506.0	
8539	chr1	227791150	227791371	221	110.0	
8540	chr1	227816917	227817483	566	283.0	
8541	chr1	227844527	227844592	65	32.0	
8542	chr1	227885297	227886061	764	382.0	
8543	chr1	227886931	227888424	1493	746.0	
8544	chr1	227902251	227902505	254	127.0	
8545	chr1	227934737	227935420	683	342.0	
8546	chr1	227946504	227948477	1973	986.0	
8547	chr1	227953707	227954334	627	314.0	
8548	chr1	227999230	227999827	597	298.0	
8549	chr1	228004291	228004683	392	196.0	
8550	chr1	228009632	228009822	190	95.0	
8551	chr1	228037730	228038094	364	182.0	
8552	chr1	228058411	228061137	2726	1363.0	
8553	chr1	228071855	228072389	534	267.0	
8554	chr1	228074121	228074258	137	68.0	
8555	chr1	228081214	228087031	5817	2908.0	
8556	chr1	228087544	228091519	3975	1988.0	
8557	chr1	228092305	228094799	2494	1247.0	
8558	chr1	228096025	228097986	1961	980.0	
8559	chr1	228098555	228105779	7224	3612.0	
8560	chr1	228107708	228107718	10	5.0	
8561	chr1	228108237	228110451	2214	1107.0	
8562	chr1	228121064	228121633	569	284.0	
8563	chr1	228130555	228131637	1082	541.0	
8564	chr1	228136664	228138795	2131	1066.0	
8565	chr1	228139320	228153351	14031	7016.0	
8566	chr1	228154302	228157864	3562	1781.0	
8567	chr1	228159270	228159673	403	202.0	
8568	chr1	228160204	228160468	264	132.0	
8569	chr1	228162176	228163500	1324	662.0	
8570	chr1	228164065	228167144	3079	1540.0	
8571	chr1	228169356	228169853	497	248.0	
8572	chr1	228172511	228172726	215	108.0	
8573	chr1	228173403	228174970	1567	784.0	
8574	chr1	228180272	228180661	389	194.0	
8575	chr1	228182148	228182896	748	374.0	
8576	chr1	228185441	228186165	724	362.0	
8577	chr1	228210903	228211142	239	120.0	
8578	chr1	228212561	228214591	2030	1015.0	
8579	chr1	228215815	228215902	87	44.0	
8580	chr1	228228717	228229055	338	169.0	
8581	chr1	228275136	228276836	1700	850.0	
8582	chr1	228378208	228379116	908	454.0	
8583	chr1	228404180	228404591	411	206.0	
8584	chr1	228405287	228409213	3926	1963.0	
8585	chr1	228415897	228417276	1379	690.0	
8586	chr1	228445540	228446414	874	437.0	
8587	chr1	228452182	228452980	798	399.0	
8588	chr1	228453630	228453766	136	68.0	
8589	chr1	228456920	228459656	2736	1368.0	
8590	chr1	228463405	228466165	2760	1380.0	
8591	chr1	228471727	228472276	549	274.0	
8592	chr1	228478816	228479772	956	478.0	
8593	chr1	228485000	228485466	466	233.0	
8594	chr1	228486127	228488699	2572	1286.0	
8595	chr1	228500156	228501809	1653	826.0	
8596	chr1	228515215	228515685	470	235.0	
8597	chr1	228555604	228556047	443	222.0	
8598	chr1	228635378	228635794	416	208.0	
8599	chr1	228646435	228648525	2090	1045.0	
8600	chr1	228664314	228664863	549	274.0	
8601	chr1	228697314	228697603	289	144.0	
8602	chr1	228734692	228736753	2061	1030.0	
8603	chr1	228737483	228737874	391	196.0	
8604	chr1	228742481	228742753	272	136.0	
8605	chr1	228748607	228748804	197	98.0	
8606	chr1	228751640	228751993	353	176.0	
8607	chr1	228765523	228766053	530	265.0	
8608	chr1	228772834	228772898	64	32.0	
8609	chr1	228778956	228779345	389	194.0	
8610	chr1	228794078	228794704	626	313.0	
8611	chr1	228799945	228800317	372	186.0	
8612	chr1	228804843	228805122	279	140.0	
8613	chr1	228809729	228810177	448	224.0	
8614	chr1	228811179	228811572	393	196.0	
8615	chr1	228826131	228827435	1304	652.0	
8616	chr1	228837958	228838889	931	466.0	
8617	chr1	228842269	228842402	133	66.0	
8618	chr1	228850426	228851081	655	328.0	
8619	chr1	228852100	228852457	357	178.0	
8620	chr1	228864383	228864744	361	180.0	
8621	chr1	228898442	228898948	506	253.0	
8622	chr1	228921389	228921941	552	276.0	
8623	chr1	228936172	228936533	361	180.0	
8624	chr1	228938161	228939025	864	432.0	
8625	chr1	228940885	228942047	1162	581.0	
8626	chr1	228944984	228945387	403	202.0	
8627	chr1	228960693	228961100	407	204.0	
8628	chr1	228979354	228979755	401	200.0	
8629	chr1	228982712	228982978	266	133.0	
8630	chr1	228986237	228986747	510	255.0	
8631	chr1	228989985	228991370	1385	692.0	
8632	chr1	228995214	228995607	393	196.0	
8633	chr1	229008378	229008661	283	142.0	
8634	chr1	229017152	229017155	3	2.0	
8635	chr1	229023519	229025080	1561	780.0	
8636	chr1	229027275	229028282	1007	504.0	
8637	chr1	229035477	229035780	303	152.0	
8638	chr1	229043122	229043552	430	215.0	
8639	chr1	229058009	229059006	997	498.0	
8640	chr1	229068005	229069058	1053	526.0	
8641	chr1	229070119	229070626	507	254.0	
8642	chr1	229109424	229109764	340	170.0	
8643	chr1	229117861	229118249	388	194.0	
8644	chr1	229127228	229127685	457	228.0	
8645	chr1	229129232	229130687	1455	728.0	
8646	chr1	229133612	229134403	791	396.0	
8647	chr1	229136855	229137644	789	394.0	
8648	chr1	229139616	229139625	9	4.0	
8649	chr1	229155320	229156008	688	344.0	
8650	chr1	229157072	229157196	124	62.0	
8651	chr1	229158088	229159285	1197	598.0	
8652	chr1	229160127	229160558	431	216.0	
8653	chr1	229165078	229165686	608	304.0	
8654	chr1	229191937	229192519	582	291.0	
8655	chr1	229193503	229194006	503	252.0	
8656	chr1	229197358	229197481	123	62.0	
8657	chr1	229199500	229200338	838	419.0	
8658	chr1	229227191	229227936	745	372.0	
8659	chr1	229229434	229230618	1184	592.0	
8660	chr1	229250047	229250824	777	388.0	
8661	chr1	229253004	229254048	1044	522.0	
8662	chr1	229254818	229255318	500	250.0	
8663	chr1	229257942	229258934	992	496.0	
8664	chr1	229270287	229273206	2919	1460.0	
8665	chr1	229273826	229274197	371	186.0	
8666	chr1	229325377	229326896	1519	760.0	
8667	chr1	229327656	229328216	560	280.0	
8668	chr1	229328754	229328766	12	6.0	
8669	chr1	229337962	229338720	758	379.0	
8670	chr1	229339522	229339893	371	186.0	
8671	chr1	229341217	229344180	2963	1482.0	
8672	chr1	229347575	229347818	243	122.0	
8673	chr1	229365735	229365863	128	64.0	
8674	chr1	229411181	229411210	29	14.0	
8675	chr1	229430784	229431148	364	182.0	
8676	chr1	229478870	229479185	315	158.0	
8677	chr1	229480037	229480929	892	446.0	
8678	chr1	229481960	229482419	459	230.0	
8679	chr1	229507577	229509214	1637	818.0	
8680	chr1	229514470	229515120	650	325.0	
8681	chr1	229557404	229559809	2405	1202.0	
8682	chr1	229567432	229567562	130	65.0	
8683	chr1	229578742	229579568	826	413.0	
8684	chr1	229581899	229582505	606	303.0	
8685	chr1	229624714	229626991	2277	1138.0	
8686	chr1	229644228	229644668	440	220.0	
8687	chr1	229661190	229661741	551	276.0	
8688	chr1	229664074	229664604	530	265.0	
8689	chr1	229692490	229692522	32	16.0	
8690	chr1	229855958	229856697	739	370.0	
8691	chr1	230002359	230002845	486	243.0	
8692	chr1	230004036	230004917	881	440.0	
8693	chr1	230031028	230031660	632	316.0	
8694	chr1	230066261	230069284	3023	1512.0	
8695	chr1	230084529	230084698	169	84.0	
8696	chr1	230104571	230106272	1701	850.0	
8697	chr1	230109831	230110332	501	250.0	
8698	chr1	230112144	230112858	714	357.0	
8699	chr1	230120875	230121225	350	175.0	
8700	chr1	230123261	230124184	923	462.0	
8701	chr1	230124804	230124930	126	63.0	
8702	chr1	230126814	230127448	634	317.0	
8703	chr1	230140460	230140549	89	44.0	
8704	chr1	230145688	230146761	1073	536.0	
8705	chr1	230149849	230150896	1047	524.0	
8706	chr1	230153554	230154548	994	497.0	
8707	chr1	230160932	230161401	469	234.0	
8708	chr1	230167283	230167968	685	342.0	
8709	chr1	230169671	230170199	528	264.0	
8710	chr1	230176988	230177166	178	89.0	
8711	chr1	230187038	230187164	126	63.0	
8712	chr1	230191008	230191740	732	366.0	
8713	chr1	230208683	230209299	616	308.0	
8714	chr1	230212314	230213061	747	374.0	
8715	chr1	230268911	230269181	270	135.0	
8716	chr1	230270617	230270638	21	10.0	
8717	chr1	230274453	230274516	63	32.0	
8718	chr1	230291572	230292162	590	295.0	
8719	chr1	230306223	230306522	299	150.0	
8720	chr1	230310513	230310982	469	234.0	
8721	chr1	230426062	230426956	894	447.0	
8722	chr1	230458459	230458943	484	242.0	
8723	chr1	230459528	230459780	252	126.0	
8724	chr1	230508061	230508258	197	98.0	
8725	chr1	230509372	230510169	797	398.0	
8726	chr1	230570995	230571382	387	194.0	
8727	chr1	230573675	230574147	472	236.0	
8728	chr1	230632289	230632629	340	170.0	
8729	chr1	230641743	230643367	1624	812.0	
8730	chr1	230753669	230754381	712	356.0	enhancer
8731	chr1	230863487	230863653	166	83.0	
8732	chr1	230867555	230869390	1835	918.0	
8733	chr1	230917159	230918016	857	428.0	
8734	chr1	230972412	230973577	1165	582.0	
8735	chr1	230976726	230980321	3595	1798.0	
8736	chr1	231020192	231020829	637	318.0	
8737	chr1	231028547	231029000	453	226.0	
8738	chr1	231036315	231036826	511	256.0	
8739	chr1	231039018	231042337	3319	1660.0	
8740	chr1	231049408	231049715	307	154.0	
8741	chr1	231053377	231054254	877	438.0	
8742	chr1	231091931	231092303	372	186.0	
8743	chr1	231108656	231108715	59	30.0	
8744	chr1	231162213	231162548	335	168.0	
8745	chr1	231211119	231212010	891	446.0	
8746	chr1	231214990	231215365	375	188.0	
8747	chr1	231240385	231242982	2597	1298.0	
8748	chr1	231315767	231316237	470	235.0	
8749	chr1	231336672	231339637	2965	1482.0	
8750	chr1	231357718	231358487	769	384.0	
8751	chr1	231359057	231359543	486	243.0	
8752	chr1	231383523	231383949	426	213.0	
8753	chr1	231390917	231391262	345	172.0	
8754	chr1	231410297	231410686	389	194.0	
8755	chr1	231419766	231423078	3312	1656.0	
8756	chr1	231460512	231461095	583	292.0	
8757	chr1	231493853	231493895	42	21.0	
8758	chr1	231515533	231516289	756	378.0	
8759	chr1	231523735	231524273	538	269.0	
8760	chr1	231527709	231530728	3019	1510.0	
8761	chr1	231550334	231550746	412	206.0	
8762	chr1	231590508	231591073	565	282.0	
8763	chr1	231603519	231604418	899	450.0	
8764	chr1	231605431	231605775	344	172.0	
8765	chr1	231610517	231610519	2	1.0	
8766	chr1	231611930	231614153	2223	1112.0	
8767	chr1	231625853	231629589	3736	1868.0	
8768	chr1	231651701	231652213	512	256.0	
8769	chr1	231663161	231663732	571	286.0	
8770	chr1	231665778	231666111	333	166.0	
8771	chr1	231690035	231690458	423	212.0	
8772	chr1	231699695	231700154	459	230.0	
8773	chr1	231725123	231725594	471	236.0	
8774	chr1	231750832	231751709	877	438.0	
8775	chr1	231756740	231757446	706	353.0	
8776	chr1	231774765	231775515	750	375.0	
8777	chr1	231776593	231776848	255	128.0	
8778	chr1	231777972	231778750	778	389.0	
8779	chr1	231781676	231782412	736	368.0	
8780	chr1	231803269	231804263	994	497.0	
8781	chr1	231806447	231807119	672	336.0	
8782	chr1	231808906	231809434	528	264.0	
8783	chr1	231845100	231845408	308	154.0	
8784	chr1	231866645	231867088	443	222.0	
8785	chr1	231869360	231869824	464	232.0	
8786	chr1	231918542	231919073	531	266.0	
8787	chr1	231919772	231920218	446	223.0	
8788	chr1	231970647	231971799	1152	576.0	
8789	chr1	231973842	231974141	299	150.0	
8790	chr1	231990366	231990910	544	272.0	
8791	chr1	232335250	232335773	523	262.0	
8792	chr1	232457541	232458061	520	260.0	
8793	chr1	232459081	232459467	386	193.0	
8794	chr1	232528569	232529189	620	310.0	
8795	chr1	232578634	232579277	643	322.0	
8796	chr1	232580345	232580607	262	131.0	
8797	chr1	232589745	232591167	1422	711.0	
8798	chr1	232596894	232597295	401	200.0	
8799	chr1	232599811	232600768	957	478.0	
8800	chr1	232607953	232608227	274	137.0	
8801	chr1	232610830	232611392	562	281.0	
8802	chr1	232620201	232621509	1308	654.0	
8803	chr1	232624647	232625039	392	196.0	
8804	chr1	232627547	232628261	714	357.0	
8805	chr1	232629187	232631271	2084	1042.0	
8806	chr1	232634003	232634652	649	324.0	
8807	chr1	232635711	232636193	482	241.0	
8808	chr1	232704725	232705190	465	232.0	
8809	chr1	232720024	232720529	505	252.0	
8810	chr1	232726127	232726137	10	5.0	
8811	chr1	232765767	232765937	170	85.0	
8812	chr1	232767313	232768031	718	359.0	
8813	chr1	232793876	232794203	327	164.0	
8814	chr1	232805080	232806320	1240	620.0	
8815	chr1	232923634	232924634	1000	500.0	
8816	chr1	232932773	232932949	176	88.0	
8817	chr1	232937896	232938342	446	223.0	
8818	chr1	232944182	232944800	618	309.0	
8819	chr1	232950019	232951763	1744	872.0	
8820	chr1	232952869	232953352	483	242.0	
8821	chr1	232963452	232963737	285	142.0	
8822	chr1	232977972	232978432	460	230.0	
8823	chr1	233082832	233083146	314	157.0	
8824	chr1	233105469	233105607	138	69.0	
8825	chr1	233108015	233108409	394	197.0	
8826	chr1	233112744	233115359	2615	1308.0	
8827	chr1	233179688	233179976	288	144.0	
8828	chr1	233241039	233241502	463	232.0	
8829	chr1	233242777	233243267	490	245.0	
8830	chr1	233252351	233252803	452	226.0	
8831	chr1	233277600	233277999	399	200.0	
8832	chr1	233278663	233278973	310	155.0	
8833	chr1	233281792	233282609	817	408.0	
8834	chr1	233290640	233291898	1258	629.0	
8835	chr1	233294803	233296124	1321	660.0	
8836	chr1	233304468	233304898	430	215.0	
8837	chr1	233326758	233329067	2309	1154.0	
8838	chr1	233356411	233356813	402	201.0	
8839	chr1	233394890	233395257	367	184.0	
8840	chr1	233511221	233511532	311	156.0	
8841	chr1	233791124	233791449	325	162.0	
8842	chr1	234065866	234066175	309	154.0	
8843	chr1	234114649	234114987	338	169.0	
8844	chr1	234154682	234155025	343	172.0	
8845	chr1	234212752	234214561	1809	904.0	
8846	chr1	234244487	234244849	362	181.0	
8847	chr1	234302306	234302854	548	274.0	
8848	chr1	234309681	234310419	738	369.0	
8849	chr1	234322960	234323414	454	227.0	
8850	chr1	234325925	234327225	1300	650.0	
8851	chr1	234329955	234332537	2582	1291.0	
8852	chr1	234356509	234357304	795	398.0	
8853	chr1	234368727	234368854	127	64.0	
8854	chr1	234372802	234374577	1775	888.0	
8855	chr1	234395350	234395631	281	140.0	
8856	chr1	234398809	234399473	664	332.0	
8857	chr1	234400688	234401266	578	289.0	
8858	chr1	234408626	234409768	1142	571.0	
8859	chr1	234476194	234476567	373	186.0	
8860	chr1	234477795	234479634	1839	920.0	
8861	chr1	234486913	234487365	452	226.0	
8862	chr1	234498633	234501407	2774	1387.0	
8863	chr1	234512300	234513162	862	431.0	
8864	chr1	234518068	234518531	463	232.0	
8865	chr1	234522354	234524136	1782	891.0	
8866	chr1	234525313	234525860	547	274.0	
8867	chr1	234528506	234528951	445	222.0	
8868	chr1	234529711	234529989	278	139.0	
8869	chr1	234532349	234533066	717	358.0	
8870	chr1	234579946	234580377	431	216.0	
8871	chr1	234597697	234598408	711	356.0	
8872	chr1	234599080	234603211	4131	2066.0	
8873	chr1	234603789	234613966	10177	5088.0	
8874	chr1	234618981	234620884	1903	952.0	
8875	chr1	234645225	234646224	999	500.0	
8876	chr1	234656811	234657840	1029	514.0	
8877	chr1	234663229	234663755	526	263.0	
8878	chr1	234675966	234676661	695	348.0	
8879	chr1	234684112	234684660	548	274.0	
8880	chr1	234691641	234691958	317	158.0	
8881	chr1	234700168	234700582	414	207.0	
8882	chr1	234705692	234705932	240	120.0	
8883	chr1	234707553	234708014	461	230.0	
8884	chr1	234723110	234725956	2846	1423.0	
8885	chr1	234727129	234727413	284	142.0	
8886	chr1	234730486	234732236	1750	875.0	
8887	chr1	234748050	234748398	348	174.0	
8888	chr1	234755346	234755860	514	257.0	
8889	chr1	234758617	234759736	1119	560.0	
8890	chr1	234768126	234769121	995	498.0	
8891	chr1	234771480	234773265	1785	892.0	
8892	chr1	234774875	234776192	1317	658.0	
8893	chr1	234777048	234779158	2110	1055.0	
8894	chr1	234780625	234781763	1138	569.0	
8895	chr1	234836196	234836902	706	353.0	
8896	chr1	234840832	234843722	2890	1445.0	
8897	chr1	234844412	234845960	1548	774.0	
8898	chr1	234849034	234850330	1296	648.0	
8899	chr1	234851299	234852132	833	416.0	
8900	chr1	234854120	234854691	571	286.0	
8901	chr1	234863110	234863440	330	165.0	
8902	chr1	234866025	234867553	1528	764.0	
8903	chr1	234874348	234874970	622	311.0	
8904	chr1	234876199	234877097	898	449.0	
8905	chr1	234881242	234881693	451	226.0	
8906	chr1	234911510	234912378	868	434.0	
8907	chr1	234918264	234918591	327	164.0	
8908	chr1	234925896	234927514	1618	809.0	
8909	chr1	234932954	234935103	2149	1074.0	
8910	chr1	234943110	234943582	472	236.0	
8911	chr1	234944843	234945433	590	295.0	
8912	chr1	234954859	234955890	1031	516.0	
8913	chr1	234958973	234960106	1133	566.0	
8914	chr1	234960666	234965633	4967	2484.0	
8915	chr1	234969177	234969284	107	54.0	
8916	chr1	234969993	234972802	2809	1404.0	
8917	chr1	234974972	234981539	6567	3284.0	
8918	chr1	234984174	234984995	821	410.0	
8919	chr1	234986965	234986987	22	11.0	
8920	chr1	234987578	234987993	415	208.0	
8921	chr1	235006366	235006722	356	178.0	
8922	chr1	235010932	235013848	2916	1458.0	
8923	chr1	235015571	235016167	596	298.0	
8924	chr1	235040777	235041602	825	412.0	
8925	chr1	235043265	235043666	401	200.0	
8926	chr1	235048000	235048563	563	282.0	
8927	chr1	235052357	235052707	350	175.0	
8928	chr1	235079974	235080318	344	172.0	
8929	chr1	235083085	235084193	1108	554.0	
8930	chr1	235093531	235094453	922	461.0	
8931	chr1	235102760	235105863	3103	1552.0	
8932	chr1	235127330	235129585	2255	1128.0	
8933	chr1	235160325	235162144	1819	910.0	
8934	chr1	235206775	235207642	867	434.0	
8935	chr1	235253083	235253636	553	276.0	
8936	chr1	235259203	235259792	589	294.0	
8937	chr1	235270614	235271348	734	367.0	
8938	chr1	235275121	235275766	645	322.0	
8939	chr1	235277909	235278157	248	124.0	
8940	chr1	235285931	235287273	1342	671.0	
8941	chr1	235296674	235298258	1584	792.0	
8942	chr1	235298871	235300045	1174	587.0	
8943	chr1	235304408	235305788	1380	690.0	
8944	chr1	235312746	235313698	952	476.0	
8945	chr1	235317234	235317549	315	158.0	
8946	chr1	235319176	235319297	121	60.0	
8947	chr1	235320230	235322368	2138	1069.0	
8948	chr1	235325281	235325682	401	200.0	
8949	chr1	235326406	235330654	4248	2124.0	
8950	chr1	235331514	235331905	391	196.0	
8951	chr1	235336832	235337381	549	274.0	
8952	chr1	235339801	235340046	245	122.0	
8953	chr1	235366745	235368150	1405	702.0	
8954	chr1	235411524	235412151	627	314.0	
8955	chr1	235415259	235415749	490	245.0	
8956	chr1	235416973	235417559	586	293.0	
8957	chr1	235423093	235423736	643	322.0	
8958	chr1	235492847	235493158	311	156.0	
8959	chr1	235502876	235506025	3149	1574.0	
8960	chr1	235513530	235514192	662	331.0	
8961	chr1	235546233	235546784	551	276.0	
8962	chr1	235567855	235568146	291	146.0	
8963	chr1	235641599	235643375	1776	888.0	
8964	chr1	235648500	235651179	2679	1340.0	
8965	chr1	235697556	235697898	342	171.0	
8966	chr1	235764003	235764350	347	174.0	
8967	chr1	235767845	235768194	349	174.0	
8968	chr1	235817388	235817761	373	186.0	
8969	chr1	235831042	235831542	500	250.0	
8970	chr1	235835324	235835607	283	142.0	
8971	chr1	235837991	235838410	419	210.0	
8972	chr1	235842109	235842631	522	261.0	
8973	chr1	235843331	235843833	502	251.0	
8974	chr1	235845561	235846156	595	298.0	
8975	chr1	235847992	235848772	780	390.0	
8976	chr1	235849386	235849779	393	196.0	
8977	chr1	235851960	235852422	462	231.0	
8978	chr1	235854411	235854434	23	12.0	
8979	chr1	235855815	235856413	598	299.0	
8980	chr1	235858891	235859300	409	204.0	
8981	chr1	235862311	235868746	6435	3218.0	
8982	chr1	235872704	235873709	1005	502.0	
8983	chr1	235875268	235875475	207	104.0	
8984	chr1	235876249	235877143	894	447.0	
8985	chr1	235878222	235878833	611	306.0	
8986	chr1	235879461	235880732	1271	636.0	
8987	chr1	235883465	235884029	564	282.0	
8988	chr1	235885918	235886240	322	161.0	
8989	chr1	235887573	235888799	1226	613.0	
8990	chr1	235892621	235893596	975	488.0	
8991	chr1	235900294	235901043	749	374.0	
8992	chr1	235908850	235909009	159	80.0	
8993	chr1	235917073	235917983	910	455.0	
8994	chr1	235919151	235920433	1282	641.0	
8995	chr1	235923385	235923963	578	289.0	
8996	chr1	235932014	235932655	641	320.0	
8997	chr1	235933353	235934013	660	330.0	
8998	chr1	235937225	235937578	353	176.0	
8999	chr1	235938395	235939532	1137	568.0	
9000	chr1	235940212	235940811	599	300.0	
9001	chr1	235942051	235942948	897	448.0	
9002	chr1	235943779	235943807	28	14.0	
9003	chr1	235945729	235947693	1964	982.0	
9004	chr1	235951595	235952167	572	286.0	
9005	chr1	235952944	235953389	445	222.0	
9006	chr1	235954279	235955562	1283	642.0	
9007	chr1	235971159	235972702	1543	772.0	"recombination_feature	recombination_feature	sequence_feature"
9008	chr1	235980681	235981412	731	366.0	
9009	chr1	235998679	236000181	1502	751.0	"recombination_feature	recombination_feature	recombination_feature	sequence_feature"
9010	chr1	236004209	236004509	300	150.0	
9011	chr1	236023324	236023375	51	26.0	
9012	chr1	236052345	236052694	349	174.0	
9013	chr1	236064013	236065626	1613	806.0	
9014	chr1	236066520	236067462	942	471.0	
9015	chr1	236097277	236097696	419	210.0	"recombination_feature	recombination_feature	repeat_region"
9016	chr1	236103580	236104088	508	254.0	
9017	chr1	236109314	236109771	457	228.0	
9018	chr1	236120639	236121235	596	298.0	"recombination_feature	sequence_feature	sequence_feature	sequence_feature	sequence_feature"
9019	chr1	236137506	236137785	279	140.0	
9020	chr1	236141291	236143855	2564	1282.0	
9021	chr1	236156290	236157221	931	466.0	
9022	chr1	236159657	236160603	946	473.0	
9023	chr1	236161249	236161687	438	219.0	
9024	chr1	236163710	236164186	476	238.0	
9025	chr1	236168810	236169150	340	170.0	
9026	chr1	236206667	236206929	262	131.0	
9027	chr1	236223095	236223362	267	134.0	
9028	chr1	236228539	236228721	182	91.0	
9029	chr1	236259321	236259383	62	31.0	
9030	chr1	236280454	236282953	2499	1250.0	
9031	chr1	236284186	236285595	1409	704.0	
9032	chr1	236393785	236396467	2682	1341.0	
9033	chr1	236415627	236417888	2261	1130.0	
9034	chr1	236425295	236425597	302	151.0	
9035	chr1	236451966	236452404	438	219.0	
9036	chr1	236465873	236466323	450	225.0	
9037	chr1	236489862	236490329	467	234.0	
9038	chr1	236491219	236491384	165	82.0	
9039	chr1	236503104	236503605	501	250.0	
9040	chr1	236508872	236508877	5	2.0	
9041	chr1	236516807	236517418	611	306.0	
9042	chr1	236523164	236525251	2087	1044.0	
9043	chr1	236545772	236546168	396	198.0	
9044	chr1	236603771	236605235	1464	732.0	
9045	chr1	236686057	236687008	951	476.0	
9046	chr1	236759254	236759665	411	206.0	
9047	chr1	236794525	236796706	2181	1090.0	
9048	chr1	236868808	236869306	498	249.0	
9049	chr1	236869897	236871208	1311	656.0	
9050	chr1	237411459	237412112	653	326.0	
9051	chr1	237736615	237737169	554	277.0	
9052	chr1	237789734	237789974	240	120.0	
9053	chr1	237799769	237800229	460	230.0	
9054	chr1	237806771	237807118	347	174.0	
9055	chr1	237861960	237862346	386	193.0	
9056	chr1	237864288	237864927	639	320.0	
9057	chr1	238252584	238252655	71	36.0	
9058	chr1	239025339	239025630	291	146.0	
9059	chr1	239363955	239364283	328	164.0	
9060	chr1	239367423	239367792	369	184.0	
9061	chr1	239386416	239386830	414	207.0	
9062	chr1	239501572	239502273	701	350.0	
9063	chr1	239547866	239548510	644	322.0	
9064	chr1	239558856	239559395	539	270.0	
9065	chr1	239586992	239587612	620	310.0	
9066	chr1	239717353	239717422	69	34.0	
9067	chr1	239718617	239720306	1689	844.0	
9068	chr1	239805132	239805194	62	31.0	
9069	chr1	239815993	239816836	843	422.0	
9070	chr1	239841541	239842028	487	244.0	
9071	chr1	239858052	239858472	420	210.0	
9072	chr1	239861924	239862501	577	288.0	
9073	chr1	239898008	239898569	561	280.0	
9074	chr1	239909850	239910368	518	259.0	
9075	chr1	239914836	239915243	407	204.0	
9076	chr1	239944694	239945042	348	174.0	
9077	chr1	240455251	240455596	345	172.0	
9078	chr1	240493065	240493377	312	156.0	
9079	chr1	240576002	240576808	806	403.0	
9080	chr1	240611596	240612510	914	457.0	
9081	chr1	240666590	240666940	350	175.0	
9082	chr1	240687836	240688091	255	128.0	
9083	chr1	240692164	240692239	75	38.0	
9084	chr1	241356763	241356940	177	88.0	
9085	chr1	241424189	241424424	235	118.0	
9086	chr1	241518507	241520402	1895	948.0	
9087	chr1	241531122	241534155	3033	1516.0	
9088	chr1	241542122	241542896	774	387.0	
9089	chr1	241551102	241552706	1604	802.0	
9090	chr1	241560538	241560915	377	188.0	
9091	chr1	241589609	241589766	157	78.0	
9092	chr1	241592238	241592573	335	168.0	
9093	chr1	241610947	241611650	703	352.0	
9094	chr1	241612514	241612951	437	218.0	
9095	chr1	241627383	241628426	1043	522.0	
9096	chr1	241635785	241635977	192	96.0	
9097	chr1	241637599	241638427	828	414.0	
9098	chr1	241639095	241641648	2553	1276.0	
9099	chr1	241677055	241677811	756	378.0	
9100	chr1	241706812	241707256	444	222.0	
9101	chr1	241810814	241811529	715	358.0	
9102	chr1	241817966	241818389	423	212.0	
9103	chr1	241847380	241848819	1439	720.0	
9104	chr1	241899234	241899565	331	166.0	
9105	chr1	241964595	241965317	722	361.0	
9106	chr1	241984311	241984650	339	170.0	
9107	chr1	241998287	241998996	709	354.0	
9108	chr1	242017611	242018000	389	194.0	
9109	chr1	242147238	242147318	80	40.0	
9110	chr1	242784113	242784423	310	155.0	
9111	chr1	243101432	243101984	552	276.0	
9112	chr1	243244505	243244920	415	208.0	
9113	chr1	243246819	243247296	477	238.0	
9114	chr1	243253212	243256688	3476	1738.0	
9115	chr1	243264575	243265151	576	288.0	
9116	chr1	243267339	243268370	1031	516.0	
9117	chr1	243284349	243285160	811	406.0	
9118	chr1	243286415	243286880	465	232.0	
9119	chr1	243287561	243288388	827	414.0	
9120	chr1	243313002	243313351	349	174.0	
9121	chr1	243325280	243325706	426	213.0	
9122	chr1	243343932	243344370	438	219.0	
9123	chr1	243354555	243354966	411	206.0	
9124	chr1	243421367	243422278	911	456.0	
9125	chr1	243447359	243447694	335	168.0	
9126	chr1	243452036	243452580	544	272.0	
9127	chr1	243459045	243459475	430	215.0	
9128	chr1	243471023	243473944	2921	1460.0	
9129	chr1	243477519	243478247	728	364.0	
9130	chr1	243482152	243483738	1586	793.0	
9131	chr1	243495562	243496740	1178	589.0	
9132	chr1	243507362	243508928	1566	783.0	
9133	chr1	243596112	243597010	898	449.0	
9134	chr1	243598470	243598827	357	178.0	
9135	chr1	243642937	243643222	285	142.0	
9136	chr1	243710535	243710926	391	196.0	
9137	chr1	243713149	243714021	872	436.0	enhancer
9138	chr1	243727141	243728397	1256	628.0	
9139	chr1	243730350	243732572	2222	1111.0	
9140	chr1	243734060	243734812	752	376.0	
9141	chr1	243748617	243749152	535	268.0	
9142	chr1	243803492	243804065	573	286.0	
9143	chr1	243807366	243807734	368	184.0	
9144	chr1	243838145	243838584	439	220.0	
9145	chr1	243842178	243842291	113	56.0	
9146	chr1	243842889	243843614	725	362.0	
9147	chr1	243848424	243851648	3224	1612.0	
9148	chr1	243910483	243911084	601	300.0	
9149	chr1	243917131	243918411	1280	640.0	
9150	chr1	243924426	243924865	439	220.0	
9151	chr1	243947045	243947415	370	185.0	
9152	chr1	243963586	243963910	324	162.0	
9153	chr1	244010268	244010571	303	152.0	
9154	chr1	244046743	244052787	6044	3022.0	
9155	chr1	244053920	244054087	167	84.0	
9156	chr1	244054768	244055193	425	212.0	
9157	chr1	244074365	244075827	1462	731.0	
9158	chr1	244077481	244077882	401	200.0	
9159	chr1	244137720	244138039	319	160.0	
9160	chr1	244157855	244157973	118	59.0	
9161	chr1	244160342	244160800	458	229.0	
9162	chr1	244209973	244210304	331	166.0	
9163	chr1	244214303	244214720	417	208.0	
9164	chr1	244224341	244225081	740	370.0	
9165	chr1	244237456	244237903	447	224.0	
9166	chr1	244254245	244255000	755	378.0	
9167	chr1	244272739	244274229	1490	745.0	
9168	chr1	244291414	244291638	224	112.0	
9169	chr1	244296455	244296802	347	174.0	
9170	chr1	244298959	244300185	1226	613.0	
9171	chr1	244304115	244304511	396	198.0	
9172	chr1	244318583	244320417	1834	917.0	
9173	chr1	244322829	244323602	773	386.0	
9174	chr1	244324911	244326142	1231	616.0	
9175	chr1	244341635	244342225	590	295.0	
9176	chr1	244349139	244349399	260	130.0	
9177	chr1	244353684	244354184	500	250.0	
9178	chr1	244360091	244360975	884	442.0	
9179	chr1	244409571	244410157	586	293.0	
9180	chr1	244439304	244439872	568	284.0	
9181	chr1	244445730	244446414	684	342.0	
9182	chr1	244450195	244452842	2647	1324.0	
9183	chr1	244460229	244462108	1879	940.0	
9184	chr1	244599786	244600434	648	324.0	
9185	chr1	244603408	244603821	413	206.0	
9186	chr1	244652099	244654743	2644	1322.0	
9187	chr1	244665699	244666259	560	280.0	
9188	chr1	244666764	244667016	252	126.0	
9189	chr1	244729415	244730948	1533	766.0	
9190	chr1	244796746	244797245	499	250.0	
9191	chr1	244801135	244801760	625	312.0	
9192	chr1	244815302	244816973	1671	836.0	
9193	chr1	244833489	244839334	5845	2922.0	
9194	chr1	244840213	244840980	767	384.0	
9195	chr1	244845724	244847195	1471	736.0	
9196	chr1	244847928	244865536	17608	8804.0	
9197	chr1	244918400	244919442	1042	521.0	
9198	chr1	244920742	244921425	683	342.0	
9199	chr1	244940299	244940558	259	130.0	
9200	chr1	244941083	244941508	425	212.0	
9201	chr1	244945094	244945638	544	272.0	
9202	chr1	244952789	244953387	598	299.0	
9203	chr1	244957811	244957839	28	14.0	
9204	chr1	244963393	244964627	1234	617.0	
9205	chr1	244969263	244972720	3457	1728.0	
9206	chr1	245042603	245043271	668	334.0	
9207	chr1	245051204	245052370	1166	583.0	
9208	chr1	245054009	245055289	1280	640.0	
9209	chr1	245056807	245057428	621	310.0	
9210	chr1	245152942	245157317	4375	2188.0	
9211	chr1	245168071	245168584	513	256.0	
9212	chr1	245188277	245188898	621	310.0	
9213	chr1	245255799	245256212	413	206.0	
9214	chr1	245258602	245259096	494	247.0	
9215	chr1	245310593	245311683	1090	545.0	
9216	chr1	245433250	245433654	404	202.0	
9217	chr1	245458753	245459386	633	316.0	
9218	chr1	245476096	245476223	127	64.0	
9219	chr1	245480837	245481118	281	140.0	
9220	chr1	245501697	245501987	290	145.0	
9221	chr1	245512981	245513354	373	186.0	
9222	chr1	245673874	245674464	590	295.0	
9223	chr1	245679805	245680281	476	238.0	
9224	chr1	245681049	245681286	237	118.0	
9225	chr1	245690200	245690636	436	218.0	
9226	chr1	245699040	245699309	269	134.0	
9227	chr1	245807498	245807615	117	58.0	
9228	chr1	245942909	245943189	280	140.0	
9229	chr1	245953260	245954827	1567	784.0	
9230	chr1	245956162	245956886	724	362.0	
9231	chr1	246003088	246003551	463	232.0	
9232	chr1	246012363	246012588	225	112.0	
9233	chr1	246067629	246068045	416	208.0	
9234	chr1	246106409	246106727	318	159.0	
9235	chr1	246113733	246113792	59	30.0	
9236	chr1	246117096	246117983	887	444.0	
9237	chr1	246153168	246153441	273	136.0	
9238	chr1	246157425	246157970	545	272.0	
9239	chr1	246159260	246159610	350	175.0	
9240	chr1	246182179	246182489	310	155.0	
9241	chr1	246214854	246215909	1055	528.0	
9242	chr1	246492638	246492988	350	175.0	
9243	chr1	246497230	246497933	703	352.0	
9244	chr1	246506329	246507971	1642	821.0	
9245	chr1	246527432	246527859	427	214.0	
9246	chr1	246565156	246567724	2568	1284.0	
9247	chr1	246569250	246570599	1349	674.0	
9248	chr1	246571176	246571998	822	411.0	
9249	chr1	246573621	246573974	353	176.0	
9250	chr1	246577119	246577520	401	200.0	
9251	chr1	246582397	246582839	442	221.0	
9252	chr1	246587614	246588015	401	200.0	
9253	chr1	246601276	246601655	379	190.0	
9254	chr1	246607469	246607736	267	134.0	
9255	chr1	246608655	246609519	864	432.0	
9256	chr1	246689327	246690154	827	414.0	
9257	chr1	246694422	246694813	391	196.0	
9258	chr1	246696421	246696982	561	280.0	
9259	chr1	246698739	246699665	926	463.0	
9260	chr1	246703873	246704001	128	64.0	
9261	chr1	246707497	246707956	459	230.0	
9262	chr1	246709931	246710099	168	84.0	
9263	chr1	246723778	246725025	1247	624.0	
9264	chr1	246726236	246726763	527	264.0	
9265	chr1	246730794	246731304	510	255.0	
9266	chr1	246753734	246754354	620	310.0	
9267	chr1	246760634	246760789	155	78.0	
9268	chr1	246782333	246782472	139	70.0	
9269	chr1	246784803	246785266	463	232.0	
9270	chr1	246789073	246789106	33	16.0	
9271	chr1	246817755	246818198	443	222.0	
9272	chr1	246821286	246821656	370	185.0	
9273	chr1	246833605	246834218	613	306.0	
9274	chr1	246907460	246907882	422	211.0	
9275	chr1	246909627	246909701	74	37.0	
9276	chr1	246930112	246932833	2721	1360.0	
9277	chr1	246959623	246960540	917	458.0	
9278	chr1	246961652	246962803	1151	576.0	
9279	chr1	246969745	246969926	181	90.0	
9280	chr1	246971272	246971771	499	250.0	
9281	chr1	247007384	247008426	1042	521.0	
9282	chr1	247077536	247079844	2308	1154.0	
9283	chr1	247103587	247104900	1313	656.0	
9284	chr1	247110682	247112651	1969	984.0	
9285	chr1	247114731	247115277	546	273.0	
9286	chr1	247118915	247119356	441	220.0	
9287	chr1	247127754	247128056	302	151.0	
9288	chr1	247172190	247173810	1620	810.0	
9289	chr1	247205003	247205626	623	312.0	
9290	chr1	247209035	247212441	3406	1703.0	
9291	chr1	247218239	247218492	253	126.0	
9292	chr1	247322708	247323561	853	426.0	
9293	chr1	247330772	247333894	3122	1561.0	
9294	chr1	247335227	247335236	9	4.0	
9295	chr1	247347548	247348216	668	334.0	
9296	chr1	247357686	247357955	269	134.0	
9297	chr1	247358753	247361424	2671	1336.0	
9298	chr1	247372632	247374296	1664	832.0	
9299	chr1	247386660	247387291	631	316.0	
9300	chr1	247389773	247391025	1252	626.0	
9301	chr1	247401327	247402717	1390	695.0	
9302	chr1	247406770	247408688	1918	959.0	
9303	chr1	247409629	247410554	925	462.0	
9304	chr1	247411489	247412236	747	374.0	
9305	chr1	247415251	247416944	1693	846.0	
9306	chr1	247417687	247418475	788	394.0	
9307	chr1	247419297	247419805	508	254.0	
9308	chr1	247420699	247421807	1108	554.0	
9309	chr1	247424165	247424575	410	205.0	
9310	chr1	247425356	247425412	56	28.0	
9311	chr1	247426435	247427383	948	474.0	
9312	chr1	247428544	247431006	2462	1231.0	
9313	chr1	247431751	247432066	315	158.0	
9314	chr1	247433983	247435876	1893	946.0	
9315	chr1	247437440	247438687	1247	624.0	
9316	chr1	247439850	247440865	1015	508.0	
9317	chr1	247441507	247442052	545	272.0	
9318	chr1	247445465	247446565	1100	550.0	
9319	chr1	247447997	247448409	412	206.0	
9320	chr1	247455980	247456420	440	220.0	
9321	chr1	247457117	247457568	451	226.0	
9322	chr1	247476432	247476742	310	155.0	
9323	chr1	247487047	247487577	530	265.0	
9324	chr1	247494746	247495244	498	249.0	
9325	chr1	247500701	247501415	714	357.0	
9326	chr1	247517872	247518450	578	289.0	
9327	chr1	247529964	247530135	171	86.0	
9328	chr1	247548727	247549044	317	158.0	
9329	chr1	247576666	247576676	10	5.0	
9330	chr1	247639236	247639975	739	370.0	
9331	chr1	247646905	247647206	301	150.0	
9332	chr1	247681305	247681644	339	170.0	
9333	chr1	247852701	247853385	684	342.0	
9334	chr1	247856940	247858151	1211	606.0	
9335	chr1	247906142	247907070	928	464.0	
9336	chr1	247936755	247937659	904	452.0	
9337	chr1	248403975	248404459	484	242.0	
9338	chr1	248482265	248482463	198	99.0	
9339	chr1	248565582	248565997	415	208.0	
9340	chr1	248568997	248569514	517	258.0	
9341	chr1	248576385	248576606	221	110.0	
9342	chr1	248618922	248619282	360	180.0	
9343	chr1	248622455	248623108	653	326.0	
9344	chr1	248631660	248632062	402	201.0	
9345	chr1	248663576	248663804	228	114.0	
9346	chr1	248686823	248687255	432	216.0	
9347	chr1	248696301	248696622	321	160.0	
9348	chr1	248710474	248710981	507	254.0	
9349	chr1	248786088	248786620	532	266.0	
9350	chr1	248792310	248792774	464	232.0	
9351	chr1	248804592	248806335	1743	872.0	
9352	chr1	248806897	248807576	679	340.0	
9353	chr1	248811042	248811254	212	106.0	
9354	chr1	248816737	248817501	764	382.0	
9355	chr1	248818736	248819421	685	342.0	
9356	chr1	248822194	248822932	738	369.0	
9357	chr1	248825126	248827272	2146	1073.0	
9358	chr1	248828761	248829389	628	314.0	
9359	chr1	248834379	248834959	580	290.0	
9360	chr1	248837278	248839706	2428	1214.0	
9361	chr1	248841619	248842144	525	262.0	
9362	chr1	248850446	248851889	1443	722.0	
9363	chr1	248852580	248854541	1961	980.0	
9364	chr1	248857578	248860158	2580	1290.0	
9365	chr1	248862628	248863929	1301	650.0	
9366	chr1	248872637	248875572	2935	1468.0	
9367	chr1	248905536	248907441	1905	952.0	
9368	chr1	248924597	248925661	1064	532.0	
9369	chr2	10601	10797	196	98.0	
9370	chr2	11333	12009	676	338.0	
9371	chr2	18419	19012	593	296.0	
9372	chr2	24061	24498	437	218.0	
9373	chr2	33613	34005	392	196.0	
9374	chr2	45392	47546	2154	1077.0	
9375	chr2	166478	166774	296	148.0	
9376	chr2	172230	172413	183	92.0	
9377	chr2	175918	176842	924	462.0	
9378	chr2	192881	193660	779	390.0	
9379	chr2	237863	238231	368	184.0	
9380	chr2	246418	246908	490	245.0	
9381	chr2	260912	261145	233	116.0	
9382	chr2	263284	265721	2437	1218.0	
9383	chr2	287490	288387	897	448.0	
9384	chr2	289659	290542	883	442.0	
9385	chr2	318048	318230	182	91.0	
9386	chr2	393820	394840	1020	510.0	
9387	chr2	419850	420395	545	272.0	
9388	chr2	429535	430997	1462	731.0	
9389	chr2	437723	438670	947	474.0	
9390	chr2	441206	441721	515	258.0	
9391	chr2	445153	445722	569	284.0	
9392	chr2	454945	455563	618	309.0	
9393	chr2	460679	461376	697	348.0	
9394	chr2	464868	465269	401	200.0	
9395	chr2	529401	529681	280	140.0	
9396	chr2	584970	585699	729	364.0	
9397	chr2	636510	637543	1033	516.0	
9398	chr2	656832	656989	157	78.0	
9399	chr2	662421	662986	565	282.0	
9400	chr2	675987	678096	2109	1054.0	
9401	chr2	696434	696921	487	244.0	
9402	chr2	714307	714758	451	226.0	
9403	chr2	767468	767757	289	144.0	
9404	chr2	950395	951086	691	346.0	
9405	chr2	974021	974442	421	210.0	
9406	chr2	1140398	1140759	361	180.0	
9407	chr2	1162712	1163223	511	256.0	
9408	chr2	1167132	1167225	93	46.0	
9409	chr2	1509167	1509975	808	404.0	
9410	chr2	1518301	1518884	583	292.0	
9411	chr2	1546086	1546386	300	150.0	
9412	chr2	1550643	1551124	481	240.0	
9413	chr2	1564479	1564726	247	124.0	
9414	chr2	1614689	1614956	267	134.0	
9415	chr2	1707742	1708099	357	178.0	
9416	chr2	1750880	1751178	298	149.0	
9417	chr2	1781237	1781928	691	346.0	
9418	chr2	1798859	1798861	2	1.0	
9419	chr2	1817491	1817880	389	194.0	
9420	chr2	1823182	1823396	214	107.0	
9421	chr2	2057006	2057834	828	414.0	
9422	chr2	2613154	2614082	928	464.0	
9423	chr2	2646290	2647484	1194	597.0	
9424	chr2	2681854	2682281	427	214.0	
9425	chr2	2704088	2704873	785	392.0	
9426	chr2	2758065	2758070	5	2.0	
9427	chr2	3151668	3151728	60	30.0	
9428	chr2	3195927	3196048	121	60.0	
9429	chr2	3222474	3223794	1320	660.0	
9430	chr2	3242517	3243344	827	414.0	
9431	chr2	3264313	3264735	422	211.0	enhancer
9432	chr2	3303329	3304240	911	456.0	
9433	chr2	3357363	3357900	537	268.0	
9434	chr2	3377165	3380573	3408	1704.0	
9435	chr2	3423799	3424326	527	264.0	
9436	chr2	3461806	3462812	1006	503.0	
9437	chr2	3483008	3483872	864	432.0	
9438	chr2	3518203	3520498	2295	1148.0	
9439	chr2	3535784	3537113	1329	664.0	
9440	chr2	3557577	3559327	1750	875.0	
9441	chr2	3574591	3576472	1881	940.0	
9442	chr2	3577359	3577460	101	50.0	
9443	chr2	3650771	3652514	1743	872.0	
9444	chr2	3780796	3780931	135	68.0	
9445	chr2	4102231	4102264	33	16.0	
9446	chr2	6224275	6224692	417	208.0	
9447	chr2	6345491	6345944	453	226.0	
9448	chr2	6773049	6773571	522	261.0	
9449	chr2	6780579	6781344	765	382.0	
9450	chr2	6826268	6827019	751	376.0	
9451	chr2	6828241	6828542	301	150.0	
9452	chr2	6832735	6833590	855	428.0	
9453	chr2	6864600	6866810	2210	1105.0	
9454	chr2	6872542	6872602	60	30.0	
9455	chr2	6877189	6878353	1164	582.0	
9456	chr2	6880287	6880851	564	282.0	
9457	chr2	6897118	6897581	463	232.0	
9458	chr2	6909315	6910576	1261	630.0	
9459	chr2	6913148	6914308	1160	580.0	
9460	chr2	6916753	6919303	2550	1275.0	
9461	chr2	6934874	6935340	466	233.0	
9462	chr2	6986558	6986904	346	173.0	
9463	chr2	6999167	6999559	392	196.0	
9464	chr2	7004385	7005088	703	352.0	
9465	chr2	7007711	7008762	1051	526.0	
9466	chr2	7014280	7015320	1040	520.0	
9467	chr2	7031519	7032204	685	342.0	
9468	chr2	7037669	7038167	498	249.0	
9469	chr2	7044227	7044731	504	252.0	
9470	chr2	7057724	7058506	782	391.0	
9471	chr2	7059070	7059809	739	370.0	
9472	chr2	7071752	7072442	690	345.0	
9473	chr2	7083870	7084273	403	202.0	
9474	chr2	7097146	7098026	880	440.0	
9475	chr2	7202957	7203367	410	205.0	
9476	chr2	7241420	7241544	124	62.0	
9477	chr2	7242469	7243727	1258	629.0	
9478	chr2	7427223	7428091	868	434.0	
9479	chr2	7430254	7431812	1558	779.0	
9480	chr2	7432460	7432811	351	176.0	
9481	chr2	7436422	7438445	2023	1012.0	
9482	chr2	7438961	7439262	301	150.0	
9483	chr2	7441151	7441341	190	95.0	
9484	chr2	7450207	7451212	1005	502.0	
9485	chr2	7452313	7452504	191	96.0	
9486	chr2	7467942	7468595	653	326.0	
9487	chr2	7517074	7517475	401	200.0	
9488	chr2	7567472	7568247	775	388.0	
9489	chr2	7592737	7592940	203	102.0	
9490	chr2	7625500	7625848	348	174.0	
9491	chr2	7649853	7650146	293	146.0	
9492	chr2	7672029	7672804	775	388.0	
9493	chr2	7692789	7693007	218	109.0	
9494	chr2	7725085	7727922	2837	1418.0	
9495	chr2	7730411	7730922	511	256.0	
9496	chr2	7732559	7732868	309	154.0	
9497	chr2	7740133	7740477	344	172.0	
9498	chr2	7744416	7745429	1013	506.0	
9499	chr2	7748633	7749477	844	422.0	
9500	chr2	7773066	7774310	1244	622.0	
9501	chr2	7795658	7796348	690	345.0	
9502	chr2	7835638	7836012	374	187.0	
9503	chr2	7841712	7842115	403	202.0	
9504	chr2	7866770	7868382	1612	806.0	
9505	chr2	7895360	7895609	249	124.0	
9506	chr2	7896942	7897345	403	202.0	
9507	chr2	8004194	8004772	578	289.0	
9508	chr2	8008992	8009409	417	208.0	
9509	chr2	8023177	8023695	518	259.0	
9510	chr2	8058579	8059144	565	282.0	
9511	chr2	8076303	8077115	812	406.0	
9512	chr2	8090710	8091571	861	430.0	
9513	chr2	8107784	8107988	204	102.0	
9514	chr2	8116587	8117108	521	260.0	
9515	chr2	8135298	8135683	385	192.0	
9516	chr2	8139213	8139506	293	146.0	
9517	chr2	8145283	8145778	495	248.0	
9518	chr2	8152904	8153414	510	255.0	
9519	chr2	8168264	8169074	810	405.0	
9520	chr2	8176294	8177868	1574	787.0	
9521	chr2	8178933	8179296	363	182.0	
9522	chr2	8193916	8194003	87	44.0	
9523	chr2	8204703	8205139	436	218.0	
9524	chr2	8229467	8230185	718	359.0	
9525	chr2	8234084	8235073	989	494.0	
9526	chr2	8239665	8240134	469	234.0	
9527	chr2	8244592	8245108	516	258.0	
9528	chr2	8246232	8246487	255	128.0	
9529	chr2	8251292	8251730	438	219.0	
9530	chr2	8260502	8260516	14	7.0	
9531	chr2	8277858	8278109	251	126.0	
9532	chr2	8281852	8283404	1552	776.0	
9533	chr2	8298333	8299504	1171	586.0	
9534	chr2	8301693	8304209	2516	1258.0	
9535	chr2	8304962	8305646	684	342.0	
9536	chr2	8309163	8309606	443	222.0	
9537	chr2	8310500	8311462	962	481.0	
9538	chr2	8312872	8314548	1676	838.0	
9539	chr2	8315715	8316234	519	260.0	
9540	chr2	8324361	8324832	471	236.0	
9541	chr2	8328208	8328756	548	274.0	
9542	chr2	8334780	8335398	618	309.0	
9543	chr2	8337309	8337797	488	244.0	
9544	chr2	8346155	8346711	556	278.0	
9545	chr2	8352412	8352674	262	131.0	
9546	chr2	8357758	8358527	769	384.0	
9547	chr2	8376755	8377351	596	298.0	
9548	chr2	8380290	8380387	97	48.0	
9549	chr2	8394117	8394589	472	236.0	
9550	chr2	8408713	8409484	771	386.0	
9551	chr2	8413780	8413951	171	86.0	
9552	chr2	8415198	8415828	630	315.0	
9553	chr2	8421820	8422027	207	104.0	
9554	chr2	8425081	8425998	917	458.0	
9555	chr2	8426868	8426900	32	16.0	
9556	chr2	8428392	8428718	326	163.0	
9557	chr2	8432679	8433700	1021	510.0	
9558	chr2	8438469	8438968	499	250.0	
9559	chr2	8454963	8458239	3276	1638.0	
9560	chr2	8469864	8470001	137	68.0	
9561	chr2	8472372	8473322	950	475.0	
9562	chr2	8475126	8478845	3719	1860.0	
9563	chr2	8480893	8482120	1227	614.0	
9564	chr2	8484591	8484973	382	191.0	
9565	chr2	8486058	8489628	3570	1785.0	
9566	chr2	8498797	8499360	563	282.0	
9567	chr2	8501046	8501467	421	210.0	
9568	chr2	8511831	8512574	743	372.0	
9569	chr2	8514865	8516626	1761	880.0	
9570	chr2	8518801	8519699	898	449.0	
9571	chr2	8520831	8521450	619	310.0	
9572	chr2	8522528	8523284	756	378.0	
9573	chr2	8525418	8526643	1225	612.0	
9574	chr2	8534173	8536393	2220	1110.0	
9575	chr2	8538481	8538781	300	150.0	
9576	chr2	8539761	8540363	602	301.0	
9577	chr2	8543052	8547324	4272	2136.0	
9578	chr2	8551745	8552550	805	402.0	
9579	chr2	8571427	8571672	245	122.0	
9580	chr2	8572715	8572886	171	86.0	
9581	chr2	8574598	8577321	2723	1362.0	
9582	chr2	8583047	8584432	1385	692.0	
9583	chr2	8585884	8586431	547	274.0	
9584	chr2	8588437	8588956	519	260.0	
9585	chr2	8596287	8596678	391	196.0	
9586	chr2	8597853	8599130	1277	638.0	
9587	chr2	8602720	8603293	573	286.0	
9588	chr2	8644400	8645304	904	452.0	
9589	chr2	8657488	8657964	476	238.0	
9590	chr2	8658925	8659755	830	415.0	
9591	chr2	8663986	8665153	1167	584.0	
9592	chr2	8676337	8686398	10061	5030.0	
9593	chr2	8693221	8693722	501	250.0	
9594	chr2	8821316	8822547	1231	616.0	
9595	chr2	8835312	8835821	509	254.0	
9596	chr2	8836439	8838287	1848	924.0	
9597	chr2	8841835	8842414	579	290.0	
9598	chr2	8984140	8984486	346	173.0	
9599	chr2	8984994	8985103	109	54.0	
9600	chr2	9002629	9004786	2157	1078.0	
9601	chr2	9095607	9096225	618	309.0	
9602	chr2	9136948	9137660	712	356.0	
9603	chr2	9139658	9140165	507	254.0	
9604	chr2	9142466	9143373	907	454.0	
9605	chr2	9166661	9166999	338	169.0	
9606	chr2	9168717	9169922	1205	602.0	
9607	chr2	9170736	9171058	322	161.0	
9608	chr2	9178569	9178890	321	160.0	
9609	chr2	9191526	9192319	793	396.0	
9610	chr2	9205924	9207914	1990	995.0	
9611	chr2	9230809	9231747	938	469.0	
9612	chr2	9233884	9235138	1254	627.0	
9613	chr2	9258904	9259538	634	317.0	
9614	chr2	9260395	9261608	1213	606.0	
9615	chr2	9263467	9263656	189	94.0	
9616	chr2	9333663	9333905	242	121.0	
9617	chr2	9335437	9336613	1176	588.0	
9618	chr2	9422164	9424572	2408	1204.0	
9619	chr2	9463555	9463956	401	200.0	
9620	chr2	9473376	9476503	3127	1564.0	
9621	chr2	9535179	9535535	356	178.0	
9622	chr2	9537800	9539964	2164	1082.0	
9623	chr2	9543542	9543989	447	224.0	
9624	chr2	9547955	9549168	1213	606.0	
9625	chr2	9550096	9551467	1371	686.0	
9626	chr2	9552229	9553313	1084	542.0	
9627	chr2	9554694	9556912	2218	1109.0	
9628	chr2	9557781	9558036	255	128.0	
9629	chr2	9558960	9559215	255	128.0	
9630	chr2	9594568	9595096	528	264.0	
9631	chr2	9596351	9597255	904	452.0	
9632	chr2	9607541	9608887	1346	673.0	
9633	chr2	9610200	9611897	1697	848.0	
9634	chr2	9612639	9612646	7	4.0	
9635	chr2	9613216	9613928	712	356.0	
9636	chr2	9615654	9616113	459	230.0	
9637	chr2	9617426	9619290	1864	932.0	
9638	chr2	9619805	9622110	2305	1152.0	
9639	chr2	9622912	9625807	2895	1448.0	
9640	chr2	9626339	9633181	6842	3421.0	
9641	chr2	9641563	9642003	440	220.0	
9642	chr2	9650395	9650397	2	1.0	
9643	chr2	9655369	9657202	1833	916.0	
9644	chr2	9663060	9663692	632	316.0	
9645	chr2	9678756	9678883	127	64.0	
9646	chr2	9680940	9681925	985	492.0	
9647	chr2	9690384	9690634	250	125.0	
9648	chr2	9692779	9693607	828	414.0	
9649	chr2	9697876	9698439	563	282.0	
9650	chr2	9699493	9700218	725	362.0	
9651	chr2	9702533	9704322	1789	894.0	
9652	chr2	9712211	9712579	368	184.0	
9653	chr2	9735606	9736423	817	408.0	
9654	chr2	9736975	9737926	951	476.0	
9655	chr2	9738480	9739982	1502	751.0	
9656	chr2	9752418	9754883	2465	1232.0	
9657	chr2	9757728	9758127	399	200.0	
9658	chr2	9764145	9764516	371	186.0	
9659	chr2	9770351	9770796	445	222.0	
9660	chr2	9778167	9778238	71	36.0	
9661	chr2	9779573	9780770	1197	598.0	
9662	chr2	9781880	9782905	1025	512.0	
9663	chr2	9792660	9793000	340	170.0	
9664	chr2	9798983	9801846	2863	1432.0	
9665	chr2	9813586	9814287	701	350.0	
9666	chr2	9831038	9831111	73	36.0	
9667	chr2	9841352	9845008	3656	1828.0	
9668	chr2	9948973	9948984	11	6.0	
9669	chr2	9950375	9952459	2084	1042.0	
9670	chr2	9983935	9984856	921	460.0	
9671	chr2	9991824	9992116	292	146.0	
9672	chr2	10019195	10020174	979	490.0	
9673	chr2	10028501	10030063	1562	781.0	
9674	chr2	10034211	10036992	2781	1390.0	
9675	chr2	10037667	10037979	312	156.0	
9676	chr2	10042084	10045295	3211	1606.0	
9677	chr2	10046077	10046205	128	64.0	
9678	chr2	10048137	10049141	1004	502.0	
9679	chr2	10057165	10057626	461	230.0	
9680	chr2	10065539	10065827	288	144.0	
9681	chr2	10072325	10073272	947	474.0	
9682	chr2	10078967	10081427	2460	1230.0	
9683	chr2	10091032	10092065	1033	516.0	
9684	chr2	10097311	10097859	548	274.0	
9685	chr2	10115914	10116566	652	326.0	
9686	chr2	10119732	10125153	5421	2710.0	
9687	chr2	10141850	10142754	904	452.0	
9688	chr2	10241621	10242129	508	254.0	
9689	chr2	10270293	10271185	892	446.0	
9690	chr2	10278178	10279244	1066	533.0	
9691	chr2	10282697	10283891	1194	597.0	
9692	chr2	10285108	10286160	1052	526.0	
9693	chr2	10297786	10298664	878	439.0	
9694	chr2	10300767	10306186	5419	2710.0	
9695	chr2	10307077	10308066	989	494.0	
9696	chr2	10325496	10325879	383	192.0	
9697	chr2	10328646	10328801	155	78.0	
9698	chr2	10329302	10333613	4311	2156.0	
9699	chr2	10344467	10345483	1016	508.0	
9700	chr2	10350684	10351412	728	364.0	
9701	chr2	10375517	10376328	811	406.0	
9702	chr2	10378068	10378762	694	347.0	
9703	chr2	10379993	10380524	531	266.0	
9704	chr2	10381956	10383473	1517	758.0	
9705	chr2	10384082	10384460	378	189.0	
9706	chr2	10390395	10391001	606	303.0	
9707	chr2	10393356	10393699	343	172.0	
9708	chr2	10398383	10399033	650	325.0	
9709	chr2	10400124	10401878	1754	877.0	
9710	chr2	10406490	10410914	4424	2212.0	
9711	chr2	10412334	10412823	489	244.0	
9712	chr2	10431436	10442964	11528	5764.0	
9713	chr2	10444380	10449952	5572	2786.0	
9714	chr2	10487604	10487810	206	103.0	
9715	chr2	10493193	10494266	1073	536.0	
9716	chr2	10497744	10498372	628	314.0	
9717	chr2	10537522	10537922	400	200.0	
9718	chr2	10544126	10544879	753	376.0	
9719	chr2	10620652	10620843	191	96.0	
9720	chr2	10654226	10654228	2	1.0	
9721	chr2	10659990	10660367	377	188.0	
9722	chr2	10668381	10668838	457	228.0	
9723	chr2	10689077	10690767	1690	845.0	
9724	chr2	10721338	10721779	441	220.0	
9725	chr2	10745377	10746137	760	380.0	
9726	chr2	10787756	10787884	128	64.0	
9727	chr2	10790298	10791236	938	469.0	
9728	chr2	10810057	10813596	3539	1770.0	
9729	chr2	10817402	10817826	424	212.0	
9730	chr2	10821337	10821682	345	172.0	
9731	chr2	10826059	10826406	347	174.0	
9732	chr2	10831911	10832979	1068	534.0	
9733	chr2	10835066	10835773	707	354.0	
9734	chr2	10863706	10865432	1726	863.0	
9735	chr2	10876378	10876847	469	234.0	
9736	chr2	10877720	10878119	399	200.0	
9737	chr2	11104047	11104497	450	225.0	
9738	chr2	11124288	11124896	608	304.0	
9739	chr2	11127848	11128041	193	96.0	
9740	chr2	11128618	11130586	1968	984.0	
9741	chr2	11132113	11133717	1604	802.0	
9742	chr2	11145190	11145818	628	314.0	
9743	chr2	11154282	11156229	1947	974.0	
9744	chr2	11160755	11161536	781	390.0	
9745	chr2	11175269	11175907	638	319.0	
9746	chr2	11187751	11188073	322	161.0	
9747	chr2	11203411	11203916	505	252.0	
9748	chr2	11224932	11225231	299	150.0	
9749	chr2	11293038	11293100	62	31.0	
9750	chr2	11330683	11330817	134	67.0	
9751	chr2	11342672	11345688	3016	1508.0	
9752	chr2	11346227	11346615	388	194.0	
9753	chr2	11446624	11447153	529	264.0	
9754	chr2	11465268	11467216	1948	974.0	
9755	chr2	11477861	11478359	498	249.0	
9756	chr2	11483180	11483397	217	108.0	
9757	chr2	11582676	11583137	461	230.0	
9758	chr2	11584146	11584668	522	261.0	
9759	chr2	11669729	11670212	483	242.0	
9760	chr2	11681986	11682471	485	242.0	
9761	chr2	11687857	11688996	1139	570.0	
9762	chr2	11691039	11691577	538	269.0	
9763	chr2	11692674	11693522	848	424.0	
9764	chr2	11696947	11698542	1595	798.0	
9765	chr2	11701639	11702557	918	459.0	
9766	chr2	11711531	11712249	718	359.0	
9767	chr2	11719533	11719749	216	108.0	
9768	chr2	11738449	11739381	932	466.0	
9769	chr2	11743545	11751410	7865	3932.0	
9770	chr2	11753109	11755004	1895	948.0	
9771	chr2	11757115	11757598	483	242.0	
9772	chr2	11775261	11775948	687	344.0	
9773	chr2	11777454	11779808	2354	1177.0	
9774	chr2	11784855	11785348	493	246.0	
9775	chr2	11829137	11830859	1722	861.0	
9776	chr2	11852854	11853188	334	167.0	
9777	chr2	11858805	11859304	499	250.0	
9778	chr2	11863241	11864370	1129	564.0	
9779	chr2	11866946	11867123	177	88.0	
9780	chr2	11870667	11870980	313	156.0	
9781	chr2	11872609	11874220	1611	806.0	
9782	chr2	11898520	11898975	455	228.0	
9783	chr2	11902886	11904613	1727	864.0	
9784	chr2	11907087	11907774	687	344.0	
9785	chr2	11914578	11914636	58	29.0	
9786	chr2	11933820	11934329	509	254.0	
9787	chr2	11944343	11945944	1601	800.0	
9788	chr2	11950022	11950559	537	268.0	
9789	chr2	11955996	11956284	288	144.0	
9790	chr2	12005763	12006500	737	368.0	
9791	chr2	12014003	12014356	353	176.0	
9792	chr2	12032362	12032882	520	260.0	
9793	chr2	12044592	12045447	855	428.0	
9794	chr2	12050365	12050725	360	180.0	
9795	chr2	12057163	12058187	1024	512.0	
9796	chr2	12064081	12064721	640	320.0	
9797	chr2	12071339	12071747	408	204.0	
9798	chr2	12074133	12074661	528	264.0	
9799	chr2	12081383	12081966	583	292.0	
9800	chr2	12110054	12110546	492	246.0	
9801	chr2	12127490	12128140	650	325.0	
9802	chr2	12168711	12170461	1750	875.0	
9803	chr2	12176933	12178067	1134	567.0	
9804	chr2	12192661	12193250	589	294.0	
9805	chr2	12201263	12201756	493	246.0	
9806	chr2	12205294	12205352	58	29.0	
9807	chr2	12220020	12220098	78	39.0	
9808	chr2	12326953	12327115	162	81.0	
9809	chr2	12412756	12413354	598	299.0	
9810	chr2	12416531	12417095	564	282.0	
9811	chr2	12430291	12431396	1105	552.0	
9812	chr2	12451684	12452639	955	478.0	
9813	chr2	12456122	12457291	1169	584.0	
9814	chr2	12463215	12463550	335	168.0	
9815	chr2	12465647	12465961	314	157.0	
9816	chr2	12487282	12487629	347	174.0	
9817	chr2	12488242	12488959	717	358.0	
9818	chr2	12492897	12493468	571	286.0	
9819	chr2	12498228	12498301	73	36.0	
9820	chr2	12501010	12503145	2135	1068.0	
9821	chr2	12507050	12507821	771	386.0	
9822	chr2	12513366	12513511	145	72.0	
9823	chr2	12514609	12515266	657	328.0	
9824	chr2	12556994	12557038	44	22.0	
9825	chr2	12587786	12588775	989	494.0	
9826	chr2	12616509	12617619	1110	555.0	
9827	chr2	12695334	12695857	523	262.0	
9828	chr2	12708665	12709864	1199	600.0	
9829	chr2	12715359	12720625	5266	2633.0	
9830	chr2	12721187	12721586	399	200.0	
9831	chr2	12722143	12722864	721	360.0	
9832	chr2	12727721	12729131	1410	705.0	
9833	chr2	12731830	12732322	492	246.0	
9834	chr2	12797841	12798218	377	188.0	
9835	chr2	12855520	12855948	428	214.0	
9836	chr2	12856574	12857584	1010	505.0	
9837	chr2	12861373	12861962	589	294.0	
9838	chr2	12897295	12897489	194	97.0	
9839	chr2	12931177	12931649	472	236.0	
9840	chr2	12965377	12965875	498	249.0	
9841	chr2	13006836	13007348	512	256.0	
9842	chr2	14903795	14904130	335	168.0	
9843	chr2	15038378	15038684	306	153.0	
9844	chr2	15141950	15142792	842	421.0	
9845	chr2	15176895	15177620	725	362.0	
9846	chr2	15178989	15179298	309	154.0	
9847	chr2	15316166	15317052	886	443.0	
9848	chr2	15518566	15518780	214	107.0	
9849	chr2	15560299	15562281	1982	991.0	
9850	chr2	15576859	15577591	732	366.0	
9851	chr2	15588421	15588698	277	138.0	
9852	chr2	15591300	15592699	1399	700.0	
9853	chr2	15637212	15637702	490	245.0	
9854	chr2	15939649	15940234	585	292.0	
9855	chr2	15965611	15966547	936	468.0	
9856	chr2	16005881	16006731	850	425.0	
9857	chr2	16508190	16508586	396	198.0	
9858	chr2	16525281	16525637	356	178.0	
9859	chr2	16553226	16553650	424	212.0	
9860	chr2	16584875	16585597	722	361.0	
9861	chr2	16608517	16609640	1123	562.0	
9862	chr2	16610753	16610768	15	8.0	
9863	chr2	16613472	16613840	368	184.0	
9864	chr2	16617224	16617802	578	289.0	
9865	chr2	16622527	16623535	1008	504.0	
9866	chr2	16625039	16627051	2012	1006.0	
9867	chr2	16628266	16628718	452	226.0	
9868	chr2	16630383	16631238	855	428.0	
9869	chr2	16633402	16634247	845	422.0	
9870	chr2	16635763	16636478	715	358.0	
9871	chr2	16649357	16651438	2081	1040.0	
9872	chr2	16653320	16655604	2284	1142.0	
9873	chr2	16656272	16659094	2822	1411.0	
9874	chr2	16660049	16660666	617	308.0	
9875	chr2	16662620	16662682	62	31.0	
9876	chr2	16663424	16667044	3620	1810.0	
9877	chr2	16680322	16681098	776	388.0	
9878	chr2	16687882	16688377	495	248.0	
9879	chr2	16700448	16700946	498	249.0	
9880	chr2	16709716	16710447	731	366.0	
9881	chr2	16713084	16713438	354	177.0	
9882	chr2	16716220	16716392	172	86.0	
9883	chr2	16717470	16717974	504	252.0	
9884	chr2	16729377	16729603	226	113.0	
9885	chr2	16756952	16757628	676	338.0	
9886	chr2	16760416	16761128	712	356.0	
9887	chr2	16763340	16764477	1137	568.0	
9888	chr2	16773080	16773515	435	218.0	
9889	chr2	16775497	16775967	470	235.0	
9890	chr2	16833018	16833034	16	8.0	
9891	chr2	16861099	16862983	1884	942.0	
9892	chr2	16871356	16871723	367	184.0	
9893	chr2	16900421	16900762	341	170.0	
9894	chr2	16960688	16960907	219	110.0	
9895	chr2	17202732	17203123	391	196.0	
9896	chr2	17643379	17643514	135	68.0	
9897	chr2	17645986	17646664	678	339.0	
9898	chr2	17671064	17671398	334	167.0	
9899	chr2	17719552	17719957	405	202.0	
9900	chr2	17750028	17750140	112	56.0	
9901	chr2	17752238	17755049	2811	1406.0	
9902	chr2	17759926	17760036	110	55.0	
9903	chr2	17804293	17804854	561	280.0	
9904	chr2	17805434	17805559	125	62.0	
9905	chr2	17813163	17814047	884	442.0	
9906	chr2	17830489	17830965	476	238.0	
9907	chr2	17851960	17852051	91	46.0	
9908	chr2	17877724	17878888	1164	582.0	
9909	chr2	18387654	18388097	443	222.0	
9910	chr2	18520470	18520959	489	244.0	
9911	chr2	18559379	18561360	1981	990.0	
9912	chr2	19347169	19352772	5603	2802.0	
9913	chr2	19354413	19354748	335	168.0	
9914	chr2	19355507	19359317	3810	1905.0	
9915	chr2	19360121	19364641	4520	2260.0	
9916	chr2	19365287	19365679	392	196.0	
9917	chr2	19366641	19366999	358	179.0	
9918	chr2	19474022	19474610	588	294.0	
9919	chr2	19786686	19786782	96	48.0	
9920	chr2	19863157	19864012	855	428.0	
9921	chr2	19868248	19869533	1285	642.0	
9922	chr2	19891766	19892422	656	328.0	
9923	chr2	19899860	19902726	2866	1433.0	
9924	chr2	19955780	19956256	476	238.0	
9925	chr2	19971603	19972207	604	302.0	
9926	chr2	19987971	19988333	362	181.0	
9927	chr2	19989393	19990678	1285	642.0	
9928	chr2	20012157	20013520	1363	682.0	
9929	chr2	20015466	20015939	473	236.0	
9930	chr2	20036254	20036655	401	200.0	
9931	chr2	20049394	20053195	3801	1900.0	
9932	chr2	20066243	20066644	401	200.0	
9933	chr2	20097939	20098633	694	347.0	
9934	chr2	20106714	20107123	409	204.0	
9935	chr2	20185696	20186918	1222	611.0	
9936	chr2	20224669	20225619	950	475.0	
9937	chr2	20242113	20243017	904	452.0	
9938	chr2	20247270	20247455	185	92.0	
9939	chr2	20291003	20291435	432	216.0	
9940	chr2	20305326	20305756	430	215.0	
9941	chr2	20326085	20326602	517	258.0	
9942	chr2	20330177	20330529	352	176.0	
9943	chr2	20333787	20334156	369	184.0	
9944	chr2	20344763	20345266	503	252.0	
9945	chr2	20346771	20346937	166	83.0	
9946	chr2	20348610	20348999	389	194.0	
9947	chr2	20349870	20352580	2710	1355.0	
9948	chr2	20357557	20358188	631	316.0	
9949	chr2	20365249	20365718	469	234.0	
9950	chr2	20378999	20379424	425	212.0	
9951	chr2	20395965	20396430	465	232.0	
9952	chr2	20411188	20411963	775	388.0	
9953	chr2	20423797	20425773	1976	988.0	
9954	chr2	20429445	20430067	622	311.0	
9955	chr2	20430822	20431274	452	226.0	
9956	chr2	20438287	20440225	1938	969.0	
9957	chr2	20443231	20443654	423	212.0	
9958	chr2	20445433	20451086	5653	2826.0	
9959	chr2	20452821	20452964	143	72.0	
9960	chr2	20494101	20494553	452	226.0	
9961	chr2	20576229	20577368	1139	570.0	
9962	chr2	20595256	20596792	1536	768.0	
9963	chr2	20617865	20618686	821	410.0	
9964	chr2	20635755	20636223	468	234.0	
9965	chr2	20642133	20643039	906	453.0	
9966	chr2	20649743	20651999	2256	1128.0	
9967	chr2	20660758	20662280	1522	761.0	
9968	chr2	20663379	20663954	575	288.0	
9969	chr2	20665151	20667808	2657	1328.0	
9970	chr2	20669562	20670019	457	228.0	
9971	chr2	20672339	20672530	191	96.0	
9972	chr2	20675703	20677687	1984	992.0	
9973	chr2	20699164	20699710	546	273.0	
9974	chr2	20821785	20823594	1809	904.0	
9975	chr2	20962883	20963404	521	260.0	
9976	chr2	21042845	21043279	434	217.0	"enhancer	region	enhancer	enhancer	protein_binding_site	protein_binding_site"
9977	chr2	21231728	21232507	779	390.0	
9978	chr2	21233187	21233558	371	186.0	
9979	chr2	21255772	21256619	847	424.0	
9980	chr2	21317141	21317540	399	200.0	
9981	chr2	22273831	22274230	399	200.0	
9982	chr2	22276617	22277201	584	292.0	
9983	chr2	22281043	22281505	462	231.0	
9984	chr2	22282183	22282646	463	232.0	
9985	chr2	23351516	23351929	413	206.0	
9986	chr2	23375528	23375782	254	127.0	
9987	chr2	23380520	23381784	1264	632.0	
9988	chr2	23384629	23387397	2768	1384.0	
9989	chr2	23404483	23404764	281	140.0	
9990	chr2	23452775	23453450	675	338.0	
9991	chr2	23526180	23526421	241	120.0	
9992	chr2	23532220	23533371	1151	576.0	
9993	chr2	23545320	23545711	391	196.0	
9994	chr2	23757694	23758029	335	168.0	
9995	chr2	23767854	23768570	716	358.0	
9996	chr2	23788084	23788492	408	204.0	
9997	chr2	23801406	23801807	401	200.0	
9998	chr2	23824657	23825290	633	316.0	
9999	chr2	23826102	23826415	313	156.0	
10000	chr2	23891583	23892518	935	468.0	
10001	chr2	23900899	23901272	373	186.0	
10002	chr2	23902360	23902775	415	208.0	
10003	chr2	23916679	23916997	318	159.0	
10004	chr2	23925555	23928290	2735	1368.0	
10005	chr2	23939067	23941445	2378	1189.0	
10006	chr2	23988366	23988749	383	192.0	
10007	chr2	24009772	24010389	617	308.0	
10008	chr2	24021518	24021695	177	88.0	
10009	chr2	24046778	24048121	1343	672.0	
10010	chr2	24048883	24050850	1967	984.0	
10011	chr2	24060826	24061276	450	225.0	
10012	chr2	24075618	24077958	2340	1170.0	
10013	chr2	24081305	24081974	669	334.0	
10014	chr2	24083583	24085331	1748	874.0	
10015	chr2	24122791	24124259	1468	734.0	
10016	chr2	24164435	24165013	578	289.0	
10017	chr2	24315649	24315978	329	164.0	
10018	chr2	24329670	24330278	608	304.0	
10019	chr2	24343209	24343653	444	222.0	
10020	chr2	24354239	24355636	1397	698.0	
10021	chr2	24358155	24358170	15	8.0	
10022	chr2	24359155	24361418	2263	1132.0	
10023	chr2	24363342	24363721	379	190.0	
10024	chr2	24364771	24365610	839	420.0	
10025	chr2	24382192	24382854	662	331.0	
10026	chr2	24409873	24410381	508	254.0	
10027	chr2	24421623	24422069	446	223.0	
10028	chr2	24448545	24449287	742	371.0	
10029	chr2	24452086	24452816	730	365.0	
10030	chr2	24456628	24457078	450	225.0	
10031	chr2	24461742	24462133	391	196.0	
10032	chr2	24471679	24472061	382	191.0	
10033	chr2	24482171	24483339	1168	584.0	
10034	chr2	24489683	24494294	4611	2306.0	
10035	chr2	24508940	24509692	752	376.0	
10036	chr2	24516071	24516131	60	30.0	
10037	chr2	24517321	24517685	364	182.0	
10038	chr2	24538731	24539090	359	180.0	
10039	chr2	24586303	24587351	1048	524.0	
10040	chr2	24613031	24613696	665	332.0	
10041	chr2	24632182	24632593	411	206.0	
10042	chr2	24652579	24653098	519	260.0	
10043	chr2	24690541	24690777	236	118.0	
10044	chr2	24739299	24740063	764	382.0	
10045	chr2	24744188	24744226	38	19.0	
10046	chr2	24745826	24746225	399	200.0	
10047	chr2	24785584	24786376	792	396.0	
10048	chr2	24791076	24791399	323	162.0	
10049	chr2	24792471	24794170	1699	850.0	
10050	chr2	24825007	24825408	401	200.0	
10051	chr2	24826402	24826565	163	82.0	
10052	chr2	24827184	24828236	1052	526.0	
10053	chr2	24886556	24887458	902	451.0	
10054	chr2	24918917	24921594	2677	1338.0	
10055	chr2	24926413	24927438	1025	512.0	
10056	chr2	24970707	24973150	2443	1222.0	
10057	chr2	24975388	24975928	540	270.0	
10058	chr2	25030743	25031047	304	152.0	
10059	chr2	25041181	25043694	2513	1256.0	
10060	chr2	25098853	25099139	286	143.0	
10061	chr2	25126252	25126295	43	22.0	
10062	chr2	25128899	25129873	974	487.0	
10063	chr2	25131466	25132368	902	451.0	
10064	chr2	25160962	25162070	1108	554.0	
10065	chr2	25165872	25166472	600	300.0	
10066	chr2	25168022	25169063	1041	520.0	"promoter	TATA_box	region	protein_binding_site	protein_binding_site	protein_binding_site	enhancer	region	protein_binding_site	region	protein_binding_site	protein_binding_site"
10067	chr2	25196159	25197025	866	433.0	
10068	chr2	25204215	25204893	678	339.0	
10069	chr2	25206980	25207610	630	315.0	
10070	chr2	25209903	25210828	925	462.0	
10071	chr2	25214575	25216711	2136	1068.0	
10072	chr2	25226329	25226810	481	240.0	
10073	chr2	25228708	25229365	657	328.0	
10074	chr2	25250588	25253121	2533	1266.0	
10075	chr2	25265695	25266404	709	354.0	
10076	chr2	25273008	25277970	4962	2481.0	
10077	chr2	25278829	25280822	1993	996.0	
10078	chr2	25285543	25286903	1360	680.0	
10079	chr2	25294046	25296052	2006	1003.0	
10080	chr2	25301277	25302363	1086	543.0	
10081	chr2	25304543	25305929	1386	693.0	
10082	chr2	25306730	25307328	598	299.0	
10083	chr2	25309299	25309833	534	267.0	
10084	chr2	25312959	25316887	3928	1964.0	
10085	chr2	25322677	25323930	1253	626.0	
10086	chr2	25333970	25334606	636	318.0	
10087	chr2	25337117	25338106	989	494.0	
10088	chr2	25339337	25343190	3853	1926.0	
10089	chr2	25350328	25350566	238	119.0	
10090	chr2	25361571	25363547	1976	988.0	
10091	chr2	25376303	25377889	1586	793.0	
10092	chr2	25399569	25399867	298	149.0	
10093	chr2	25402713	25402768	55	28.0	
10094	chr2	25403330	25403911	581	290.0	
10095	chr2	25409531	25409825	294	147.0	
10096	chr2	25410489	25410647	158	79.0	
10097	chr2	25419551	25420137	586	293.0	
10098	chr2	25420740	25422450	1710	855.0	
10099	chr2	25483521	25484278	757	378.0	
10100	chr2	25521877	25522809	932	466.0	
10101	chr2	25551574	25551621	47	24.0	
10102	chr2	25557630	25558980	1350	675.0	
10103	chr2	25566649	25567859	1210	605.0	
10104	chr2	25582090	25582906	816	408.0	
10105	chr2	25587407	25587709	302	151.0	
10106	chr2	25591793	25592568	775	388.0	
10107	chr2	25606913	25607290	377	188.0	
10108	chr2	25609703	25609887	184	92.0	
10109	chr2	25649863	25650513	650	325.0	
10110	chr2	25664630	25665101	471	236.0	
10111	chr2	25672459	25674632	2173	1086.0	
10112	chr2	25700124	25700541	417	208.0	
10113	chr2	25712104	25712189	85	42.0	
10114	chr2	25741035	25741250	215	108.0	
10115	chr2	25743099	25743793	694	347.0	
10116	chr2	25756444	25756876	432	216.0	
10117	chr2	25790121	25790522	401	200.0	
10118	chr2	25794482	25795214	732	366.0	
10119	chr2	25816247	25816623	376	188.0	
10120	chr2	25822081	25822677	596	298.0	
10121	chr2	25825229	25825635	406	203.0	
10122	chr2	25831711	25832209	498	249.0	
10123	chr2	25851597	25852362	765	382.0	
10124	chr2	25853055	25853664	609	304.0	
10125	chr2	25877109	25879317	2208	1104.0	
10126	chr2	25897735	25897776	41	20.0	
10127	chr2	25916202	25916945	743	372.0	
10128	chr2	25950910	25951591	681	340.0	
10129	chr2	25960792	25961442	650	325.0	
10130	chr2	25981769	25983209	1440	720.0	
10131	chr2	25991146	25992332	1186	593.0	
10132	chr2	25997695	25998171	476	238.0	
10133	chr2	26001935	26003618	1683	842.0	
10134	chr2	26008536	26009799	1263	632.0	
10135	chr2	26011781	26012917	1136	568.0	
10136	chr2	26016361	26016933	572	286.0	
10137	chr2	26018033	26018550	517	258.0	
10138	chr2	26032969	26036290	3321	1660.0	
10139	chr2	26044072	26044832	760	380.0	
10140	chr2	26068506	26069129	623	312.0	
10141	chr2	26086045	26086695	650	325.0	
10142	chr2	26088028	26088483	455	228.0	
10143	chr2	26144991	26145499	508	254.0	
10144	chr2	26171425	26174074	2649	1324.0	
10145	chr2	26174721	26174976	255	128.0	
10146	chr2	26178715	26179816	1101	550.0	
10147	chr2	26184208	26185657	1449	724.0	
10148	chr2	26186286	26186534	248	124.0	
10149	chr2	26196893	26197440	547	274.0	
10150	chr2	26240896	26241283	387	194.0	
10151	chr2	26242878	26246221	3343	1672.0	
10152	chr2	26255980	26256390	410	205.0	
10153	chr2	26268459	26270194	1735	868.0	
10154	chr2	26274000	26274436	436	218.0	
10155	chr2	26298354	26300567	2213	1106.0	
10156	chr2	26329917	26330694	777	388.0	
10157	chr2	26344991	26347755	2764	1382.0	
10158	chr2	26382721	26382935	214	107.0	
10159	chr2	26401694	26402109	415	208.0	
10160	chr2	26412141	26412725	584	292.0	
10161	chr2	26455393	26456308	915	458.0	
10162	chr2	26462603	26462811	208	104.0	
10163	chr2	26469119	26469525	406	203.0	
10164	chr2	26477558	26477667	109	54.0	
10165	chr2	26493152	26494228	1076	538.0	
10166	chr2	26503101	26504096	995	498.0	
10167	chr2	26519642	26519996	354	177.0	
10168	chr2	26562280	26562761	481	240.0	
10169	chr2	26577748	26578229	481	240.0	
10170	chr2	26605409	26605823	414	207.0	
10171	chr2	26608608	26608887	279	140.0	
10172	chr2	26610018	26610198	180	90.0	
10173	chr2	26619523	26619753	230	115.0	
10174	chr2	26692388	26693122	734	367.0	
10175	chr2	26728478	26728591	113	56.0	
10176	chr2	26740768	26741268	500	250.0	
10177	chr2	26745681	26746178	497	248.0	
10178	chr2	26763668	26765548	1880	940.0	
10179	chr2	26767019	26767462	443	222.0	
10180	chr2	26768743	26769775	1032	516.0	
10181	chr2	26771000	26771456	456	228.0	
10182	chr2	26772121	26773159	1038	519.0	
10183	chr2	26785251	26787003	1752	876.0	
10184	chr2	26789007	26789256	249	124.0	
10185	chr2	26809952	26810617	665	332.0	
10186	chr2	26846263	26846886	623	312.0	
10187	chr2	26847802	26849966	2164	1082.0	
10188	chr2	26887017	26887541	524	262.0	
10189	chr2	26922668	26923110	442	221.0	
10190	chr2	26942591	26943005	414	207.0	
10191	chr2	26959304	26959732	428	214.0	
10192	chr2	26961470	26962183	713	356.0	
10193	chr2	26969997	26971792	1795	898.0	
10194	chr2	26982324	26982710	386	193.0	
10195	chr2	27010665	27011218	553	276.0	
10196	chr2	27016843	27017254	411	206.0	
10197	chr2	27031958	27034053	2095	1048.0	
10198	chr2	27041924	27042558	634	317.0	
10199	chr2	27049496	27052684	3188	1594.0	
10200	chr2	27070834	27072953	2119	1060.0	
10201	chr2	27074938	27075895	957	478.0	
10202	chr2	27078682	27079056	374	187.0	
10203	chr2	27080685	27082047	1362	681.0	
10204	chr2	27085351	27087521	2170	1085.0	
10205	chr2	27095994	27097380	1386	693.0	
10206	chr2	27098364	27099039	675	338.0	
10207	chr2	27118571	27119471	900	450.0	
10208	chr2	27121913	27122373	460	230.0	
10209	chr2	27122904	27124425	1521	760.0	
10210	chr2	27133454	27135524	2070	1035.0	
10211	chr2	27169638	27170416	778	389.0	
10212	chr2	27191481	27191938	457	228.0	
10213	chr2	27211170	27213377	2207	1104.0	
10214	chr2	27216894	27218308	1414	707.0	
10215	chr2	27250103	27250710	607	304.0	
10216	chr2	27261962	27265488	3526	1763.0	
10217	chr2	27279613	27280633	1020	510.0	
10218	chr2	27296429	27296982	553	276.0	
10219	chr2	27302962	27303869	907	454.0	
10220	chr2	27306331	27307332	1001	500.0	
10221	chr2	27321110	27321415	305	152.0	
10222	chr2	27322059	27323968	1909	954.0	
10223	chr2	27351985	27352068	83	42.0	
10224	chr2	27355857	27357664	1807	904.0	
10225	chr2	27369470	27371959	2489	1244.0	
10226	chr2	27377535	27381644	4109	2054.0	
10227	chr2	27391072	27392368	1296	648.0	
10228	chr2	27408160	27410384	2224	1112.0	
10229	chr2	27427874	27431865	3991	1996.0	
10230	chr2	27442022	27443461	1439	720.0	
10231	chr2	27488991	27490555	1564	782.0	
10232	chr2	27491280	27491629	349	174.0	
10233	chr2	27494576	27497033	2457	1228.0	
10234	chr2	27572355	27573643	1288	644.0	
10235	chr2	27581248	27583873	2625	1312.0	
10236	chr2	27626879	27627292	413	206.0	
10237	chr2	27627917	27629617	1700	850.0	
10238	chr2	27638109	27638464	355	178.0	
10239	chr2	27662959	27664662	1703	852.0	
10240	chr2	27667473	27667483	10	5.0	
10241	chr2	27683211	27684147	936	468.0	
10242	chr2	27684992	27685512	520	260.0	
10243	chr2	27703514	27704334	820	410.0	
10244	chr2	27705897	27706394	497	248.0	
10245	chr2	27715144	27716215	1071	536.0	
10246	chr2	27720118	27720541	423	212.0	
10247	chr2	27723275	27723699	424	212.0	
10248	chr2	27727145	27727662	517	258.0	
10249	chr2	27735186	27736197	1011	506.0	
10250	chr2	27754042	27754891	849	424.0	
10251	chr2	27756688	27757402	714	357.0	
10252	chr2	27764383	27765038	655	328.0	
10253	chr2	27765558	27766498	940	470.0	
10254	chr2	27771062	27772479	1417	708.0	
10255	chr2	27796806	27797425	619	310.0	
10256	chr2	27798437	27799325	888	444.0	
10257	chr2	27809643	27810342	699	350.0	
10258	chr2	27831235	27832868	1633	816.0	
10259	chr2	27854294	27854730	436	218.0	
10260	chr2	27889665	27891991	2326	1163.0	
10261	chr2	27892961	27893554	593	296.0	
10262	chr2	27894246	27894543	297	148.0	
10263	chr2	27897534	27898177	643	322.0	
10264	chr2	27914426	27914719	293	146.0	
10265	chr2	27920384	27921043	659	330.0	
10266	chr2	27946732	27946877	145	72.0	
10267	chr2	27954695	27955591	896	448.0	
10268	chr2	27956813	27957381	568	284.0	
10269	chr2	27959370	27960918	1548	774.0	
10270	chr2	27965772	27966314	542	271.0	
10271	chr2	27993345	27993942	597	298.0	
10272	chr2	28047704	28048008	304	152.0	
10273	chr2	28084632	28084973	341	170.0	
10274	chr2	28251357	28251661	304	152.0	
10275	chr2	28273674	28275424	1750	875.0	
10276	chr2	28325900	28326414	514	257.0	
10277	chr2	28340577	28340925	348	174.0	
10278	chr2	28342572	28343640	1068	534.0	
10279	chr2	28347537	28348716	1179	590.0	
10280	chr2	28350977	28351017	40	20.0	
10281	chr2	28355674	28357245	1571	786.0	
10282	chr2	28358207	28361391	3184	1592.0	
10283	chr2	28363906	28364054	148	74.0	
10284	chr2	28365992	28367550	1558	779.0	
10285	chr2	28377992	28379619	1627	814.0	
10286	chr2	28381769	28382156	387	194.0	
10287	chr2	28389140	28421392	32252	16126.0	
10288	chr2	28422591	28425947	3356	1678.0	
10289	chr2	28428030	28428380	350	175.0	
10290	chr2	28430509	28431081	572	286.0	
10291	chr2	28432386	28432678	292	146.0	
10292	chr2	28434315	28434479	164	82.0	
10293	chr2	28437554	28437651	97	48.0	
10294	chr2	28444885	28446319	1434	717.0	
10295	chr2	28447870	28450452	2582	1291.0	
10296	chr2	28452194	28453115	921	460.0	
10297	chr2	28461066	28461447	381	190.0	
10298	chr2	28463791	28464382	591	296.0	
10299	chr2	28469864	28470347	483	242.0	
10300	chr2	28471361	28471502	141	70.0	
10301	chr2	28506603	28506819	216	108.0	
10302	chr2	28508205	28508942	737	368.0	
10303	chr2	28544587	28546310	1723	862.0	
10304	chr2	28547778	28548481	703	352.0	
10305	chr2	28566263	28567654	1391	696.0	
10306	chr2	28583959	28584679	720	360.0	
10307	chr2	28586784	28587386	602	301.0	
10308	chr2	28588057	28588755	698	349.0	
10309	chr2	28594015	28595267	1252	626.0	
10310	chr2	28600050	28600861	811	406.0	
10311	chr2	28601398	28602311	913	456.0	
10312	chr2	28602932	28603429	497	248.0	
10313	chr2	28613127	28614546	1419	710.0	
10314	chr2	28615576	28616186	610	305.0	
10315	chr2	28617540	28617872	332	166.0	
10316	chr2	28619791	28622482	2691	1346.0	
10317	chr2	28623163	28626075	2912	1456.0	
10318	chr2	28647654	28648152	498	249.0	
10319	chr2	28680922	28682002	1080	540.0	
10320	chr2	28708669	28708956	287	144.0	
10321	chr2	28713538	28713977	439	220.0	
10322	chr2	28715900	28718099	2199	1100.0	
10323	chr2	28745998	28746059	61	30.0	
10324	chr2	28747705	28748629	924	462.0	
10325	chr2	28750294	28754721	4427	2214.0	
10326	chr2	28755315	28755871	556	278.0	
10327	chr2	28756590	28757514	924	462.0	
10328	chr2	28758445	28758850	405	202.0	
10329	chr2	28764907	28764909	2	1.0	
10330	chr2	28765674	28765806	132	66.0	
10331	chr2	28770993	28771277	284	142.0	
10332	chr2	28773524	28773616	92	46.0	
10333	chr2	28775618	28775759	141	70.0	
10334	chr2	28784819	28785181	362	181.0	
10335	chr2	28809954	28811456	1502	751.0	
10336	chr2	28821273	28821810	537	268.0	
10337	chr2	28869448	28871230	1782	891.0	
10338	chr2	28893832	28895976	2144	1072.0	
10339	chr2	28951879	28953351	1472	736.0	
10340	chr2	28956489	28956665	176	88.0	
10341	chr2	28958524	28959227	703	352.0	
10342	chr2	28972915	28973354	439	220.0	
10343	chr2	29000159	29002264	2105	1052.0	
10344	chr2	29009299	29013432	4133	2066.0	
10345	chr2	29014037	29016955	2918	1459.0	
10346	chr2	29018159	29018185	26	13.0	
10347	chr2	29066381	29066574	193	96.0	
10348	chr2	29067263	29067364	101	50.0	
10349	chr2	29081181	29081800	619	310.0	
10350	chr2	29113599	29117111	3512	1756.0	
10351	chr2	29119216	29119806	590	295.0	
10352	chr2	29196582	29197240	658	329.0	
10353	chr2	29224065	29224148	83	42.0	
10354	chr2	29309099	29309552	453	226.0	
10355	chr2	29314643	29315654	1011	506.0	
10356	chr2	29316746	29318555	1809	904.0	
10357	chr2	29329961	29330028	67	34.0	
10358	chr2	29480522	29480839	317	158.0	
10359	chr2	29920247	29920459	212	106.0	
10360	chr2	29921437	29922014	577	288.0	
10361	chr2	30072246	30072668	422	211.0	
10362	chr2	30090753	30091270	517	258.0	
10363	chr2	30115589	30116125	536	268.0	
10364	chr2	30138926	30139833	907	454.0	
10365	chr2	30144848	30175500	30652	15326.0	
10366	chr2	30176080	30181547	5467	2734.0	
10367	chr2	30202005	30202372	367	184.0	
10368	chr2	30208329	30209660	1331	666.0	
10369	chr2	30222320	30227341	5021	2510.0	
10370	chr2	30230300	30240834	10534	5267.0	
10371	chr2	30243701	30244825	1124	562.0	
10372	chr2	30248326	30248507	181	90.0	
10373	chr2	30249368	30251361	1993	996.0	
10374	chr2	30251950	30268769	16819	8410.0	
10375	chr2	30271337	30271700	363	182.0	
10376	chr2	30276522	30276827	305	152.0	
10377	chr2	30282005	30282621	616	308.0	
10378	chr2	30287754	30288678	924	462.0	
10379	chr2	30293484	30294027	543	272.0	
10380	chr2	30311060	30311388	328	164.0	
10381	chr2	30315544	30316144	600	300.0	
10382	chr2	30325871	30326117	246	123.0	
10383	chr2	30333106	30333494	388	194.0	
10384	chr2	30334625	30336128	1503	752.0	
10385	chr2	30336656	30338015	1359	680.0	
10386	chr2	30361712	30362314	602	301.0	
10387	chr2	30366259	30366618	359	180.0	
10388	chr2	30421242	30423151	1909	954.0	
10389	chr2	30428791	30429260	469	234.0	
10390	chr2	30436747	30437407	660	330.0	
10391	chr2	30439928	30440200	272	136.0	
10392	chr2	30446509	30448287	1778	889.0	
10393	chr2	30481365	30481920	555	278.0	
10394	chr2	30495887	30496288	401	200.0	
10395	chr2	30503234	30503996	762	381.0	
10396	chr2	30584343	30584441	98	49.0	
10397	chr2	30631302	30631310	8	4.0	
10398	chr2	30702690	30703273	583	292.0	
10399	chr2	30706796	30707612	816	408.0	
10400	chr2	30708819	30709083	264	132.0	
10401	chr2	30711487	30712267	780	390.0	
10402	chr2	30712806	30714722	1916	958.0	
10403	chr2	30715243	30715268	25	12.0	
10404	chr2	30729120	30729300	180	90.0	
10405	chr2	30792487	30792885	398	199.0	
10406	chr2	30862030	30862431	401	200.0	
10407	chr2	30867000	30867426	426	213.0	
10408	chr2	31137858	31138879	1021	510.0	
10409	chr2	31170056	31170537	481	240.0	
10410	chr2	31219016	31220156	1140	570.0	
10411	chr2	31222150	31222458	308	154.0	
10412	chr2	31233280	31234715	1435	718.0	
10413	chr2	31297901	31298035	134	67.0	
10414	chr2	31318379	31320355	1976	988.0	
10415	chr2	31324260	31324703	443	222.0	
10416	chr2	31328136	31328339	203	102.0	
10417	chr2	31333358	31334044	686	343.0	
10418	chr2	31416278	31416638	360	180.0	
10419	chr2	31430140	31430486	346	173.0	
10420	chr2	31523903	31524254	351	176.0	
10421	chr2	31811979	31812577	598	299.0	
10422	chr2	31837410	31837452	42	21.0	
10423	chr2	31888625	31888867	242	121.0	
10424	chr2	31893117	31893563	446	223.0	
10425	chr2	31956847	31957791	944	472.0	
10426	chr2	31980565	31981467	902	451.0	
10427	chr2	31997749	31998119	370	185.0	
10428	chr2	31998713	31999189	476	238.0	
10429	chr2	32006939	32007134	195	98.0	
10430	chr2	32008413	32012144	3731	1866.0	
10431	chr2	32039061	32040500	1439	720.0	
10432	chr2	32062339	32064824	2485	1242.0	
10433	chr2	32069149	32069850	701	350.0	
10434	chr2	32080618	32080951	333	166.0	
10435	chr2	32132756	32133335	579	290.0	
10436	chr2	32135406	32135718	312	156.0	
10437	chr2	32165057	32166578	1521	760.0	
10438	chr2	32261829	32262774	945	472.0	
10439	chr2	32264418	32266089	1671	836.0	
10440	chr2	32277360	32278834	1474	737.0	
10441	chr2	32284255	32284965	710	355.0	
10442	chr2	32289090	32289825	735	368.0	
10443	chr2	32356073	32358797	2724	1362.0	
10444	chr2	32361510	32361823	313	156.0	
10445	chr2	32384464	32384969	505	252.0	
10446	chr2	32484673	32485566	893	446.0	
10447	chr2	32496669	32497264	595	298.0	
10448	chr2	32498339	32498828	489	244.0	
10449	chr2	32553764	32554275	511	256.0	
10450	chr2	32560566	32561259	693	346.0	
10451	chr2	32591747	32592429	682	341.0	
10452	chr2	32614073	32614462	389	194.0	
10453	chr2	32627158	32628724	1566	783.0	
10454	chr2	32756033	32756727	694	347.0	
10455	chr2	32838412	32838780	368	184.0	
10456	chr2	32946168	32948080	1912	956.0	
10457	chr2	33133396	33133650	254	127.0	
10458	chr2	33272019	33272515	496	248.0	
10459	chr2	33275594	33276181	587	294.0	
10460	chr2	33336201	33336892	691	346.0	
10461	chr2	33372965	33373350	385	192.0	
10462	chr2	33395674	33396053	379	190.0	
10463	chr2	33448470	33448838	368	184.0	
10464	chr2	33475240	33478558	3318	1659.0	
10465	chr2	33479469	33479537	68	34.0	
10466	chr2	33484537	33485102	565	282.0	
10467	chr2	33494262	33494648	386	193.0	
10468	chr2	33497099	33497656	557	278.0	
10469	chr2	33502157	33502176	19	10.0	
10470	chr2	33528419	33528712	293	146.0	
10471	chr2	33554791	33555277	486	243.0	
10472	chr2	33583174	33583715	541	270.0	
10473	chr2	33598288	33600170	1882	941.0	
10474	chr2	34096677	34096875	198	99.0	
10475	chr2	35447200	35447601	401	200.0	
10476	chr2	35973139	35973503	364	182.0	
10477	chr2	35978222	35978572	350	175.0	
10478	chr2	36235903	36236152	249	124.0	
10479	chr2	36240210	36241345	1135	568.0	
10480	chr2	36246225	36246939	714	357.0	
10481	chr2	36351647	36352491	844	422.0	
10482	chr2	36353308	36353484	176	88.0	
10483	chr2	36355056	36358276	3220	1610.0	
10484	chr2	36441874	36442148	274	137.0	
10485	chr2	36456105	36456751	646	323.0	
10486	chr2	36461319	36461702	383	192.0	
10487	chr2	36469249	36469458	209	104.0	
10488	chr2	36477834	36478179	345	172.0	
10489	chr2	36479037	36479334	297	148.0	
10490	chr2	36507336	36507735	399	200.0	
10491	chr2	36549301	36549488	187	94.0	
10492	chr2	36553575	36554298	723	362.0	
10493	chr2	36561493	36561912	419	210.0	
10494	chr2	36597237	36598734	1497	748.0	
10495	chr2	36618320	36618764	444	222.0	
10496	chr2	36646248	36646621	373	186.0	
10497	chr2	36664098	36664539	441	220.0	
10498	chr2	36677479	36678356	877	438.0	
10499	chr2	36698927	36699558	631	316.0	
10500	chr2	36705845	36706388	543	272.0	
10501	chr2	36770693	36771118	425	212.0	
10502	chr2	36780203	36780642	439	220.0	
10503	chr2	36785106	36785631	525	262.0	
10504	chr2	36798649	36799204	555	278.0	
10505	chr2	36800255	36801290	1035	518.0	
10506	chr2	36835041	36835452	411	206.0	
10507	chr2	36889803	36890194	391	196.0	
10508	chr2	36915654	36916046	392	196.0	
10509	chr2	36965207	36967530	2323	1162.0	
10510	chr2	37005017	37005635	618	309.0	
10511	chr2	37011244	37011274	30	15.0	
10512	chr2	37012760	37013439	679	340.0	
10513	chr2	37080148	37081513	1365	682.0	
10514	chr2	37083605	37086104	2499	1250.0	
10515	chr2	37089979	37090597	618	309.0	
10516	chr2	37149563	37150013	450	225.0	
10517	chr2	37154814	37155165	351	176.0	
10518	chr2	37155726	37157691	1965	982.0	
10519	chr2	37168320	37168789	469	234.0	
10520	chr2	37189476	37190222	746	373.0	
10521	chr2	37195863	37197471	1608	804.0	
10522	chr2	37201797	37202198	401	200.0	
10523	chr2	37230561	37232600	2039	1020.0	
10524	chr2	37318356	37318795	439	220.0	
10525	chr2	37322570	37326670	4100	2050.0	
10526	chr2	37343419	37346361	2942	1471.0	
10527	chr2	37349207	37349771	564	282.0	
10528	chr2	37376247	37377561	1314	657.0	
10529	chr2	37389904	37391253	1349	674.0	
10530	chr2	37394236	37394722	486	243.0	
10531	chr2	37395827	37396488	661	330.0	
10532	chr2	37414313	37415040	727	364.0	
10533	chr2	37456354	37456951	597	298.0	
10534	chr2	37460294	37460737	443	222.0	
10535	chr2	37523756	37524423	667	334.0	
10536	chr2	37527393	37527695	302	151.0	
10537	chr2	37533186	37533626	440	220.0	
10538	chr2	37535691	37536643	952	476.0	
10539	chr2	37546316	37546785	469	234.0	
10540	chr2	37550216	37550440	224	112.0	
10541	chr2	37555350	37556065	715	358.0	
10542	chr2	37558567	37559146	579	290.0	
10543	chr2	37561611	37561981	370	185.0	
10544	chr2	37568555	37568967	412	206.0	
10545	chr2	37582539	37583464	925	462.0	
10546	chr2	37585070	37586965	1895	948.0	
10547	chr2	37587650	37588165	515	258.0	
10548	chr2	37590350	37590592	242	121.0	
10549	chr2	37599384	37602325	2941	1470.0	
10550	chr2	37614381	37614422	41	20.0	
10551	chr2	37615516	37617522	2006	1003.0	
10552	chr2	37623571	37624964	1393	696.0	
10553	chr2	37625753	37626896	1143	572.0	
10554	chr2	37630699	37631208	509	254.0	
10555	chr2	37633954	37634051	97	48.0	
10556	chr2	37634913	37637871	2958	1479.0	
10557	chr2	37643116	37643651	535	268.0	
10558	chr2	37645308	37646197	889	444.0	
10559	chr2	37647434	37658247	10813	5406.0	
10560	chr2	37662777	37662778	1	0.0	
10561	chr2	37663606	37666351	2745	1372.0	
10562	chr2	37667199	37667393	194	97.0	
10563	chr2	37668380	37673278	4898	2449.0	
10564	chr2	37674776	37675548	772	386.0	
10565	chr2	37683640	37684367	727	364.0	
10566	chr2	37711351	37711891	540	270.0	
10567	chr2	37713285	37713815	530	265.0	
10568	chr2	37758046	37758448	402	201.0	
10569	chr2	37760525	37760879	354	177.0	
10570	chr2	37761914	37762792	878	439.0	
10571	chr2	37764806	37765055	249	124.0	
10572	chr2	37767838	37768879	1041	520.0	
10573	chr2	37769522	37769916	394	197.0	
10574	chr2	37771799	37771986	187	94.0	
10575	chr2	37798226	37798764	538	269.0	
10576	chr2	37819196	37819450	254	127.0	
10577	chr2	37820532	37820930	398	199.0	
10578	chr2	37822647	37823248	601	300.0	
10579	chr2	37825693	37826045	352	176.0	
10580	chr2	37828971	37829895	924	462.0	
10581	chr2	37832374	37833056	682	341.0	
10582	chr2	37849902	37850295	393	196.0	
10583	chr2	37851483	37852425	942	471.0	
10584	chr2	37855103	37855958	855	428.0	
10585	chr2	37868906	37869213	307	154.0	
10586	chr2	37877428	37877911	483	242.0	
10587	chr2	37890847	37891511	664	332.0	
10588	chr2	37892223	37893348	1125	562.0	
10589	chr2	37895178	37895591	413	206.0	
10590	chr2	37911443	37911642	199	100.0	
10591	chr2	37924518	37926085	1567	784.0	
10592	chr2	37928392	37928753	361	180.0	
10593	chr2	37934534	37935536	1002	501.0	
10594	chr2	37982079	37982484	405	202.0	
10595	chr2	37987599	37987731	132	66.0	
10596	chr2	38074300	38077585	3285	1642.0	
10597	chr2	38088287	38088657	370	185.0	
10598	chr2	38098276	38098945	669	334.0	
10599	chr2	38106467	38106868	401	200.0	
10600	chr2	38113051	38113472	421	210.0	
10601	chr2	38114233	38115970	1737	868.0	
10602	chr2	38128400	38131206	2806	1403.0	
10603	chr2	38146438	38147265	827	414.0	
10604	chr2	38148367	38149075	708	354.0	
10605	chr2	38152075	38152241	166	83.0	
10606	chr2	38168622	38169243	621	310.0	
10607	chr2	38174480	38175348	868	434.0	
10608	chr2	38176590	38176990	400	200.0	
10609	chr2	38178117	38179651	1534	767.0	
10610	chr2	38184884	38185395	511	256.0	
10611	chr2	38264522	38264884	362	181.0	
10612	chr2	38274576	38275025	449	224.0	
10613	chr2	38315676	38316161	485	242.0	
10614	chr2	38353710	38354071	361	180.0	
10615	chr2	38375791	38378158	2367	1184.0	
10616	chr2	38380061	38381111	1050	525.0	
10617	chr2	38387897	38389242	1345	672.0	
10618	chr2	38465752	38466113	361	180.0	
10619	chr2	38485700	38486178	478	239.0	
10620	chr2	38498211	38498485	274	137.0	
10621	chr2	38508290	38508952	662	331.0	
10622	chr2	38528077	38528409	332	166.0	
10623	chr2	38532992	38533686	694	347.0	
10624	chr2	38535772	38536572	800	400.0	
10625	chr2	38542785	38543453	668	334.0	
10626	chr2	38571213	38571589	376	188.0	
10627	chr2	38578984	38579195	211	106.0	
10628	chr2	38581294	38582140	846	423.0	
10629	chr2	38587697	38588191	494	247.0	
10630	chr2	38590101	38590348	247	124.0	
10631	chr2	38593906	38593910	4	2.0	
10632	chr2	38594612	38596638	2026	1013.0	
10633	chr2	38598331	38599147	816	408.0	
10634	chr2	38599848	38604267	4419	2210.0	
10635	chr2	38607779	38608138	359	180.0	
10636	chr2	38611302	38611881	579	290.0	
10637	chr2	38612904	38613604	700	350.0	
10638	chr2	38619306	38619958	652	326.0	
10639	chr2	38622114	38622706	592	296.0	
10640	chr2	38626306	38626940	634	317.0	
10641	chr2	38634602	38635002	400	200.0	
10642	chr2	38643530	38644191	661	330.0	
10643	chr2	38647999	38648521	522	261.0	
10644	chr2	38652404	38654921	2517	1258.0	
10645	chr2	38663318	38664226	908	454.0	
10646	chr2	38665348	38668083	2735	1368.0	
10647	chr2	38677659	38678284	625	312.0	
10648	chr2	38681730	38683356	1626	813.0	
10649	chr2	38693633	38694034	401	200.0	
10650	chr2	38696730	38698202	1472	736.0	
10651	chr2	38700104	38701151	1047	524.0	
10652	chr2	38708527	38710652	2125	1062.0	
10653	chr2	38713275	38713676	401	200.0	
10654	chr2	38716198	38716638	440	220.0	
10655	chr2	38717284	38717315	31	16.0	
10656	chr2	38720347	38752334	31987	15994.0	
10657	chr2	38754660	38754919	259	130.0	
10658	chr2	38777616	38778872	1256	628.0	
10659	chr2	38791686	38792170	484	242.0	
10660	chr2	38806057	38806393	336	168.0	
10661	chr2	38827600	38828001	401	200.0	
10662	chr2	38830756	38831213	457	228.0	
10663	chr2	38831913	38832667	754	377.0	
10664	chr2	38835069	38836553	1484	742.0	
10665	chr2	38839492	38840014	522	261.0	
10666	chr2	38875135	38876554	1419	710.0	
10667	chr2	38945759	38946348	589	294.0	
10668	chr2	38947596	38948051	455	228.0	
10669	chr2	38959909	38960958	1049	524.0	
10670	chr2	38978522	38978971	449	224.0	
10671	chr2	38997750	38998242	492	246.0	
10672	chr2	39059336	39059747	411	206.0	
10673	chr2	39093288	39093559	271	136.0	
10674	chr2	39118743	39121889	3146	1573.0	
10675	chr2	39123712	39125265	1553	776.0	
10676	chr2	39126902	39129579	2677	1338.0	
10677	chr2	39136731	39136996	265	132.0	
10678	chr2	39140483	39141726	1243	622.0	
10679	chr2	39143264	39143475	211	106.0	
10680	chr2	39216358	39217595	1237	618.0	
10681	chr2	39227830	39229104	1274	637.0	
10682	chr2	39229763	39230469	706	353.0	
10683	chr2	39243765	39244216	451	226.0	
10684	chr2	39244838	39245731	893	446.0	
10685	chr2	39266077	39266473	396	198.0	
10686	chr2	39377370	39377996	626	313.0	
10687	chr2	39379655	39380072	417	208.0	
10688	chr2	39408701	39409268	567	284.0	
10689	chr2	39435290	39435402	112	56.0	
10690	chr2	39436032	39438418	2386	1193.0	
10691	chr2	39469850	39470291	441	220.0	
10692	chr2	39474695	39474783	88	44.0	
10693	chr2	39476422	39477010	588	294.0	
10694	chr2	39483594	39483878	284	142.0	
10695	chr2	39488403	39488922	519	260.0	
10696	chr2	39491797	39493201	1404	702.0	
10697	chr2	39504161	39504805	644	322.0	
10698	chr2	39513612	39514053	441	220.0	
10699	chr2	39527165	39527440	275	138.0	
10700	chr2	39625638	39626016	378	189.0	
10701	chr2	39778272	39779973	1701	850.0	
10702	chr2	39780722	39781412	690	345.0	
10703	chr2	39913562	39913968	406	203.0	
10704	chr2	40029131	40029361	230	115.0	
10705	chr2	40037301	40037795	494	247.0	
10706	chr2	40042017	40042357	340	170.0	
10707	chr2	40148252	40148826	574	287.0	
10708	chr2	40167952	40168294	342	171.0	
10709	chr2	40220249	40220465	216	108.0	
10710	chr2	40287857	40287967	110	55.0	
10711	chr2	40332342	40332638	296	148.0	
10712	chr2	40384676	40385179	503	252.0	
10713	chr2	40394021	40395060	1039	520.0	
10714	chr2	40431419	40431982	563	282.0	
10715	chr2	40440772	40441220	448	224.0	
10716	chr2	40446151	40446500	349	174.0	
10717	chr2	40448501	40448811	310	155.0	
10718	chr2	40449900	40452545	2645	1322.0	
10719	chr2	40454326	40454726	400	200.0	
10720	chr2	40455381	40456201	820	410.0	
10721	chr2	40471211	40472154	943	472.0	
10722	chr2	40474275	40474612	337	168.0	
10723	chr2	40479749	40480700	951	476.0	
10724	chr2	40482248	40483923	1675	838.0	
10725	chr2	40487504	40488668	1164	582.0	
10726	chr2	40489323	40489823	500	250.0	
10727	chr2	40511700	40512312	612	306.0	
10728	chr2	40554680	40555109	429	214.0	
10729	chr2	40558726	40559240	514	257.0	
10730	chr2	40564147	40564560	413	206.0	
10731	chr2	40668453	40668825	372	186.0	
10732	chr2	40760065	40760404	339	170.0	
10733	chr2	40957442	40958017	575	288.0	
10734	chr2	41456225	41456666	441	220.0	
10735	chr2	41715445	41716061	616	308.0	
10736	chr2	41718801	41719038	237	118.0	
10737	chr2	41720327	41720664	337	168.0	
10738	chr2	41735719	41736699	980	490.0	
10739	chr2	41782591	41782721	130	65.0	
10740	chr2	41837062	41837117	55	28.0	
10741	chr2	41840331	41841823	1492	746.0	
10742	chr2	41853663	41853981	318	159.0	
10743	chr2	41869621	41870358	737	368.0	
10744	chr2	41896223	41897185	962	481.0	
10745	chr2	41922264	41922497	233	116.0	
10746	chr2	41953600	41953972	372	186.0	
10747	chr2	41966742	41967452	710	355.0	
10748	chr2	42047128	42048842	1714	857.0	
10749	chr2	42060575	42061032	457	228.0	
10750	chr2	42086233	42087039	806	403.0	
10751	chr2	42089269	42089786	517	258.0	
10752	chr2	42092254	42092700	446	223.0	
10753	chr2	42095723	42107158	11435	5718.0	
10754	chr2	42108196	42108252	56	28.0	
10755	chr2	42110509	42110623	114	57.0	
10756	chr2	42113937	42114680	743	372.0	
10757	chr2	42117835	42118853	1018	509.0	
10758	chr2	42123450	42124909	1459	730.0	
10759	chr2	42125795	42129857	4062	2031.0	
10760	chr2	42132246	42134166	1920	960.0	
10761	chr2	42135510	42136570	1060	530.0	
10762	chr2	42141379	42142457	1078	539.0	
10763	chr2	42168494	42172228	3734	1867.0	
10764	chr2	42173536	42173622	86	43.0	
10765	chr2	42183760	42184243	483	242.0	
10766	chr2	42192755	42193980	1225	612.0	
10767	chr2	42196390	42197342	952	476.0	
10768	chr2	42216015	42216021	6	3.0	
10769	chr2	42216746	42217072	326	163.0	
10770	chr2	42238651	42239161	510	255.0	
10771	chr2	42250861	42251353	492	246.0	
10772	chr2	42256598	42257007	409	204.0	
10773	chr2	42267540	42267900	360	180.0	
10774	chr2	42296360	42296591	231	116.0	
10775	chr2	42297158	42297932	774	387.0	
10776	chr2	42315202	42315341	139	70.0	
10777	chr2	42328440	42328580	140	70.0	
10778	chr2	42342140	42342529	389	194.0	
10779	chr2	42359203	42362462	3259	1630.0	
10780	chr2	42367006	42367042	36	18.0	
10781	chr2	42493005	42495613	2608	1304.0	
10782	chr2	42513449	42513613	164	82.0	
10783	chr2	42547157	42547421	264	132.0	
10784	chr2	42566094	42566381	287	144.0	
10785	chr2	42567897	42569595	1698	849.0	
10786	chr2	42648781	42649551	770	385.0	
10787	chr2	42651999	42652561	562	281.0	
10788	chr2	42663054	42664165	1111	556.0	
10789	chr2	42693010	42694447	1437	718.0	
10790	chr2	42722329	42723105	776	388.0	
10791	chr2	42725612	42726013	401	200.0	
10792	chr2	42752013	42755761	3748	1874.0	
10793	chr2	42763915	42764553	638	319.0	
10794	chr2	42770477	42771229	752	376.0	
10795	chr2	42788043	42788244	201	100.0	
10796	chr2	42791854	42793814	1960	980.0	
10797	chr2	42804140	42804910	770	385.0	
10798	chr2	42809463	42811963	2500	1250.0	
10799	chr2	42812896	42814138	1242	621.0	
10800	chr2	42827487	42829450	1963	982.0	
10801	chr2	42835872	42836757	885	442.0	
10802	chr2	42858901	42859371	470	235.0	
10803	chr2	42907152	42907270	118	59.0	
10804	chr2	42946636	42947273	637	318.0	
10805	chr2	42948270	42948470	200	100.0	
10806	chr2	42949163	42949532	369	184.0	
10807	chr2	42961438	42962903	1465	732.0	
10808	chr2	42967978	42968421	443	222.0	
10809	chr2	42974899	42976806	1907	954.0	
10810	chr2	43014417	43015049	632	316.0	
10811	chr2	43018226	43018861	635	318.0	
10812	chr2	43021315	43021553	238	119.0	
10813	chr2	43024452	43025075	623	312.0	
10814	chr2	43026168	43026237	69	34.0	
10815	chr2	43027056	43027608	552	276.0	
10816	chr2	43040574	43040841	267	134.0	
10817	chr2	43050224	43050607	383	192.0	
10818	chr2	43059138	43060035	897	448.0	
10819	chr2	43086642	43086650	8	4.0	
10820	chr2	43097459	43098191	732	366.0	
10821	chr2	43105460	43108249	2789	1394.0	
10822	chr2	43109146	43110004	858	429.0	
10823	chr2	43124591	43124975	384	192.0	
10824	chr2	43126882	43137814	10932	5466.0	
10825	chr2	43139603	43140442	839	420.0	
10826	chr2	43142869	43143350	481	240.0	
10827	chr2	43144288	43144628	340	170.0	
10828	chr2	43149475	43149891	416	208.0	
10829	chr2	43157760	43160769	3009	1504.0	
10830	chr2	43161755	43161862	107	54.0	
10831	chr2	43167813	43172333	4520	2260.0	
10832	chr2	43172906	43176542	3636	1818.0	
10833	chr2	43178327	43179501	1174	587.0	
10834	chr2	43184176	43184809	633	316.0	
10835	chr2	43185793	43186024	231	116.0	
10836	chr2	43186683	43187668	985	492.0	
10837	chr2	43191484	43192662	1178	589.0	
10838	chr2	43193213	43195995	2782	1391.0	
10839	chr2	43196689	43197701	1012	506.0	
10840	chr2	43199681	43200403	722	361.0	
10841	chr2	43201274	43202078	804	402.0	
10842	chr2	43203768	43203812	44	22.0	
10843	chr2	43205950	43206192	242	121.0	
10844	chr2	43207392	43207971	579	290.0	
10845	chr2	43209295	43211283	1988	994.0	
10846	chr2	43212343	43214780	2437	1218.0	
10847	chr2	43217386	43230261	12875	6438.0	enhancer
10848	chr2	43233435	43234302	867	434.0	
10849	chr2	43239805	43240902	1097	548.0	
10850	chr2	43245012	43245137	125	62.0	
10851	chr2	43262977	43263295	318	159.0	
10852	chr2	43266658	43267094	436	218.0	
10853	chr2	43268667	43269368	701	350.0	
10854	chr2	43288661	43289173	512	256.0	
10855	chr2	43293531	43294452	921	460.0	
10856	chr2	43302883	43303603	720	360.0	
10857	chr2	43304898	43306134	1236	618.0	
10858	chr2	43331382	43331665	283	142.0	
10859	chr2	43333522	43333999	477	238.0	
10860	chr2	43367059	43367227	168	84.0	
10861	chr2	43387295	43387432	137	68.0	
10862	chr2	43407957	43408940	983	492.0	
10863	chr2	43424842	43425193	351	176.0	
10864	chr2	43426234	43427145	911	456.0	
10865	chr2	43439033	43439195	162	81.0	
10866	chr2	43456207	43456674	467	234.0	
10867	chr2	43459320	43459880	560	280.0	
10868	chr2	43461710	43462072	362	181.0	
10869	chr2	43482180	43483279	1099	550.0	
10870	chr2	43484259	43484724	465	232.0	
10871	chr2	43519655	43520231	576	288.0	
10872	chr2	43537077	43537661	584	292.0	
10873	chr2	43539816	43540550	734	367.0	
10874	chr2	43542284	43542811	527	264.0	
10875	chr2	43566020	43566369	349	174.0	
10876	chr2	43577251	43577693	442	221.0	
10877	chr2	43595236	43597167	1931	966.0	
10878	chr2	43605051	43605370	319	160.0	
10879	chr2	43609255	43609760	505	252.0	
10880	chr2	43612385	43612952	567	284.0	
10881	chr2	43636537	43638216	1679	840.0	
10882	chr2	43773735	43774717	982	491.0	
10883	chr2	43877840	43878319	479	240.0	
10884	chr2	43950449	43950770	321	160.0	
10885	chr2	43995157	43996928	1771	886.0	
10886	chr2	44044094	44044798	704	352.0	
10887	chr2	44083007	44083065	58	29.0	
10888	chr2	44086895	44087982	1087	544.0	
10889	chr2	44090624	44090921	297	148.0	
10890	chr2	44100234	44100931	697	348.0	
10891	chr2	44120355	44120944	589	294.0	
10892	chr2	44167369	44170767	3398	1699.0	
10893	chr2	44181634	44181868	234	117.0	
10894	chr2	44183833	44184567	734	367.0	
10895	chr2	44186788	44187310	522	261.0	
10896	chr2	44189121	44189508	387	194.0	
10897	chr2	44191307	44192107	800	400.0	
10898	chr2	44236172	44237855	1683	842.0	
10899	chr2	44244001	44244703	702	351.0	
10900	chr2	44342858	44343234	376	188.0	
10901	chr2	44358525	44358902	377	188.0	
10902	chr2	44360737	44363263	2526	1263.0	
10903	chr2	44479169	44479879	710	355.0	
10904	chr2	44550660	44550904	244	122.0	
10905	chr2	44568666	44568822	156	78.0	
10906	chr2	44578396	44579238	842	421.0	
10907	chr2	44593503	44593904	401	200.0	
10908	chr2	44616604	44617040	436	218.0	
10909	chr2	44708239	44708785	546	273.0	
10910	chr2	44713272	44713513	241	120.0	
10911	chr2	44729788	44729941	153	76.0	
10912	chr2	44753566	44753805	239	120.0	
10913	chr2	44777492	44777921	429	214.0	
10914	chr2	44778434	44779216	782	391.0	
10915	chr2	44941403	44942090	687	344.0	
10916	chr2	44943606	44943624	18	9.0	
10917	chr2	44952164	44952576	412	206.0	
10918	chr2	44955524	44956078	554	277.0	
10919	chr2	44981613	44982004	391	196.0	
10920	chr2	45014103	45014331	228	114.0	
10921	chr2	45130704	45131193	489	244.0	
10922	chr2	45134724	45135110	386	193.0	
10923	chr2	45494695	45495076	381	190.0	
10924	chr2	45567387	45568690	1303	652.0	
10925	chr2	45575920	45576196	276	138.0	
10926	chr2	45578408	45578901	493	246.0	
10927	chr2	45584028	45584404	376	188.0	
10928	chr2	45585208	45585751	543	272.0	
10929	chr2	45606788	45607209	421	210.0	
10930	chr2	45610241	45612477	2236	1118.0	
10931	chr2	45637378	45637866	488	244.0	
10932	chr2	45643192	45644439	1247	624.0	
10933	chr2	45649436	45654667	5231	2616.0	
10934	chr2	45681710	45681868	158	79.0	
10935	chr2	45695613	45695958	345	172.0	
10936	chr2	45700291	45700740	449	224.0	
10937	chr2	45721188	45721525	337	168.0	
10938	chr2	45724287	45724867	580	290.0	
10939	chr2	45725790	45726017	227	114.0	
10940	chr2	45728376	45729058	682	341.0	
10941	chr2	45729597	45730477	880	440.0	
10942	chr2	45765239	45766136	897	448.0	
10943	chr2	45770073	45771890	1817	908.0	
10944	chr2	45776191	45776576	385	192.0	
10945	chr2	45778186	45779081	895	448.0	
10946	chr2	45833717	45834348	631	316.0	
10947	chr2	45836687	45837207	520	260.0	
10948	chr2	45843174	45843581	407	204.0	
10949	chr2	45858135	45858251	116	58.0	
10950	chr2	45860319	45861265	946	473.0	
10951	chr2	45862312	45862366	54	27.0	
10952	chr2	45884202	45884490	288	144.0	
10953	chr2	45888111	45891583	3472	1736.0	
10954	chr2	45892691	45893156	465	232.0	
10955	chr2	45897810	45898386	576	288.0	
10956	chr2	45909635	45910233	598	299.0	
10957	chr2	45919323	45920006	683	342.0	
10958	chr2	45929882	45930497	615	308.0	
10959	chr2	45936101	45936833	732	366.0	
10960	chr2	45985084	45985392	308	154.0	
10961	chr2	45986533	45986841	308	154.0	
10962	chr2	45993351	45993884	533	266.0	
10963	chr2	46053503	46054031	528	264.0	
10964	chr2	46062863	46063355	492	246.0	
10965	chr2	46082555	46083250	695	348.0	
10966	chr2	46097714	46098296	582	291.0	
10967	chr2	46144389	46144893	504	252.0	
10968	chr2	46163056	46163361	305	152.0	
10969	chr2	46174623	46174858	235	118.0	
10970	chr2	46177307	46177965	658	329.0	
10971	chr2	46178856	46179680	824	412.0	
10972	chr2	46187151	46187732	581	290.0	
10973	chr2	46223540	46223874	334	167.0	
10974	chr2	46224663	46225432	769	384.0	
10975	chr2	46229450	46230488	1038	519.0	
10976	chr2	46239106	46240298	1192	596.0	
10977	chr2	46256666	46256784	118	59.0	
10978	chr2	46268164	46268639	475	238.0	
10979	chr2	46275990	46276405	415	208.0	
10980	chr2	46294127	46294578	451	226.0	
10981	chr2	46296378	46300187	3809	1904.0	
10982	chr2	46304541	46305117	576	288.0	
10983	chr2	46315180	46315797	617	308.0	
10984	chr2	46350358	46350609	251	126.0	
10985	chr2	46351288	46352501	1213	606.0	
10986	chr2	46364679	46365316	637	318.0	
10987	chr2	46368461	46368796	335	168.0	
10988	chr2	46369664	46370308	644	322.0	
10989	chr2	46385940	46386670	730	365.0	
10990	chr2	46387373	46387751	378	189.0	
10991	chr2	46388831	46388959	128	64.0	
10992	chr2	46431134	46431579	445	222.0	
10993	chr2	46439349	46440383	1034	517.0	
10994	chr2	46461144	46462550	1406	703.0	
10995	chr2	46464238	46465041	803	402.0	
10996	chr2	46469918	46470958	1040	520.0	
10997	chr2	46477386	46477874	488	244.0	
10998	chr2	46490540	46490893	353	176.0	
10999	chr2	46497774	46498227	453	226.0	
11000	chr2	46499410	46500774	1364	682.0	
11001	chr2	46510610	46511000	390	195.0	
11002	chr2	46521035	46521919	884	442.0	
11003	chr2	46530789	46530872	83	42.0	
11004	chr2	46534467	46536016	1549	774.0	
11005	chr2	46537212	46537349	137	68.0	
11006	chr2	46538284	46538835	551	276.0	
11007	chr2	46541000	46545895	4895	2448.0	
11008	chr2	46547078	46550013	2935	1468.0	
11009	chr2	46552018	46552651	633	316.0	
11010	chr2	46554982	46555438	456	228.0	
11011	chr2	46558824	46559676	852	426.0	
11012	chr2	46561676	46562105	429	214.0	
11013	chr2	46562742	46563737	995	498.0	
11014	chr2	46564931	46565964	1033	516.0	
11015	chr2	46568440	46570140	1700	850.0	
11016	chr2	46601349	46601725	376	188.0	
11017	chr2	46615840	46617834	1994	997.0	
11018	chr2	46632495	46632641	146	73.0	
11019	chr2	46634885	46635302	417	208.0	
11020	chr2	46650456	46650975	519	260.0	
11021	chr2	46656922	46657326	404	202.0	
11022	chr2	46697901	46700609	2708	1354.0	
11023	chr2	46747388	46747789	401	200.0	
11024	chr2	46775772	46775828	56	28.0	
11025	chr2	46841671	46842046	375	188.0	
11026	chr2	46873737	46873943	206	103.0	
11027	chr2	46877003	46877065	62	31.0	
11028	chr2	46889002	46889599	597	298.0	
11029	chr2	46903018	46903371	353	176.0	
11030	chr2	46913845	46916912	3067	1534.0	
11031	chr2	46917520	46918016	496	248.0	
11032	chr2	46918780	46919271	491	246.0	
11033	chr2	46937303	46937986	683	342.0	
11034	chr2	46939506	46944704	5198	2599.0	
11035	chr2	46946025	46946053	28	14.0	
11036	chr2	46951322	46951732	410	205.0	
11037	chr2	46963866	46964431	565	282.0	
11038	chr2	46966877	46968379	1502	751.0	
11039	chr2	46970177	46971294	1117	558.0	
11040	chr2	46974185	46974946	761	380.0	
11041	chr2	46977591	46980222	2631	1316.0	
11042	chr2	46981726	46981874	148	74.0	
11043	chr2	46982991	46987790	4799	2400.0	
11044	chr2	47002389	47003219	830	415.0	
11045	chr2	47016311	47016994	683	342.0	
11046	chr2	47033721	47035980	2259	1130.0	
11047	chr2	47038900	47039597	697	348.0	
11048	chr2	47040122	47040461	339	170.0	
11049	chr2	47056690	47058967	2277	1138.0	
11050	chr2	47065713	47066146	433	216.0	
11051	chr2	47068052	47068156	104	52.0	
11052	chr2	47070525	47075755	5230	2615.0	enhancer
11053	chr2	47078912	47080476	1564	782.0	
11054	chr2	47083096	47084685	1589	794.0	
11055	chr2	47090888	47091255	367	184.0	
11056	chr2	47155430	47156526	1096	548.0	
11057	chr2	47165104	47165563	459	230.0	
11058	chr2	47168644	47168655	11	6.0	
11059	chr2	47172162	47177587	5425	2712.0	
11060	chr2	47179216	47179925	709	354.0	
11061	chr2	47193115	47193360	245	122.0	
11062	chr2	47260070	47260134	64	32.0	
11063	chr2	47271917	47273443	1526	763.0	
11064	chr2	47288767	47289374	607	304.0	
11065	chr2	47296096	47296649	553	276.0	
11066	chr2	47299522	47301353	1831	916.0	
11067	chr2	47309816	47311224	1408	704.0	
11068	chr2	47322906	47323727	821	410.0	
11069	chr2	47335038	47335471	433	216.0	
11070	chr2	47336372	47337333	961	480.0	
11071	chr2	47345273	47345279	6	3.0	
11072	chr2	47388081	47388705	624	312.0	
11073	chr2	47402343	47404107	1764	882.0	
11074	chr2	47457289	47457531	242	121.0	
11075	chr2	47487098	47487627	529	264.0	
11076	chr2	47520679	47521999	1320	660.0	
11077	chr2	47571315	47571645	330	165.0	
11078	chr2	47724060	47724880	820	410.0	
11079	chr2	47752102	47753306	1204	602.0	
11080	chr2	47767679	47768517	838	419.0	
11081	chr2	47782195	47784566	2371	1186.0	
11082	chr2	47785781	47786582	801	400.0	
11083	chr2	47798468	47799738	1270	635.0	
11084	chr2	47857771	47858265	494	247.0	
11085	chr2	47862993	47863013	20	10.0	
11086	chr2	47867328	47867670	342	171.0	
11087	chr2	47870903	47871294	391	196.0	
11088	chr2	47885091	47885527	436	218.0	
11089	chr2	47888462	47889272	810	405.0	
11090	chr2	47894026	47894077	51	26.0	
11091	chr2	47896356	47897638	1282	641.0	
11092	chr2	47898179	47898757	578	289.0	
11093	chr2	47899831	47900524	693	346.0	
11094	chr2	47901890	47902242	352	176.0	
11095	chr2	47904114	47907925	3811	1906.0	
11096	chr2	47917247	47917911	664	332.0	
11097	chr2	47935144	47935438	294	147.0	
11098	chr2	48080740	48081132	392	196.0	
11099	chr2	48106085	48107865	1780	890.0	
11100	chr2	48110916	48112459	1543	772.0	
11101	chr2	48113116	48114812	1696	848.0	
11102	chr2	48116595	48116836	241	120.0	
11103	chr2	48120660	48121326	666	333.0	
11104	chr2	48144857	48145015	158	79.0	
11105	chr2	48146019	48147039	1020	510.0	
11106	chr2	48169003	48169753	750	375.0	
11107	chr2	48174481	48174951	470	235.0	
11108	chr2	48189767	48190274	507	254.0	
11109	chr2	48197383	48197395	12	6.0	
11110	chr2	48198370	48198831	461	230.0	
11111	chr2	48220545	48220946	401	200.0	
11112	chr2	48227513	48228069	556	278.0	
11113	chr2	48250906	48251449	543	272.0	
11114	chr2	48253311	48253645	334	167.0	
11115	chr2	48258496	48258897	401	200.0	
11116	chr2	48265574	48266066	492	246.0	
11117	chr2	48287970	48288491	521	260.0	
11118	chr2	48313014	48317762	4748	2374.0	
11119	chr2	48319640	48321113	1473	736.0	
11120	chr2	48328890	48329425	535	268.0	
11121	chr2	48332222	48332744	522	261.0	
11122	chr2	48339285	48339498	213	106.0	
11123	chr2	48341767	48341780	13	6.0	
11124	chr2	48343595	48344857	1262	631.0	
11125	chr2	48346165	48346522	357	178.0	
11126	chr2	48352872	48353772	900	450.0	
11127	chr2	48356675	48357557	882	441.0	
11128	chr2	48362472	48362933	461	230.0	
11129	chr2	48382991	48383491	500	250.0	
11130	chr2	48395647	48396034	387	194.0	
11131	chr2	48412895	48413267	372	186.0	
11132	chr2	48415240	48416456	1216	608.0	
11133	chr2	48420245	48421364	1119	560.0	
11134	chr2	48433466	48434400	934	467.0	
11135	chr2	48438246	48438597	351	176.0	
11136	chr2	48439949	48441819	1870	935.0	
11137	chr2	48448281	48449337	1056	528.0	
11138	chr2	48454706	48454780	74	37.0	
11139	chr2	48461720	48461850	130	65.0	
11140	chr2	48529719	48530845	1126	563.0	
11141	chr2	48946475	48946901	426	213.0	
11142	chr2	49973965	49974477	512	256.0	
11143	chr2	50144310	50144382	72	36.0	
11144	chr2	50491495	50491892	397	198.0	
11145	chr2	50492408	50492860	452	226.0	
11146	chr2	53231989	53232271	282	141.0	
11147	chr2	53767256	53768524	1268	634.0	
11148	chr2	53778815	53779124	309	154.0	
11149	chr2	53784425	53785003	578	289.0	
11150	chr2	53785620	53788530	2910	1455.0	
11151	chr2	53961626	53962213	587	294.0	
11152	chr2	53964502	53965316	814	407.0	
11153	chr2	53966894	53971761	4867	2434.0	
11154	chr2	53993953	53995394	1441	720.0	
11155	chr2	54013921	54014497	576	288.0	
11156	chr2	54041122	54041600	478	239.0	
11157	chr2	54047066	54047400	334	167.0	
11158	chr2	54048379	54048765	386	193.0	
11159	chr2	54092786	54093690	904	452.0	
11160	chr2	54099790	54100649	859	430.0	
11161	chr2	54103692	54104201	509	254.0	
11162	chr2	54106893	54107358	465	232.0	
11163	chr2	54115020	54116406	1386	693.0	
11164	chr2	54272175	54272609	434	217.0	
11165	chr2	54329772	54331596	1824	912.0	
11166	chr2	54394319	54394992	673	336.0	
11167	chr2	54421844	54422711	867	434.0	
11168	chr2	54429718	54430451	733	366.0	
11169	chr2	54455811	54457836	2025	1012.0	
11170	chr2	54503224	54503375	151	76.0	
11171	chr2	54522493	54523143	650	325.0	
11172	chr2	54532613	54533597	984	492.0	
11173	chr2	54535712	54536240	528	264.0	
11174	chr2	54557034	54562852	5818	2909.0	
11175	chr2	54568073	54576151	8078	4039.0	
11176	chr2	54577095	54577187	92	46.0	
11177	chr2	54579137	54580646	1509	754.0	
11178	chr2	54581313	54582697	1384	692.0	
11179	chr2	54583260	54583291	31	16.0	
11180	chr2	54585279	54585570	291	146.0	
11181	chr2	54587681	54590054	2373	1186.0	
11182	chr2	54590662	54590907	245	122.0	
11183	chr2	54593510	54593541	31	16.0	
11184	chr2	54595894	54598007	2113	1056.0	
11185	chr2	54599816	54600238	422	211.0	
11186	chr2	54601847	54601988	141	70.0	
11187	chr2	54602556	54603477	921	460.0	
11188	chr2	54604048	54605349	1301	650.0	
11189	chr2	54606531	54606978	447	224.0	
11190	chr2	54634518	54635334	816	408.0	
11191	chr2	54638041	54638553	512	256.0	
11192	chr2	54657578	54657979	401	200.0	
11193	chr2	54665340	54665953	613	306.0	
11194	chr2	54669577	54670260	683	342.0	
11195	chr2	54672818	54674109	1291	646.0	
11196	chr2	54680648	54680754	106	53.0	
11197	chr2	54704651	54705119	468	234.0	
11198	chr2	54708464	54710022	1558	779.0	
11199	chr2	54722706	54725540	2834	1417.0	
11200	chr2	54838482	54839005	523	262.0	
11201	chr2	54866973	54867257	284	142.0	
11202	chr2	54897721	54898138	417	208.0	
11203	chr2	54899811	54900199	388	194.0	
11204	chr2	54903950	54904549	599	300.0	
11205	chr2	54942212	54942985	773	386.0	
11206	chr2	54955830	54955849	19	10.0	
11207	chr2	54979678	54979743	65	32.0	
11208	chr2	55000095	55000726	631	316.0	
11209	chr2	55006321	55006660	339	170.0	
11210	chr2	55009595	55011361	1766	883.0	
11211	chr2	55014914	55015386	472	236.0	
11212	chr2	55019235	55020190	955	478.0	
11213	chr2	55022034	55023243	1209	604.0	
11214	chr2	55026186	55026723	537	268.0	
11215	chr2	55029079	55029267	188	94.0	
11216	chr2	55031328	55031375	47	24.0	
11217	chr2	55033278	55033792	514	257.0	
11218	chr2	55037385	55037577	192	96.0	
11219	chr2	55043244	55043414	170	85.0	
11220	chr2	55047471	55052697	5226	2613.0	
11221	chr2	55054052	55054822	770	385.0	
11222	chr2	55061407	55061909	502	251.0	
11223	chr2	55071136	55071331	195	98.0	
11224	chr2	55083273	55083422	149	74.0	
11225	chr2	55090846	55091030	184	92.0	
11226	chr2	55093416	55093819	403	202.0	
11227	chr2	55099766	55100461	695	348.0	
11228	chr2	55111630	55113326	1696	848.0	
11229	chr2	55122160	55122585	425	212.0	
11230	chr2	55129354	55129729	375	188.0	
11231	chr2	55133322	55134875	1553	776.0	
11232	chr2	55136871	55137848	977	488.0	
11233	chr2	55150656	55151492	836	418.0	
11234	chr2	55152251	55154474	2223	1112.0	
11235	chr2	55159220	55159616	396	198.0	
11236	chr2	55161293	55162242	949	474.0	
11237	chr2	55168484	55168984	500	250.0	
11238	chr2	55175548	55176070	522	261.0	
11239	chr2	55222988	55225261	2273	1136.0	
11240	chr2	55227610	55228496	886	443.0	
11241	chr2	55231512	55234503	2991	1496.0	
11242	chr2	55235803	55236198	395	198.0	
11243	chr2	55268315	55270135	1820	910.0	
11244	chr2	55281563	55283093	1530	765.0	
11245	chr2	55292187	55292838	651	326.0	
11246	chr2	55311555	55311894	339	170.0	
11247	chr2	55365312	55365706	394	197.0	
11248	chr2	55409008	55409621	613	306.0	
11249	chr2	55415364	55415983	619	310.0	
11250	chr2	55417781	55420779	2998	1499.0	
11251	chr2	55425235	55425921	686	343.0	
11252	chr2	55431940	55432411	471	236.0	
11253	chr2	55483811	55483984	173	86.0	
11254	chr2	55518779	55520951	2172	1086.0	
11255	chr2	55530481	55531117	636	318.0	
11256	chr2	55616347	55620617	4270	2135.0	
11257	chr2	55693002	55694222	1220	610.0	
11258	chr2	55871394	55872098	704	352.0	
11259	chr2	56183507	56184136	629	314.0	
11260	chr2	57396260	57396805	545	272.0	
11261	chr2	57429798	57430305	507	254.0	
11262	chr2	57434454	57434872	418	209.0	
11263	chr2	57443787	57444777	990	495.0	
11264	chr2	57490766	57491197	431	216.0	
11265	chr2	57497515	57497834	319	160.0	
11266	chr2	57516774	57517102	328	164.0	
11267	chr2	57549602	57549979	377	188.0	
11268	chr2	57598517	57598788	271	136.0	
11269	chr2	57720805	57721236	431	216.0	
11270	chr2	57759775	57760323	548	274.0	
11271	chr2	57876378	57876699	321	160.0	
11272	chr2	57890455	57890898	443	222.0	
11273	chr2	57892721	57893343	622	311.0	
11274	chr2	57894280	57894850	570	285.0	
11275	chr2	57906091	57906574	483	242.0	
11276	chr2	57908420	57909351	931	466.0	
11277	chr2	58023425	58024351	926	463.0	
11278	chr2	58032197	58032864	667	334.0	
11279	chr2	58039044	58039563	519	260.0	
11280	chr2	58045881	58047689	1808	904.0	
11281	chr2	58054378	58054642	264	132.0	
11282	chr2	58064189	58064231	42	21.0	
11283	chr2	58107592	58108488	896	448.0	
11284	chr2	58112450	58113232	782	391.0	"sequence_feature	enhancer"
11285	chr2	58240538	58241750	1212	606.0	
11286	chr2	58449494	58450056	562	281.0	
11287	chr2	58569820	58570141	321	160.0	
11288	chr2	58571225	58571565	340	170.0	
11289	chr2	58609314	58609768	454	227.0	
11290	chr2	58686937	58687136	199	100.0	
11291	chr2	58701886	58701983	97	48.0	
11292	chr2	58731417	58731818	401	200.0	
11293	chr2	58762227	58762563	336	168.0	
11294	chr2	59025163	59025553	390	195.0	
11295	chr2	59301764	59302220	456	228.0	
11296	chr2	59594896	59594976	80	40.0	
11297	chr2	59726223	59726680	457	228.0	
11298	chr2	59887713	59888512	799	400.0	
11299	chr2	60104778	60105306	528	264.0	
11300	chr2	60297732	60298079	347	174.0	
11301	chr2	60303699	60304050	351	176.0	
11302	chr2	60317765	60318369	604	302.0	
11303	chr2	60334539	60334971	432	216.0	
11304	chr2	60337054	60337676	622	311.0	
11305	chr2	60350809	60352895	2086	1043.0	
11306	chr2	60353632	60354319	687	344.0	
11307	chr2	60355797	60356680	883	442.0	
11308	chr2	60366082	60366599	517	258.0	
11309	chr2	60370014	60371142	1128	564.0	
11310	chr2	60385660	60386159	499	250.0	
11311	chr2	60391286	60391428	142	71.0	
11312	chr2	60413656	60414231	575	288.0	
11313	chr2	60416242	60416777	535	268.0	
11314	chr2	60424252	60424558	306	153.0	
11315	chr2	60439042	60440209	1167	584.0	
11316	chr2	60446619	60447157	538	269.0	
11317	chr2	60454597	60454711	114	57.0	
11318	chr2	60459949	60460187	238	119.0	
11319	chr2	60472045	60472510	465	232.0	
11320	chr2	60482144	60482535	391	196.0	
11321	chr2	60483927	60485329	1402	701.0	
11322	chr2	60492661	60492766	105	52.0	
11323	chr2	60498285	60499172	887	444.0	
11324	chr2	60511751	60512428	677	338.0	
11325	chr2	60515466	60516820	1354	677.0	
11326	chr2	60523944	60524377	433	216.0	
11327	chr2	60527588	60529907	2319	1160.0	
11328	chr2	60530634	60530955	321	160.0	
11329	chr2	60534240	60534639	399	200.0	enhancer
11330	chr2	60543968	60544645	677	338.0	
11331	chr2	60549132	60557889	8757	4378.0	
11332	chr2	60560718	60561708	990	495.0	
11333	chr2	60565426	60565896	470	235.0	
11334	chr2	60569275	60570160	885	442.0	
11335	chr2	60581542	60582271	729	364.0	
11336	chr2	60641741	60642677	936	468.0	
11337	chr2	60660992	60661490	498	249.0	
11338	chr2	60674493	60674994	501	250.0	
11339	chr2	60699709	60699947	238	119.0	
11340	chr2	60707564	60708164	600	300.0	
11341	chr2	60710638	60711236	598	299.0	
11342	chr2	60735444	60736178	734	367.0	
11343	chr2	60745653	60746144	491	246.0	
11344	chr2	60755559	60757417	1858	929.0	
11345	chr2	60780881	60781053	172	86.0	
11346	chr2	60794248	60794675	427	214.0	
11347	chr2	60796212	60797513	1301	650.0	
11348	chr2	60805351	60805840	489	244.0	
11349	chr2	60806832	60807714	882	441.0	
11350	chr2	60809415	60809744	329	164.0	
11351	chr2	60818198	60820418	2220	1110.0	
11352	chr2	60834140	60834765	625	312.0	
11353	chr2	60840689	60841412	723	362.0	
11354	chr2	60849348	60849582	234	117.0	
11355	chr2	60852358	60852924	566	283.0	
11356	chr2	60853433	60853926	493	246.0	
11357	chr2	60856916	60857502	586	293.0	
11358	chr2	60862646	60863073	427	214.0	
11359	chr2	60865389	60865769	380	190.0	
11360	chr2	60867718	60868535	817	408.0	
11361	chr2	60873508	60873775	267	134.0	
11362	chr2	60880304	60883783	3479	1740.0	
11363	chr2	60884831	60886323	1492	746.0	
11364	chr2	60886907	60887372	465	232.0	
11365	chr2	60888017	60888196	179	90.0	
11366	chr2	60888712	60889336	624	312.0	
11367	chr2	60890112	60891927	1815	908.0	
11368	chr2	60897629	60898712	1083	542.0	
11369	chr2	60899215	60900279	1064	532.0	
11370	chr2	60904763	60905005	242	121.0	
11371	chr2	60905956	60906799	843	422.0	
11372	chr2	60926261	60927774	1513	756.0	
11373	chr2	60934210	60934557	347	174.0	
11374	chr2	60937375	60937626	251	126.0	
11375	chr2	60948886	60949294	408	204.0	
11376	chr2	60954017	60954565	548	274.0	
11377	chr2	60965150	60965666	516	258.0	
11378	chr2	60966563	60966917	354	177.0	
11379	chr2	60971379	60972715	1336	668.0	
11380	chr2	60979259	60979614	355	178.0	
11381	chr2	60984694	60985139	445	222.0	
11382	chr2	60992619	60993548	929	464.0	
11383	chr2	60998555	60999549	994	497.0	
11384	chr2	61012199	61012794	595	298.0	
11385	chr2	61014869	61014969	100	50.0	
11386	chr2	61016593	61018749	2156	1078.0	
11387	chr2	61044797	61044917	120	60.0	
11388	chr2	61065082	61066796	1714	857.0	
11389	chr2	61144547	61145410	863	432.0	
11390	chr2	61158501	61158980	479	240.0	
11391	chr2	61170199	61170595	396	198.0	
11392	chr2	61176168	61179607	3439	1720.0	
11393	chr2	61193651	61194434	783	392.0	
11394	chr2	61354601	61354899	298	149.0	
11395	chr2	61356495	61356690	195	98.0	
11396	chr2	61369013	61369406	393	196.0	
11397	chr2	61419502	61419508	6	3.0	
11398	chr2	61421125	61421650	525	262.0	
11399	chr2	61425147	61426970	1823	912.0	
11400	chr2	61434210	61434867	657	328.0	
11401	chr2	61436078	61436663	585	292.0	
11402	chr2	61439202	61439997	795	398.0	
11403	chr2	61443450	61444096	646	323.0	
11404	chr2	61450169	61450527	358	179.0	
11405	chr2	61464360	61464880	520	260.0	
11406	chr2	61469807	61472735	2928	1464.0	
11407	chr2	61474341	61474871	530	265.0	
11408	chr2	61475784	61476251	467	234.0	
11409	chr2	61493519	61494063	544	272.0	
11410	chr2	61535960	61539662	3702	1851.0	
11411	chr2	61658897	61659225	328	164.0	
11412	chr2	61663019	61663406	387	194.0	
11413	chr2	61670716	61671474	758	379.0	
11414	chr2	61693737	61695574	1837	918.0	
11415	chr2	61762357	61762741	384	192.0	
11416	chr2	61763473	61765139	1666	833.0	
11417	chr2	61774310	61774710	400	200.0	
11418	chr2	61775903	61776404	501	250.0	
11419	chr2	61793204	61794020	816	408.0	
11420	chr2	61853130	61855478	2348	1174.0	
11421	chr2	61886700	61886707	7	4.0	
11422	chr2	61887271	61889702	2431	1216.0	
11423	chr2	61898901	61899185	284	142.0	
11424	chr2	61905180	61906438	1258	629.0	
11425	chr2	61917800	61918245	445	222.0	
11426	chr2	61978575	61978959	384	192.0	
11427	chr2	61993435	61993799	364	182.0	
11428	chr2	62010914	62011008	94	47.0	
11429	chr2	62015483	62016061	578	289.0	
11430	chr2	62039190	62039778	588	294.0	
11431	chr2	62099005	62099382	377	188.0	
11432	chr2	62119668	62119915	247	124.0	
11433	chr2	62129529	62129962	433	216.0	
11434	chr2	62153757	62154064	307	154.0	
11435	chr2	62186666	62186774	108	54.0	
11436	chr2	62192766	62193273	507	254.0	
11437	chr2	62194889	62201250	6361	3180.0	
11438	chr2	62201998	62203226	1228	614.0	
11439	chr2	62205119	62205241	122	61.0	
11440	chr2	62206051	62206095	44	22.0	
11441	chr2	62208365	62209938	1573	786.0	
11442	chr2	62211086	62211419	333	166.0	
11443	chr2	62214002	62214275	273	136.0	
11444	chr2	62215450	62218301	2851	1426.0	
11445	chr2	62219154	62220257	1103	552.0	
11446	chr2	62221115	62221605	490	245.0	
11447	chr2	62222436	62223359	923	462.0	
11448	chr2	62229553	62229563	10	5.0	
11449	chr2	62235268	62235500	232	116.0	
11450	chr2	62265110	62265372	262	131.0	
11451	chr2	62287342	62288496	1154	577.0	
11452	chr2	62292305	62292517	212	106.0	
11453	chr2	62293599	62293925	326	163.0	
11454	chr2	62302634	62306131	3497	1748.0	
11455	chr2	62306636	62307381	745	372.0	
11456	chr2	62309363	62310268	905	452.0	
11457	chr2	62313618	62314585	967	484.0	
11458	chr2	62332723	62333422	699	350.0	
11459	chr2	62411658	62412681	1023	512.0	
11460	chr2	62414911	62415527	616	308.0	
11461	chr2	62456688	62457628	940	470.0	
11462	chr2	62475039	62475918	879	440.0	
11463	chr2	62478177	62478578	401	200.0	
11464	chr2	62505574	62506572	998	499.0	
11465	chr2	62660186	62660263	77	38.0	
11466	chr2	62704666	62707148	2482	1241.0	
11467	chr2	62725267	62725615	348	174.0	
11468	chr2	62775077	62775449	372	186.0	
11469	chr2	63047459	63048819	1360	680.0	enhancer
11470	chr2	63050218	63051267	1049	524.0	
11471	chr2	63054009	63054672	663	332.0	
11472	chr2	63056706	63057152	446	223.0	
11473	chr2	63058792	63060337	1545	772.0	
11474	chr2	63124225	63124535	310	155.0	
11475	chr2	63424868	63424986	118	59.0	
11476	chr2	63587407	63589734	2327	1164.0	
11477	chr2	63591025	63591414	389	194.0	
11478	chr2	63692009	63692410	401	200.0	
11479	chr2	63699025	63699434	409	204.0	
11480	chr2	63840017	63843115	3098	1549.0	
11481	chr2	63850774	63850953	179	90.0	
11482	chr2	63853568	63854048	480	240.0	
11483	chr2	63855816	63856814	998	499.0	
11484	chr2	63861140	63861712	572	286.0	
11485	chr2	63866041	63866440	399	200.0	
11486	chr2	63888708	63889205	497	248.0	
11487	chr2	64015300	64015828	528	264.0	
11488	chr2	64018208	64020880	2672	1336.0	
11489	chr2	64021621	64021971	350	175.0	
11490	chr2	64025804	64026138	334	167.0	
11491	chr2	64036076	64036757	681	340.0	
11492	chr2	64049528	64050332	804	402.0	
11493	chr2	64052511	64052680	169	84.0	
11494	chr2	64064510	64065226	716	358.0	
11495	chr2	64090322	64090606	284	142.0	
11496	chr2	64101282	64101972	690	345.0	
11497	chr2	64114003	64114945	942	471.0	
11498	chr2	64115525	64116373	848	424.0	
11499	chr2	64122438	64122685	247	124.0	
11500	chr2	64135433	64135534	101	50.0	
11501	chr2	64137471	64138820	1349	674.0	
11502	chr2	64141477	64145100	3623	1812.0	
11503	chr2	64145621	64146018	397	198.0	
11504	chr2	64179847	64180112	265	132.0	
11505	chr2	64186718	64187553	835	418.0	
11506	chr2	64191667	64193187	1520	760.0	
11507	chr2	64200123	64200524	401	200.0	
11508	chr2	64202500	64202740	240	120.0	
11509	chr2	64203824	64205097	1273	636.0	
11510	chr2	64211283	64215057	3774	1887.0	
11511	chr2	64220223	64220706	483	242.0	
11512	chr2	64222926	64223672	746	373.0	
11513	chr2	64227911	64229011	1100	550.0	
11514	chr2	64260396	64261366	970	485.0	
11515	chr2	64273218	64274341	1123	562.0	
11516	chr2	64276945	64277919	974	487.0	
11517	chr2	64282962	64284260	1298	649.0	
11518	chr2	64312325	64312739	414	207.0	
11519	chr2	64325593	64328486	2893	1446.0	
11520	chr2	64330633	64331490	857	428.0	
11521	chr2	64414994	64415073	79	40.0	
11522	chr2	64453709	64455113	1404	702.0	
11523	chr2	64467367	64467844	477	238.0	
11524	chr2	64474273	64474587	314	157.0	
11525	chr2	64487947	64488775	828	414.0	
11526	chr2	64504874	64505389	515	258.0	
11527	chr2	64522536	64525766	3230	1615.0	
11528	chr2	64534353	64534682	329	164.0	
11529	chr2	64555564	64555967	403	202.0	
11530	chr2	64562041	64562767	726	363.0	
11531	chr2	64586854	64587876	1022	511.0	
11532	chr2	64606320	64608184	1864	932.0	
11533	chr2	64608710	64610109	1399	700.0	
11534	chr2	64617799	64618231	432	216.0	
11535	chr2	64625199	64626739	1540	770.0	
11536	chr2	64628910	64629022	112	56.0	
11537	chr2	64634320	64634822	502	251.0	
11538	chr2	64635968	64637904	1936	968.0	
11539	chr2	64642886	64645492	2606	1303.0	
11540	chr2	64646246	64646980	734	367.0	
11541	chr2	64652071	64656081	4010	2005.0	
11542	chr2	64657339	64658678	1339	670.0	
11543	chr2	64661592	64662225	633	316.0	
11544	chr2	64667063	64667871	808	404.0	
11545	chr2	64679045	64679582	537	268.0	
11546	chr2	64681654	64682076	422	211.0	
11547	chr2	64699687	64700642	955	478.0	
11548	chr2	64711313	64711555	242	121.0	
11549	chr2	64726810	64727837	1027	514.0	
11550	chr2	64730363	64732246	1883	942.0	
11551	chr2	64748646	64752402	3756	1878.0	
11552	chr2	64754123	64754238	115	58.0	
11553	chr2	64766588	64768950	2362	1181.0	
11554	chr2	64786632	64787047	415	208.0	
11555	chr2	64787683	64788166	483	242.0	
11556	chr2	64819403	64820490	1087	544.0	
11557	chr2	64825328	64826273	945	472.0	
11558	chr2	64830873	64832227	1354	677.0	
11559	chr2	64837950	64839156	1206	603.0	
11560	chr2	64839767	64840495	728	364.0	
11561	chr2	64841505	64842044	539	270.0	
11562	chr2	64845529	64846757	1228	614.0	
11563	chr2	64852531	64855267	2736	1368.0	
11564	chr2	64858472	64860945	2473	1236.0	
11565	chr2	64861557	64866385	4828	2414.0	
11566	chr2	64869851	64870290	439	220.0	
11567	chr2	64873191	64874088	897	448.0	
11568	chr2	64881120	64881547	427	214.0	
11569	chr2	64899810	64900278	468	234.0	
11570	chr2	64904416	64905077	661	330.0	
11571	chr2	64913281	64913600	319	160.0	
11572	chr2	64915075	64915559	484	242.0	
11573	chr2	64917245	64919025	1780	890.0	
11574	chr2	64924104	64924639	535	268.0	
11575	chr2	64932280	64933244	964	482.0	
11576	chr2	64937608	64938954	1346	673.0	
11577	chr2	64939488	64939968	480	240.0	
11578	chr2	64941947	64942070	123	62.0	
11579	chr2	64944153	64944477	324	162.0	
11580	chr2	64945981	64946904	923	462.0	
11581	chr2	64978881	64979285	404	202.0	
11582	chr2	64985505	64985671	166	83.0	
11583	chr2	64988025	64990662	2637	1318.0	
11584	chr2	65017051	65018872	1821	910.0	
11585	chr2	65025521	65026233	712	356.0	
11586	chr2	65026933	65028228	1295	648.0	
11587	chr2	65030506	65032678	2172	1086.0	
11588	chr2	65033188	65033606	418	209.0	
11589	chr2	65040403	65041105	702	351.0	
11590	chr2	65053112	65053722	610	305.0	
11591	chr2	65055219	65058199	2980	1490.0	
11592	chr2	65064471	65066008	1537	768.0	
11593	chr2	65067695	65069472	1777	888.0	
11594	chr2	65071518	65072816	1298	649.0	
11595	chr2	65076012	65076377	365	182.0	
11596	chr2	65081073	65081931	858	429.0	
11597	chr2	65111988	65112237	249	124.0	
11598	chr2	65116717	65117376	659	330.0	
11599	chr2	65121023	65121616	593	296.0	
11600	chr2	65122326	65123140	814	407.0	
11601	chr2	65125332	65126237	905	452.0	
11602	chr2	65128360	65131267	2907	1454.0	
11603	chr2	65136252	65136637	385	192.0	
11604	chr2	65142522	65142956	434	217.0	
11605	chr2	65160122	65160213	91	46.0	
11606	chr2	65164475	65164861	386	193.0	
11607	chr2	65165558	65166033	475	238.0	
11608	chr2	65169224	65169651	427	214.0	
11609	chr2	65187090	65187722	632	316.0	
11610	chr2	65204800	65205179	379	190.0	
11611	chr2	65226852	65229678	2826	1413.0	
11612	chr2	65231854	65233225	1371	686.0	
11613	chr2	65265163	65265426	263	132.0	
11614	chr2	65300542	65302327	1785	892.0	
11615	chr2	65320386	65320491	105	52.0	
11616	chr2	65353877	65354301	424	212.0	
11617	chr2	65360474	65360799	325	162.0	
11618	chr2	65366485	65367046	561	280.0	
11619	chr2	65367577	65367810	233	116.0	
11620	chr2	65368677	65368869	192	96.0	
11621	chr2	65377608	65378150	542	271.0	
11622	chr2	65381738	65383640	1902	951.0	
11623	chr2	65390092	65390493	401	200.0	
11624	chr2	65420723	65421429	706	353.0	
11625	chr2	65430152	65433394	3242	1621.0	
11626	chr2	65435299	65437320	2021	1010.0	
11627	chr2	65450498	65450737	239	120.0	
11628	chr2	65553208	65553675	467	234.0	
11629	chr2	65573076	65573582	506	253.0	
11630	chr2	65575078	65575458	380	190.0	
11631	chr2	65606187	65606675	488	244.0	
11632	chr2	65630654	65630932	278	139.0	
11633	chr2	65922695	65923310	615	308.0	
11634	chr2	66433323	66435384	2061	1030.0	
11635	chr2	66481260	66481418	158	79.0	
11636	chr2	66494694	66494969	275	138.0	
11637	chr2	66508599	66508680	81	40.0	
11638	chr2	67396829	67398457	1628	814.0	
11639	chr2	67616752	67617194	442	221.0	
11640	chr2	68031568	68031846	278	139.0	
11641	chr2	68062286	68063531	1245	622.0	
11642	chr2	68108053	68108606	553	276.0	
11643	chr2	68120995	68121804	809	404.0	
11644	chr2	68122335	68122843	508	254.0	
11645	chr2	68152995	68152996	1	0.0	
11646	chr2	68156754	68158554	1800	900.0	
11647	chr2	68172187	68172215	28	14.0	
11648	chr2	68173161	68173823	662	331.0	
11649	chr2	68185492	68185990	498	249.0	
11650	chr2	68191048	68191523	475	238.0	
11651	chr2	68196031	68196725	694	347.0	
11652	chr2	68200381	68200713	332	166.0	
11653	chr2	68203370	68204088	718	359.0	
11654	chr2	68206104	68207187	1083	542.0	
11655	chr2	68225090	68225835	745	372.0	
11656	chr2	68230500	68231168	668	334.0	
11657	chr2	68236273	68236953	680	340.0	
11658	chr2	68238995	68239793	798	399.0	
11659	chr2	68246425	68246916	491	246.0	
11660	chr2	68248901	68249214	313	156.0	
11661	chr2	68249913	68254037	4124	2062.0	
11662	chr2	68255371	68255885	514	257.0	
11663	chr2	68272556	68273067	511	256.0	
11664	chr2	68282774	68283217	443	222.0	
11665	chr2	68287871	68288402	531	266.0	
11666	chr2	68292338	68292469	131	66.0	
11667	chr2	68295582	68295642	60	30.0	
11668	chr2	68318880	68320410	1530	765.0	
11669	chr2	68341634	68341997	363	182.0	
11670	chr2	68357880	68358376	496	248.0	
11671	chr2	68361700	68363212	1512	756.0	
11672	chr2	68364346	68366714	2368	1184.0	
11673	chr2	68367537	68370467	2930	1465.0	
11674	chr2	68371182	68372623	1441	720.0	
11675	chr2	68373339	68373342	3	2.0	
11676	chr2	68375650	68377675	2025	1012.0	
11677	chr2	68378873	68380695	1822	911.0	
11678	chr2	68381688	68381792	104	52.0	
11679	chr2	68383551	68389442	5891	2946.0	
11680	chr2	68390903	68392460	1557	778.0	
11681	chr2	68395803	68396204	401	200.0	
11682	chr2	68403048	68403745	697	348.0	
11683	chr2	68404831	68405309	478	239.0	
11684	chr2	68411292	68412932	1640	820.0	
11685	chr2	68417954	68418055	101	50.0	
11686	chr2	68423486	68425863	2377	1188.0	
11687	chr2	68426939	68428020	1081	540.0	
11688	chr2	68434941	68435406	465	232.0	
11689	chr2	68438442	68438870	428	214.0	
11690	chr2	68440772	68442237	1465	732.0	
11691	chr2	68447956	68449502	1546	773.0	
11692	chr2	68452259	68452969	710	355.0	
11693	chr2	68463250	68463760	510	255.0	
11694	chr2	68465177	68468233	3056	1528.0	
11695	chr2	68487767	68488159	392	196.0	
11696	chr2	68516069	68516391	322	161.0	
11697	chr2	68595115	68595597	482	241.0	
11698	chr2	68643329	68644007	678	339.0	
11699	chr2	68653508	68654067	559	280.0	
11700	chr2	68662481	68662885	404	202.0	
11701	chr2	68679417	68679988	571	286.0	
11702	chr2	68689617	68690606	989	494.0	
11703	chr2	68692539	68692924	385	192.0	
11704	chr2	68709364	68710035	671	336.0	
11705	chr2	68714706	68715845	1139	570.0	
11706	chr2	68716511	68717632	1121	560.0	
11707	chr2	68719874	68720332	458	229.0	
11708	chr2	68721376	68722244	868	434.0	
11709	chr2	68726559	68727706	1147	574.0	
11710	chr2	68732007	68732701	694	347.0	
11711	chr2	68733951	68735722	1771	886.0	
11712	chr2	68737215	68738506	1291	646.0	
11713	chr2	68739040	68743354	4314	2157.0	
11714	chr2	68744597	68746387	1790	895.0	
11715	chr2	68749192	68749353	161	80.0	
11716	chr2	68751272	68752556	1284	642.0	
11717	chr2	68753150	68754011	861	430.0	
11718	chr2	68762323	68763429	1106	553.0	
11719	chr2	68764373	68772404	8031	4016.0	
11720	chr2	68774051	68777154	3103	1552.0	
11721	chr2	68779727	68780029	302	151.0	
11722	chr2	68781230	68781657	427	214.0	
11723	chr2	68784103	68785269	1166	583.0	
11724	chr2	68787532	68787933	401	200.0	
11725	chr2	68789450	68790855	1405	702.0	
11726	chr2	68795083	68795194	111	56.0	
11727	chr2	68796193	68796772	579	290.0	
11728	chr2	68801438	68802509	1071	536.0	
11729	chr2	68806353	68806892	539	270.0	
11730	chr2	68807601	68808584	983	492.0	
11731	chr2	68809657	68810166	509	254.0	
11732	chr2	68812511	68812582	71	36.0	
11733	chr2	68828421	68830174	1753	876.0	
11734	chr2	68831666	68833127	1461	730.0	
11735	chr2	68834705	68836111	1406	703.0	
11736	chr2	68836918	68837698	780	390.0	
11737	chr2	68839215	68839658	443	222.0	
11738	chr2	68857266	68858387	1121	560.0	
11739	chr2	68861303	68861749	446	223.0	
11740	chr2	68907846	68910235	2389	1194.0	
11741	chr2	68912656	68913166	510	255.0	
11742	chr2	68925233	68925752	519	260.0	
11743	chr2	68943430	68943971	541	270.0	
11744	chr2	68948805	68949052	247	124.0	
11745	chr2	69012462	69014000	1538	769.0	
11746	chr2	69025968	69026396	428	214.0	
11747	chr2	69082437	69082817	380	190.0	
11748	chr2	69162938	69163720	782	391.0	
11749	chr2	69177282	69178819	1537	768.0	
11750	chr2	69271963	69273093	1130	565.0	
11751	chr2	69306398	69307846	1448	724.0	
11752	chr2	69345444	69345778	334	167.0	
11753	chr2	69372097	69372434	337	168.0	
11754	chr2	69375670	69376188	518	259.0	
11755	chr2	69386340	69388005	1665	832.0	
11756	chr2	69390396	69390926	530	265.0	
11757	chr2	69436372	69438233	1861	930.0	
11758	chr2	69439336	69440069	733	366.0	
11759	chr2	69457237	69457282	45	22.0	
11760	chr2	69469381	69469829	448	224.0	
11761	chr2	69490499	69490842	343	172.0	
11762	chr2	69494274	69494281	7	4.0	
11763	chr2	69498987	69500321	1334	667.0	
11764	chr2	69505583	69506179	596	298.0	
11765	chr2	69507908	69508304	396	198.0	
11766	chr2	69509117	69509403	286	143.0	
11767	chr2	69519041	69519228	187	94.0	
11768	chr2	69535620	69536509	889	444.0	
11769	chr2	69554793	69555433	640	320.0	
11770	chr2	69559600	69560302	702	351.0	
11771	chr2	69564691	69566671	1980	990.0	
11772	chr2	69567346	69568199	853	426.0	
11773	chr2	69572850	69573127	277	138.0	
11774	chr2	69575958	69575996	38	19.0	
11775	chr2	69576840	69577309	469	234.0	
11776	chr2	69577848	69577915	67	34.0	
11777	chr2	69579544	69579950	406	203.0	
11778	chr2	69581980	69583324	1344	672.0	
11779	chr2	69584470	69584870	400	200.0	
11780	chr2	69597054	69597539	485	242.0	
11781	chr2	69604849	69605482	633	316.0	
11782	chr2	69615863	69617121	1258	629.0	
11783	chr2	69619584	69620326	742	371.0	
11784	chr2	69620861	69621252	391	196.0	
11785	chr2	69622836	69623085	249	124.0	
11786	chr2	69625027	69625824	797	398.0	
11787	chr2	69628053	69629091	1038	519.0	
11788	chr2	69634129	69634670	541	270.0	
11789	chr2	69639377	69639931	554	277.0	
11790	chr2	69640589	69646965	6376	3188.0	
11791	chr2	69647860	69649008	1148	574.0	
11792	chr2	69650315	69650807	492	246.0	
11793	chr2	69680237	69680703	466	233.0	
11794	chr2	69683148	69683842	694	347.0	
11795	chr2	69685597	69686098	501	250.0	
11796	chr2	69693052	69694551	1499	750.0	
11797	chr2	69703254	69703582	328	164.0	
11798	chr2	69704556	69704698	142	71.0	
11799	chr2	69714405	69715130	725	362.0	
11800	chr2	69724373	69725273	900	450.0	
11801	chr2	69731630	69731742	112	56.0	
11802	chr2	69740574	69742884	2310	1155.0	
11803	chr2	69754108	69754316	208	104.0	
11804	chr2	69756138	69756421	283	142.0	
11805	chr2	69762737	69763114	377	188.0	
11806	chr2	69764967	69765273	306	153.0	
11807	chr2	69770125	69770738	613	306.0	
11808	chr2	69774578	69776007	1429	714.0	
11809	chr2	69790155	69790508	353	176.0	
11810	chr2	69798916	69799380	464	232.0	
11811	chr2	69802977	69803428	451	226.0	
11812	chr2	69816851	69817388	537	268.0	
11813	chr2	69824953	69825145	192	96.0	
11814	chr2	69828839	69831029	2190	1095.0	
11815	chr2	69893200	69894590	1390	695.0	
11816	chr2	69902054	69903389	1335	668.0	
11817	chr2	69911755	69912473	718	359.0	
11818	chr2	69913742	69916407	2665	1332.0	
11819	chr2	69916923	69918810	1887	944.0	
11820	chr2	69926910	69927625	715	358.0	
11821	chr2	69930787	69931069	282	141.0	
11822	chr2	69931756	69932483	727	364.0	
11823	chr2	69933334	69934863	1529	764.0	
11824	chr2	69935946	69936026	80	40.0	
11825	chr2	69936904	69937591	687	344.0	
11826	chr2	69938819	69938875	56	28.0	
11827	chr2	69943133	69948085	4952	2476.0	
11828	chr2	69952473	69953126	653	326.0	
11829	chr2	69975759	69976209	450	225.0	
11830	chr2	69977370	69977520	150	75.0	
11831	chr2	69978407	69979290	883	442.0	
11832	chr2	69983429	69984023	594	297.0	
11833	chr2	69985384	69986638	1254	627.0	
11834	chr2	69997238	69997752	514	257.0	
11835	chr2	70002423	70002961	538	269.0	
11836	chr2	70010112	70010952	840	420.0	
11837	chr2	70018758	70019670	912	456.0	
11838	chr2	70029498	70030607	1109	554.0	
11839	chr2	70039431	70039752	321	160.0	
11840	chr2	70043181	70044270	1089	544.0	
11841	chr2	70046473	70048002	1529	764.0	
11842	chr2	70062455	70062600	145	72.0	
11843	chr2	70068664	70071665	3001	1500.0	
11844	chr2	70074083	70074436	353	176.0	
11845	chr2	70078510	70078826	316	158.0	
11846	chr2	70083258	70092143	8885	4442.0	enhancer
11847	chr2	70094229	70096010	1781	890.0	
11848	chr2	70103279	70105002	1723	862.0	
11849	chr2	70107682	70109856	2174	1087.0	
11850	chr2	70110931	70111712	781	390.0	
11851	chr2	70115538	70116299	761	380.0	
11852	chr2	70121208	70122353	1145	572.0	
11853	chr2	70122895	70127372	4477	2238.0	
11854	chr2	70131689	70138018	6329	3164.0	
11855	chr2	70140589	70144053	3464	1732.0	
11856	chr2	70145095	70145222	127	64.0	
11857	chr2	70146285	70146616	331	166.0	
11858	chr2	70161110	70161225	115	58.0	
11859	chr2	70181376	70181712	336	168.0	
11860	chr2	70189771	70191605	1834	917.0	
11861	chr2	70247448	70249338	1890	945.0	
11862	chr2	70257147	70258978	1831	916.0	
11863	chr2	70291424	70291458	34	17.0	
11864	chr2	70292855	70294450	1595	798.0	
11865	chr2	70300905	70302575	1670	835.0	
11866	chr2	70303631	70304518	887	444.0	
11867	chr2	70341133	70341613	480	240.0	
11868	chr2	70440510	70441047	537	268.0	
11869	chr2	70471163	70471416	253	126.0	
11870	chr2	70472528	70473636	1108	554.0	
11871	chr2	70475286	70475668	382	191.0	
11872	chr2	70510121	70510695	574	287.0	
11873	chr2	70515858	70517118	1260	630.0	
11874	chr2	70523469	70524755	1286	643.0	
11875	chr2	70529682	70530083	401	200.0	
11876	chr2	70551275	70551764	489	244.0	
11877	chr2	70552344	70554766	2422	1211.0	
11878	chr2	70617539	70618033	494	247.0	
11879	chr2	70647819	70648291	472	236.0	
11880	chr2	70655209	70655616	407	204.0	
11881	chr2	70656759	70657063	304	152.0	
11882	chr2	70686802	70687272	470	235.0	
11883	chr2	70766902	70768578	1676	838.0	
11884	chr2	70785309	70785694	385	192.0	
11885	chr2	70789491	70790762	1271	636.0	
11886	chr2	70791739	70792096	357	178.0	
11887	chr2	70793219	70793950	731	366.0	
11888	chr2	70835741	70836010	269	134.0	
11889	chr2	70838306	70838888	582	291.0	
11890	chr2	70851550	70852206	656	328.0	
11891	chr2	70861751	70862294	543	272.0	
11892	chr2	70871109	70872131	1022	511.0	
11893	chr2	70887506	70889046	1540	770.0	
11894	chr2	70900357	70901673	1316	658.0	
11895	chr2	70906910	70907965	1055	528.0	
11896	chr2	70919725	70920272	547	274.0	
11897	chr2	70946620	70947315	695	348.0	
11898	chr2	70948007	70949079	1072	536.0	
11899	chr2	70964606	70965561	955	478.0	
11900	chr2	70976609	70979396	2787	1394.0	
11901	chr2	70984402	70985520	1118	559.0	
11902	chr2	70993666	70995988	2322	1161.0	
11903	chr2	71000681	71001780	1099	550.0	
11904	chr2	71023477	71024157	680	340.0	
11905	chr2	71045814	71046591	777	388.0	
11906	chr2	71049640	71050040	400	200.0	
11907	chr2	71064159	71066135	1976	988.0	
11908	chr2	71067476	71069485	2009	1004.0	
11909	chr2	71070030	71072861	2831	1416.0	
11910	chr2	71082632	71083188	556	278.0	
11911	chr2	71083913	71084471	558	279.0	
11912	chr2	71100417	71100884	467	234.0	
11913	chr2	71129535	71131339	1804	902.0	
11914	chr2	71157185	71157867	682	341.0	
11915	chr2	71183632	71183688	56	28.0	
11916	chr2	71226234	71228037	1803	902.0	
11917	chr2	71236160	71236561	401	200.0	
11918	chr2	71276055	71278222	2167	1084.0	
11919	chr2	71299350	71299806	456	228.0	
11920	chr2	71330690	71332758	2068	1034.0	
11921	chr2	71333637	71333689	52	26.0	
11922	chr2	71416801	71417880	1079	540.0	
11923	chr2	71440757	71441160	403	202.0	
11924	chr2	71449362	71449681	319	160.0	
11925	chr2	71451106	71454132	3026	1513.0	
11926	chr2	71460857	71461235	378	189.0	
11927	chr2	71466323	71467379	1056	528.0	
11928	chr2	71474049	71474857	808	404.0	
11929	chr2	71477111	71477798	687	344.0	
11930	chr2	71510130	71510627	497	248.0	
11931	chr2	71530752	71531112	360	180.0	
11932	chr2	71538953	71539208	255	128.0	
11933	chr2	71545170	71546026	856	428.0	
11934	chr2	71548599	71549062	463	232.0	
11935	chr2	71630004	71630161	157	78.0	
11936	chr2	71882983	71883345	362	181.0	
11937	chr2	71920859	71921203	344	172.0	
11938	chr2	72137425	72137850	425	212.0	
11939	chr2	72149002	72149256	254	127.0	
11940	chr2	72149767	72150752	985	492.0	
11941	chr2	72581114	72581470	356	178.0	
11942	chr2	72770836	72771293	457	228.0	
11943	chr2	72824103	72826493	2390	1195.0	
11944	chr2	72833303	72833721	418	209.0	
11945	chr2	72859708	72860206	498	249.0	
11946	chr2	72862242	72863061	819	410.0	
11947	chr2	72886924	72888402	1478	739.0	
11948	chr2	72891006	72891515	509	254.0	
11949	chr2	72892632	72894045	1413	706.0	
11950	chr2	72915872	72918974	3102	1551.0	
11951	chr2	72920338	72920920	582	291.0	
11952	chr2	72953806	72954860	1054	527.0	
11953	chr2	72956780	72957455	675	338.0	
11954	chr2	72973543	72974029	486	243.0	
11955	chr2	72979822	72980518	696	348.0	
11956	chr2	72993017	72993854	837	418.0	
11957	chr2	73032942	73035437	2495	1248.0	
11958	chr2	73069005	73072608	3603	1802.0	
11959	chr2	73085358	73086415	1057	528.0	
11960	chr2	73107346	73107911	565	282.0	
11961	chr2	73111197	73114943	3746	1873.0	
11962	chr2	73156541	73157003	462	231.0	
11963	chr2	73163516	73164221	705	352.0	
11964	chr2	73174702	73178223	3521	1760.0	
11965	chr2	73202189	73203508	1319	660.0	
11966	chr2	73212204	73214916	2712	1356.0	
11967	chr2	73225769	73226053	284	142.0	
11968	chr2	73232479	73236016	3537	1768.0	
11969	chr2	73253826	73254272	446	223.0	
11970	chr2	73257698	73258152	454	227.0	
11971	chr2	73260313	73260692	379	190.0	
11972	chr2	73268760	73270122	1362	681.0	
11973	chr2	73283316	73285655	2339	1170.0	
11974	chr2	73290115	73294197	4082	2041.0	
11975	chr2	73385060	73387050	1990	995.0	
11976	chr2	73451611	73451704	93	46.0	
11977	chr2	73680215	73680540	325	162.0	
11978	chr2	73699961	73700481	520	260.0	
11979	chr2	73716476	73717349	873	436.0	
11980	chr2	73736596	73738154	1558	779.0	
11981	chr2	73779264	73780642	1378	689.0	
11982	chr2	73823901	73824413	512	256.0	
11983	chr2	73827018	73827388	370	185.0	
11984	chr2	73828243	73831489	3246	1623.0	
11985	chr2	73838178	73838640	462	231.0	
11986	chr2	73877264	73878064	800	400.0	
11987	chr2	73896306	73897221	915	458.0	
11988	chr2	73907497	73908416	919	460.0	
11989	chr2	73921137	73921636	499	250.0	
11990	chr2	73925067	73927550	2483	1242.0	
11991	chr2	73928571	73929401	830	415.0	
11992	chr2	73937926	73938281	355	178.0	
11993	chr2	73939410	73939880	470	235.0	
11994	chr2	73948404	73949221	817	408.0	
11995	chr2	73952389	73952991	602	301.0	
11996	chr2	73969527	73971823	2296	1148.0	
11997	chr2	73972821	73973274	453	226.0	
11998	chr2	73978680	73981980	3300	1650.0	
11999	chr2	73982543	73988392	5849	2924.0	
12000	chr2	73992021	73992085	64	32.0	
12001	chr2	73993746	73994493	747	374.0	
12002	chr2	73998365	73998967	602	301.0	
12003	chr2	74000686	74003380	2694	1347.0	
12004	chr2	74017119	74017577	458	229.0	
12005	chr2	74020601	74021365	764	382.0	
12006	chr2	74025458	74027381	1923	962.0	
12007	chr2	74029763	74030029	266	133.0	
12008	chr2	74031140	74033234	2094	1047.0	
12009	chr2	74033931	74034284	353	176.0	
12010	chr2	74037111	74038328	1217	608.0	
12011	chr2	74041138	74041638	500	250.0	
12012	chr2	74053266	74053760	494	247.0	
12013	chr2	74070946	74071868	922	461.0	
12014	chr2	74072454	74073175	721	360.0	
12015	chr2	74079658	74080851	1193	596.0	
12016	chr2	74104840	74104841	1	0.0	
12017	chr2	74119657	74120961	1304	652.0	
12018	chr2	74147069	74148794	1725	862.0	
12019	chr2	74151451	74151799	348	174.0	
12020	chr2	74176640	74177378	738	369.0	
12021	chr2	74177964	74179711	1747	874.0	
12022	chr2	74181587	74182447	860	430.0	
12023	chr2	74185121	74186595	1474	737.0	
12024	chr2	74197892	74200369	2477	1238.0	
12025	chr2	74205415	74206888	1473	736.0	
12026	chr2	74219962	74220011	49	24.0	
12027	chr2	74250087	74250708	621	310.0	
12028	chr2	74267003	74267639	636	318.0	
12029	chr2	74290194	74291550	1356	678.0	
12030	chr2	74334798	74335451	653	326.0	
12031	chr2	74380121	74380555	434	217.0	
12032	chr2	74391067	74392643	1576	788.0	
12033	chr2	74399814	74400335	521	260.0	
12034	chr2	74413443	74413770	327	164.0	
12035	chr2	74414529	74417077	2548	1274.0	
12036	chr2	74419978	74422690	2712	1356.0	
12037	chr2	74439941	74442483	2542	1271.0	
12038	chr2	74452187	74453188	1001	500.0	
12039	chr2	74454293	74455776	1483	742.0	
12040	chr2	74456872	74459738	2866	1433.0	
12041	chr2	74461450	74461744	294	147.0	
12042	chr2	74464440	74466384	1944	972.0	
12043	chr2	74471604	74473412	1808	904.0	
12044	chr2	74476994	74477404	410	205.0	
12045	chr2	74481832	74484053	2221	1110.0	
12046	chr2	74497689	74499991	2302	1151.0	
12047	chr2	74501327	74503828	2501	1250.0	
12048	chr2	74505080	74505196	116	58.0	
12049	chr2	74506471	74508573	2102	1051.0	
12050	chr2	74513091	74516860	3769	1884.0	
12051	chr2	74525992	74526825	833	416.0	
12052	chr2	74528738	74531473	2735	1368.0	
12053	chr2	74532183	74532643	460	230.0	
12054	chr2	74544702	74544809	107	54.0	
12055	chr2	74548701	74549913	1212	606.0	
12056	chr2	74553133	74556306	3173	1586.0	
12057	chr2	74562397	74562721	324	162.0	
12058	chr2	74566751	74567187	436	218.0	
12059	chr2	74571100	74571529	429	214.0	
12060	chr2	74573644	74574510	866	433.0	
12061	chr2	74576724	74578020	1296	648.0	
12062	chr2	74587549	74588131	582	291.0	
12063	chr2	74619851	74620335	484	242.0	
12064	chr2	74648104	74648544	440	220.0	
12065	chr2	74653463	74655059	1596	798.0	
12066	chr2	74690560	74690999	439	220.0	
12067	chr2	74694309	74694349	40	20.0	
12068	chr2	74714901	74716024	1123	562.0	
12069	chr2	74740611	74741961	1350	675.0	
12070	chr2	74764903	74765379	476	238.0	
12071	chr2	74789143	74789819	676	338.0	
12072	chr2	74806843	74807359	516	258.0	
12073	chr2	74816642	74817837	1195	598.0	
12074	chr2	74824596	74825137	541	270.0	
12075	chr2	74826109	74826568	459	230.0	
12076	chr2	74831801	74837924	6123	3062.0	
12077	chr2	74840116	74841017	901	450.0	
12078	chr2	74843577	74846142	2565	1282.0	
12079	chr2	74848761	74851099	2338	1169.0	
12080	chr2	74851874	74852171	297	148.0	
12081	chr2	74863686	74864179	493	246.0	
12082	chr2	74864960	74865255	295	148.0	
12083	chr2	74872304	74873078	774	387.0	
12084	chr2	74874706	74876753	2047	1024.0	
12085	chr2	74884163	74884511	348	174.0	
12086	chr2	74919681	74920480	799	400.0	
12087	chr2	74922446	74923207	761	380.0	
12088	chr2	74945226	74945445	219	110.0	
12089	chr2	74957857	74959825	1968	984.0	
12090	chr2	74979915	74980217	302	151.0	
12091	chr2	75018051	75018641	590	295.0	
12092	chr2	75041695	75042183	488	244.0	
12093	chr2	75064915	75065291	376	188.0	
12094	chr2	75162907	75163254	347	174.0	
12095	chr2	75199507	75199932	425	212.0	
12096	chr2	75211390	75211760	370	185.0	
12097	chr2	75287657	75288404	747	374.0	
12098	chr2	75311964	75312409	445	222.0	
12099	chr2	75403947	75404311	364	182.0	
12100	chr2	75416882	75417227	345	172.0	
12101	chr2	75431895	75432067	172	86.0	
12102	chr2	75609041	75609450	409	204.0	
12103	chr2	75627882	75628307	425	212.0	
12104	chr2	75640475	75641125	650	325.0	
12105	chr2	75646327	75647586	1259	630.0	
12106	chr2	75677224	75677758	534	267.0	
12107	chr2	75710123	75711816	1693	846.0	
12108	chr2	78673041	78673393	352	176.0	
12109	chr2	78977503	78978273	770	385.0	
12110	chr2	82837862	82838292	430	215.0	
12111	chr2	83340322	83340570	248	124.0	
12112	chr2	83342889	83343460	571	286.0	
12113	chr2	84302908	84303247	339	170.0	
12114	chr2	84314787	84315229	442	221.0	
12115	chr2	84450447	84450939	492	246.0	
12116	chr2	84458325	84460228	1903	952.0	
12117	chr2	84481545	84482273	728	364.0	
12118	chr2	84495480	84496188	708	354.0	
12119	chr2	84515822	84517017	1195	598.0	
12120	chr2	84631110	84631472	362	181.0	
12121	chr2	84649828	84650086	258	129.0	
12122	chr2	84693949	84694721	772	386.0	
12123	chr2	84741174	84741919	745	372.0	
12124	chr2	84781885	84783533	1648	824.0	
12125	chr2	84830001	84830587	586	293.0	
12126	chr2	84832566	84833733	1167	584.0	
12127	chr2	84840167	84842108	1941	970.0	
12128	chr2	84843798	84844133	335	168.0	
12129	chr2	84845577	84847761	2184	1092.0	
12130	chr2	84849416	84850068	652	326.0	
12131	chr2	84854851	84856225	1374	687.0	
12132	chr2	84856741	84857385	644	322.0	
12133	chr2	84858964	84859243	279	140.0	
12134	chr2	84864730	84865802	1072	536.0	
12135	chr2	84874816	84875373	557	278.0	
12136	chr2	84878430	84882753	4323	2162.0	
12137	chr2	84888269	84890457	2188	1094.0	
12138	chr2	84894067	84895447	1380	690.0	
12139	chr2	84898097	84899066	969	484.0	
12140	chr2	84900995	84901364	369	184.0	
12141	chr2	84904419	84910262	5843	2922.0	
12142	chr2	84919136	84920566	1430	715.0	
12143	chr2	84923971	84927466	3495	1748.0	
12144	chr2	84938030	84941270	3240	1620.0	
12145	chr2	84942999	84943342	343	172.0	
12146	chr2	84945777	84947046	1269	634.0	
12147	chr2	84959132	84959580	448	224.0	
12148	chr2	84963591	84965192	1601	800.0	
12149	chr2	84969032	84973405	4373	2186.0	
12150	chr2	84974068	84974506	438	219.0	
12151	chr2	84980501	84980582	81	40.0	
12152	chr2	85005800	85006477	677	338.0	
12153	chr2	85008914	85009598	684	342.0	
12154	chr2	85012879	85013261	382	191.0	
12155	chr2	85014624	85016093	1469	734.0	
12156	chr2	85017987	85018117	130	65.0	
12157	chr2	85053895	85054162	267	134.0	
12158	chr2	85057321	85058692	1371	686.0	
12159	chr2	85066799	85067204	405	202.0	
12160	chr2	85132838	85133741	903	452.0	
12161	chr2	85243694	85244037	343	172.0	
12162	chr2	85266395	85266901	506	253.0	
12163	chr2	85285251	85285964	713	356.0	
12164	chr2	85291096	85292029	933	466.0	
12165	chr2	85298507	85299202	695	348.0	
12166	chr2	85300269	85300942	673	336.0	
12167	chr2	85306835	85307787	952	476.0	
12168	chr2	85308931	85310653	1722	861.0	
12169	chr2	85318362	85320252	1890	945.0	
12170	chr2	85324410	85328789	4379	2190.0	
12171	chr2	85343530	85344755	1225	612.0	
12172	chr2	85345265	85345585	320	160.0	
12173	chr2	85353619	85355504	1885	942.0	
12174	chr2	85391180	85391826	646	323.0	
12175	chr2	85392327	85392934	607	304.0	
12176	chr2	85401788	85402319	531	266.0	
12177	chr2	85405229	85406320	1091	546.0	
12178	chr2	85408103	85410894	2791	1396.0	
12179	chr2	85413468	85414432	964	482.0	
12180	chr2	85416195	85416670	475	238.0	
12181	chr2	85417903	85419502	1599	800.0	
12182	chr2	85420322	85421606	1284	642.0	
12183	chr2	85428472	85429410	938	469.0	
12184	chr2	85434631	85439032	4401	2200.0	
12185	chr2	85441838	85442274	436	218.0	
12186	chr2	85499009	85499514	505	252.0	
12187	chr2	85500190	85500663	473	236.0	
12188	chr2	85501181	85501752	571	286.0	
12189	chr2	85516684	85517080	396	198.0	
12190	chr2	85524479	85524856	377	188.0	
12191	chr2	85534872	85535341	469	234.0	
12192	chr2	85537459	85542340	4881	2440.0	
12193	chr2	85542891	85543001	110	55.0	
12194	chr2	85544418	85548828	4410	2205.0	
12195	chr2	85549756	85553467	3711	1856.0	
12196	chr2	85560762	85562310	1548	774.0	
12197	chr2	85563912	85565137	1225	612.0	
12198	chr2	85577123	85580033	2910	1455.0	
12199	chr2	85583332	85586147	2815	1408.0	
12200	chr2	85587485	85588418	933	466.0	
12201	chr2	85589942	85591354	1412	706.0	
12202	chr2	85594807	85596485	1678	839.0	
12203	chr2	85600151	85603644	3493	1746.0	
12204	chr2	85611257	85612742	1485	742.0	
12205	chr2	85615485	85616963	1478	739.0	
12206	chr2	85637259	85638105	846	423.0	
12207	chr2	85648033	85648965	932	466.0	
12208	chr2	85666270	85666979	709	354.0	
12209	chr2	85669634	85669738	104	52.0	
12210	chr2	85672313	85673025	712	356.0	
12211	chr2	85674352	85674861	509	254.0	
12212	chr2	85678920	85679693	773	386.0	
12213	chr2	85684672	85685207	535	268.0	
12214	chr2	85693612	85695282	1670	835.0	
12215	chr2	85698337	85698353	16	8.0	
12216	chr2	85701413	85701934	521	260.0	
12217	chr2	85704599	85707856	3257	1628.0	
12218	chr2	85709253	85709863	610	305.0	
12219	chr2	85711760	85712769	1009	504.0	
12220	chr2	85716494	85716893	399	200.0	
12221	chr2	85723991	85724206	215	108.0	
12222	chr2	85728735	85729564	829	414.0	
12223	chr2	85747942	85748537	595	298.0	
12224	chr2	85750437	85751135	698	349.0	
12225	chr2	85753349	85755796	2447	1224.0	
12226	chr2	85775783	85776124	341	170.0	
12227	chr2	85785074	85785563	489	244.0	
12228	chr2	85790368	85790898	530	265.0	
12229	chr2	85804533	85805021	488	244.0	
12230	chr2	85813971	85814667	696	348.0	
12231	chr2	85827165	85828064	899	450.0	
12232	chr2	85830657	85831054	397	198.0	
12233	chr2	85840092	85840496	404	202.0	
12234	chr2	85843585	85843920	335	168.0	
12235	chr2	85851111	85854627	3516	1758.0	
12236	chr2	85860932	85862991	2059	1030.0	
12237	chr2	85873689	85874039	350	175.0	
12238	chr2	85875507	85876039	532	266.0	
12239	chr2	85879522	85879701	179	90.0	
12240	chr2	85885704	85891123	5419	2710.0	
12241	chr2	85894606	85894884	278	139.0	
12242	chr2	85928632	85928943	311	156.0	
12243	chr2	85963711	85964245	534	267.0	
12244	chr2	85979411	85979726	315	158.0	
12245	chr2	85993729	85994736	1007	504.0	
12246	chr2	85998531	86000576	2045	1022.0	
12247	chr2	86016850	86018961	2111	1056.0	
12248	chr2	86034339	86034429	90	45.0	
12249	chr2	86035336	86041559	6223	3112.0	enhancer
12250	chr2	86050440	86050813	373	186.0	
12251	chr2	86068035	86068740	705	352.0	
12252	chr2	86072298	86073035	737	368.0	
12253	chr2	86078709	86081260	2551	1276.0	
12254	chr2	86105112	86106907	1795	898.0	
12255	chr2	86140140	86140169	29	14.0	
12256	chr2	86143354	86143699	345	172.0	
12257	chr2	86184865	86186671	1806	903.0	
12258	chr2	86194344	86196342	1998	999.0	
12259	chr2	86198848	86200239	1391	696.0	
12260	chr2	86220983	86221534	551	276.0	
12261	chr2	86225438	86226528	1090	545.0	
12262	chr2	86229206	86229543	337	168.0	
12263	chr2	86238268	86238886	618	309.0	
12264	chr2	86243995	86244363	368	184.0	
12265	chr2	86358867	86359389	522	261.0	
12266	chr2	86368051	86368943	892	446.0	
12267	chr2	86399175	86399304	129	64.0	
12268	chr2	86411422	86411773	351	176.0	
12269	chr2	86416143	86416513	370	185.0	
12270	chr2	86433185	86433472	287	144.0	
12271	chr2	86440263	86443398	3135	1568.0	
12272	chr2	86468448	86469016	568	284.0	
12273	chr2	86487050	86487177	127	64.0	
12274	chr2	86518470	86518907	437	218.0	
12275	chr2	86552803	86553435	632	316.0	
12276	chr2	86562242	86564112	1870	935.0	
12277	chr2	86577912	86578158	246	123.0	
12278	chr2	86584034	86584661	627	314.0	
12279	chr2	86604005	86604244	239	120.0	
12280	chr2	86611045	86611271	226	113.0	
12281	chr2	86621269	86624586	3317	1658.0	
12282	chr2	86697822	86697927	105	52.0	
12283	chr2	86719452	86721518	2066	1033.0	
12284	chr2	86745819	86746088	269	134.0	
12285	chr2	86747953	86748358	405	202.0	
12286	chr2	86764494	86765175	681	340.0	
12287	chr2	86781478	86781878	400	200.0	
12288	chr2	86783549	86792132	8583	4292.0	"enhancer	region	enhancer	enhancer	protein_binding_site	protein_binding_site	mobile_genetic_element	protein_binding_site	stem_loop	protein_binding_site	protein_binding_site	region	mobile_genetic_element	region"
12289	chr2	86793380	86795536	2156	1078.0	
12290	chr2	86806010	86810177	4167	2084.0	
12291	chr2	86819025	86819394	369	184.0	
12292	chr2	86821185	86821994	809	404.0	
12293	chr2	86825002	86827303	2301	1150.0	
12294	chr2	86834900	86835296	396	198.0	
12295	chr2	86836945	86838036	1091	546.0	
12296	chr2	86839613	86839743	130	65.0	
12297	chr2	86861192	86862442	1250	625.0	
12298	chr2	87075107	87077286	2179	1090.0	
12299	chr2	87217769	87218168	399	200.0	
12300	chr2	87331981	87332338	357	178.0	
12301	chr2	87341531	87341910	379	190.0	
12302	chr2	87396632	87396858	226	113.0	
12303	chr2	87455243	87456197	954	477.0	
12304	chr2	87456716	87456829	113	56.0	
12305	chr2	87464215	87464621	406	203.0	
12306	chr2	87466768	87467178	410	205.0	
12307	chr2	87469152	87469664	512	256.0	
12308	chr2	87477026	87477385	359	180.0	
12309	chr2	87486144	87486522	378	189.0	
12310	chr2	87496013	87496422	409	204.0	
12311	chr2	87515294	87515431	137	68.0	
12312	chr2	87518100	87518263	163	82.0	
12313	chr2	87521080	87521486	406	203.0	
12314	chr2	87525691	87525943	252	126.0	
12315	chr2	88001604	88002279	675	338.0	
12316	chr2	88015353	88017660	2307	1154.0	
12317	chr2	88027671	88028354	683	342.0	
12318	chr2	88036205	88036664	459	230.0	
12319	chr2	88054047	88056554	2507	1254.0	
12320	chr2	88060284	88061141	857	428.0	
12321	chr2	88159668	88160361	693	346.0	
12322	chr2	88169827	88171004	1177	588.0	
12323	chr2	88187119	88187396	277	138.0	
12324	chr2	88191463	88191859	396	198.0	
12325	chr2	88195328	88195552	224	112.0	
12326	chr2	88200262	88200625	363	182.0	
12327	chr2	88230949	88231309	360	180.0	
12328	chr2	88239648	88240334	686	343.0	
12329	chr2	88265369	88265976	607	304.0	
12330	chr2	88269827	88270292	465	232.0	
12331	chr2	88281766	88282316	550	275.0	
12332	chr2	88307843	88308161	318	159.0	
12333	chr2	88342924	88343016	92	46.0	
12334	chr2	88350851	88351374	523	262.0	
12335	chr2	88451935	88452827	892	446.0	
12336	chr2	88590973	88591484	511	256.0	
12337	chr2	88599667	88600630	963	482.0	
12338	chr2	88606626	88607016	390	195.0	
12339	chr2	88614479	88614722	243	122.0	
12340	chr2	88615847	88616199	352	176.0	
12341	chr2	88617962	88618010	48	24.0	
12342	chr2	88624733	88625583	850	425.0	
12343	chr2	88626290	88628851	2561	1280.0	
12344	chr2	88629362	88629728	366	183.0	
12345	chr2	88638684	88639214	530	265.0	
12346	chr2	88669579	88670051	472	236.0	
12347	chr2	88671739	88672270	531	266.0	
12348	chr2	88680144	88680916	772	386.0	
12349	chr2	88687472	88687536	64	32.0	
12350	chr2	88690855	88692919	2064	1032.0	
12351	chr2	88693866	88694370	504	252.0	
12352	chr2	88697434	88697841	407	204.0	
12353	chr2	88739934	88740441	507	254.0	
12354	chr2	88751791	88752169	378	189.0	
12355	chr2	88754134	88754739	605	302.0	
12356	chr2	88765324	88766071	747	374.0	
12357	chr2	88831646	88832123	477	238.0	
12358	chr2	88838162	88838804	642	321.0	
12359	chr2	88845734	88846355	621	310.0	enhancer
12360	chr2	88855513	88855854	341	170.0	
12361	chr2	88858153	88858454	301	150.0	
12362	chr2	88866016	88867284	1268	634.0	
12363	chr2	88871363	88871717	354	177.0	
12364	chr2	88874078	88874465	387	194.0	
12365	chr2	88880346	88880821	475	238.0	
12366	chr2	88897693	88898096	403	202.0	
12367	chr2	88903764	88904184	420	210.0	
12368	chr2	88933993	88934427	434	217.0	
12369	chr2	89208416	89208986	570	285.0	
12370	chr2	89213470	89213497	27	14.0	
12371	chr2	89272769	89273308	539	270.0	
12372	chr2	89809992	89810075	83	42.0	
12373	chr2	89811406	89814656	3250	1625.0	
12374	chr2	89816806	89816936	130	65.0	
12375	chr2	89828428	89831214	2786	1393.0	
12376	chr2	89833075	89834533	1458	729.0	
12377	chr2	89836307	89837037	730	365.0	
12378	chr2	89839422	89840680	1258	629.0	
12379	chr2	89841578	89841599	21	10.0	
12380	chr2	89842255	89842704	449	224.0	
12381	chr2	89909310	89909716	406	203.0	
12382	chr2	90326202	90326634	432	216.0	
12383	chr2	90323088	90325129	2041	1020.0	
12384	chr2	90288693	90288765	72	36.0	
12385	chr2	91571706	91576846	5140	2570.0	
12386	chr2	91579621	91580018	397	198.0	
12387	chr2	91581428	91582855	1427	714.0	
12388	chr2	91583483	91585223	1740	870.0	
12389	chr2	91585824	91586131	307	154.0	
12390	chr2	91587820	91592426	4606	2303.0	
12391	chr2	91593285	91595662	2377	1188.0	
12392	chr2	91597287	91597307	20	10.0	
12393	chr2	91597876	91599888	2012	1006.0	
12394	chr2	91601106	91602059	953	476.0	
12395	chr2	91602884	91603228	344	172.0	
12396	chr2	91605610	91609504	3894	1947.0	
12397	chr2	91610482	91613412	2930	1465.0	
12398	chr2	91614241	91621172	6931	3466.0	
12399	chr2	91623134	91625241	2107	1054.0	
12400	chr2	91625882	91633951	8069	4034.0	
12401	chr2	91659721	91660300	579	290.0	
12402	chr2	91743059	91743433	374	187.0	
12403	chr2	91748814	91750011	1197	598.0	
12404	chr2	91766332	91766891	559	280.0	
12405	chr2	91772095	91772738	643	322.0	
12406	chr2	92081525	92081657	132	66.0	
12407	chr2	92093062	92093864	802	401.0	
12408	chr2	92096109	92096536	427	214.0	
12409	chr2	92102034	92103454	1420	710.0	
12410	chr2	92108046	92109407	1361	680.0	
12411	chr2	92112729	92113331	602	301.0	
12412	chr2	92117340	92119170	1830	915.0	
12413	chr2	92119826	92120261	435	218.0	
12414	chr2	92120831	92121973	1142	571.0	
12415	chr2	92127223	92128137	914	457.0	
12416	chr2	92129110	92130860	1750	875.0	
12417	chr2	92132839	92133440	601	300.0	
12418	chr2	92135337	92136355	1018	509.0	
12419	chr2	94874139	94874630	491	246.0	
12420	chr2	95022081	95023926	1845	922.0	
12421	chr2	95024903	95027341	2438	1219.0	
12422	chr2	95053633	95053776	143	72.0	
12423	chr2	95061851	95062161	310	155.0	
12424	chr2	95074091	95075535	1444	722.0	
12425	chr2	95076411	95077667	1256	628.0	
12426	chr2	95079112	95080399	1287	644.0	
12427	chr2	95115073	95115975	902	451.0	
12428	chr2	95121054	95122662	1608	804.0	
12429	chr2	95158716	95160553	1837	918.0	
12430	chr2	95164972	95166552	1580	790.0	
12431	chr2	95192870	95193338	468	234.0	
12432	chr2	95206817	95208139	1322	661.0	
12433	chr2	95260064	95260433	369	184.0	
12434	chr2	95345462	95346287	825	412.0	
12435	chr2	95389106	95389586	480	240.0	
12436	chr2	95401860	95403882	2022	1011.0	
12437	chr2	95413956	95414384	428	214.0	
12438	chr2	95526329	95527086	757	378.0	
12439	chr2	95682414	95682895	481	240.0	
12440	chr2	95700459	95701035	576	288.0	
12441	chr2	95728958	95729210	252	126.0	
12442	chr2	95734933	95735710	777	388.0	
12443	chr2	95991151	95993250	2099	1050.0	
12444	chr2	96009788	96011522	1734	867.0	
12445	chr2	96022479	96023215	736	368.0	
12446	chr2	96063207	96063771	564	282.0	
12447	chr2	96103468	96104482	1014	507.0	
12448	chr2	96107640	96107953	313	156.0	
12449	chr2	96108669	96149394	40725	20362.0	
12450	chr2	96149994	96152251	2257	1128.0	
12451	chr2	96153129	96155149	2020	1010.0	
12452	chr2	96156094	96159844	3750	1875.0	
12453	chr2	96161637	96165303	3666	1833.0	
12454	chr2	96167568	96167734	166	83.0	
12455	chr2	96174080	96175144	1064	532.0	
12456	chr2	96203029	96205511	2482	1241.0	
12457	chr2	96207159	96210202	3043	1522.0	
12458	chr2	96215389	96215636	247	124.0	
12459	chr2	96221043	96221543	500	250.0	
12460	chr2	96224928	96225663	735	368.0	
12461	chr2	96233412	96234380	968	484.0	
12462	chr2	96241345	96242889	1544	772.0	
12463	chr2	96245490	96246360	870	435.0	
12464	chr2	96246959	96247405	446	223.0	
12465	chr2	96251629	96252114	485	242.0	
12466	chr2	96254882	96254972	90	45.0	
12467	chr2	96256344	96258615	2271	1136.0	enhancer
12468	chr2	96259697	96261323	1626	813.0	enhancer
12469	chr2	96264691	96268144	3453	1726.0	
12470	chr2	96304735	96306417	1682	841.0	
12471	chr2	96315338	96316342	1004	502.0	
12472	chr2	96319082	96319752	670	335.0	
12473	chr2	96320676	96322647	1971	986.0	
12474	chr2	96324431	96326638	2207	1104.0	
12475	chr2	96333585	96334155	570	285.0	
12476	chr2	96334992	96337496	2504	1252.0	
12477	chr2	96338726	96339079	353	176.0	
12478	chr2	96341979	96342618	639	320.0	
12479	chr2	96343758	96344513	755	378.0	
12480	chr2	96345353	96345763	410	205.0	
12481	chr2	96359306	96359719	413	206.0	
12482	chr2	96389794	96390092	298	149.0	
12483	chr2	96395467	96396559	1092	546.0	
12484	chr2	96407114	96408179	1065	532.0	
12485	chr2	96437644	96437826	182	91.0	
12486	chr2	96470494	96471131	637	318.0	
12487	chr2	96475004	96475405	401	200.0	
12488	chr2	96485387	96487050	1663	832.0	
12489	chr2	96489535	96490146	611	306.0	
12490	chr2	96501422	96501968	546	273.0	
12491	chr2	96507738	96510103	2365	1182.0	
12492	chr2	96527068	96529232	2164	1082.0	
12493	chr2	96529902	96530163	261	130.0	
12494	chr2	96531623	96534119	2496	1248.0	
12495	chr2	96535639	96540613	4974	2487.0	
12496	chr2	96541745	96543396	1651	826.0	
12497	chr2	96544015	96544700	685	342.0	
12498	chr2	96545923	96555503	9580	4790.0	
12499	chr2	96556518	96557497	979	490.0	
12500	chr2	96594308	96595215	907	454.0	
12501	chr2	96616991	96618296	1305	652.0	
12502	chr2	96618802	96618922	120	60.0	
12503	chr2	96623034	96623698	664	332.0	
12504	chr2	96636721	96639039	2318	1159.0	
12505	chr2	96654789	96656928	2139	1070.0	
12506	chr2	96664516	96665832	1316	658.0	
12507	chr2	96737812	96738283	471	236.0	
12508	chr2	96739268	96740907	1639	820.0	
12509	chr2	96747680	96748166	486	243.0	
12510	chr2	96760086	96764772	4686	2343.0	
12511	chr2	96768049	96768466	417	208.0	
12512	chr2	96769861	96770243	382	191.0	
12513	chr2	96772887	96775037	2150	1075.0	
12514	chr2	96800559	96802590	2031	1016.0	
12515	chr2	96806432	96807425	993	496.0	
12516	chr2	96815156	96817566	2410	1205.0	
12517	chr2	96838543	96840167	1624	812.0	
12518	chr2	96856885	96859225	2340	1170.0	
12519	chr2	96859727	96860501	774	387.0	
12520	chr2	96861783	96862395	612	306.0	
12521	chr2	96863071	96863472	401	200.0	
12522	chr2	96866410	96871376	4966	2483.0	
12523	chr2	96873548	96875040	1492	746.0	
12524	chr2	96884702	96884880	178	89.0	
12525	chr2	96885626	96886387	761	380.0	
12526	chr2	96887797	96888750	953	476.0	
12527	chr2	96891579	96892022	443	222.0	
12528	chr2	96895633	96895857	224	112.0	
12529	chr2	96913150	96914361	1211	606.0	
12530	chr2	96923857	96925391	1534	767.0	
12531	chr2	96940993	96941190	197	98.0	
12532	chr2	96950817	96951786	969	484.0	
12533	chr2	96954209	96954879	670	335.0	
12534	chr2	96960138	96961031	893	446.0	
12535	chr2	96961627	96963739	2112	1056.0	
12536	chr2	96977792	96978191	399	200.0	
12537	chr2	97012210	97012518	308	154.0	
12538	chr2	97094652	97095598	946	473.0	
12539	chr2	97112197	97114242	2045	1022.0	
12540	chr2	97200793	97201127	334	167.0	
12541	chr2	97202723	97202734	11	6.0	
12542	chr2	97589261	97591257	1996	998.0	
12543	chr2	97644940	97646975	2035	1018.0	
12544	chr2	97662369	97665051	2682	1341.0	
12545	chr2	97696946	97697719	773	386.0	
12546	chr2	97700039	97700653	614	307.0	
12547	chr2	97709646	97711438	1792	896.0	
12548	chr2	97712371	97719596	7225	3612.0	
12549	chr2	97720857	97721747	890	445.0	
12550	chr2	97728061	97728773	712	356.0	
12551	chr2	97738203	97738971	768	384.0	
12552	chr2	97740437	97740955	518	259.0	
12553	chr2	97741776	97743059	1283	642.0	
12554	chr2	97745335	97746223	888	444.0	
12555	chr2	97747140	97749195	2055	1028.0	
12556	chr2	97759776	97760358	582	291.0	
12557	chr2	97760869	97762200	1331	666.0	
12558	chr2	97768178	97768559	381	190.0	
12559	chr2	97806657	97807452	795	398.0	
12560	chr2	97826309	97826639	330	165.0	
12561	chr2	97870411	97870976	565	282.0	
12562	chr2	97911303	97911847	544	272.0	
12563	chr2	97931113	97931821	708	354.0	
12564	chr2	97933279	97933589	310	155.0	
12565	chr2	97948950	97949369	419	210.0	
12566	chr2	97979603	97980272	669	334.0	
12567	chr2	97991428	97991577	149	74.0	
12568	chr2	97994601	97996871	2270	1135.0	
12569	chr2	98009980	98010537	557	278.0	
12570	chr2	98011173	98011191	18	9.0	
12571	chr2	98012339	98013236	897	448.0	
12572	chr2	98015617	98016119	502	251.0	
12573	chr2	98022105	98022468	363	182.0	
12574	chr2	98026343	98027979	1636	818.0	
12575	chr2	98039322	98039915	593	296.0	
12576	chr2	98081697	98082394	697	348.0	
12577	chr2	98086430	98088827	2397	1198.0	
12578	chr2	98091642	98092173	531	266.0	
12579	chr2	98123288	98123747	459	230.0	
12580	chr2	98133947	98134782	835	418.0	
12581	chr2	98149238	98149761	523	262.0	
12582	chr2	98252300	98252859	559	280.0	
12583	chr2	98269191	98269578	387	194.0	
12584	chr2	98384985	98385508	523	262.0	
12585	chr2	98412601	98413455	854	427.0	
12586	chr2	98438645	98439321	676	338.0	
12587	chr2	98444150	98447240	3090	1545.0	
12588	chr2	98447828	98449230	1402	701.0	
12589	chr2	98452337	98453428	1091	546.0	
12590	chr2	98454122	98456237	2115	1058.0	
12591	chr2	98458093	98459058	965	482.0	
12592	chr2	98459718	98461668	1950	975.0	
12593	chr2	98463123	98467635	4512	2256.0	
12594	chr2	98468665	98469106	441	220.0	
12595	chr2	98469913	98470314	401	200.0	
12596	chr2	98472080	98474576	2496	1248.0	
12597	chr2	98478041	98480732	2691	1346.0	
12598	chr2	98483106	98484027	921	460.0	
12599	chr2	98485072	98485508	436	218.0	
12600	chr2	98486625	98486843	218	109.0	
12601	chr2	98487657	98488504	847	424.0	
12602	chr2	98489431	98489948	517	258.0	
12603	chr2	98492405	98493113	708	354.0	
12604	chr2	98503937	98506481	2544	1272.0	
12605	chr2	98507673	98509381	1708	854.0	
12606	chr2	98514916	98515793	877	438.0	
12607	chr2	98516551	98517024	473	236.0	
12608	chr2	98517937	98518676	739	370.0	
12609	chr2	98542036	98542074	38	19.0	
12610	chr2	98549124	98549507	383	192.0	
12611	chr2	98551277	98551831	554	277.0	
12612	chr2	98556388	98557073	685	342.0	
12613	chr2	98568942	98569787	845	422.0	
12614	chr2	98580928	98581033	105	52.0	
12615	chr2	98601529	98601971	442	221.0	
12616	chr2	98607111	98609712	2601	1300.0	
12617	chr2	98616877	98616948	71	36.0	
12618	chr2	98623677	98624046	369	184.0	
12619	chr2	98634001	98635214	1213	606.0	
12620	chr2	98637353	98638277	924	462.0	
12621	chr2	98649043	98649937	894	447.0	
12622	chr2	98654842	98655545	703	352.0	
12623	chr2	98656676	98657334	658	329.0	
12624	chr2	98658847	98659858	1011	506.0	
12625	chr2	98663311	98664865	1554	777.0	
12626	chr2	98693573	98693665	92	46.0	
12627	chr2	98710630	98711133	503	252.0	
12628	chr2	98715555	98716478	923	462.0	
12629	chr2	98726351	98726478	127	64.0	
12630	chr2	98727661	98728761	1100	550.0	
12631	chr2	98729521	98732239	2718	1359.0	
12632	chr2	98733617	98735283	1666	833.0	
12633	chr2	98736292	98736985	693	346.0	
12634	chr2	98748647	98749667	1020	510.0	
12635	chr2	98757692	98760813	3121	1560.0	
12636	chr2	98761360	98761885	525	262.0	
12637	chr2	98764319	98764968	649	324.0	
12638	chr2	98765899	98766738	839	420.0	
12639	chr2	98768217	98773220	5003	2502.0	
12640	chr2	98805170	98805959	789	394.0	
12641	chr2	98807241	98807497	256	128.0	
12642	chr2	98822224	98823502	1278	639.0	
12643	chr2	98824297	98825117	820	410.0	
12644	chr2	98828708	98829315	607	304.0	
12645	chr2	98833448	98833489	41	20.0	
12646	chr2	98835514	98837707	2193	1096.0	
12647	chr2	98936279	98936848	569	284.0	
12648	chr2	99066006	99067059	1053	526.0	
12649	chr2	99101730	99102073	343	172.0	
12650	chr2	99137055	99137237	182	91.0	
12651	chr2	99140486	99142301	1815	908.0	
12652	chr2	99144148	99144649	501	250.0	
12653	chr2	99150626	99151137	511	256.0	
12654	chr2	99153893	99156092	2199	1100.0	
12655	chr2	99156872	99157274	402	201.0	
12656	chr2	99178940	99179738	798	399.0	
12657	chr2	99180468	99181795	1327	664.0	
12658	chr2	99335615	99338618	3003	1502.0	
12659	chr2	99488467	99491039	2572	1286.0	
12660	chr2	99514811	99515326	515	258.0	
12661	chr2	99555336	99555855	519	260.0	
12662	chr2	99559015	99559518	503	252.0	
12663	chr2	99638260	99638353	93	46.0	
12664	chr2	99660895	99661260	365	182.0	
12665	chr2	99755992	99756597	605	302.0	
12666	chr2	99767677	99768200	523	262.0	
12667	chr2	99771489	99773285	1796	898.0	
12668	chr2	99780223	99780674	451	226.0	
12669	chr2	99785631	99785971	340	170.0	
12670	chr2	99787842	99788255	413	206.0	
12671	chr2	99802753	99803147	394	197.0	
12672	chr2	99812596	99812664	68	34.0	
12673	chr2	99827117	99827831	714	357.0	
12674	chr2	99861389	99861788	399	200.0	
12675	chr2	99862687	99862725	38	19.0	
12676	chr2	99864740	99864996	256	128.0	
12677	chr2	99867602	99868128	526	263.0	
12678	chr2	99877936	99878336	400	200.0	
12679	chr2	99898444	99898558	114	57.0	
12680	chr2	99928452	99928888	436	218.0	
12681	chr2	100008955	100009973	1018	509.0	
12682	chr2	100039552	100039960	408	204.0	
12683	chr2	100042584	100042929	345	172.0	
12684	chr2	100060829	100061296	467	234.0	
12685	chr2	100071392	100071760	368	184.0	
12686	chr2	100104385	100105590	1205	602.0	"sequence_feature	repeat_region"
12687	chr2	100110351	100111166	815	408.0	
12688	chr2	100113720	100114570	850	425.0	
12689	chr2	100138175	100138177	2	1.0	
12690	chr2	100140512	100141031	519	260.0	
12691	chr2	100142156	100142962	806	403.0	
12692	chr2	100178004	100178582	578	289.0	
12693	chr2	100184264	100184987	723	362.0	
12694	chr2	100211511	100212041	530	265.0	
12695	chr2	100214168	100214557	389	194.0	
12696	chr2	100218553	100218959	406	203.0	
12697	chr2	100234959	100235807	848	424.0	
12698	chr2	100242881	100243740	859	430.0	
12699	chr2	100245906	100246558	652	326.0	
12700	chr2	100247369	100248066	697	348.0	
12701	chr2	100250685	100251045	360	180.0	
12702	chr2	100261649	100263276	1627	814.0	
12703	chr2	100274068	100274339	271	136.0	
12704	chr2	100279007	100279338	331	166.0	
12705	chr2	100289022	100289366	344	172.0	
12706	chr2	100291035	100292020	985	492.0	
12707	chr2	100322295	100322481	186	93.0	
12708	chr2	100381108	100381689	581	290.0	
12709	chr2	100394086	100395694	1608	804.0	
12710	chr2	100416763	100417931	1168	584.0	
12711	chr2	100425880	100426206	326	163.0	
12712	chr2	100427606	100428065	459	230.0	
12713	chr2	100513627	100513953	326	163.0	
12714	chr2	100554671	100555380	709	354.0	
12715	chr2	100561810	100564301	2491	1246.0	
12716	chr2	100571792	100572016	224	112.0	
12717	chr2	100580189	100581696	1507	754.0	
12718	chr2	100584791	100585450	659	330.0	
12719	chr2	100587935	100588721	786	393.0	
12720	chr2	100594825	100595339	514	257.0	
12721	chr2	100606602	100607294	692	346.0	
12722	chr2	100610196	100610739	543	272.0	
12723	chr2	100643489	100644763	1274	637.0	
12724	chr2	100653549	100654241	692	346.0	
12725	chr2	100812236	100812525	289	144.0	
12726	chr2	100818441	100820562	2121	1060.0	
12727	chr2	100924400	100925136	736	368.0	
12728	chr2	100941106	100941485	379	190.0	
12729	chr2	100976932	100977224	292	146.0	
12730	chr2	100984780	100985309	529	264.0	
12731	chr2	100992428	100992508	80	40.0	
12732	chr2	101001520	101003898	2378	1189.0	
12733	chr2	101007613	101007675	62	31.0	
12734	chr2	101012406	101013225	819	410.0	
12735	chr2	101030875	101031448	573	286.0	
12736	chr2	101038612	101039330	718	359.0	
12737	chr2	101041322	101041839	517	258.0	
12738	chr2	101044084	101044109	25	12.0	
12739	chr2	101112660	101113150	490	245.0	enhancer
12740	chr2	101113825	101114114	289	144.0	
12741	chr2	101114681	101115199	518	259.0	
12742	chr2	101117790	101118191	401	200.0	
12743	chr2	101127336	101127705	369	184.0	
12744	chr2	101150493	101153389	2896	1448.0	
12745	chr2	101167442	101167940	498	249.0	
12746	chr2	101173552	101174405	853	426.0	
12747	chr2	101175211	101175494	283	142.0	
12748	chr2	101179819	101180588	769	384.0	
12749	chr2	101187857	101187974	117	58.0	
12750	chr2	101190755	101191707	952	476.0	
12751	chr2	101205417	101205982	565	282.0	
12752	chr2	101223648	101224521	873	436.0	
12753	chr2	101238914	101239308	394	197.0	
12754	chr2	101240667	101241068	401	200.0	
12755	chr2	101251753	101254464	2711	1356.0	
12756	chr2	101297795	101298149	354	177.0	
12757	chr2	101299027	101301120	2093	1046.0	
12758	chr2	101302913	101303264	351	176.0	
12759	chr2	101303984	101310378	6394	3197.0	
12760	chr2	101311018	101312040	1022	511.0	
12761	chr2	101313103	101313392	289	144.0	
12762	chr2	101327797	101329591	1794	897.0	
12763	chr2	101330356	101331068	712	356.0	
12764	chr2	101340344	101340349	5	2.0	
12765	chr2	101341471	101342768	1297	648.0	
12766	chr2	101350240	101350629	389	194.0	
12767	chr2	101361130	101362494	1364	682.0	
12768	chr2	101368437	101368719	282	141.0	
12769	chr2	101386667	101387964	1297	648.0	
12770	chr2	101399424	101401593	2169	1084.0	
12771	chr2	101405277	101405796	519	260.0	
12772	chr2	101419011	101419498	487	244.0	
12773	chr2	101441993	101442345	352	176.0	
12774	chr2	101446781	101447324	543	272.0	
12775	chr2	101461413	101461797	384	192.0	
12776	chr2	101463653	101464656	1003	502.0	
12777	chr2	101466399	101466973	574	287.0	
12778	chr2	101473776	101475428	1652	826.0	
12779	chr2	101509514	101509944	430	215.0	
12780	chr2	101516993	101517751	758	379.0	
12781	chr2	101521438	101521915	477	238.0	
12782	chr2	101522852	101523250	398	199.0	
12783	chr2	101524849	101525490	641	320.0	
12784	chr2	101534208	101534815	607	304.0	
12785	chr2	101546384	101546957	573	286.0	
12786	chr2	101560891	101561308	417	208.0	
12787	chr2	101570678	101571416	738	369.0	
12788	chr2	101618818	101619526	708	354.0	
12789	chr2	101622622	101623804	1182	591.0	
12790	chr2	101625324	101625918	594	297.0	
12791	chr2	101627267	101627999	732	366.0	
12792	chr2	101630326	101630626	300	150.0	
12793	chr2	101651595	101652347	752	376.0	
12794	chr2	101689431	101689473	42	21.0	
12795	chr2	101692022	101692451	429	214.0	
12796	chr2	101696292	101700359	4067	2034.0	
12797	chr2	101702317	101705429	3112	1556.0	
12798	chr2	101706489	101707477	988	494.0	
12799	chr2	101710383	101711135	752	376.0	
12800	chr2	101713900	101714636	736	368.0	
12801	chr2	101715910	101717856	1946	973.0	
12802	chr2	101718480	101719729	1249	624.0	
12803	chr2	101722713	101724033	1320	660.0	
12804	chr2	101725693	101726196	503	252.0	
12805	chr2	101729736	101730125	389	194.0	
12806	chr2	101736181	101737345	1164	582.0	
12807	chr2	101740655	101741120	465	232.0	
12808	chr2	101751637	101752553	916	458.0	
12809	chr2	101755553	101755716	163	82.0	
12810	chr2	101757984	101758338	354	177.0	
12811	chr2	101763081	101763174	93	46.0	
12812	chr2	101763743	101764288	545	272.0	
12813	chr2	101768709	101768861	152	76.0	
12814	chr2	101770703	101771021	318	159.0	
12815	chr2	101781142	101781812	670	335.0	
12816	chr2	101806121	101807124	1003	502.0	
12817	chr2	101820703	101820746	43	22.0	
12818	chr2	101822828	101823893	1065	532.0	
12819	chr2	101828185	101828699	514	257.0	
12820	chr2	101829600	101829801	201	100.0	
12821	chr2	101831182	101831719	537	268.0	
12822	chr2	101842516	101842542	26	13.0	
12823	chr2	101883797	101884295	498	249.0	
12824	chr2	101909693	101910227	534	267.0	
12825	chr2	101912320	101913076	756	378.0	
12826	chr2	101921456	101922154	698	349.0	
12827	chr2	101931720	101931721	1	0.0	
12828	chr2	101957975	101958512	537	268.0	
12829	chr2	101960953	101962641	1688	844.0	
12830	chr2	101972530	101973505	975	488.0	
12831	chr2	101981420	101982016	596	298.0	
12832	chr2	101987020	101987777	757	378.0	
12833	chr2	101990161	101990219	58	29.0	
12834	chr2	101991296	101992140	844	422.0	
12835	chr2	101999567	101999617	50	25.0	
12836	chr2	102002471	102002522	51	26.0	
12837	chr2	102004629	102005053	424	212.0	
12838	chr2	102006187	102006716	529	264.0	
12839	chr2	102010852	102011481	629	314.0	
12840	chr2	102020511	102021193	682	341.0	
12841	chr2	102025435	102026124	689	344.0	
12842	chr2	102033001	102034052	1051	526.0	
12843	chr2	102041234	102041847	613	306.0	
12844	chr2	102052986	102053684	698	349.0	
12845	chr2	102063342	102064682	1340	670.0	
12846	chr2	102065790	102066102	312	156.0	
12847	chr2	102074160	102074845	685	342.0	
12848	chr2	102081624	102083616	1992	996.0	
12849	chr2	102094912	102095388	476	238.0	
12850	chr2	102104207	102104877	670	335.0	
12851	chr2	102115076	102115135	59	30.0	
12852	chr2	102116561	102116912	351	176.0	
12853	chr2	102130140	102130539	399	200.0	
12854	chr2	102138255	102138680	425	212.0	
12855	chr2	102142279	102143381	1102	551.0	
12856	chr2	102155772	102156267	495	248.0	
12857	chr2	102185342	102185721	379	190.0	
12858	chr2	102187486	102188311	825	412.0	
12859	chr2	102227316	102228601	1285	642.0	
12860	chr2	102234231	102234548	317	158.0	
12861	chr2	102235458	102235912	454	227.0	
12862	chr2	102238294	102238805	511	256.0	
12863	chr2	102240316	102241483	1167	584.0	
12864	chr2	102250912	102252043	1131	566.0	
12865	chr2	102253186	102253836	650	325.0	
12866	chr2	102256251	102256659	408	204.0	
12867	chr2	102258417	102259045	628	314.0	
12868	chr2	102261777	102263069	1292	646.0	
12869	chr2	102264871	102265006	135	68.0	
12870	chr2	102271857	102272258	401	200.0	
12871	chr2	102273735	102274320	585	292.0	
12872	chr2	102276916	102277233	317	158.0	
12873	chr2	102278691	102279110	419	210.0	
12874	chr2	102282635	102283222	587	294.0	
12875	chr2	102291269	102291938	669	334.0	
12876	chr2	102295621	102295965	344	172.0	
12877	chr2	102301797	102302312	515	258.0	
12878	chr2	102351885	102351889	4	2.0	
12879	chr2	102355305	102358888	3583	1792.0	
12880	chr2	102366601	102369129	2528	1264.0	
12881	chr2	102391519	102391945	426	213.0	
12882	chr2	102417691	102419027	1336	668.0	
12883	chr2	102422011	102422255	244	122.0	
12884	chr2	102422886	102423287	401	200.0	
12885	chr2	102424719	102425187	468	234.0	
12886	chr2	102436193	102436730	537	268.0	
12887	chr2	102442972	102443853	881	440.0	
12888	chr2	102449362	102449816	454	227.0	
12889	chr2	102472914	102473327	413	206.0	
12890	chr2	102489713	102490006	293	146.0	
12891	chr2	102505362	102505593	231	116.0	
12892	chr2	102508782	102510173	1391	696.0	
12893	chr2	102520022	102520411	389	194.0	
12894	chr2	102522830	102523382	552	276.0	
12895	chr2	102581841	102582320	479	240.0	
12896	chr2	102603866	102604324	458	229.0	
12897	chr2	102615804	102616272	468	234.0	
12898	chr2	102619276	102619729	453	226.0	
12899	chr2	102735399	102737524	2125	1062.0	
12900	chr2	102753553	102753956	403	202.0	
12901	chr2	102806301	102806581	280	140.0	
12902	chr2	102841287	102841492	205	102.0	
12903	chr2	102848472	102848712	240	120.0	
12904	chr2	104378700	104379420	720	360.0	
12905	chr2	104443072	104443518	446	223.0	
12906	chr2	104466072	104466346	274	137.0	
12907	chr2	104473522	104473967	445	222.0	
12908	chr2	104487333	104487750	417	208.0	
12909	chr2	104572665	104573403	738	369.0	
12910	chr2	104599760	104600064	304	152.0	
12911	chr2	104620682	104621289	607	304.0	
12912	chr2	104658376	104659199	823	412.0	
12913	chr2	104752513	104752665	152	76.0	
12914	chr2	104755233	104755730	497	248.0	
12915	chr2	104772876	104773586	710	355.0	
12916	chr2	104781013	104781709	696	348.0	
12917	chr2	104793953	104794344	391	196.0	
12918	chr2	104842970	104843441	471	236.0	
12919	chr2	104849505	104849953	448	224.0	enhancer
12920	chr2	104852225	104855613	3388	1694.0	
12921	chr2	104856561	104857667	1106	553.0	
12922	chr2	104861954	104862091	137	68.0	
12923	chr2	104873150	104873871	721	360.0	
12924	chr2	104889162	104889652	490	245.0	
12925	chr2	104976434	104977236	802	401.0	
12926	chr2	105037187	105039054	1867	934.0	
12927	chr2	105071461	105072419	958	479.0	
12928	chr2	105100060	105100461	401	200.0	
12929	chr2	105104425	105104640	215	108.0	
12930	chr2	105114473	105114900	427	214.0	
12931	chr2	105119053	105119376	323	162.0	
12932	chr2	105129712	105130136	424	212.0	
12933	chr2	105143612	105144302	690	345.0	
12934	chr2	105175291	105175497	206	103.0	
12935	chr2	105235564	105236040	476	238.0	
12936	chr2	105237882	105238387	505	252.0	
12937	chr2	105287739	105288127	388	194.0	
12938	chr2	105294883	105295220	337	168.0	
12939	chr2	105309132	105309622	490	245.0	
12940	chr2	105313887	105314366	479	240.0	
12941	chr2	105324066	105324450	384	192.0	
12942	chr2	105328189	105331087	2898	1449.0	
12943	chr2	105336780	105338433	1653	826.0	
12944	chr2	105344958	105345383	425	212.0	
12945	chr2	105361168	105361505	337	168.0	
12946	chr2	105369674	105370459	785	392.0	
12947	chr2	105373860	105374330	470	235.0	
12948	chr2	105398301	105399583	1282	641.0	
12949	chr2	105426616	105427271	655	328.0	
12950	chr2	105545708	105546138	430	215.0	
12951	chr2	105568295	105568427	132	66.0	
12952	chr2	105576296	105576776	480	240.0	
12953	chr2	105738055	105739821	1766	883.0	
12954	chr2	105743517	105748909	5392	2696.0	
12955	chr2	105749462	105751069	1607	804.0	
12956	chr2	105753689	105756782	3093	1546.0	
12957	chr2	105757369	105757990	621	310.0	
12958	chr2	105761888	105762630	742	371.0	
12959	chr2	105765835	105766089	254	127.0	
12960	chr2	105769557	105770547	990	495.0	
12961	chr2	105774229	105774822	593	296.0	
12962	chr2	105775674	105778462	2788	1394.0	
12963	chr2	105780596	105781016	420	210.0	
12964	chr2	105782199	105782529	330	165.0	
12965	chr2	105786292	105788329	2037	1018.0	
12966	chr2	105789685	105791164	1479	740.0	
12967	chr2	105795569	105799253	3684	1842.0	
12968	chr2	105800102	105801585	1483	742.0	
12969	chr2	105802249	105804041	1792	896.0	
12970	chr2	105808868	105809410	542	271.0	
12971	chr2	105822153	105822741	588	294.0	
12972	chr2	105827709	105828923	1214	607.0	
12973	chr2	105830514	105830732	218	109.0	
12974	chr2	105834853	105835324	471	236.0	
12975	chr2	105855594	105857774	2180	1090.0	
12976	chr2	105859044	105859752	708	354.0	
12977	chr2	105861183	105861675	492	246.0	
12978	chr2	105863855	105865277	1422	711.0	
12979	chr2	105872163	105872800	637	318.0	
12980	chr2	105873612	105874212	600	300.0	
12981	chr2	105888621	105888978	357	178.0	
12982	chr2	105895936	105896558	622	311.0	
12983	chr2	105919849	105920270	421	210.0	
12984	chr2	105927176	105927878	702	351.0	
12985	chr2	105929290	105929953	663	332.0	
12986	chr2	105934457	105935591	1134	567.0	
12987	chr2	106053111	106053465	354	177.0	
12988	chr2	106055255	106055590	335	168.0	
12989	chr2	106057210	106057544	334	167.0	
12990	chr2	106058567	106059098	531	266.0	
12991	chr2	106065089	106066082	993	496.0	
12992	chr2	106085210	106086237	1027	514.0	
12993	chr2	106093912	106098358	4446	2223.0	
12994	chr2	106104289	106105513	1224	612.0	
12995	chr2	106107744	106108695	951	476.0	
12996	chr2	106137881	106139194	1313	656.0	
12997	chr2	106144508	106145182	674	337.0	
12998	chr2	106147773	106148114	341	170.0	
12999	chr2	106158769	106161640	2871	1436.0	
13000	chr2	106184360	106184805	445	222.0	
13001	chr2	106187305	106188010	705	352.0	
13002	chr2	106189190	106190233	1043	522.0	
13003	chr2	106192526	106195048	2522	1261.0	
13004	chr2	106201642	106201998	356	178.0	
13005	chr2	106269470	106270605	1135	568.0	
13006	chr2	106330355	106330780	425	212.0	
13007	chr2	106353724	106354073	349	174.0	
13008	chr2	106461907	106462302	395	198.0	
13009	chr2	106511569	106512364	795	398.0	
13010	chr2	106515048	106515467	419	210.0	
13011	chr2	106530822	106531276	454	227.0	
13012	chr2	106536760	106538330	1570	785.0	
13013	chr2	106542662	106543362	700	350.0	
13014	chr2	106546265	106546939	674	337.0	
13015	chr2	106581829	106582981	1152	576.0	
13016	chr2	106587344	106587777	433	216.0	
13017	chr2	108267171	108267456	285	142.0	
13018	chr2	108378114	108378245	131	66.0	
13019	chr2	108448292	108451056	2764	1382.0	
13020	chr2	108530799	108531193	394	197.0	
13021	chr2	108533285	108535567	2282	1141.0	
13022	chr2	108536466	108536528	62	31.0	
13023	chr2	108565675	108566135	460	230.0	
13024	chr2	108579581	108580419	838	419.0	
13025	chr2	108583865	108584647	782	391.0	
13026	chr2	108585189	108585858	669	334.0	
13027	chr2	108587563	108588821	1258	629.0	
13028	chr2	108589911	108590132	221	110.0	
13029	chr2	108590829	108591801	972	486.0	
13030	chr2	108593762	108595555	1793	896.0	
13031	chr2	108596875	108597781	906	453.0	
13032	chr2	108607698	108608132	434	217.0	
13033	chr2	108608947	108609717	770	385.0	
13034	chr2	108610936	108611381	445	222.0	
13035	chr2	108612041	108613154	1113	556.0	
13036	chr2	108615663	108616107	444	222.0	
13037	chr2	108618530	108619285	755	378.0	
13038	chr2	108619933	108622378	2445	1222.0	
13039	chr2	108625508	108625594	86	43.0	
13040	chr2	108629414	108629673	259	130.0	
13041	chr2	108631561	108631979	418	209.0	
13042	chr2	108635990	108637774	1784	892.0	
13043	chr2	108652212	108653186	974	487.0	
13044	chr2	108718495	108720407	1912	956.0	
13045	chr2	108721101	108721125	24	12.0	
13046	chr2	108723913	108724191	278	139.0	
13047	chr2	108725288	108726385	1097	548.0	
13048	chr2	108776592	108776843	251	126.0	
13049	chr2	108785900	108787500	1600	800.0	
13050	chr2	108855324	108855580	256	128.0	
13051	chr2	108928305	108928790	485	242.0	
13052	chr2	108958013	108958457	444	222.0	
13053	chr2	108965493	108966042	549	274.0	
13054	chr2	108986967	108987584	617	308.0	
13055	chr2	108988375	108989562	1187	594.0	
13056	chr2	109020186	109020524	338	169.0	
13057	chr2	109030860	109033229	2369	1184.0	
13058	chr2	109047109	109047213	104	52.0	
13059	chr2	109127881	109130609	2728	1364.0	
13060	chr2	109143540	109144718	1178	589.0	
13061	chr2	109194270	109194739	469	234.0	
13062	chr2	109205542	109205912	370	185.0	
13063	chr2	109210804	109211194	390	195.0	
13064	chr2	109212803	109215140	2337	1168.0	
13065	chr2	109217321	109218711	1390	695.0	
13066	chr2	109226257	109226588	331	166.0	
13067	chr2	109238286	109239219	933	466.0	
13068	chr2	109254400	109254929	529	264.0	
13069	chr2	109255540	109256382	842	421.0	
13070	chr2	109266893	109267684	791	396.0	
13071	chr2	109275052	109275398	346	173.0	
13072	chr2	109331874	109332955	1081	540.0	
13073	chr2	109333845	109334218	373	186.0	
13074	chr2	109348497	109349631	1134	567.0	
13075	chr2	109510036	109510736	700	350.0	
13076	chr2	109546055	109546480	425	212.0	
13077	chr2	109611591	109611978	387	194.0	
13078	chr2	109613208	109615528	2320	1160.0	
13079	chr2	109635894	109636809	915	458.0	
13080	chr2	109637807	109638303	496	248.0	
13081	chr2	109794370	109794874	504	252.0	
13082	chr2	110101365	110101900	535	268.0	
13083	chr2	110157416	110157549	133	66.0	
13084	chr2	110204280	110205508	1228	614.0	
13085	chr2	110211853	110213011	1158	579.0	
13086	chr2	110576905	110577100	195	98.0	
13087	chr2	110610814	110611030	216	108.0	
13088	chr2	110657713	110658179	466	233.0	
13089	chr2	110674851	110675991	1140	570.0	
13090	chr2	110677173	110679604	2431	1216.0	
13091	chr2	110707609	110707737	128	64.0	
13092	chr2	110709251	110709657	406	203.0	
13093	chr2	110714849	110715224	375	188.0	
13094	chr2	110732407	110733455	1048	524.0	
13095	chr2	110748334	110748932	598	299.0	
13096	chr2	110804717	110805430	713	356.0	
13097	chr2	110806059	110806458	399	200.0	
13098	chr2	110811483	110812204	721	360.0	
13099	chr2	110820085	110820504	419	210.0	
13100	chr2	110827538	110827906	368	184.0	
13101	chr2	110846342	110847800	1458	729.0	
13102	chr2	110852133	110854757	2624	1312.0	
13103	chr2	110857898	110859453	1555	778.0	
13104	chr2	110860640	110860972	332	166.0	
13105	chr2	110865177	110865536	359	180.0	
13106	chr2	110875090	110875515	425	212.0	
13107	chr2	110876945	110877374	429	214.0	
13108	chr2	110946910	110947484	574	287.0	
13109	chr2	110983030	110983614	584	292.0	
13110	chr2	110993424	110995005	1581	790.0	
13111	chr2	111006321	111006792	471	236.0	
13112	chr2	111017130	111017607	477	238.0	
13113	chr2	111022605	111023161	556	278.0	
13114	chr2	111029053	111029093	40	20.0	
13115	chr2	111032078	111033398	1320	660.0	
13116	chr2	111050161	111050208	47	24.0	
13117	chr2	111055188	111055472	284	142.0	
13118	chr2	111061356	111061538	182	91.0	
13119	chr2	111071646	111072087	441	220.0	
13120	chr2	111085762	111085820	58	29.0	
13121	chr2	111100560	111101275	715	358.0	
13122	chr2	111115935	111124054	8119	4060.0	
13123	chr2	111128101	111128849	748	374.0	
13124	chr2	111133811	111134525	714	357.0	
13125	chr2	111135544	111136268	724	362.0	
13126	chr2	111137326	111137455	129	64.0	
13127	chr2	111143637	111143745	108	54.0	
13128	chr2	111148547	111148895	348	174.0	
13129	chr2	111156965	111158243	1278	639.0	
13130	chr2	111162759	111163394	635	318.0	
13131	chr2	111168591	111168873	282	141.0	
13132	chr2	111176783	111177184	401	200.0	
13133	chr2	111190072	111190356	284	142.0	
13134	chr2	111209012	111209371	359	180.0	
13135	chr2	111219218	111219852	634	317.0	
13136	chr2	111221711	111222102	391	196.0	
13137	chr2	111416384	111416520	136	68.0	
13138	chr2	111454445	111454800	355	178.0	
13139	chr2	111483036	111483406	370	185.0	
13140	chr2	111485942	111486278	336	168.0	
13141	chr2	111493709	111493743	34	17.0	
13142	chr2	111494325	111495280	955	478.0	
13143	chr2	111519121	111519456	335	168.0	
13144	chr2	111526078	111526669	591	296.0	
13145	chr2	111534843	111535251	408	204.0	
13146	chr2	111618529	111619662	1133	566.0	
13147	chr2	111624648	111625494	846	423.0	
13148	chr2	111626060	111626365	305	152.0	
13149	chr2	111632468	111633037	569	284.0	
13150	chr2	111633691	111634766	1075	538.0	
13151	chr2	111642846	111643453	607	304.0	
13152	chr2	111659262	111660211	949	474.0	
13153	chr2	111665725	111666132	407	204.0	
13154	chr2	111667499	111667941	442	221.0	
13155	chr2	111671103	111672043	940	470.0	
13156	chr2	111675766	111676307	541	270.0	
13157	chr2	111679191	111679620	429	214.0	
13158	chr2	111698642	111700012	1370	685.0	
13159	chr2	111701940	111702727	787	394.0	
13160	chr2	111705757	111706244	487	244.0	
13161	chr2	111747672	111748006	334	167.0	
13162	chr2	111883501	111885011	1510	755.0	
13163	chr2	111887679	111888180	501	250.0	
13164	chr2	111897624	111899797	2173	1086.0	
13165	chr2	111901000	111901114	114	57.0	
13166	chr2	111906385	111906854	469	234.0	
13167	chr2	111920119	111920555	436	218.0	
13168	chr2	111944634	111944998	364	182.0	
13169	chr2	111994088	111994461	373	186.0	
13170	chr2	112001075	112001902	827	414.0	
13171	chr2	112003928	112004853	925	462.0	
13172	chr2	112005948	112006616	668	334.0	
13173	chr2	112010728	112011187	459	230.0	
13174	chr2	112032605	112033927	1322	661.0	
13175	chr2	112048770	112049832	1062	531.0	
13176	chr2	112053757	112056977	3220	1610.0	
13177	chr2	112121654	112122077	423	212.0	
13178	chr2	112137624	112138540	916	458.0	
13179	chr2	112154758	112157081	2323	1162.0	
13180	chr2	112159643	112159835	192	96.0	
13181	chr2	112181357	112183639	2282	1141.0	
13182	chr2	112187356	112189269	1913	956.0	
13183	chr2	112254174	112256356	2182	1091.0	
13184	chr2	112259147	112260122	975	488.0	
13185	chr2	112274538	112276787	2249	1124.0	
13186	chr2	112277631	112278053	422	211.0	
13187	chr2	112432398	112434018	1620	810.0	
13188	chr2	112480499	112483431	2932	1466.0	
13189	chr2	112501034	112501543	509	254.0	
13190	chr2	112529754	112530008	254	127.0	
13191	chr2	112541131	112543604	2473	1236.0	
13192	chr2	112582064	112585374	3310	1655.0	
13193	chr2	112599762	112600528	766	383.0	
13194	chr2	112618423	112618805	382	191.0	
13195	chr2	112624134	112625279	1145	572.0	
13196	chr2	112625789	112627824	2035	1018.0	
13197	chr2	112630342	112632380	2038	1019.0	
13198	chr2	112634184	112635156	972	486.0	
13199	chr2	112636125	112636997	872	436.0	
13200	chr2	112644567	112649225	4658	2329.0	
13201	chr2	112650492	112651690	1198	599.0	
13202	chr2	112654689	112655065	376	188.0	
13203	chr2	112655790	112656315	525	262.0	
13204	chr2	112656955	112658305	1350	675.0	
13205	chr2	112658814	112661253	2439	1220.0	
13206	chr2	112662948	112664140	1192	596.0	
13207	chr2	112664863	112667246	2383	1192.0	
13208	chr2	112673782	112675088	1306	653.0	
13209	chr2	112682003	112682484	481	240.0	
13210	chr2	112686346	112686761	415	208.0	
13211	chr2	112690445	112693367	2922	1461.0	
13212	chr2	112699913	112701609	1696	848.0	
13213	chr2	112706136	112706654	518	259.0	
13214	chr2	112707751	112709094	1343	672.0	
13215	chr2	112724692	112725276	584	292.0	
13216	chr2	112726251	112727338	1087	544.0	
13217	chr2	112728747	112729747	1000	500.0	
13218	chr2	112749586	112750547	961	480.0	
13219	chr2	112754556	112755020	464	232.0	
13220	chr2	112757292	112757640	348	174.0	
13221	chr2	112763908	112765440	1532	766.0	
13222	chr2	112767798	112768853	1055	528.0	
13223	chr2	112772355	112772818	463	232.0	
13224	chr2	112784240	112784981	741	370.0	
13225	chr2	112787622	112788426	804	402.0	
13226	chr2	112793228	112795145	1917	958.0	
13227	chr2	112795829	112796193	364	182.0	
13228	chr2	112798967	112799946	979	490.0	
13229	chr2	112811683	112812462	779	390.0	
13230	chr2	112821814	112822188	374	187.0	
13231	chr2	112824050	112837340	13290	6645.0	
13232	chr2	112839045	112840327	1282	641.0	
13233	chr2	112841017	112842408	1391	696.0	
13234	chr2	112871395	112871796	401	200.0	
13235	chr2	112879555	112880355	800	400.0	
13236	chr2	112881083	112881946	863	432.0	
13237	chr2	112884790	112885362	572	286.0	
13238	chr2	112887767	112888510	743	372.0	
13239	chr2	112920880	112921344	464	232.0	
13240	chr2	112936137	112936744	607	304.0	
13241	chr2	112941700	112942182	482	241.0	
13242	chr2	112958767	112959246	479	240.0	
13243	chr2	112984951	112985510	559	280.0	
13244	chr2	112996542	112997206	664	332.0	
13245	chr2	113080048	113080492	444	222.0	
13246	chr2	113083135	113084654	1519	760.0	
13247	chr2	113089964	113090375	411	206.0	
13248	chr2	113097872	113098589	717	358.0	
13249	chr2	113111787	113112435	648	324.0	
13250	chr2	113116025	113116863	838	419.0	
13251	chr2	113120865	113121190	325	162.0	
13252	chr2	113123642	113125039	1397	698.0	
13253	chr2	113127020	113128254	1234	617.0	
13254	chr2	113136832	113137485	653	326.0	
13255	chr2	113138175	113139216	1041	520.0	
13256	chr2	113156782	113158188	1406	703.0	
13257	chr2	113167070	113169436	2366	1183.0	
13258	chr2	113172897	113176730	3833	1916.0	
13259	chr2	113178911	113179310	399	200.0	
13260	chr2	113180262	113182387	2125	1062.0	
13261	chr2	113184860	113185266	406	203.0	
13262	chr2	113187488	113188202	714	357.0	
13263	chr2	113197678	113197713	35	18.0	
13264	chr2	113198458	113199669	1211	606.0	
13265	chr2	113203610	113204748	1138	569.0	
13266	chr2	113211688	113212917	1229	614.0	
13267	chr2	113217299	113218879	1580	790.0	
13268	chr2	113219888	113220353	465	232.0	
13269	chr2	113232834	113232936	102	51.0	
13270	chr2	113234240	113234414	174	87.0	
13271	chr2	113235088	113236008	920	460.0	
13272	chr2	113248922	113249960	1038	519.0	
13273	chr2	113250976	113251704	728	364.0	
13274	chr2	113257475	113257937	462	231.0	
13275	chr2	113260949	113261639	690	345.0	
13276	chr2	113272787	113273470	683	342.0	
13277	chr2	113276037	113276041	4	2.0	
13278	chr2	113276996	113277113	117	58.0	
13279	chr2	113277657	113277811	154	77.0	
13280	chr2	113282946	113283465	519	260.0	
13281	chr2	113297584	113297946	362	181.0	
13282	chr2	113324445	113325218	773	386.0	
13283	chr2	113342566	113343168	602	301.0	
13284	chr2	113365753	113366280	527	264.0	
13285	chr2	113368533	113368931	398	199.0	
13286	chr2	113370449	113371006	557	278.0	
13287	chr2	113374755	113375454	699	350.0	
13288	chr2	113376249	113377489	1240	620.0	
13289	chr2	113386710	113387422	712	356.0	
13290	chr2	113389989	113391260	1271	636.0	
13291	chr2	113407759	113407862	103	52.0	
13292	chr2	113431806	113432149	343	172.0	
13293	chr2	113437459	113438651	1192	596.0	
13294	chr2	113499581	113499657	76	38.0	
13295	chr2	113500632	113500847	215	108.0	
13296	chr2	113502568	113504509	1941	970.0	
13297	chr2	113541130	113542330	1200	600.0	
13298	chr2	113551617	113552293	676	338.0	
13299	chr2	113583301	113584592	1291	646.0	
13300	chr2	113587177	113587635	458	229.0	
13301	chr2	113601906	113604761	2855	1428.0	
13302	chr2	113626563	113627849	1286	643.0	
13303	chr2	113656071	113656352	281	140.0	
13304	chr2	113679558	113679838	280	140.0	
13305	chr2	113692676	113694150	1474	737.0	
13306	chr2	113699270	113699364	94	47.0	
13307	chr2	113700098	113700637	539	270.0	
13308	chr2	113755509	113757654	2145	1072.0	
13309	chr2	113792044	113792057	13	6.0	
13310	chr2	113799463	113799648	185	92.0	
13311	chr2	113834323	113834669	346	173.0	
13312	chr2	113854927	113855383	456	228.0	
13313	chr2	113857357	113857952	595	298.0	
13314	chr2	113859031	113860156	1125	562.0	
13315	chr2	113863016	113863694	678	339.0	
13316	chr2	113875137	113875424	287	144.0	
13317	chr2	113876317	113878381	2064	1032.0	
13318	chr2	113886203	113887760	1557	778.0	
13319	chr2	113888949	113891656	2707	1354.0	
13320	chr2	113893451	113893552	101	50.0	
13321	chr2	113894209	113895749	1540	770.0	
13322	chr2	113897621	113897691	70	35.0	
13323	chr2	113901939	113902367	428	214.0	
13324	chr2	113903588	113903591	3	2.0	
13325	chr2	113905768	113906282	514	257.0	
13326	chr2	113910153	113911286	1133	566.0	
13327	chr2	113923476	113924075	599	300.0	
13328	chr2	113950725	113951331	606	303.0	
13329	chr2	113965592	113966079	487	244.0	
13330	chr2	113966712	113967334	622	311.0	
13331	chr2	113976500	113976921	421	210.0	
13332	chr2	113979716	113980079	363	182.0	
13333	chr2	114011788	114011892	104	52.0	
13334	chr2	117785760	117785901	141	70.0	
13335	chr2	117803720	117804105	385	192.0	
13336	chr2	117814072	117816210	2138	1069.0	
13337	chr2	117820421	117820814	393	196.0	
13338	chr2	117835529	117836806	1277	638.0	
13339	chr2	117930832	117931083	251	126.0	
13340	chr2	117979803	117981711	1908	954.0	
13341	chr2	118003022	118003988	966	483.0	
13342	chr2	118012750	118017495	4745	2372.0	
13343	chr2	118032189	118032859	670	335.0	
13344	chr2	118040875	118041361	486	243.0	
13345	chr2	118046644	118047055	411	206.0	
13346	chr2	118049785	118050200	415	208.0	
13347	chr2	118055319	118056669	1350	675.0	
13348	chr2	118059776	118060233	457	228.0	
13349	chr2	118061307	118061878	571	286.0	
13350	chr2	118087736	118089931	2195	1098.0	
13351	chr2	118097593	118098964	1371	686.0	
13352	chr2	118103928	118104901	973	486.0	
13353	chr2	118122545	118123243	698	349.0	
13354	chr2	118124514	118124813	299	150.0	
13355	chr2	118169228	118169901	673	336.0	
13356	chr2	118185337	118186955	1618	809.0	
13357	chr2	118188165	118188182	17	8.0	
13358	chr2	118197256	118197648	392	196.0	
13359	chr2	118202627	118203195	568	284.0	
13360	chr2	118221916	118222431	515	258.0	
13361	chr2	118223595	118225322	1727	864.0	
13362	chr2	118309795	118311075	1280	640.0	
13363	chr2	118848010	118848041	31	16.0	
13364	chr2	118855328	118856314	986	493.0	
13365	chr2	118865066	118865504	438	219.0	
13366	chr2	118878505	118879181	676	338.0	
13367	chr2	118881467	118881994	527	264.0	
13368	chr2	118882525	118883312	787	394.0	
13369	chr2	118902267	118903294	1027	514.0	
13370	chr2	118913662	118914199	537	268.0	
13371	chr2	118929031	118929459	428	214.0	
13372	chr2	118936187	118937393	1206	603.0	
13373	chr2	118939956	118941111	1155	578.0	
13374	chr2	118945815	118946373	558	279.0	
13375	chr2	118948266	118948626	360	180.0	
13376	chr2	118954357	118955225	868	434.0	
13377	chr2	118968054	118968391	337	168.0	
13378	chr2	118969009	118969318	309	154.0	
13379	chr2	118970564	118971302	738	369.0	
13380	chr2	118973535	118974576	1041	520.0	
13381	chr2	118985524	118985597	73	36.0	
13382	chr2	119008114	119008465	351	176.0	
13383	chr2	119174430	119174801	371	186.0	
13384	chr2	119223360	119225106	1746	873.0	
13385	chr2	119263589	119263991	402	201.0	
13386	chr2	119265124	119265580	456	228.0	
13387	chr2	119282171	119284587	2416	1208.0	
13388	chr2	119290846	119291286	440	220.0	
13389	chr2	119326874	119327309	435	218.0	
13390	chr2	119339138	119339697	559	280.0	
13391	chr2	119352658	119352663	5	2.0	
13392	chr2	119355584	119356416	832	416.0	
13393	chr2	119365800	119368280	2480	1240.0	
13394	chr2	119387599	119388222	623	312.0	
13395	chr2	119407692	119408115	423	212.0	
13396	chr2	119431117	119431931	814	407.0	
13397	chr2	119476211	119476681	470	235.0	
13398	chr2	119483114	119483533	419	210.0	
13399	chr2	119517459	119517867	408	204.0	
13400	chr2	119543993	119544666	673	336.0	
13401	chr2	119641485	119642033	548	274.0	
13402	chr2	119647521	119647783	262	131.0	
13403	chr2	119657465	119657886	421	210.0	
13404	chr2	119660013	119660462	449	224.0	
13405	chr2	119677753	119679862	2109	1054.0	
13406	chr2	119694852	119695716	864	432.0	
13407	chr2	119697858	119697912	54	27.0	
13408	chr2	119702738	119703480	742	371.0	
13409	chr2	119704410	119705325	915	458.0	
13410	chr2	119753268	119754252	984	492.0	
13411	chr2	119758864	119761152	2288	1144.0	
13412	chr2	119821349	119821481	132	66.0	
13413	chr2	119823719	119824139	420	210.0	
13414	chr2	119826295	119826801	506	253.0	
13415	chr2	119862431	119862787	356	178.0	
13416	chr2	119864299	119864802	503	252.0	
13417	chr2	119929268	119930096	828	414.0	
13418	chr2	120006231	120006366	135	68.0	
13419	chr2	120012486	120013822	1336	668.0	
13420	chr2	120109084	120110919	1835	918.0	
13421	chr2	120174617	120175500	883	442.0	
13422	chr2	120176546	120178216	1670	835.0	
13423	chr2	120181882	120182546	664	332.0	
13424	chr2	120203133	120203732	599	300.0	
13425	chr2	120206213	120206625	412	206.0	
13426	chr2	120210116	120210817	701	350.0	
13427	chr2	120222542	120224591	2049	1024.0	
13428	chr2	120231039	120233202	2163	1082.0	
13429	chr2	120241697	120242037	340	170.0	
13430	chr2	120243168	120243513	345	172.0	
13431	chr2	120251454	120254430	2976	1488.0	
13432	chr2	120264701	120265563	862	431.0	
13433	chr2	120269394	120269539	145	72.0	
13434	chr2	120287202	120287820	618	309.0	
13435	chr2	120305984	120306297	313	156.0	
13436	chr2	120312729	120313624	895	448.0	
13437	chr2	120314622	120314941	319	160.0	
13438	chr2	120337942	120338499	557	278.0	
13439	chr2	120342122	120342173	51	26.0	
13440	chr2	120343105	120343841	736	368.0	
13441	chr2	120344363	120347279	2916	1458.0	
13442	chr2	120442879	120443344	465	232.0	
13443	chr2	120680228	120680693	465	232.0	
13444	chr2	121075018	121075440	422	211.0	enhancer
13445	chr2	121076886	121077393	507	254.0	
13446	chr2	121080174	121080554	380	190.0	
13447	chr2	121084948	121085300	352	176.0	
13448	chr2	121128722	121129169	447	224.0	
13449	chr2	121188942	121189379	437	218.0	
13450	chr2	121190016	121190224	208	104.0	
13451	chr2	121197212	121198410	1198	599.0	
13452	chr2	121284461	121285556	1095	548.0	
13453	chr2	121286985	121287920	935	468.0	
13454	chr2	121293493	121293728	235	118.0	
13455	chr2	121303594	121303876	282	141.0	
13456	chr2	121309686	121310299	613	306.0	
13457	chr2	121322820	121323239	419	210.0	
13458	chr2	121356066	121356452	386	193.0	
13459	chr2	121402247	121402743	496	248.0	
13460	chr2	121529773	121532234	2461	1230.0	
13461	chr2	121533096	121533143	47	24.0	
13462	chr2	121539562	121540113	551	276.0	
13463	chr2	121558392	121558634	242	121.0	
13464	chr2	121596180	121597219	1039	520.0	
13465	chr2	121610047	121612439	2392	1196.0	
13466	chr2	121648278	121651022	2744	1372.0	
13467	chr2	121698548	121701315	2767	1384.0	
13468	chr2	121718495	121719312	817	408.0	
13469	chr2	121735510	121739088	3578	1789.0	
13470	chr2	121746249	121746578	329	164.0	
13471	chr2	121748221	121748526	305	152.0	
13472	chr2	121754847	121756419	1572	786.0	
13473	chr2	121974789	121975679	890	445.0	
13474	chr2	122706728	122707062	334	167.0	
13475	chr2	122737581	122738175	594	297.0	
13476	chr2	122755344	122755946	602	301.0	
13477	chr2	122763979	122764366	387	194.0	
13478	chr2	123073311	123073831	520	260.0	
13479	chr2	123738666	123738892	226	113.0	
13480	chr2	124264844	124265033	189	94.0	
13481	chr2	126413104	126413479	375	188.0	
13482	chr2	126528060	126528523	463	232.0	
13483	chr2	126634246	126634681	435	218.0	
13484	chr2	126637442	126637687	245	122.0	
13485	chr2	126644491	126645599	1108	554.0	
13486	chr2	126647873	126648125	252	126.0	
13487	chr2	126655187	126660320	5133	2566.0	
13488	chr2	126661300	126665105	3805	1902.0	
13489	chr2	126682473	126682533	60	30.0	
13490	chr2	126761933	126762941	1008	504.0	
13491	chr2	126776199	126777996	1797	898.0	
13492	chr2	126799248	126799765	517	258.0	
13493	chr2	126826519	126826858	339	170.0	
13494	chr2	126828107	126828880	773	386.0	
13495	chr2	126831567	126832092	525	262.0	
13496	chr2	126846185	126846693	508	254.0	
13497	chr2	126886076	126886945	869	434.0	
13498	chr2	126956757	126957167	410	205.0	
13499	chr2	126971394	126972477	1083	542.0	
13500	chr2	127014551	127015164	613	306.0	
13501	chr2	127025133	127026208	1075	538.0	
13502	chr2	127046571	127046947	376	188.0	
13503	chr2	127049860	127050975	1115	558.0	
13504	chr2	127051656	127052735	1079	540.0	
13505	chr2	127061489	127061690	201	100.0	
13506	chr2	127064287	127065577	1290	645.0	
13507	chr2	127066545	127069864	3319	1660.0	
13508	chr2	127079450	127082680	3230	1615.0	
13509	chr2	127084021	127086183	2162	1081.0	
13510	chr2	127086707	127087831	1124	562.0	
13511	chr2	127093597	127093968	371	186.0	
13512	chr2	127105627	127108071	2444	1222.0	
13513	chr2	127128362	127128937	575	288.0	
13514	chr2	127134969	127135729	760	380.0	
13515	chr2	127143931	127144053	122	61.0	
13516	chr2	127158768	127159347	579	290.0	
13517	chr2	127176572	127177275	703	352.0	
13518	chr2	127179830	127180119	289	144.0	
13519	chr2	127197581	127198210	629	314.0	
13520	chr2	127233662	127234171	509	254.0	
13521	chr2	127241206	127241483	277	138.0	
13522	chr2	127278968	127279075	107	54.0	
13523	chr2	127293378	127295550	2172	1086.0	
13524	chr2	127305963	127306600	637	318.0	
13525	chr2	127313285	127313848	563	282.0	
13526	chr2	127348452	127348878	426	213.0	
13527	chr2	127354404	127354570	166	83.0	
13528	chr2	127355379	127355854	475	238.0	
13529	chr2	127364983	127365946	963	482.0	
13530	chr2	127377710	127378055	345	172.0	
13531	chr2	127381724	127381785	61	30.0	
13532	chr2	127382621	127383364	743	372.0	
13533	chr2	127384415	127384916	501	250.0	
13534	chr2	127385549	127389079	3530	1765.0	
13535	chr2	127389618	127390661	1043	522.0	
13536	chr2	127398115	127398715	600	300.0	
13537	chr2	127404490	127405369	879	440.0	
13538	chr2	127407417	127408925	1508	754.0	
13539	chr2	127410772	127412613	1841	920.0	
13540	chr2	127415573	127417129	1556	778.0	
13541	chr2	127422725	127423949	1224	612.0	
13542	chr2	127479188	127479646	458	229.0	
13543	chr2	127485544	127486908	1364	682.0	
13544	chr2	127498511	127498755	244	122.0	
13545	chr2	127508477	127509045	568	284.0	
13546	chr2	127523571	127523907	336	168.0	
13547	chr2	127525133	127527829	2696	1348.0	
13548	chr2	127560238	127560510	272	136.0	
13549	chr2	127563001	127564294	1293	646.0	
13550	chr2	127578020	127578299	279	140.0	
13551	chr2	127591199	127592039	840	420.0	
13552	chr2	127620790	127621326	536	268.0	
13553	chr2	127630039	127631057	1018	509.0	
13554	chr2	127632930	127634667	1737	868.0	
13555	chr2	127637639	127639251	1612	806.0	
13556	chr2	127639914	127641113	1199	600.0	
13557	chr2	127641801	127642625	824	412.0	
13558	chr2	127646561	127646972	411	206.0	
13559	chr2	127649167	127650347	1180	590.0	
13560	chr2	127659862	127660242	380	190.0	
13561	chr2	127674641	127675876	1235	618.0	
13562	chr2	127681301	127681564	263	132.0	
13563	chr2	127695602	127696487	885	442.0	
13564	chr2	127700298	127702775	2477	1238.0	
13565	chr2	127705144	127705600	456	228.0	
13566	chr2	127749430	127750105	675	338.0	
13567	chr2	127794841	127795349	508	254.0	
13568	chr2	127810140	127812161	2021	1010.0	
13569	chr2	127829543	127831224	1681	840.0	
13570	chr2	127857147	127858796	1649	824.0	
13571	chr2	127859580	127860444	864	432.0	
13572	chr2	127864910	127865196	286	143.0	
13573	chr2	127874871	127875087	216	108.0	
13574	chr2	127884612	127887076	2464	1232.0	
13575	chr2	127891893	127891996	103	52.0	
13576	chr2	127898161	127898820	659	330.0	
13577	chr2	127954820	127955257	437	218.0	
13578	chr2	128026481	128029168	2687	1344.0	
13579	chr2	128063394	128063815	421	210.0	
13580	chr2	128090577	128092130	1553	776.0	
13581	chr2	128162172	128162947	775	388.0	
13582	chr2	128166859	128167402	543	272.0	
13583	chr2	128168523	128170038	1515	758.0	
13584	chr2	128179129	128179639	510	255.0	
13585	chr2	128195777	128196777	1000	500.0	
13586	chr2	128217674	128218082	408	204.0	
13587	chr2	128232646	128234139	1493	746.0	
13588	chr2	128273357	128274082	725	362.0	
13589	chr2	128279697	128281298	1601	800.0	
13590	chr2	128291037	128292755	1718	859.0	
13591	chr2	128294837	128295348	511	256.0	
13592	chr2	128299668	128300775	1107	554.0	
13593	chr2	128301510	128302606	1096	548.0	
13594	chr2	128304212	128305935	1723	862.0	
13595	chr2	128308259	128308502	243	122.0	
13596	chr2	128313584	128313707	123	62.0	
13597	chr2	128315508	128315633	125	62.0	
13598	chr2	128316305	128319641	3336	1668.0	
13599	chr2	128321326	128322778	1452	726.0	
13600	chr2	128323616	128323631	15	8.0	
13601	chr2	128372627	128373262	635	318.0	
13602	chr2	128382179	128382582	403	202.0	
13603	chr2	128442492	128443548	1056	528.0	
13604	chr2	128458770	128458805	35	18.0	
13605	chr2	128472802	128473818	1016	508.0	
13606	chr2	128504186	128504655	469	234.0	
13607	chr2	128513000	128514539	1539	770.0	
13608	chr2	128520320	128521324	1004	502.0	
13609	chr2	128531910	128532072	162	81.0	
13610	chr2	128557668	128558270	602	301.0	
13611	chr2	128603383	128603657	274	137.0	
13612	chr2	128622307	128622812	505	252.0	
13613	chr2	128638334	128638717	383	192.0	
13614	chr2	128642920	128643170	250	125.0	
13615	chr2	128654297	128654886	589	294.0	
13616	chr2	128686420	128686892	472	236.0	
13617	chr2	128702917	128702925	8	4.0	
13618	chr2	128710804	128711181	377	188.0	
13619	chr2	128714266	128714729	463	232.0	
13620	chr2	128732993	128733595	602	301.0	
13621	chr2	128734450	128735348	898	449.0	
13622	chr2	128736513	128737209	696	348.0	
13623	chr2	128754169	128754559	390	195.0	
13624	chr2	129203245	129203785	540	270.0	
13625	chr2	129464294	129464349	55	28.0	
13626	chr2	129483319	129483828	509	254.0	
13627	chr2	129758739	129759353	614	307.0	
13628	chr2	129811884	129812740	856	428.0	
13629	chr2	129849527	129850044	517	258.0	
13630	chr2	129876976	129878942	1966	983.0	
13631	chr2	129923867	129923918	51	26.0	
13632	chr2	130144313	130145349	1036	518.0	
13633	chr2	130156056	130156391	335	168.0	
13634	chr2	130157533	130158601	1068	534.0	
13635	chr2	130180965	130183517	2552	1276.0	
13636	chr2	130229100	130229518	418	209.0	
13637	chr2	130332257	130333147	890	445.0	
13638	chr2	130337071	130337472	401	200.0	
13639	chr2	130341455	130343716	2261	1130.0	
13640	chr2	130352231	130352817	586	293.0	
13641	chr2	130353862	130353893	31	16.0	
13642	chr2	130354798	130356909	2111	1056.0	
13643	chr2	130370331	130373832	3501	1750.0	
13644	chr2	130376641	130377483	842	421.0	
13645	chr2	130385661	130386203	542	271.0	
13646	chr2	130390304	130392298	1994	997.0	
13647	chr2	130693463	130693920	457	228.0	
13648	chr2	130726748	130730491	3743	1872.0	
13649	chr2	130755976	130756509	533	266.0	
13650	chr2	130796203	130799412	3209	1604.0	
13651	chr2	130823936	130825128	1192	596.0	
13652	chr2	130836665	130837223	558	279.0	
13653	chr2	130864775	130865493	718	359.0	
13654	chr2	130873619	130874181	562	281.0	
13655	chr2	130920399	130920853	454	227.0	
13656	chr2	130985345	130985822	477	238.0	
13657	chr2	131034696	131035523	827	414.0	
13658	chr2	131039879	131042376	2497	1248.0	
13659	chr2	131045797	131046060	263	132.0	
13660	chr2	131092453	131094393	1940	970.0	
13661	chr2	131101990	131102084	94	47.0	
13662	chr2	131104230	131107200	2970	1485.0	
13663	chr2	131114779	131115324	545	272.0	
13664	chr2	131146203	131146712	509	254.0	
13665	chr2	131153724	131154687	963	482.0	
13666	chr2	131156420	131156860	440	220.0	
13667	chr2	131413130	131413547	417	208.0	
13668	chr2	131491002	131493932	2930	1465.0	
13669	chr2	131494785	131495064	279	140.0	
13670	chr2	131514489	131514890	401	200.0	
13671	chr2	131520643	131520773	130	65.0	
13672	chr2	131527387	131529823	2436	1218.0	
13673	chr2	131668764	131669556	792	396.0	
13674	chr2	131672383	131674441	2058	1029.0	
13675	chr2	131681719	131683366	1647	824.0	
13676	chr2	131801489	131802982	1493	746.0	
13677	chr2	132238842	132239294	452	226.0	
13678	chr2	132257565	132258268	703	352.0	
13679	chr2	132259244	132259663	419	210.0	
13680	chr2	132268103	132268880	777	388.0	
13681	chr2	132300924	132300963	39	20.0	
13682	chr2	132304770	132304883	113	56.0	
13683	chr2	132352430	132353887	1457	728.0	
13684	chr2	132383985	132384908	923	462.0	
13685	chr2	132391827	132392195	368	184.0	
13686	chr2	132577600	132578186	586	293.0	
13687	chr2	132645942	132646282	340	170.0	
13688	chr2	133844237	133844654	417	208.0	
13689	chr2	133886678	133886943	265	132.0	
13690	chr2	133953574	133953922	348	174.0	
13691	chr2	133968585	133968586	1	0.0	
13692	chr2	134020677	134021054	377	188.0	
13693	chr2	134021889	134022106	217	108.0	
13694	chr2	134060987	134061453	466	233.0	
13695	chr2	134108071	134108592	521	260.0	
13696	chr2	134118157	134122062	3905	1952.0	
13697	chr2	134122591	134123781	1190	595.0	
13698	chr2	134125490	134125653	163	82.0	
13699	chr2	134127449	134127987	538	269.0	
13700	chr2	134128737	134128851	114	57.0	
13701	chr2	134137035	134137762	727	364.0	
13702	chr2	134140844	134141203	359	180.0	
13703	chr2	134154203	134155506	1303	652.0	
13704	chr2	134160936	134161458	522	261.0	
13705	chr2	134173353	134173587	234	117.0	
13706	chr2	134175417	134175773	356	178.0	
13707	chr2	134178606	134178706	100	50.0	
13708	chr2	134181010	134181712	702	351.0	
13709	chr2	134198045	134198446	401	200.0	
13710	chr2	134205993	134206463	470	235.0	
13711	chr2	134207507	134208054	547	274.0	
13712	chr2	134208851	134209199	348	174.0	
13713	chr2	134217257	134219770	2513	1256.0	
13714	chr2	134220536	134220950	414	207.0	
13715	chr2	134228654	134228807	153	76.0	
13716	chr2	134231840	134234369	2529	1264.0	
13717	chr2	134244209	134246147	1938	969.0	
13718	chr2	134250796	134251243	447	224.0	
13719	chr2	134252042	134252624	582	291.0	
13720	chr2	134253403	134254317	914	457.0	
13721	chr2	134258375	134259291	916	458.0	
13722	chr2	134261595	134263206	1611	806.0	
13723	chr2	134275043	134275875	832	416.0	
13724	chr2	134282566	134283472	906	453.0	
13725	chr2	134287434	134287776	342	171.0	
13726	chr2	134288723	134289364	641	320.0	
13727	chr2	134290210	134290731	521	260.0	
13728	chr2	134294551	134295116	565	282.0	
13729	chr2	134320930	134321304	374	187.0	
13730	chr2	134324883	134325297	414	207.0	
13731	chr2	134338244	134338579	335	168.0	
13732	chr2	134402480	134402785	305	152.0	
13733	chr2	134411600	134412461	861	430.0	
13734	chr2	134450428	134451347	919	460.0	
13735	chr2	134460502	134460921	419	210.0	
13736	chr2	134461531	134461828	297	148.0	
13737	chr2	134466163	134466265	102	51.0	
13738	chr2	134583488	134583734	246	123.0	
13739	chr2	134657687	134658027	340	170.0	
13740	chr2	134668412	134671970	3558	1779.0	
13741	chr2	134676943	134677363	420	210.0	
13742	chr2	134679284	134680147	863	432.0	
13743	chr2	134692441	134692890	449	224.0	
13744	chr2	134706651	134707247	596	298.0	
13745	chr2	134712747	134713451	704	352.0	
13746	chr2	134717876	134719580	1704	852.0	
13747	chr2	134736181	134736959	778	389.0	
13748	chr2	134739210	134740601	1391	696.0	
13749	chr2	134758524	134759188	664	332.0	
13750	chr2	134782699	134783145	446	223.0	
13751	chr2	134783838	134784376	538	269.0	
13752	chr2	134912364	134912765	401	200.0	
13753	chr2	134917382	134919775	2393	1196.0	
13754	chr2	134943520	134943977	457	228.0	
13755	chr2	135004178	135004691	513	256.0	
13756	chr2	135043359	135043739	380	190.0	
13757	chr2	135051565	135053639	2074	1037.0	
13758	chr2	135112354	135112742	388	194.0	
13759	chr2	135529959	135532483	2524	1262.0	
13760	chr2	135590924	135591101	177	88.0	
13761	chr2	135657994	135658595	601	300.0	
13762	chr2	135676093	135676113	20	10.0	
13763	chr2	135689794	135689928	134	67.0	
13764	chr2	135709801	135710330	529	264.0	
13765	chr2	135740974	135743357	2383	1192.0	
13766	chr2	135744650	135745260	610	305.0	
13767	chr2	135747716	135747730	14	7.0	
13768	chr2	135792407	135792928	521	260.0	
13769	chr2	135794692	135795139	447	224.0	
13770	chr2	135797385	135798094	709	354.0	
13771	chr2	135798816	135798848	32	16.0	
13772	chr2	135820012	135820467	455	228.0	
13773	chr2	135840654	135841032	378	189.0	
13774	chr2	135874860	135877204	2344	1172.0	
13775	chr2	135890795	135891304	509	254.0	
13776	chr2	135893311	135893922	611	306.0	
13777	chr2	135913681	135914160	479	240.0	
13778	chr2	135916217	135916634	417	208.0	
13779	chr2	135932112	135932208	96	48.0	
13780	chr2	135948492	135949158	666	333.0	
13781	chr2	135954152	135954618	466	233.0	
13782	chr2	135960915	135961003	88	44.0	
13783	chr2	135963085	135963095	10	5.0	
13784	chr2	135972880	135973142	262	131.0	
13785	chr2	135980825	135980893	68	34.0	
13786	chr2	135984058	135986466	2408	1204.0	
13787	chr2	135997272	135997787	515	258.0	
13788	chr2	136000468	136000966	498	249.0	
13789	chr2	136006054	136006077	23	12.0	
13790	chr2	136007713	136009105	1392	696.0	
13791	chr2	136012235	136013491	1256	628.0	
13792	chr2	136015186	136015988	802	401.0	
13793	chr2	136017066	136017129	63	32.0	
13794	chr2	136019209	136019928	719	360.0	
13795	chr2	136022389	136023212	823	412.0	
13796	chr2	136025457	136025965	508	254.0	
13797	chr2	136051523	136052186	663	332.0	
13798	chr2	136056980	136058130	1150	575.0	
13799	chr2	136059187	136059377	190	95.0	
13800	chr2	136098457	136098819	362	181.0	
13801	chr2	136106530	136106913	383	192.0	
13802	chr2	136110504	136110941	437	218.0	
13803	chr2	136111469	136119942	8473	4236.0	
13804	chr2	136121144	136121680	536	268.0	
13805	chr2	136122540	136138365	15825	7912.0	
13806	chr2	136139433	136140066	633	316.0	
13807	chr2	136141749	136141977	228	114.0	
13808	chr2	136205004	136205167	163	82.0	
13809	chr2	136206547	136207991	1444	722.0	
13810	chr2	136210118	136211027	909	454.0	
13811	chr2	136212521	136215017	2496	1248.0	
13812	chr2	136216080	136216578	498	249.0	
13813	chr2	136221037	136221430	393	196.0	
13814	chr2	136225842	136226707	865	432.0	
13815	chr2	136238116	136240285	2169	1084.0	
13816	chr2	136242530	136243248	718	359.0	
13817	chr2	136245972	136246663	691	346.0	
13818	chr2	136253409	136254147	738	369.0	
13819	chr2	136254842	136256512	1670	835.0	
13820	chr2	136281037	136282366	1329	664.0	
13821	chr2	136305487	136306073	586	293.0	
13822	chr2	136311290	136311599	309	154.0	
13823	chr2	136322381	136322909	528	264.0	
13824	chr2	136324083	136324381	298	149.0	
13825	chr2	136324930	136326377	1447	724.0	
13826	chr2	136326923	136327986	1063	532.0	
13827	chr2	136331286	136331677	391	196.0	
13828	chr2	136378486	136379235	749	374.0	
13829	chr2	136381788	136382895	1107	554.0	
13830	chr2	136384370	136385275	905	452.0	
13831	chr2	136389813	136390206	393	196.0	
13832	chr2	136393587	136393802	215	108.0	
13833	chr2	136423323	136424601	1278	639.0	
13834	chr2	137178667	137179402	735	368.0	
13835	chr2	137838517	137838826	309	154.0	
13836	chr2	137947348	137948162	814	407.0	
13837	chr2	137952468	137953194	726	363.0	
13838	chr2	137959257	137959498	241	120.0	
13839	chr2	137960158	137960616	458	229.0	
13840	chr2	137963923	137964831	908	454.0	
13841	chr2	137968722	137969842	1120	560.0	
13842	chr2	138028139	138029021	882	441.0	
13843	chr2	138090386	138090732	346	173.0	
13844	chr2	138475119	138475896	777	388.0	
13845	chr2	138499740	138500050	310	155.0	
13846	chr2	138500948	138503853	2905	1452.0	
13847	chr2	138504672	138505286	614	307.0	
13848	chr2	138515336	138515353	17	8.0	
13849	chr2	138516006	138516407	401	200.0	
13850	chr2	138523631	138524062	431	216.0	
13851	chr2	138689758	138690169	411	206.0	
13852	chr2	138814459	138815062	603	302.0	
13853	chr2	138827378	138827824	446	223.0	
13854	chr2	138829381	138829653	272	136.0	
13855	chr2	139031760	139031922	162	81.0	
13856	chr2	141557320	141557665	345	172.0	
13857	chr2	142695423	142695769	346	173.0	
13858	chr2	142786911	142787277	366	183.0	
13859	chr2	142840373	142840908	535	268.0	
13860	chr2	142865658	142867470	1812	906.0	
13861	chr2	142868047	142868888	841	420.0	
13862	chr2	142870522	142871055	533	266.0	
13863	chr2	142873021	142874963	1942	971.0	
13864	chr2	142877289	142878655	1366	683.0	
13865	chr2	142880147	142880743	596	298.0	
13866	chr2	142980811	142980909	98	49.0	
13867	chr2	142989353	142990008	655	328.0	
13868	chr2	143030060	143030595	535	268.0	
13869	chr2	143034217	143034797	580	290.0	
13870	chr2	143068248	143069023	775	388.0	
13871	chr2	143070813	143071005	192	96.0	
13872	chr2	143083529	143084284	755	378.0	
13873	chr2	143088375	143088858	483	242.0	
13874	chr2	143110457	143111438	981	490.0	
13875	chr2	143121997	143122300	303	152.0	
13876	chr2	143128362	143129819	1457	728.0	
13877	chr2	143132256	143132823	567	284.0	
13878	chr2	143137841	143137965	124	62.0	
13879	chr2	143140017	143141827	1810	905.0	
13880	chr2	143142574	143142596	22	11.0	
13881	chr2	143148712	143149172	460	230.0	
13882	chr2	143150070	143150799	729	364.0	
13883	chr2	143152167	143153340	1173	586.0	
13884	chr2	143158464	143159258	794	397.0	
13885	chr2	143161991	143162697	706	353.0	
13886	chr2	143176667	143177925	1258	629.0	
13887	chr2	143205040	143205778	738	369.0	
13888	chr2	143217501	143218161	660	330.0	
13889	chr2	143222373	143222846	473	236.0	
13890	chr2	143245122	143245697	575	288.0	
13891	chr2	143246471	143247710	1239	620.0	
13892	chr2	143248418	143248623	205	102.0	
13893	chr2	143254085	143254509	424	212.0	
13894	chr2	143255669	143256791	1122	561.0	
13895	chr2	143258117	143259989	1872	936.0	
13896	chr2	143261438	143264074	2636	1318.0	
13897	chr2	143282654	143283086	432	216.0	
13898	chr2	143284017	143284503	486	243.0	
13899	chr2	143329331	143329683	352	176.0	
13900	chr2	143402543	143402824	281	140.0	
13901	chr2	143422601	143423123	522	261.0	
13902	chr2	143452845	143453484	639	320.0	
13903	chr2	143477676	143478175	499	250.0	
13904	chr2	143513235	143513434	199	100.0	
13905	chr2	143586935	143587111	176	88.0	
13906	chr2	143589008	143589028	20	10.0	
13907	chr2	143686616	143686875	259	130.0	
13908	chr2	143730146	143730550	404	202.0	
13909	chr2	144138142	144138394	252	126.0	
13910	chr2	144143444	144144204	760	380.0	
13911	chr2	144152768	144153211	443	222.0	
13912	chr2	144162700	144163011	311	156.0	
13913	chr2	144183551	144184281	730	365.0	
13914	chr2	144190947	144191535	588	294.0	
13915	chr2	144198071	144198569	498	249.0	
13916	chr2	144216263	144216495	232	116.0	
13917	chr2	144227625	144227966	341	170.0	
13918	chr2	144233437	144233667	230	115.0	
13919	chr2	144234425	144234428	3	2.0	
13920	chr2	144237700	144238686	986	493.0	
13921	chr2	144240953	144241248	295	148.0	
13922	chr2	144267222	144267542	320	160.0	
13923	chr2	144320212	144321027	815	408.0	
13924	chr2	144324462	144325785	1323	662.0	
13925	chr2	144331053	144333333	2280	1140.0	
13926	chr2	144372396	144373185	789	394.0	
13927	chr2	144374199	144374724	525	262.0	
13928	chr2	144376419	144376959	540	270.0	
13929	chr2	144377902	144378365	463	232.0	
13930	chr2	144379755	144381428	1673	836.0	
13931	chr2	144382695	144383461	766	383.0	
13932	chr2	144406599	144406733	134	67.0	
13933	chr2	144412646	144413176	530	265.0	
13934	chr2	144413844	144415812	1968	984.0	
13935	chr2	144426282	144427199	917	458.0	
13936	chr2	144429514	144431843	2329	1164.0	enhancer
13937	chr2	144434761	144435268	507	254.0	
13938	chr2	144438537	144439037	500	250.0	
13939	chr2	144440846	144441707	861	430.0	
13940	chr2	144444344	144444588	244	122.0	
13941	chr2	144446076	144446516	440	220.0	
13942	chr2	144447534	144447946	412	206.0	
13943	chr2	144448646	144449623	977	488.0	
13944	chr2	144451837	144453280	1443	722.0	
13945	chr2	144454516	144455365	849	424.0	
13946	chr2	144456145	144457278	1133	566.0	
13947	chr2	144458779	144460633	1854	927.0	
13948	chr2	144461182	144462868	1686	843.0	
13949	chr2	144465750	144466081	331	166.0	
13950	chr2	144466767	144466855	88	44.0	
13951	chr2	144467665	144468047	382	191.0	
13952	chr2	144471162	144471840	678	339.0	
13953	chr2	144473580	144473586	6	3.0	
13954	chr2	144475009	144475515	506	253.0	
13955	chr2	144477547	144477560	13	6.0	
13956	chr2	144489964	144490497	533	266.0	
13957	chr2	144491086	144491521	435	218.0	
13958	chr2	144492950	144493530	580	290.0	
13959	chr2	144495371	144495937	566	283.0	
13960	chr2	144496821	144497451	630	315.0	
13961	chr2	144504023	144504614	591	296.0	
13962	chr2	144505196	144506117	921	460.0	
13963	chr2	144507342	144508977	1635	818.0	
13964	chr2	144509591	144511532	1941	970.0	
13965	chr2	144512173	144524888	12715	6358.0	
13966	chr2	144548714	144549210	496	248.0	
13967	chr2	144560253	144560708	455	228.0	
13968	chr2	144562451	144562498	47	24.0	
13969	chr2	144570504	144570967	463	232.0	
13970	chr2	144580767	144582043	1276	638.0	enhancer
13971	chr2	144582882	144583853	971	486.0	enhancer
13972	chr2	144596192	144596781	589	294.0	
13973	chr2	144598099	144599868	1769	884.0	
13974	chr2	144605428	144605566	138	69.0	
13975	chr2	144606540	144608405	1865	932.0	
13976	chr2	144636872	144637290	418	209.0	
13977	chr2	144645457	144645823	366	183.0	
13978	chr2	144659326	144661689	2363	1182.0	
13979	chr2	144663219	144663716	497	248.0	
13980	chr2	144666101	144666368	267	134.0	
13981	chr2	144671586	144672393	807	404.0	
13982	chr2	144682252	144684394	2142	1071.0	
13983	chr2	144686491	144687466	975	488.0	
13984	chr2	144693149	144693625	476	238.0	
13985	chr2	144701030	144702453	1423	712.0	
13986	chr2	144703683	144704509	826	413.0	
13987	chr2	144825259	144826143	884	442.0	
13988	chr2	144833048	144833480	432	216.0	
13989	chr2	144890816	144891165	349	174.0	
13990	chr2	144935882	144935977	95	48.0	
13991	chr2	144946360	144946699	339	170.0	
13992	chr2	145141976	145142379	403	202.0	
13993	chr2	145171006	145171259	253	126.0	
13994	chr2	145235388	145235649	261	130.0	
13995	chr2	145259035	145259618	583	292.0	
13996	chr2	145411373	145411964	591	296.0	
13997	chr2	145638700	145639081	381	190.0	
13998	chr2	145682478	145683187	709	354.0	
13999	chr2	145692849	145693637	788	394.0	
14000	chr2	145742973	145743499	526	263.0	
14001	chr2	145750521	145752876	2355	1178.0	
14002	chr2	145771551	145771905	354	177.0	
14003	chr2	145811320	145812182	862	431.0	
14004	chr2	147045223	147045419	196	98.0	
14005	chr2	147082869	147083256	387	194.0	
14006	chr2	147182159	147182739	580	290.0	
14007	chr2	147288153	147288554	401	200.0	
14008	chr2	147297779	147298163	384	192.0	
14009	chr2	147364692	147365074	382	191.0	
14010	chr2	147449411	147449955	544	272.0	
14011	chr2	147500245	147500620	375	188.0	
14012	chr2	147561019	147561581	562	281.0	
14013	chr2	147623266	147623778	512	256.0	
14014	chr2	147628803	147629467	664	332.0	
14015	chr2	147630407	147631684	1277	638.0	
14016	chr2	147632213	147632544	331	166.0	
14017	chr2	147636414	147637396	982	491.0	
14018	chr2	147642658	147643016	358	179.0	
14019	chr2	147663264	147664397	1133	566.0	
14020	chr2	147689213	147690315	1102	551.0	
14021	chr2	147698424	147698545	121	60.0	
14022	chr2	147824688	147824935	247	124.0	
14023	chr2	147837851	147838122	271	136.0	
14024	chr2	147843456	147846833	3377	1688.0	
14025	chr2	147910925	147911326	401	200.0	
14026	chr2	147937693	147938131	438	219.0	
14027	chr2	147989749	147990277	528	264.0	
14028	chr2	148019886	148022230	2344	1172.0	
14029	chr2	148023857	148024271	414	207.0	
14030	chr2	148201369	148201692	323	162.0	
14031	chr2	148509122	148510061	939	470.0	
14032	chr2	148524101	148525357	1256	628.0	
14033	chr2	148526839	148528953	2114	1057.0	
14034	chr2	148540054	148540546	492	246.0	
14035	chr2	148545362	148546790	1428	714.0	
14036	chr2	148552591	148553816	1225	612.0	
14037	chr2	148614005	148615088	1083	542.0	
14038	chr2	148619782	148620117	335	168.0	
14039	chr2	148642761	148646651	3890	1945.0	
14040	chr2	148651948	148652307	359	180.0	
14041	chr2	148653292	148653759	467	234.0	
14042	chr2	148658251	148659511	1260	630.0	
14043	chr2	148674033	148674519	486	243.0	
14044	chr2	148725745	148725947	202	101.0	
14045	chr2	148764869	148765178	309	154.0	
14046	chr2	148813633	148814195	562	281.0	
14047	chr2	148870288	148870667	379	190.0	
14048	chr2	148874446	148877682	3236	1618.0	
14049	chr2	148880652	148880962	310	155.0	
14050	chr2	148887253	148888633	1380	690.0	
14051	chr2	148926169	148927692	1523	762.0	
14052	chr2	148948890	148949291	401	200.0	
14053	chr2	148965809	148966349	540	270.0	
14054	chr2	148975787	148975996	209	104.0	
14055	chr2	148989824	148990347	523	262.0	
14056	chr2	149017167	149017803	636	318.0	
14057	chr2	149019728	149020073	345	172.0	
14058	chr2	149021141	149021957	816	408.0	
14059	chr2	149038531	149038865	334	167.0	
14060	chr2	149040504	149040844	340	170.0	
14061	chr2	149069129	149069934	805	402.0	
14062	chr2	149085116	149086402	1286	643.0	
14063	chr2	149152462	149153138	676	338.0	
14064	chr2	149160830	149161958	1128	564.0	
14065	chr2	149167449	149168359	910	455.0	
14066	chr2	149330299	149330700	401	200.0	
14067	chr2	149537316	149537329	13	6.0	
14068	chr2	149544670	149545088	418	209.0	
14069	chr2	149561242	149561695	453	226.0	
14070	chr2	149568177	149568386	209	104.0	
14071	chr2	149585427	149585551	124	62.0	
14072	chr2	149586857	149588419	1562	781.0	
14073	chr2	149597320	149598357	1037	518.0	
14074	chr2	149601657	149601755	98	49.0	
14075	chr2	149859065	149859497	432	216.0	
14076	chr2	150911608	150912446	838	419.0	
14077	chr2	151051580	151052019	439	220.0	
14078	chr2	151189261	151189379	118	59.0	
14079	chr2	151238769	151240009	1240	620.0	
14080	chr2	151260626	151262437	1811	906.0	
14081	chr2	151287558	151290644	3086	1543.0	
14082	chr2	151297845	151298413	568	284.0	
14083	chr2	151325793	151326171	378	189.0	
14084	chr2	151337643	151338355	712	356.0	
14085	chr2	151347915	151348416	501	250.0	
14086	chr2	151357227	151357880	653	326.0	
14087	chr2	151363430	151364352	922	461.0	
14088	chr2	151409320	151410968	1648	824.0	
14089	chr2	151423678	151424286	608	304.0	
14090	chr2	151437542	151438008	466	233.0	
14091	chr2	151475074	151475472	398	199.0	
14092	chr2	151525800	151526295	495	248.0	
14093	chr2	151636920	151639029	2109	1054.0	
14094	chr2	151669731	151670195	464	232.0	
14095	chr2	151765822	151766973	1151	576.0	
14096	chr2	151771379	151772125	746	373.0	enhancer
14097	chr2	151808312	151808975	663	332.0	
14098	chr2	151826595	151829178	2583	1292.0	
14099	chr2	151834003	151834407	404	202.0	
14100	chr2	151840195	151841197	1002	501.0	
14101	chr2	151844503	151844530	27	14.0	
14102	chr2	151878957	151879405	448	224.0	
14103	chr2	151886165	151886958	793	396.0	
14104	chr2	151904695	151905261	566	283.0	
14105	chr2	151917858	151918846	988	494.0	
14106	chr2	151922758	151923726	968	484.0	
14107	chr2	151928586	151928677	91	46.0	
14108	chr2	151947129	151948236	1107	554.0	
14109	chr2	151998939	151999424	485	242.0	
14110	chr2	152004313	152005181	868	434.0	
14111	chr2	152005883	152005978	95	48.0	
14112	chr2	152025341	152026431	1090	545.0	
14113	chr2	152030744	152031584	840	420.0	
14114	chr2	152036797	152037288	491	246.0	
14115	chr2	152038428	152039114	686	343.0	
14116	chr2	152042743	152043391	648	324.0	
14117	chr2	152046753	152047470	717	358.0	
14118	chr2	152047989	152048332	343	172.0	
14119	chr2	152049455	152049892	437	218.0	
14120	chr2	152051327	152051778	451	226.0	
14121	chr2	152054488	152055071	583	292.0	
14122	chr2	152062544	152063029	485	242.0	
14123	chr2	152071101	152071340	239	120.0	
14124	chr2	152088874	152089672	798	399.0	
14125	chr2	152097537	152099740	2203	1102.0	
14126	chr2	152171923	152171925	2	1.0	
14127	chr2	152174705	152176901	2196	1098.0	
14128	chr2	152189887	152190285	398	199.0	
14129	chr2	152334809	152336478	1669	834.0	
14130	chr2	152388283	152388586	303	152.0	
14131	chr2	152407261	152407635	374	187.0	
14132	chr2	152410303	152411640	1337	668.0	
14133	chr2	152418404	152419109	705	352.0	
14134	chr2	152420906	152422119	1213	606.0	
14135	chr2	152431998	152432792	794	397.0	
14136	chr2	152433348	152433688	340	170.0	
14137	chr2	152466815	152467585	770	385.0	
14138	chr2	152468142	152468214	72	36.0	
14139	chr2	152468865	152469555	690	345.0	
14140	chr2	152486053	152486497	444	222.0	
14141	chr2	152493549	152493817	268	134.0	
14142	chr2	152497603	152497729	126	63.0	
14143	chr2	152499831	152500300	469	234.0	
14144	chr2	152573164	152573650	486	243.0	
14145	chr2	152594026	152594931	905	452.0	
14146	chr2	152611516	152613555	2039	1020.0	
14147	chr2	152635573	152636106	533	266.0	
14148	chr2	152693962	152694624	662	331.0	
14149	chr2	152715826	152719394	3568	1784.0	
14150	chr2	152729862	152731415	1553	776.0	
14151	chr2	152740674	152741159	485	242.0	
14152	chr2	153235404	153235891	487	244.0	
14153	chr2	153477996	153479344	1348	674.0	
14154	chr2	153519317	153519620	303	152.0	
14155	chr2	154914659	154914911	252	126.0	
14156	chr2	155633870	155634593	723	362.0	
14157	chr2	155687153	155687569	416	208.0	
14158	chr2	155690719	155691281	562	281.0	
14159	chr2	155692102	155692508	406	203.0	
14160	chr2	155696727	155696728	1	0.0	
14161	chr2	156023495	156023682	187	94.0	
14162	chr2	156110865	156111220	355	178.0	
14163	chr2	156309069	156309649	580	290.0	
14164	chr2	156312083	156312344	261	130.0	
14165	chr2	156317265	156336191	18926	9463.0	
14166	chr2	156339856	156344304	4448	2224.0	
14167	chr2	156345370	156345587	217	108.0	
14168	chr2	156355931	156356608	677	338.0	
14169	chr2	156379128	156379398	270	135.0	
14170	chr2	156395955	156396652	697	348.0	
14171	chr2	156399281	156401711	2430	1215.0	
14172	chr2	156405300	156406180	880	440.0	
14173	chr2	156430359	156431562	1203	602.0	
14174	chr2	156434529	156438020	3491	1746.0	
14175	chr2	156457766	156458167	401	200.0	
14176	chr2	156464175	156465089	914	457.0	
14177	chr2	156470946	156471630	684	342.0	
14178	chr2	156472630	156473117	487	244.0	
14179	chr2	156480219	156480922	703	352.0	
14180	chr2	156496306	156496335	29	14.0	
14181	chr2	156589569	156590005	436	218.0	
14182	chr2	156664027	156664084	57	28.0	
14183	chr2	157169946	157170171	225	112.0	
14184	chr2	157178985	157179327	342	171.0	
14185	chr2	157182747	157183434	687	344.0	
14186	chr2	157194066	157194466	400	200.0	
14187	chr2	157302428	157302958	530	265.0	
14188	chr2	157321515	157321756	241	120.0	
14189	chr2	157327253	157328188	935	468.0	
14190	chr2	157331576	157332282	706	353.0	
14191	chr2	157335921	157336611	690	345.0	
14192	chr2	157403115	157404896	1781	890.0	
14193	chr2	157407028	157407491	463	232.0	
14194	chr2	157410956	157411263	307	154.0	
14195	chr2	157413038	157414598	1560	780.0	
14196	chr2	157415467	157416149	682	341.0	
14197	chr2	157416802	157421972	5170	2585.0	
14198	chr2	157432062	157432266	204	102.0	
14199	chr2	157432834	157433733	899	450.0	
14200	chr2	157434587	157435122	535	268.0	
14201	chr2	157437235	157445161	7926	3963.0	
14202	chr2	157447083	157448119	1036	518.0	
14203	chr2	157452848	157454275	1427	714.0	
14204	chr2	157463812	157464865	1053	526.0	
14205	chr2	157468553	157470628	2075	1038.0	
14206	chr2	157479902	157480746	844	422.0	
14207	chr2	157490029	157490430	401	200.0	
14208	chr2	157492140	157492671	531	266.0	
14209	chr2	157497562	157498227	665	332.0	
14210	chr2	157501092	157501399	307	154.0	
14211	chr2	157508678	157509211	533	266.0	
14212	chr2	157564868	157565180	312	156.0	
14213	chr2	157597343	157597820	477	238.0	
14214	chr2	157625114	157625939	825	412.0	
14215	chr2	157627785	157629732	1947	974.0	
14216	chr2	157777666	157777794	128	64.0	
14217	chr2	157831197	157831602	405	202.0	
14218	chr2	157838134	157838942	808	404.0	
14219	chr2	157874595	157877775	3180	1590.0	
14220	chr2	157897077	157900095	3018	1509.0	
14221	chr2	157901384	157901510	126	63.0	
14222	chr2	157938049	157938486	437	218.0	
14223	chr2	158010257	158010700	443	222.0	
14224	chr2	158015484	158015757	273	136.0	
14225	chr2	158024263	158024687	424	212.0	
14226	chr2	158034138	158034669	531	266.0	
14227	chr2	158113626	158114233	607	304.0	
14228	chr2	158116992	158117330	338	169.0	
14229	chr2	158142416	158143304	888	444.0	
14230	chr2	158191023	158191563	540	270.0	
14231	chr2	158198128	158198256	128	64.0	
14232	chr2	158214376	158214921	545	272.0	
14233	chr2	158297568	158297964	396	198.0	
14234	chr2	158319352	158319495	143	72.0	
14235	chr2	158455953	158458892	2939	1470.0	
14236	chr2	158464607	158465062	455	228.0	
14237	chr2	158745865	158745935	70	35.0	
14238	chr2	158753997	158754423	426	213.0	
14239	chr2	158901260	158901692	432	216.0	
14240	chr2	158911914	158912295	381	190.0	
14241	chr2	158967749	158970264	2515	1258.0	
14242	chr2	159035984	159036419	435	218.0	
14243	chr2	159090825	159091195	370	185.0	
14244	chr2	159091802	159092542	740	370.0	
14245	chr2	159118359	159119019	660	330.0	
14246	chr2	159124325	159125075	750	375.0	
14247	chr2	159133968	159134147	179	90.0	
14248	chr2	159144754	159145896	1142	571.0	
14249	chr2	159147219	159147560	341	170.0	
14250	chr2	159160910	159161094	184	92.0	
14251	chr2	159185323	159185714	391	196.0	
14252	chr2	159201287	159201779	492	246.0	
14253	chr2	159209655	159210377	722	361.0	
14254	chr2	159225997	159226619	622	311.0	
14255	chr2	159227435	159227817	382	191.0	
14256	chr2	159249606	159250710	1104	552.0	
14257	chr2	159285760	159287574	1814	907.0	
14258	chr2	159290313	159290996	683	342.0	
14259	chr2	159326555	159327299	744	372.0	
14260	chr2	159362810	159363432	622	311.0	
14261	chr2	159456637	159457015	378	189.0	
14262	chr2	159497111	159497680	569	284.0	
14263	chr2	159515452	159516938	1486	743.0	
14264	chr2	159549188	159549629	441	220.0	
14265	chr2	159550331	159550505	174	87.0	
14266	chr2	159562194	159562712	518	259.0	
14267	chr2	159573959	159574696	737	368.0	
14268	chr2	159595770	159596053	283	142.0	
14269	chr2	159614733	159616879	2146	1073.0	
14270	chr2	159635377	159635778	401	200.0	
14271	chr2	159695820	159696509	689	344.0	
14272	chr2	159710820	159714054	3234	1617.0	
14273	chr2	159714608	159714891	283	142.0	
14274	chr2	159717044	159717399	355	178.0	
14275	chr2	159728627	159729028	401	200.0	
14276	chr2	159738436	159738935	499	250.0	
14277	chr2	159753521	159754412	891	446.0	
14278	chr2	159755927	159755951	24	12.0	
14279	chr2	159784746	159785129	383	192.0	
14280	chr2	159792635	159793722	1087	544.0	
14281	chr2	159795599	159798763	3164	1582.0	
14282	chr2	159801845	159802675	830	415.0	
14283	chr2	159807387	159807827	440	220.0	
14284	chr2	159817307	159817664	357	178.0	
14285	chr2	159832844	159833272	428	214.0	
14286	chr2	159855172	159855972	800	400.0	
14287	chr2	159873139	159873563	424	212.0	
14288	chr2	159890884	159891494	610	305.0	
14289	chr2	159893472	159893853	381	190.0	
14290	chr2	159903071	159905679	2608	1304.0	
14291	chr2	159921594	159922259	665	332.0	
14292	chr2	159933552	159934187	635	318.0	
14293	chr2	160096395	160096855	460	230.0	
14294	chr2	160108260	160108579	319	160.0	
14295	chr2	160109946	160110344	398	199.0	
14296	chr2	160181218	160181619	401	200.0	
14297	chr2	160208081	160208414	333	166.0	
14298	chr2	160210517	160211101	584	292.0	
14299	chr2	160252245	160252753	508	254.0	
14300	chr2	160265939	160266341	402	201.0	
14301	chr2	160269411	160271226	1815	908.0	
14302	chr2	160279776	160280289	513	256.0	
14303	chr2	160294294	160294748	454	227.0	
14304	chr2	160322339	160322648	309	154.0	
14305	chr2	160324140	160324577	437	218.0	
14306	chr2	160328747	160328903	156	78.0	
14307	chr2	160332338	160332786	448	224.0	
14308	chr2	160344974	160345401	427	214.0	
14309	chr2	160351826	160352466	640	320.0	
14310	chr2	160353209	160353525	316	158.0	
14311	chr2	160356222	160356697	475	238.0	
14312	chr2	160367828	160368447	619	310.0	
14313	chr2	160371484	160372385	901	450.0	
14314	chr2	160374023	160374030	7	4.0	
14315	chr2	160375762	160376233	471	236.0	
14316	chr2	160379011	160379785	774	387.0	
14317	chr2	160380597	160382231	1634	817.0	
14318	chr2	160387772	160389200	1428	714.0	
14319	chr2	160390743	160391476	733	366.0	
14320	chr2	160393900	160394735	835	418.0	
14321	chr2	160396391	160396653	262	131.0	
14322	chr2	160402545	160402893	348	174.0	
14323	chr2	160403401	160403978	577	288.0	
14324	chr2	160405539	160409061	3522	1761.0	
14325	chr2	160410949	160412570	1621	810.0	
14326	chr2	160417868	160418169	301	150.0	
14327	chr2	160421599	160422180	581	290.0	
14328	chr2	160427661	160429862	2201	1100.0	
14329	chr2	160431534	160431620	86	43.0	
14330	chr2	160482419	160483159	740	370.0	
14331	chr2	160484877	160485583	706	353.0	
14332	chr2	160491678	160494737	3059	1530.0	
14333	chr2	160507123	160507128	5	2.0	
14334	chr2	160551269	160551688	419	210.0	
14335	chr2	160561904	160562263	359	180.0	
14336	chr2	160566629	160567226	597	298.0	
14337	chr2	160570356	160570987	631	316.0	
14338	chr2	160574841	160574842	1	0.0	
14339	chr2	160575544	160575566	22	11.0	
14340	chr2	160590760	160591091	331	166.0	
14341	chr2	160650634	160652884	2250	1125.0	
14342	chr2	160666194	160666956	762	381.0	
14343	chr2	160703780	160704705	925	462.0	
14344	chr2	160742607	160743140	533	266.0	
14345	chr2	160918922	160919295	373	186.0	
14346	chr2	160970206	160970549	343	172.0	
14347	chr2	160994121	160994850	729	364.0	
14348	chr2	161063535	161064321	786	393.0	
14349	chr2	161076962	161078608	1646	823.0	
14350	chr2	161088655	161089021	366	183.0	
14351	chr2	161090406	161091071	665	332.0	
14352	chr2	161111625	161111995	370	185.0	
14353	chr2	161122963	161123673	710	355.0	
14354	chr2	161124201	161124545	344	172.0	
14355	chr2	161135062	161135606	544	272.0	
14356	chr2	161136216	161140049	3833	1916.0	
14357	chr2	161140987	161141652	665	332.0	
14358	chr2	161147142	161147615	473	236.0	
14359	chr2	161157230	161157439	209	104.0	
14360	chr2	161159742	161161778	2036	1018.0	
14361	chr2	161163083	161164570	1487	744.0	
14362	chr2	161165483	161167853	2370	1185.0	
14363	chr2	161169663	161170115	452	226.0	
14364	chr2	161170865	161171961	1096	548.0	
14365	chr2	161175532	161175906	374	187.0	
14366	chr2	161177919	161178264	345	172.0	
14367	chr2	161199880	161200246	366	183.0	
14368	chr2	161217550	161217681	131	66.0	
14369	chr2	161223122	161223562	440	220.0	
14370	chr2	161236919	161239568	2649	1324.0	enhancer
14371	chr2	161242947	161245906	2959	1480.0	
14372	chr2	161250827	161251273	446	223.0	
14373	chr2	161272946	161273633	687	344.0	
14374	chr2	161278490	161282650	4160	2080.0	
14375	chr2	161307785	161309157	1372	686.0	
14376	chr2	161384841	161385267	426	213.0	
14377	chr2	161414255	161417229	2974	1487.0	
14378	chr2	161418638	161419177	539	270.0	
14379	chr2	161423157	161424395	1238	619.0	
14380	chr2	161426709	161427939	1230	615.0	
14381	chr2	161586565	161586898	333	166.0	
14382	chr2	161624446	161624944	498	249.0	
14383	chr2	161708666	161708744	78	39.0	
14384	chr2	161900295	161900639	344	172.0	
14385	chr2	161905322	161906071	749	374.0	
14386	chr2	161952601	161953231	630	315.0	
14387	chr2	161953962	161954557	595	298.0	
14388	chr2	161956481	161957242	761	380.0	
14389	chr2	161975456	161975925	469	234.0	
14390	chr2	161979520	161979800	280	140.0	
14391	chr2	161992399	161993449	1050	525.0	
14392	chr2	161994669	161995821	1152	576.0	
14393	chr2	162002747	162003291	544	272.0	
14394	chr2	162007536	162007845	309	154.0	
14395	chr2	162011567	162012840	1273	636.0	
14396	chr2	162013454	162014501	1047	524.0	
14397	chr2	162055367	162055841	474	237.0	
14398	chr2	162057615	162057840	225	112.0	
14399	chr2	162059017	162059660	643	322.0	
14400	chr2	162063459	162064339	880	440.0	
14401	chr2	162072469	162074884	2415	1208.0	
14402	chr2	162112512	162112765	253	126.0	
14403	chr2	162113647	162114169	522	261.0	
14404	chr2	162118578	162118984	406	203.0	
14405	chr2	162123795	162124396	601	300.0	
14406	chr2	162126116	162126662	546	273.0	
14407	chr2	162153564	162154054	490	245.0	promoter
14408	chr2	162220908	162221461	553	276.0	
14409	chr2	162252120	162252421	301	150.0	
14410	chr2	162254494	162254600	106	53.0	
14411	chr2	162260922	162262021	1099	550.0	
14412	chr2	162288749	162288939	190	95.0	
14413	chr2	162297902	162298590	688	344.0	
14414	chr2	162300975	162301801	826	413.0	
14415	chr2	162313921	162314142	221	110.0	
14416	chr2	162315825	162320206	4381	2190.0	
14417	chr2	162327071	162327564	493	246.0	
14418	chr2	162328383	162328893	510	255.0	
14419	chr2	162333934	162334385	451	226.0	
14420	chr2	162342451	162345401	2950	1475.0	
14421	chr2	162732164	162732474	310	155.0	
14422	chr2	162917680	162917922	242	121.0	
14423	chr2	163348527	163349091	564	282.0	
14424	chr2	164722538	164723267	729	364.0	
14425	chr2	164737601	164738044	443	222.0	
14426	chr2	164754408	164754755	347	174.0	
14427	chr2	164761174	164761712	538	269.0	
14428	chr2	164766258	164766659	401	200.0	
14429	chr2	164840325	164842450	2125	1062.0	
14430	chr2	164850225	164850622	397	198.0	
14431	chr2	164866369	164866796	427	214.0	
14432	chr2	164896669	164897070	401	200.0	
14433	chr2	164920435	164920794	359	180.0	
14434	chr2	164964781	164965120	339	170.0	
14435	chr2	164991835	164992160	325	162.0	
14436	chr2	164992822	164993274	452	226.0	
14437	chr2	165015021	165015439	418	209.0	
14438	chr2	165016776	165017177	401	200.0	
14439	chr2	165193386	165193545	159	80.0	
14440	chr2	165203958	165204086	128	64.0	
14441	chr2	165293447	165294197	750	375.0	
14442	chr2	165328298	165328583	285	142.0	
14443	chr2	165401280	165401692	412	206.0	
14444	chr2	165443562	165443874	312	156.0	
14445	chr2	165594851	165595246	395	198.0	
14446	chr2	165743369	165743906	537	268.0	
14447	chr2	165777527	165778181	654	327.0	
14448	chr2	165793078	165795475	2397	1198.0	
14449	chr2	165796855	165797183	328	164.0	
14450	chr2	165815322	165816141	819	410.0	
14451	chr2	165874376	165874929	553	276.0	
14452	chr2	165877566	165878284	718	359.0	
14453	chr2	165897570	165898461	891	446.0	
14454	chr2	165902734	165903387	653	326.0	
14455	chr2	165951895	165954694	2799	1400.0	
14456	chr2	166067220	166067691	471	236.0	
14457	chr2	166088658	166089050	392	196.0	
14458	chr2	166090294	166091343	1049	524.0	
14459	chr2	166092791	166093416	625	312.0	
14460	chr2	166106603	166107057	454	227.0	
14461	chr2	166127834	166128285	451	226.0	
14462	chr2	166375328	166376525	1197	598.0	
14463	chr2	166407685	166408165	480	240.0	
14464	chr2	166413553	166413603	50	25.0	
14465	chr2	166436244	166436583	339	170.0	
14466	chr2	166449398	166449842	444	222.0	
14467	chr2	166468412	166468779	367	184.0	
14468	chr2	166539310	166539750	440	220.0	
14469	chr2	166610504	166610905	401	200.0	
14470	chr2	167292318	167293664	1346	673.0	
14471	chr2	167939566	167939867	301	150.0	
14472	chr2	168002272	168002449	177	88.0	
14473	chr2	168013583	168013929	346	173.0	
14474	chr2	168025738	168026021	283	142.0	
14475	chr2	168035680	168035753	73	36.0	
14476	chr2	168042410	168042493	83	42.0	
14477	chr2	168118596	168119911	1315	658.0	
14478	chr2	168130572	168130812	240	120.0	
14479	chr2	168136345	168136808	463	232.0	
14480	chr2	168149417	168150401	984	492.0	
14481	chr2	168160907	168161242	335	168.0	
14482	chr2	168165333	168166630	1297	648.0	
14483	chr2	168170340	168171606	1266	633.0	
14484	chr2	168174623	168175257	634	317.0	
14485	chr2	168184621	168186149	1528	764.0	
14486	chr2	168192792	168193772	980	490.0	
14487	chr2	168194744	168195701	957	478.0	
14488	chr2	168210542	168212104	1562	781.0	
14489	chr2	168223042	168223932	890	445.0	
14490	chr2	168234333	168234617	284	142.0	
14491	chr2	168241198	168241551	353	176.0	
14492	chr2	168244239	168248404	4165	2082.0	
14493	chr2	168336728	168337233	505	252.0	
14494	chr2	168345530	168345911	381	190.0	
14495	chr2	168346560	168347442	882	441.0	
14496	chr2	168348099	168348205	106	53.0	
14497	chr2	168363306	168363836	530	265.0	
14498	chr2	168365133	168365653	520	260.0	
14499	chr2	168371504	168371933	429	214.0	
14500	chr2	168378851	168379544	693	346.0	
14501	chr2	168432775	168433140	365	182.0	
14502	chr2	168450142	168450558	416	208.0	
14503	chr2	168454847	168457991	3144	1572.0	
14504	chr2	168466546	168467308	762	381.0	
14505	chr2	168469202	168469828	626	313.0	
14506	chr2	168470376	168470537	161	80.0	
14507	chr2	168489915	168491387	1472	736.0	
14508	chr2	168530980	168531493	513	256.0	
14509	chr2	168541908	168542188	280	140.0	
14510	chr2	168550678	168551194	516	258.0	
14511	chr2	168552347	168552706	359	180.0	
14512	chr2	168570932	168571423	491	246.0	
14513	chr2	168583202	168583674	472	236.0	
14514	chr2	168626039	168626428	389	194.0	
14515	chr2	168635288	168635605	317	158.0	
14516	chr2	168685982	168686519	537	268.0	
14517	chr2	168705558	168705943	385	192.0	
14518	chr2	168712133	168712370	237	118.0	
14519	chr2	168731447	168732094	647	324.0	
14520	chr2	168738343	168738356	13	6.0	
14521	chr2	168750952	168751708	756	378.0	
14522	chr2	168757284	168757584	300	150.0	
14523	chr2	168758982	168759659	677	338.0	
14524	chr2	168774011	168774015	4	2.0	
14525	chr2	168849963	168849967	4	2.0	
14526	chr2	168889830	168890997	1167	584.0	
14527	chr2	168896767	168897135	368	184.0	
14528	chr2	168912816	168913182	366	183.0	
14529	chr2	168920566	168920990	424	212.0	
14530	chr2	168948610	168949039	429	214.0	
14531	chr2	168961524	168962066	542	271.0	
14532	chr2	168964527	168964800	273	136.0	
14533	chr2	168976221	168976308	87	44.0	
14534	chr2	168978511	168978912	401	200.0	
14535	chr2	168992670	168993124	454	227.0	
14536	chr2	169036759	169037519	760	380.0	
14537	chr2	169038180	169038821	641	320.0	
14538	chr2	169039748	169039851	103	52.0	
14539	chr2	169066538	169067516	978	489.0	
14540	chr2	169069266	169069862	596	298.0	
14541	chr2	169071985	169073272	1287	644.0	
14542	chr2	169080205	169080858	653	326.0	
14543	chr2	169082964	169083462	498	249.0	
14544	chr2	169090183	169090559	376	188.0	
14545	chr2	169095495	169096062	567	284.0	
14546	chr2	169100753	169100949	196	98.0	
14547	chr2	169105396	169105880	484	242.0	
14548	chr2	169106819	169108725	1906	953.0	
14549	chr2	169109558	169110378	820	410.0	
14550	chr2	169131782	169132394	612	306.0	
14551	chr2	169141723	169142223	500	250.0	
14552	chr2	169361672	169365520	3848	1924.0	
14553	chr2	169468709	169469055	346	173.0	
14554	chr2	169479148	169480144	996	498.0	
14555	chr2	169528175	169528813	638	319.0	
14556	chr2	169562459	169562953	494	247.0	
14557	chr2	169572973	169574245	1272	636.0	
14558	chr2	169583743	169585790	2047	1024.0	
14559	chr2	169589875	169590278	403	202.0	
14560	chr2	169656323	169656381	58	29.0	
14561	chr2	169659239	169659669	430	215.0	
14562	chr2	169682912	169683921	1009	504.0	
14563	chr2	169687790	169687791	1	0.0	
14564	chr2	169691666	169696090	4424	2212.0	
14565	chr2	169732690	169734675	1985	992.0	
14566	chr2	169767209	169769115	1906	953.0	
14567	chr2	169789837	169790228	391	196.0	
14568	chr2	169798219	169800282	2063	1032.0	
14569	chr2	169824107	169825543	1436	718.0	
14570	chr2	169826940	169829013	2073	1036.0	
14571	chr2	169928397	169928842	445	222.0	
14572	chr2	169933171	169933498	327	164.0	
14573	chr2	169961873	169962335	462	231.0	
14574	chr2	170361251	170361707	456	228.0	
14575	chr2	170371369	170371382	13	6.0	
14576	chr2	170408655	170409555	900	450.0	
14577	chr2	170507616	170507993	377	188.0	
14578	chr2	170651604	170652207	603	302.0	
14579	chr2	170711889	170712461	572	286.0	
14580	chr2	170713603	170717297	3694	1847.0	
14581	chr2	170736625	170736933	308	154.0	
14582	chr2	170744227	170744690	463	232.0	
14583	chr2	170770043	170771696	1653	826.0	
14584	chr2	170812719	170813143	424	212.0	
14585	chr2	170814188	170814513	325	162.0	
14586	chr2	170815575	170818638	3063	1532.0	
14587	chr2	170820192	170823936	3744	1872.0	
14588	chr2	170843711	170844050	339	170.0	
14589	chr2	170872979	170873840	861	430.0	
14590	chr2	170878448	170878872	424	212.0	
14591	chr2	170922806	170922985	179	90.0	
14592	chr2	170928102	170930951	2849	1424.0	
14593	chr2	170950340	170951225	885	442.0	
14594	chr2	170966992	170967425	433	216.0	
14595	chr2	170972970	170974440	1470	735.0	
14596	chr2	171081593	171082024	431	216.0	
14597	chr2	171084088	171084479	391	196.0	
14598	chr2	171086382	171087931	1549	774.0	
14599	chr2	171146550	171147114	564	282.0	
14600	chr2	171158865	171162730	3865	1932.0	
14601	chr2	171163329	171163747	418	209.0	
14602	chr2	171181629	171181739	110	55.0	
14603	chr2	171210749	171211568	819	410.0	
14604	chr2	171244633	171245635	1002	501.0	
14605	chr2	171248095	171248751	656	328.0	
14606	chr2	171319131	171319575	444	222.0	
14607	chr2	171323376	171323735	359	180.0	
14608	chr2	171326248	171326591	343	172.0	
14609	chr2	171336638	171337097	459	230.0	
14610	chr2	171406141	171406337	196	98.0	
14611	chr2	171407299	171407638	339	170.0	
14612	chr2	171409500	171409671	171	86.0	
14613	chr2	171415846	171416510	664	332.0	
14614	chr2	171433011	171435338	2327	1164.0	
14615	chr2	171521948	171524400	2452	1226.0	
14616	chr2	171553869	171554229	360	180.0	
14617	chr2	171573998	171574740	742	371.0	
14618	chr2	171598704	171599189	485	242.0	
14619	chr2	171655322	171656004	682	341.0	
14620	chr2	171686982	171688589	1607	804.0	
14621	chr2	171703633	171704042	409	204.0	
14622	chr2	171706211	171706516	305	152.0	
14623	chr2	171798423	171798830	407	204.0	
14624	chr2	171822510	171822881	371	186.0	
14625	chr2	171893495	171895099	1604	802.0	
14626	chr2	171921705	171923564	1859	930.0	
14627	chr2	171924579	171924884	305	152.0	
14628	chr2	171939575	171940105	530	265.0	
14629	chr2	171940929	171941293	364	182.0	
14630	chr2	171954529	171955218	689	344.0	
14631	chr2	171956118	171957441	1323	662.0	
14632	chr2	171958483	171958952	469	234.0	
14633	chr2	171999235	172000591	1356	678.0	
14634	chr2	172011721	172012313	592	296.0	
14635	chr2	172013527	172013693	166	83.0	
14636	chr2	172079763	172080505	742	371.0	
14637	chr2	172082935	172088706	5771	2886.0	
14638	chr2	172090037	172090928	891	446.0	
14639	chr2	172093477	172099490	6013	3006.0	
14640	chr2	172100005	172104646	4641	2320.0	
14641	chr2	172105593	172106942	1349	674.0	
14642	chr2	172107893	172108653	760	380.0	
14643	chr2	172109634	172110373	739	370.0	
14644	chr2	172127233	172127635	402	201.0	
14645	chr2	172168841	172169098	257	128.0	
14646	chr2	172172368	172173100	732	366.0	
14647	chr2	172179341	172179683	342	171.0	
14648	chr2	172196568	172197629	1061	530.0	
14649	chr2	172199389	172200078	689	344.0	
14650	chr2	172200600	172200620	20	10.0	
14651	chr2	172206445	172206779	334	167.0	
14652	chr2	172208702	172210412	1710	855.0	
14653	chr2	172226289	172226735	446	223.0	
14654	chr2	172234741	172235869	1128	564.0	
14655	chr2	172253134	172253632	498	249.0	
14656	chr2	172280686	172281473	787	394.0	
14657	chr2	172284945	172285422	477	238.0	
14658	chr2	172339435	172339883	448	224.0	
14659	chr2	172375349	172375663	314	157.0	
14660	chr2	172380359	172380900	541	270.0	
14661	chr2	172426837	172429896	3059	1530.0	
14662	chr2	172434542	172435475	933	466.0	
14663	chr2	172437427	172438538	1111	556.0	
14664	chr2	172440869	172442474	1605	802.0	
14665	chr2	172446517	172446962	445	222.0	
14666	chr2	172454777	172455106	329	164.0	
14667	chr2	172455975	172456263	288	144.0	
14668	chr2	172460832	172464157	3325	1662.0	
14669	chr2	172465432	172466343	911	456.0	
14670	chr2	172484296	172484751	455	228.0	
14671	chr2	172495746	172496957	1211	606.0	
14672	chr2	172508100	172508516	416	208.0	
14673	chr2	172510136	172510983	847	424.0	
14674	chr2	172513766	172514568	802	401.0	
14675	chr2	172516310	172516669	359	180.0	
14676	chr2	172549738	172550216	478	239.0	
14677	chr2	172555209	172557116	1907	954.0	
14678	chr2	172674072	172675052	980	490.0	
14679	chr2	172693042	172693954	912	456.0	
14680	chr2	172698215	172698477	262	131.0	
14681	chr2	172710532	172710887	355	178.0	
14682	chr2	172836448	172836646	198	99.0	
14683	chr2	172931905	172932304	399	200.0	
14684	chr2	172962712	172963288	576	288.0	
14685	chr2	172969127	172969604	477	238.0	
14686	chr2	172970703	172971070	367	184.0	
14687	chr2	172971967	172972402	435	218.0	
14688	chr2	172977845	172978142	297	148.0	
14689	chr2	172995864	172996311	447	224.0	
14690	chr2	173005656	173006246	590	295.0	
14691	chr2	173027372	173027909	537	268.0	
14692	chr2	173043130	173044128	998	499.0	
14693	chr2	173048728	173049706	978	489.0	
14694	chr2	173051337	173051872	535	268.0	
14695	chr2	173056923	173057370	447	224.0	
14696	chr2	173059804	173060558	754	377.0	
14697	chr2	173075426	173077306	1880	940.0	
14698	chr2	173101922	173101999	77	38.0	
14699	chr2	173123372	173123822	450	225.0	
14700	chr2	173134546	173135148	602	301.0	
14701	chr2	173148682	173148805	123	62.0	
14702	chr2	173149475	173150099	624	312.0	
14703	chr2	173151634	173152099	465	232.0	
14704	chr2	173159687	173160464	777	388.0	
14705	chr2	173210508	173211032	524	262.0	
14706	chr2	173215841	173216439	598	299.0	
14707	chr2	173262564	173263035	471	236.0	
14708	chr2	173264352	173265343	991	496.0	
14709	chr2	173354313	173355994	1681	840.0	
14710	chr2	173359278	173359515	237	118.0	
14711	chr2	173370310	173370550	240	120.0	
14712	chr2	173400865	173401027	162	81.0	
14713	chr2	173402319	173402841	522	261.0	
14714	chr2	173449077	173449560	483	242.0	
14715	chr2	173524308	173524988	680	340.0	
14716	chr2	173573084	173573140	56	28.0	
14717	chr2	173860031	173860451	420	210.0	
14718	chr2	173874622	173875641	1019	510.0	
14719	chr2	173884401	173884797	396	198.0	
14720	chr2	173897999	173899385	1386	693.0	
14721	chr2	173925162	173925657	495	248.0	
14722	chr2	173939459	173940320	861	430.0	
14723	chr2	173941367	173941989	622	311.0	
14724	chr2	173955015	173955416	401	200.0	
14725	chr2	173959393	173959676	283	142.0	
14726	chr2	173961978	173962344	366	183.0	
14727	chr2	173962881	173966477	3596	1798.0	
14728	chr2	173991018	173991850	832	416.0	
14729	chr2	173997079	173998815	1736	868.0	
14730	chr2	174012336	174013885	1549	774.0	
14731	chr2	174014729	174014836	107	54.0	
14732	chr2	174021116	174021709	593	296.0	
14733	chr2	174023709	174025732	2023	1012.0	
14734	chr2	174031414	174032836	1422	711.0	
14735	chr2	174035816	174036869	1053	526.0	
14736	chr2	174038624	174038663	39	20.0	
14737	chr2	174039430	174040544	1114	557.0	
14738	chr2	174044114	174044382	268	134.0	
14739	chr2	174048402	174048488	86	43.0	
14740	chr2	174059440	174060172	732	366.0	
14741	chr2	174072171	174072229	58	29.0	
14742	chr2	174112085	174112505	420	210.0	
14743	chr2	174158021	174158361	340	170.0	
14744	chr2	174247669	174249359	1690	845.0	
14745	chr2	174282376	174282884	508	254.0	
14746	chr2	174325832	174327976	2144	1072.0	
14747	chr2	174328706	174328973	267	134.0	
14748	chr2	174332488	174338130	5642	2821.0	
14749	chr2	174340025	174345430	5405	2702.0	enhancer
14750	chr2	174383724	174384231	507	254.0	
14751	chr2	174388680	174389204	524	262.0	
14752	chr2	174395062	174396519	1457	728.0	
14753	chr2	174462716	174463210	494	247.0	
14754	chr2	174485385	174488114	2729	1364.0	
14755	chr2	174489428	174490590	1162	581.0	
14756	chr2	174492751	174494390	1639	820.0	
14757	chr2	174516471	174517193	722	361.0	
14758	chr2	174522536	174523144	608	304.0	
14759	chr2	174524359	174525097	738	369.0	
14760	chr2	174546817	174547356	539	270.0	
14761	chr2	174552575	174552928	353	176.0	
14762	chr2	174553715	174555305	1590	795.0	
14763	chr2	174573382	174574343	961	480.0	
14764	chr2	174577742	174578448	706	353.0	
14765	chr2	174579798	174580133	335	168.0	
14766	chr2	174581619	174581622	3	2.0	
14767	chr2	174584401	174584762	361	180.0	
14768	chr2	174586583	174586690	107	54.0	
14769	chr2	174587832	174589716	1884	942.0	
14770	chr2	174590444	174592191	1747	874.0	
14771	chr2	174593051	174601163	8112	4056.0	
14772	chr2	174603047	174603792	745	372.0	
14773	chr2	174605676	174606987	1311	656.0	
14774	chr2	174608094	174609171	1077	538.0	
14775	chr2	174610583	174611379	796	398.0	
14776	chr2	174611892	174612206	314	157.0	
14777	chr2	174615881	174616333	452	226.0	
14778	chr2	174617731	174618098	367	184.0	
14779	chr2	174631256	174631385	129	64.0	
14780	chr2	174632454	174635611	3157	1578.0	
14781	chr2	174662806	174664093	1287	644.0	
14782	chr2	174666015	174667904	1889	944.0	
14783	chr2	174675546	174676195	649	324.0	
14784	chr2	174680044	174680097	53	26.0	
14785	chr2	174680967	174683933	2966	1483.0	
14786	chr2	174685740	174686040	300	150.0	
14787	chr2	174687879	174688527	648	324.0	
14788	chr2	174696945	174697786	841	420.0	
14789	chr2	174699924	174700455	531	266.0	
14790	chr2	174704112	174704996	884	442.0	
14791	chr2	174716726	174717756	1030	515.0	
14792	chr2	174723157	174723648	491	246.0	
14793	chr2	174729711	174730686	975	488.0	
14794	chr2	174738934	174739263	329	164.0	
14795	chr2	174748791	174751609	2818	1409.0	
14796	chr2	174752356	174753723	1367	684.0	
14797	chr2	174771529	174772362	833	416.0	
14798	chr2	174775752	174776100	348	174.0	
14799	chr2	174778190	174779489	1299	650.0	
14800	chr2	174780497	174780839	342	171.0	
14801	chr2	174788227	174788863	636	318.0	
14802	chr2	174902513	174902914	401	200.0	
14803	chr2	174990054	174990643	589	294.0	
14804	chr2	175004690	175006101	1411	706.0	
14805	chr2	175036500	175036945	445	222.0	
14806	chr2	175111078	175111575	497	248.0	
14807	chr2	175167060	175169069	2009	1004.0	
14808	chr2	175170685	175170985	300	150.0	
14809	chr2	175180698	175182379	1681	840.0	
14810	chr2	175187420	175187737	317	158.0	
14811	chr2	175203604	175204032	428	214.0	
14812	chr2	175207767	175208464	697	348.0	
14813	chr2	175282341	175282651	310	155.0	
14814	chr2	175366737	175367146	409	204.0	
14815	chr2	175373466	175373533	67	34.0	
14816	chr2	175414875	175415191	316	158.0	
14817	chr2	175476957	175477267	310	155.0	
14818	chr2	175567713	175568054	341	170.0	
14819	chr2	175575515	175576163	648	324.0	
14820	chr2	175579683	175579980	297	148.0	
14821	chr2	175690180	175690250	70	35.0	
14822	chr2	176001126	176003109	1983	992.0	
14823	chr2	176079786	176080908	1122	561.0	
14824	chr2	176088115	176088721	606	303.0	
14825	chr2	176092835	176093682	847	424.0	
14826	chr2	176096514	176098020	1506	753.0	
14827	chr2	176100724	176100734	10	5.0	
14828	chr2	176106557	176107321	764	382.0	
14829	chr2	176111381	176111544	163	82.0	
14830	chr2	176122240	176123313	1073	536.0	
14831	chr2	176126983	176127419	436	218.0	
14832	chr2	176129428	176130975	1547	774.0	
14833	chr2	176132269	176132652	383	192.0	
14834	chr2	176133705	176133712	7	4.0	
14835	chr2	176135818	176137159	1341	670.0	
14836	chr2	176140341	176141159	818	409.0	
14837	chr2	176188093	176189104	1011	506.0	
14838	chr2	176268978	176270308	1330	665.0	
14839	chr2	176454879	176455343	464	232.0	
14840	chr2	176473137	176473470	333	166.0	
14841	chr2	176491157	176491738	581	290.0	
14842	chr2	176493264	176493567	303	152.0	
14843	chr2	176494965	176495244	279	140.0	
14844	chr2	176553631	176554846	1215	608.0	
14845	chr2	176637546	176638582	1036	518.0	enhancer
14846	chr2	176652315	176652778	463	232.0	
14847	chr2	176653835	176654259	424	212.0	
14848	chr2	176781596	176781961	365	182.0	
14849	chr2	176814670	176815154	484	242.0	
14850	chr2	176817249	176817365	116	58.0	
14851	chr2	176826186	176826995	809	404.0	
14852	chr2	176830425	176830517	92	46.0	
14853	chr2	176852500	176853166	666	333.0	
14854	chr2	176931649	176932783	1134	567.0	
14855	chr2	176935702	176935937	235	118.0	
14856	chr2	176936504	176936676	172	86.0	
14857	chr2	176968072	176968465	393	196.0	
14858	chr2	176997043	176997900	857	428.0	
14859	chr2	176999376	176999724	348	174.0	
14860	chr2	177147074	177147516	442	221.0	
14861	chr2	177148073	177149363	1290	645.0	
14862	chr2	177161667	177162108	441	220.0	
14863	chr2	177164288	177166747	2459	1230.0	
14864	chr2	177169724	177170146	422	211.0	
14865	chr2	177171312	177171998	686	343.0	
14866	chr2	177211237	177215350	4113	2056.0	
14867	chr2	177217413	177217775	362	181.0	
14868	chr2	177221474	177222949	1475	738.0	
14869	chr2	177224081	177229978	5897	2948.0	
14870	chr2	177239289	177240659	1370	685.0	
14871	chr2	177241527	177243516	1989	994.0	
14872	chr2	177244564	177246699	2135	1068.0	
14873	chr2	177247369	177249183	1814	907.0	
14874	chr2	177250256	177253565	3309	1654.0	
14875	chr2	177254279	177258182	3903	1952.0	
14876	chr2	177258947	177266738	7791	3896.0	
14877	chr2	177281039	177281986	947	474.0	
14878	chr2	177289748	177290717	969	484.0	
14879	chr2	177296019	177296522	503	252.0	
14880	chr2	177309708	177310377	669	334.0	
14881	chr2	177332022	177332799	777	388.0	
14882	chr2	177334880	177335375	495	248.0	
14883	chr2	177351841	177353295	1454	727.0	
14884	chr2	177392133	177393827	1694	847.0	
14885	chr2	177394563	177394674	111	56.0	
14886	chr2	177395336	177395999	663	332.0	
14887	chr2	177416120	177416649	529	264.0	
14888	chr2	177552052	177553693	1641	820.0	
14889	chr2	177618026	177619557	1531	766.0	
14890	chr2	177724672	177725082	410	205.0	
14891	chr2	177753601	177754603	1002	501.0	
14892	chr2	177763423	177764145	722	361.0	
14893	chr2	177772485	177772852	367	184.0	
14894	chr2	177783954	177784909	955	478.0	
14895	chr2	177906047	177906467	420	210.0	
14896	chr2	178072673	178072972	299	150.0	
14897	chr2	178074351	178074635	284	142.0	
14898	chr2	178109831	178110237	406	203.0	
14899	chr2	178111917	178113551	1634	817.0	
14900	chr2	178114440	178114827	387	194.0	
14901	chr2	178190827	178191595	768	384.0	
14902	chr2	178193792	178195422	1630	815.0	
14903	chr2	178275623	178275970	347	174.0	
14904	chr2	178280253	178280691	438	219.0	
14905	chr2	178396976	178397465	489	244.0	
14906	chr2	178413153	178415323	2170	1085.0	
14907	chr2	178420436	178420783	347	174.0	
14908	chr2	178449661	178452301	2640	1320.0	
14909	chr2	178477953	178481720	3767	1884.0	
14910	chr2	178482459	178482825	366	183.0	
14911	chr2	178514698	178514985	287	144.0	
14912	chr2	178522470	178524182	1712	856.0	
14913	chr2	178530106	178531553	1447	724.0	
14914	chr2	178700908	178701223	315	158.0	
14915	chr2	178761789	178762176	387	194.0	
14916	chr2	178804744	178804962	218	109.0	
14917	chr2	178891376	178891825	449	224.0	
14918	chr2	178912440	178913426	986	493.0	
14919	chr2	178914176	178914712	536	268.0	
14920	chr2	179020158	179020525	367	184.0	
14921	chr2	179031634	179032600	966	483.0	
14922	chr2	179049234	179050363	1129	564.0	
14923	chr2	179095981	179096647	666	333.0	
14924	chr2	179104849	179105080	231	116.0	
14925	chr2	179170866	179171277	411	206.0	
14926	chr2	179218953	179219397	444	222.0	
14927	chr2	179234719	179235854	1135	568.0	
14928	chr2	179252573	179252626	53	26.0	
14929	chr2	179253283	179253322	39	20.0	
14930	chr2	179263269	179265844	2575	1288.0	
14931	chr2	179268202	179268975	773	386.0	
14932	chr2	179352859	179353098	239	120.0	
14933	chr2	179410609	179411291	682	341.0	
14934	chr2	179422145	179422379	234	117.0	
14935	chr2	179443110	179443233	123	62.0	
14936	chr2	180002331	180002815	484	242.0	
14937	chr2	180004265	180004555	290	145.0	
14938	chr2	180006310	180007994	1684	842.0	
14939	chr2	180124244	180124681	437	218.0	
14940	chr2	180125495	180126069	574	287.0	
14941	chr2	180359574	180360471	897	448.0	
14942	chr2	180443863	180444156	293	146.0	
14943	chr2	180539513	180539942	429	214.0	
14944	chr2	180937394	180937922	528	264.0	
14945	chr2	180977398	180978242	844	422.0	
14946	chr2	180979019	180982203	3184	1592.0	
14947	chr2	180983679	180984274	595	298.0	
14948	chr2	181058595	181059062	467	234.0	
14949	chr2	181072421	181073018	597	298.0	
14950	chr2	181077090	181077587	497	248.0	
14951	chr2	181104479	181105009	530	265.0	
14952	chr2	181123441	181125762	2321	1160.0	
14953	chr2	181126491	181126492	1	0.0	
14954	chr2	181131628	181131655	27	14.0	
14955	chr2	181140427	181142961	2534	1267.0	
14956	chr2	181143775	181144224	449	224.0	
14957	chr2	181146065	181146711	646	323.0	
14958	chr2	181163015	181163756	741	370.0	
14959	chr2	181164765	181166021	1256	628.0	
14960	chr2	181178780	181179208	428	214.0	
14961	chr2	181183872	181184603	731	366.0	
14962	chr2	181185517	181185698	181	90.0	
14963	chr2	181198253	181198780	527	264.0	
14964	chr2	181224958	181225069	111	56.0	
14965	chr2	181236110	181236382	272	136.0	
14966	chr2	181239363	181239777	414	207.0	
14967	chr2	181250658	181251059	401	200.0	
14968	chr2	181252175	181253177	1002	501.0	
14969	chr2	181255653	181256138	485	242.0	
14970	chr2	181275476	181276257	781	390.0	
14971	chr2	181281155	181281698	543	272.0	
14972	chr2	181300535	181301414	879	440.0	
14973	chr2	181303837	181306269	2432	1216.0	
14974	chr2	181306781	181307278	497	248.0	
14975	chr2	181308516	181309977	1461	730.0	
14976	chr2	181311741	181313093	1352	676.0	
14977	chr2	181352204	181352557	353	176.0	
14978	chr2	181354777	181354802	25	12.0	
14979	chr2	181364816	181364868	52	26.0	
14980	chr2	181372083	181372430	347	174.0	
14981	chr2	181375098	181375315	217	108.0	
14982	chr2	181393305	181396218	2913	1456.0	
14983	chr2	181406957	181407725	768	384.0	
14984	chr2	181410941	181411461	520	260.0	
14985	chr2	181419159	181420043	884	442.0	
14986	chr2	181420840	181421316	476	238.0	
14987	chr2	181430337	181431200	863	432.0	
14988	chr2	181438273	181438674	401	200.0	
14989	chr2	181455021	181455510	489	244.0	
14990	chr2	181456029	181462492	6463	3232.0	
14991	chr2	181463031	181463982	951	476.0	
14992	chr2	181465010	181467648	2638	1319.0	
14993	chr2	181470871	181472277	1406	703.0	
14994	chr2	181473186	181473452	266	133.0	
14995	chr2	181517709	181518286	577	288.0	
14996	chr2	181542145	181542216	71	36.0	
14997	chr2	181656507	181657390	883	442.0	
14998	chr2	181677933	181678394	461	230.0	
14999	chr2	181697095	181698031	936	468.0	
15000	chr2	181714983	181715500	517	258.0	
15001	chr2	181742872	181743138	266	133.0	
15002	chr2	181774796	181774951	155	78.0	
15003	chr2	181781191	181781481	290	145.0	
15004	chr2	181805627	181806145	518	259.0	
15005	chr2	181810740	181811370	630	315.0	
15006	chr2	181814208	181814601	393	196.0	
15007	chr2	181846370	181847071	701	350.0	
15008	chr2	181848553	181848633	80	40.0	
15009	chr2	181850855	181851595	740	370.0	
15010	chr2	181876523	181877047	524	262.0	"enhancer	sequence_feature"
15011	chr2	181891210	181893145	1935	968.0	
15012	chr2	181904054	181905298	1244	622.0	
15013	chr2	181910605	181910865	260	130.0	
15014	chr2	181937379	181937982	603	302.0	
15015	chr2	181954000	181954708	708	354.0	
15016	chr2	181991371	181991977	606	303.0	
15017	chr2	182540222	182540622	400	200.0	
15018	chr2	182553605	182553879	274	137.0	
15019	chr2	182642325	182642752	427	214.0	
15020	chr2	182650828	182651158	330	165.0	
15021	chr2	182666856	182667399	543	272.0	
15022	chr2	182682240	182682641	401	200.0	
15023	chr2	182713507	182714263	756	378.0	
15024	chr2	182715094	182718095	3001	1500.0	
15025	chr2	183032244	183032612	368	184.0	
15026	chr2	183036062	183039150	3088	1544.0	
15027	chr2	183078112	183079569	1457	728.0	
15028	chr2	183123588	183125290	1702	851.0	
15029	chr2	184562441	184563036	595	298.0	
15030	chr2	184577763	184578162	399	200.0	
15031	chr2	184596673	184600304	3631	1816.0	
15032	chr2	184628081	184628398	317	158.0	
15033	chr2	184765342	184765832	490	245.0	
15034	chr2	185738793	185739288	495	248.0	
15035	chr2	186477925	186478237	312	156.0	
15036	chr2	186483775	186487534	3759	1880.0	
15037	chr2	186491194	186491727	533	266.0	
15038	chr2	186503829	186504494	665	332.0	
15039	chr2	186575187	186575745	558	279.0	
15040	chr2	186589310	186591600	2290	1145.0	
15041	chr2	186637383	186637793	410	205.0	
15042	chr2	186641695	186642126	431	216.0	
15043	chr2	186693699	186694698	999	500.0	
15044	chr2	186848901	186849897	996	498.0	
15045	chr2	186913901	186914187	286	143.0	
15046	chr2	187169048	187169608	560	280.0	
15047	chr2	187448027	187448727	700	350.0	
15048	chr2	187475483	187475901	418	209.0	
15049	chr2	187510051	187510452	401	200.0	
15050	chr2	187586230	187586773	543	272.0	
15051	chr2	189094306	189094702	396	198.0	
15052	chr2	189143116	189143564	448	224.0	
15053	chr2	189261510	189261842	332	166.0	
15054	chr2	189300852	189301354	502	251.0	
15055	chr2	189304313	189304742	429	214.0	
15056	chr2	189347515	189347797	282	141.0	
15057	chr2	189412343	189412776	433	216.0	
15058	chr2	189437957	189438304	347	174.0	
15059	chr2	189440156	189442473	2317	1158.0	
15060	chr2	189444372	189444671	299	150.0	
15061	chr2	189466698	189467064	366	183.0	
15062	chr2	189506546	189506903	357	178.0	
15063	chr2	189513927	189514579	652	326.0	
15064	chr2	189516559	189516914	355	178.0	
15065	chr2	189530959	189531403	444	222.0	
15066	chr2	189534752	189534900	148	74.0	
15067	chr2	189559654	189559788	134	67.0	
15068	chr2	189579542	189582073	2531	1266.0	
15069	chr2	189633402	189633645	243	122.0	
15070	chr2	189657585	189659328	1743	872.0	
15071	chr2	189660771	189663094	2323	1162.0	
15072	chr2	189673708	189675631	1923	962.0	
15073	chr2	189685855	189686117	262	131.0	
15074	chr2	189698229	189698985	756	378.0	
15075	chr2	189719819	189719943	124	62.0	
15076	chr2	189751028	189751551	523	262.0	
15077	chr2	189762097	189763915	1818	909.0	
15078	chr2	189782080	189785229	3149	1574.0	
15079	chr2	189791209	189792066	857	428.0	
15080	chr2	189798712	189799120	408	204.0	
15081	chr2	189837354	189837680	326	163.0	
15082	chr2	189874882	189875336	454	227.0	
15083	chr2	189876319	189876646	327	164.0	
15084	chr2	190024015	190024219	204	102.0	
15085	chr2	190070312	190070713	401	200.0	
15086	chr2	190088840	190089280	440	220.0	
15087	chr2	190119096	190119693	597	298.0	
15088	chr2	190149125	190149591	466	233.0	
15089	chr2	190180112	190181304	1192	596.0	
15090	chr2	190277542	190277912	370	185.0	
15091	chr2	190314739	190315140	401	200.0	
15092	chr2	190318785	190320641	1856	928.0	
15093	chr2	190342997	190344891	1894	947.0	
15094	chr2	190352949	190353541	592	296.0	
15095	chr2	190356000	190356404	404	202.0	
15096	chr2	190359409	190360544	1135	568.0	
15097	chr2	190372141	190372792	651	326.0	
15098	chr2	190382815	190383324	509	254.0	
15099	chr2	190404394	190405688	1294	647.0	
15100	chr2	190406679	190410481	3802	1901.0	
15101	chr2	190413464	190413854	390	195.0	
15102	chr2	190415811	190416414	603	302.0	
15103	chr2	190418774	190419131	357	178.0	
15104	chr2	190425198	190425616	418	209.0	
15105	chr2	190433873	190434117	244	122.0	
15106	chr2	190469820	190470243	423	212.0	
15107	chr2	190512669	190513070	401	200.0	
15108	chr2	190515754	190516239	485	242.0	
15109	chr2	190520324	190520813	489	244.0	
15110	chr2	190525998	190526810	812	406.0	
15111	chr2	190528470	190529132	662	331.0	
15112	chr2	190529682	190530698	1016	508.0	
15113	chr2	190532499	190536744	4245	2122.0	
15114	chr2	190537743	190538201	458	229.0	
15115	chr2	190551850	190552487	637	318.0	
15116	chr2	190575298	190575699	401	200.0	
15117	chr2	190578367	190578945	578	289.0	
15118	chr2	190605934	190606548	614	307.0	
15119	chr2	190627737	190628554	817	408.0	
15120	chr2	190635863	190635953	90	45.0	
15121	chr2	190637615	190638016	401	200.0	
15122	chr2	190646017	190650614	4597	2298.0	
15123	chr2	190659529	190659651	122	61.0	
15124	chr2	190670529	190670962	433	216.0	
15125	chr2	190675270	190675333	63	32.0	
15126	chr2	190678446	190678967	521	260.0	
15127	chr2	190679852	190680749	897	448.0	
15128	chr2	190695676	190696274	598	299.0	
15129	chr2	190781612	190782063	451	226.0	
15130	chr2	190850463	190850948	485	242.0	
15131	chr2	190854029	190854430	401	200.0	
15132	chr2	190875774	190876355	581	290.0	
15133	chr2	190879415	190886140	6725	3362.0	
15134	chr2	190886684	190892306	5622	2811.0	
15135	chr2	190893123	190893894	771	386.0	
15136	chr2	190894583	190894984	401	200.0	
15137	chr2	190895792	190896169	377	188.0	
15138	chr2	190896783	190897129	346	173.0	
15139	chr2	190902364	190902584	220	110.0	
15140	chr2	190903888	190904903	1015	508.0	
15141	chr2	190905964	190905968	4	2.0	
15142	chr2	190907088	190908926	1838	919.0	
15143	chr2	190909713	190910193	480	240.0	
15144	chr2	190911630	190912374	744	372.0	
15145	chr2	190913673	190914133	460	230.0	
15146	chr2	190916792	190919442	2650	1325.0	
15147	chr2	190922961	190923502	541	270.0	
15148	chr2	190925342	190925676	334	167.0	
15149	chr2	190930107	190930320	213	106.0	
15150	chr2	190947182	190948327	1145	572.0	
15151	chr2	190959901	190960327	426	213.0	
15152	chr2	190961257	190961263	6	3.0	
15153	chr2	190961850	190962389	539	270.0	
15154	chr2	190964163	190964822	659	330.0	
15155	chr2	190970681	190971428	747	374.0	
15156	chr2	190996292	190997521	1229	614.0	
15157	chr2	190999168	190999513	345	172.0	
15158	chr2	191011015	191015670	4655	2328.0	
15159	chr2	191018391	191018926	535	268.0	
15160	chr2	191019956	191023851	3895	1948.0	
15161	chr2	191026449	191026893	444	222.0	
15162	chr2	191029262	191031136	1874	937.0	
15163	chr2	191032556	191033345	789	394.0	
15164	chr2	191038061	191039054	993	496.0	
15165	chr2	191049843	191050312	469	234.0	
15166	chr2	191051540	191052744	1204	602.0	
15167	chr2	191056190	191056745	555	278.0	
15168	chr2	191061358	191062302	944	472.0	
15169	chr2	191064523	191065037	514	257.0	
15170	chr2	191066129	191066953	824	412.0	
15171	chr2	191112466	191113306	840	420.0	
15172	chr2	191113828	191116268	2440	1220.0	
15173	chr2	191126267	191128996	2729	1364.0	
15174	chr2	191144060	191144306	246	123.0	
15175	chr2	191146048	191146503	455	228.0	
15176	chr2	191148241	191153328	5087	2544.0	
15177	chr2	191155424	191156092	668	334.0	
15178	chr2	191165061	191165721	660	330.0	
15179	chr2	191189007	191189670	663	332.0	
15180	chr2	191193790	191194616	826	413.0	
15181	chr2	191202134	191203368	1234	617.0	
15182	chr2	191204323	191205411	1088	544.0	
15183	chr2	191206064	191207497	1433	716.0	
15184	chr2	191218263	191218708	445	222.0	
15185	chr2	191244967	191246354	1387	694.0	
15186	chr2	191274371	191274687	316	158.0	
15187	chr2	191302497	191302785	288	144.0	
15188	chr2	191321957	191322333	376	188.0	
15189	chr2	191355490	191355680	190	95.0	
15190	chr2	191377170	191377689	519	260.0	
15191	chr2	191436374	191437136	762	381.0	
15192	chr2	191521642	191521956	314	157.0	
15193	chr2	191554993	191555717	724	362.0	
15194	chr2	191565600	191566720	1120	560.0	
15195	chr2	191570333	191571880	1547	774.0	
15196	chr2	191599691	191600085	394	197.0	
15197	chr2	191611290	191612236	946	473.0	
15198	chr2	191617396	191618720	1324	662.0	
15199	chr2	191620232	191620540	308	154.0	
15200	chr2	191622445	191623106	661	330.0	
15201	chr2	191624766	191625820	1054	527.0	
15202	chr2	191629098	191629281	183	92.0	
15203	chr2	191637423	191638564	1141	570.0	
15204	chr2	191645767	191646253	486	243.0	
15205	chr2	191650871	191651368	497	248.0	
15206	chr2	191666615	191667237	622	311.0	
15207	chr2	191675365	191680987	5622	2811.0	
15208	chr2	191682147	191682785	638	319.0	
15209	chr2	191684884	191685100	216	108.0	
15210	chr2	191686538	191687127	589	294.0	
15211	chr2	191687830	191694252	6422	3211.0	
15212	chr2	191695238	191696493	1255	628.0	
15213	chr2	191697983	191698103	120	60.0	
15214	chr2	191699548	191699691	143	72.0	
15215	chr2	191739792	191740588	796	398.0	
15216	chr2	191758841	191759360	519	260.0	
15217	chr2	191812163	191812520	357	178.0	
15218	chr2	191846871	191847374	503	252.0	
15219	chr2	191889937	191890316	379	190.0	
15220	chr2	191946895	191947172	277	138.0	
15221	chr2	192072308	192072618	310	155.0	
15222	chr2	192162352	192162850	498	249.0	
15223	chr2	192194420	192196156	1736	868.0	
15224	chr2	193272046	193272410	364	182.0	
15225	chr2	193331633	193332012	379	190.0	
15226	chr2	193347265	193348120	855	428.0	
15227	chr2	193476049	193476518	469	234.0	
15228	chr2	194104598	194105178	580	290.0	
15229	chr2	194465242	194465351	109	54.0	
15230	chr2	195318498	195318816	318	159.0	
15231	chr2	195382161	195382529	368	184.0	
15232	chr2	195468939	195469013	74	37.0	
15233	chr2	195486967	195487424	457	228.0	
15234	chr2	195498140	195498609	469	234.0	
15235	chr2	195503255	195503519	264	132.0	
15236	chr2	195509543	195509982	439	220.0	
15237	chr2	195513282	195513576	294	147.0	
15238	chr2	195532101	195534775	2674	1337.0	
15239	chr2	195535680	195537158	1478	739.0	
15240	chr2	195543069	195543432	363	182.0	
15241	chr2	195552549	195553013	464	232.0	
15242	chr2	195559160	195564866	5706	2853.0	
15243	chr2	195574270	195574755	485	242.0	
15244	chr2	195575777	195576549	772	386.0	
15245	chr2	195579975	195580612	637	318.0	
15246	chr2	195594508	195594583	75	38.0	
15247	chr2	195595860	195596261	401	200.0	
15248	chr2	195610690	195611152	462	231.0	
15249	chr2	195632997	195633257	260	130.0	
15250	chr2	195642187	195642765	578	289.0	
15251	chr2	195647207	195647690	483	242.0	
15252	chr2	195648566	195651452	2886	1443.0	
15253	chr2	195656082	195660757	4675	2338.0	
15254	chr2	195662064	195662531	467	234.0	
15255	chr2	195961910	195962316	406	203.0	
15256	chr2	196054706	196055059	353	176.0	
15257	chr2	196066775	196067285	510	255.0	
15258	chr2	196067962	196069387	1425	712.0	
15259	chr2	196078198	196078853	655	328.0	
15260	chr2	196101277	196101884	607	304.0	
15261	chr2	196130227	196134628	4401	2200.0	
15262	chr2	196135376	196136589	1213	606.0	
15263	chr2	196137486	196138898	1412	706.0	
15264	chr2	196140187	196140858	671	336.0	
15265	chr2	196142126	196143345	1219	610.0	
15266	chr2	196143872	196146374	2502	1251.0	
15267	chr2	196147121	196148228	1107	554.0	
15268	chr2	196148823	196151597	2774	1387.0	
15269	chr2	196152142	196152546	404	202.0	
15270	chr2	196153252	196154962	1710	855.0	
15271	chr2	196155622	196155962	340	170.0	
15272	chr2	196156920	196174930	18010	9005.0	
15273	chr2	196175627	196178688	3061	1530.0	
15274	chr2	196182109	196184428	2319	1160.0	
15275	chr2	196184943	196185311	368	184.0	
15276	chr2	196200324	196202077	1753	876.0	
15277	chr2	196204673	196206096	1423	712.0	
15278	chr2	196210921	196212095	1174	587.0	
15279	chr2	196213220	196214161	941	470.0	
15280	chr2	196220633	196221074	441	220.0	
15281	chr2	196229872	196230863	991	496.0	
15282	chr2	196232892	196235172	2280	1140.0	
15283	chr2	196239136	196243032	3896	1948.0	
15284	chr2	196247492	196248896	1404	702.0	
15285	chr2	196249576	196250375	799	400.0	
15286	chr2	196259781	196261004	1223	612.0	
15287	chr2	196262458	196263892	1434	717.0	
15288	chr2	196267872	196269520	1648	824.0	
15289	chr2	196274212	196274836	624	312.0	
15290	chr2	196275605	196277469	1864	932.0	
15291	chr2	196288227	196288268	41	20.0	
15292	chr2	196291786	196292835	1049	524.0	
15293	chr2	196299730	196300374	644	322.0	
15294	chr2	196337280	196337707	427	214.0	
15295	chr2	196415427	196415694	267	134.0	
15296	chr2	196453848	196453888	40	20.0	
15297	chr2	196639000	196640394	1394	697.0	
15298	chr2	196750897	196751648	751	376.0	
15299	chr2	196799047	196800027	980	490.0	
15300	chr2	196914775	196915905	1130	565.0	
15301	chr2	196925570	196928281	2711	1356.0	
15302	chr2	196932296	196932596	300	150.0	
15303	chr2	196983615	196984400	785	392.0	
15304	chr2	196985294	196986242	948	474.0	
15305	chr2	196988106	196988157	51	26.0	
15306	chr2	197011967	197012459	492	246.0	
15307	chr2	197035512	197035840	328	164.0	
15308	chr2	197041379	197041539	160	80.0	
15309	chr2	197045168	197045518	350	175.0	
15310	chr2	197062664	197062921	257	128.0	
15311	chr2	197073089	197073682	593	296.0	
15312	chr2	197075762	197076177	415	208.0	
15313	chr2	197081228	197081842	614	307.0	
15314	chr2	197086266	197086892	626	313.0	
15315	chr2	197113161	197113834	673	336.0	
15316	chr2	197116317	197116708	391	196.0	
15317	chr2	197121248	197121693	445	222.0	
15318	chr2	197130252	197131075	823	412.0	
15319	chr2	197131599	197131834	235	118.0	
15320	chr2	197137740	197138905	1165	582.0	
15321	chr2	197139985	197140570	585	292.0	
15322	chr2	197141641	197142452	811	406.0	
15323	chr2	197145390	197146213	823	412.0	
15324	chr2	197152082	197153494	1412	706.0	
15325	chr2	197156875	197156951	76	38.0	
15326	chr2	197158227	197159055	828	414.0	
15327	chr2	197159588	197160350	762	381.0	
15328	chr2	197161878	197162125	247	124.0	
15329	chr2	197168494	197169469	975	488.0	
15330	chr2	197187493	197187532	39	20.0	
15331	chr2	197191204	197192730	1526	763.0	
15332	chr2	197195633	197195994	361	180.0	
15333	chr2	197196709	197200845	4136	2068.0	
15334	chr2	197204877	197206654	1777	888.0	
15335	chr2	197207512	197213446	5934	2967.0	
15336	chr2	197215856	197217186	1330	665.0	
15337	chr2	197218290	197219051	761	380.0	
15338	chr2	197229513	197230385	872	436.0	
15339	chr2	197231671	197232449	778	389.0	
15340	chr2	197234112	197234310	198	99.0	
15341	chr2	197235732	197237104	1372	686.0	
15342	chr2	197237659	197241288	3629	1814.0	
15343	chr2	197248549	197249238	689	344.0	
15344	chr2	197254657	197257209	2552	1276.0	
15345	chr2	197258404	197259720	1316	658.0	
15346	chr2	197261537	197262585	1048	524.0	
15347	chr2	197263157	197264327	1170	585.0	
15348	chr2	197265007	197266953	1946	973.0	
15349	chr2	197269131	197269881	750	375.0	
15350	chr2	197274108	197274351	243	122.0	
15351	chr2	197274877	197275195	318	159.0	
15352	chr2	197276849	197276897	48	24.0	
15353	chr2	197279351	197280496	1145	572.0	
15354	chr2	197281386	197281862	476	238.0	
15355	chr2	197286954	197287986	1032	516.0	
15356	chr2	197290088	197290512	424	212.0	
15357	chr2	197292580	197294818	2238	1119.0	
15358	chr2	197296048	197299089	3041	1520.0	
15359	chr2	197300159	197300591	432	216.0	
15360	chr2	197301823	197302926	1103	552.0	
15361	chr2	197304415	197305240	825	412.0	
15362	chr2	197306088	197312162	6074	3037.0	
15363	chr2	197322785	197323903	1118	559.0	
15364	chr2	197328571	197328742	171	86.0	
15365	chr2	197356150	197356538	388	194.0	
15366	chr2	197358965	197359182	217	108.0	
15367	chr2	197359901	197360184	283	142.0	
15368	chr2	197378346	197379053	707	354.0	
15369	chr2	197425901	197426622	721	360.0	
15370	chr2	197428740	197432929	4189	2094.0	
15371	chr2	197433686	197436405	2719	1360.0	
15372	chr2	197442803	197444351	1548	774.0	
15373	chr2	197452340	197454499	2159	1080.0	
15374	chr2	197478190	197479171	981	490.0	
15375	chr2	197483001	197483728	727	364.0	
15376	chr2	197484416	197485893	1477	738.0	
15377	chr2	197487505	197487507	2	1.0	
15378	chr2	197490766	197490772	6	3.0	
15379	chr2	197496308	197502688	6380	3190.0	
15380	chr2	197503714	197504733	1019	510.0	
15381	chr2	197514567	197517223	2656	1328.0	
15382	chr2	197599528	197599996	468	234.0	
15383	chr2	197704631	197708005	3374	1687.0	
15384	chr2	197777823	197778193	370	185.0	
15385	chr2	197785899	197786935	1036	518.0	
15386	chr2	197802891	197806688	3797	1898.0	
15387	chr2	197807341	197807562	221	110.0	
15388	chr2	197809037	197809375	338	169.0	
15389	chr2	197813108	197813577	469	234.0	
15390	chr2	197821525	197821782	257	128.0	
15391	chr2	197837783	197838788	1005	502.0	
15392	chr2	197847721	197848129	408	204.0	enhancer
15393	chr2	197857684	197858136	452	226.0	
15394	chr2	197869421	197870357	936	468.0	
15395	chr2	197888913	197889528	615	308.0	
15396	chr2	197891895	197892321	426	213.0	
15397	chr2	197934969	197935006	37	18.0	
15398	chr2	197954368	197954663	295	148.0	
15399	chr2	198005256	198005587	331	166.0	
15400	chr2	198042098	198042490	392	196.0	
15401	chr2	198054319	198054666	347	174.0	
15402	chr2	198106537	198107318	781	390.0	
15403	chr2	198127615	198128038	423	212.0	
15404	chr2	198296613	198297295	682	341.0	
15405	chr2	198309658	198310089	431	216.0	
15406	chr2	198314576	198314969	393	196.0	
15407	chr2	198326383	198326852	469	234.0	
15408	chr2	198327678	198327690	12	6.0	
15409	chr2	199455591	199460569	4978	2489.0	
15410	chr2	199462809	199464376	1567	784.0	
15411	chr2	199469044	199469233	189	94.0	
15412	chr2	199471342	199471854	512	256.0	
15413	chr2	199488814	199489161	347	174.0	
15414	chr2	199659284	199659575	291	146.0	
15415	chr2	199704543	199705057	514	257.0	
15416	chr2	199738657	199740217	1560	780.0	
15417	chr2	199772164	199772955	791	396.0	
15418	chr2	199850457	199851751	1294	647.0	
15419	chr2	199861386	199861563	177	88.0	
15420	chr2	199910510	199912924	2414	1207.0	
15421	chr2	199914332	199914541	209	104.0	
15422	chr2	199940464	199940776	312	156.0	
15423	chr2	199954844	199956414	1570	785.0	
15424	chr2	199979776	199980472	696	348.0	
15425	chr2	199985569	199986073	504	252.0	
15426	chr2	200198989	200199456	467	234.0	
15427	chr2	200216597	200216672	75	38.0	
15428	chr2	200245538	200245681	143	72.0	
15429	chr2	200305914	200307921	2007	1004.0	
15430	chr2	200338654	200339025	371	186.0	
15431	chr2	200373440	200374763	1323	662.0	
15432	chr2	200376642	200376822	180	90.0	
15433	chr2	200383663	200384221	558	279.0	
15434	chr2	200403812	200404249	437	218.0	
15435	chr2	200451524	200451980	456	228.0	
15436	chr2	200455869	200456582	713	356.0	
15437	chr2	200466443	200468810	2367	1184.0	
15438	chr2	200471237	200471747	510	255.0	
15439	chr2	200481350	200481854	504	252.0	
15440	chr2	200509028	200510770	1742	871.0	
15441	chr2	200525530	200526916	1386	693.0	
15442	chr2	200576007	200576366	359	180.0	
15443	chr2	200578785	200579235	450	225.0	
15444	chr2	200585641	200586584	943	472.0	
15445	chr2	200615234	200615613	379	190.0	
15446	chr2	200616178	200616614	436	218.0	
15447	chr2	200635132	200635687	555	278.0	
15448	chr2	200695174	200695980	806	403.0	
15449	chr2	200702660	200703238	578	289.0	
15450	chr2	200712755	200714080	1325	662.0	
15451	chr2	200735656	200736090	434	217.0	
15452	chr2	200810184	200813244	3060	1530.0	
15453	chr2	200814083	200815654	1571	786.0	
15454	chr2	200817091	200817238	147	74.0	
15455	chr2	200818671	200819352	681	340.0	
15456	chr2	200820357	200821045	688	344.0	
15457	chr2	200825416	200825934	518	259.0	
15458	chr2	200831290	200831525	235	118.0	
15459	chr2	200844268	200865422	21154	10577.0	
15460	chr2	200866801	200867866	1065	532.0	
15461	chr2	200868642	200869223	581	290.0	
15462	chr2	200887684	200890514	2830	1415.0	
15463	chr2	200901320	200901990	670	335.0	
15464	chr2	200905651	200906127	476	238.0	
15465	chr2	200962738	200964581	1843	922.0	
15466	chr2	200968090	200968597	507	254.0	
15467	chr2	201059807	201060655	848	424.0	
15468	chr2	201069032	201069816	784	392.0	
15469	chr2	201070782	201072447	1665	832.0	
15470	chr2	201093751	201093942	191	96.0	
15471	chr2	201115345	201121443	6098	3049.0	
15472	chr2	201122373	201122704	331	166.0	
15473	chr2	201123606	201128047	4441	2220.0	
15474	chr2	201128812	201131506	2694	1347.0	
15475	chr2	201132448	201133070	622	311.0	
15476	chr2	201137303	201137541	238	119.0	
15477	chr2	201149123	201149488	365	182.0	
15478	chr2	201151134	201152144	1010	505.0	
15479	chr2	201156037	201157005	968	484.0	
15480	chr2	201157550	201158819	1269	634.0	
15481	chr2	201168513	201168844	331	166.0	
15482	chr2	201177114	201177954	840	420.0	
15483	chr2	201179901	201180421	520	260.0	
15484	chr2	201182486	201186307	3821	1910.0	
15485	chr2	201191326	201192171	845	422.0	
15486	chr2	201193795	201194801	1006	503.0	
15487	chr2	201197875	201197904	29	14.0	
15488	chr2	201208340	201209638	1298	649.0	
15489	chr2	201211827	201212798	971	486.0	
15490	chr2	201220025	201220494	469	234.0	
15491	chr2	201223361	201223481	120	60.0	
15492	chr2	201228698	201229312	614	307.0	
15493	chr2	201231885	201234761	2876	1438.0	
15494	chr2	201235763	201237056	1293	646.0	
15495	chr2	201237752	201238238	486	243.0	
15496	chr2	201239430	201240126	696	348.0	
15497	chr2	201242596	201242984	388	194.0	
15498	chr2	201246226	201246656	430	215.0	
15499	chr2	201252316	201253646	1330	665.0	
15500	chr2	201254255	201254773	518	259.0	
15501	chr2	201257047	201259240	2193	1096.0	
15502	chr2	201260037	201263026	2989	1494.0	
15503	chr2	201263750	201264216	466	233.0	
15504	chr2	201264740	201264928	188	94.0	
15505	chr2	201266864	201267988	1124	562.0	
15506	chr2	201273364	201273811	447	224.0	
15507	chr2	201357257	201357610	353	176.0	
15508	chr2	201363695	201364392	697	348.0	
15509	chr2	201413732	201414754	1022	511.0	
15510	chr2	201431998	201432473	475	238.0	
15511	chr2	201447055	201447603	548	274.0	
15512	chr2	201448689	201449057	368	184.0	
15513	chr2	201450759	201452574	1815	908.0	
15514	chr2	201572830	201573519	689	344.0	
15515	chr2	201642048	201643791	1743	872.0	
15516	chr2	201656012	201656596	584	292.0	
15517	chr2	201780185	201782245	2060	1030.0	
15518	chr2	201787401	201788004	603	302.0	
15519	chr2	201860558	201860988	430	215.0	
15520	chr2	201964743	201964950	207	104.0	
15521	chr2	202032261	202035868	3607	1804.0	
15522	chr2	202104457	202104625	168	84.0	
15523	chr2	202114984	202115120	136	68.0	
15524	chr2	202121679	202122292	613	306.0	
15525	chr2	202171354	202171591	237	118.0	
15526	chr2	202172894	202173284	390	195.0	
15527	chr2	202178303	202178762	459	230.0	
15528	chr2	202237169	202239268	2099	1050.0	
15529	chr2	202264701	202267925	3224	1612.0	
15530	chr2	202269442	202272621	3179	1590.0	
15531	chr2	202276008	202276464	456	228.0	
15532	chr2	202278028	202279327	1299	650.0	
15533	chr2	202294998	202295050	52	26.0	
15534	chr2	202374873	202377885	3012	1506.0	
15535	chr2	202379215	202380115	900	450.0	
15536	chr2	202384728	202385147	419	210.0	
15537	chr2	202573795	202574289	494	247.0	
15538	chr2	202588425	202589259	834	417.0	
15539	chr2	202608434	202610212	1778	889.0	
15540	chr2	202624186	202625466	1280	640.0	
15541	chr2	202633949	202636625	2676	1338.0	
15542	chr2	202637442	202638353	911	456.0	
15543	chr2	202639266	202639623	357	178.0	
15544	chr2	202642607	202644092	1485	742.0	
15545	chr2	202655648	202655874	226	113.0	
15546	chr2	202665181	202666937	1756	878.0	
15547	chr2	202669933	202670342	409	204.0	
15548	chr2	202673104	202673500	396	198.0	
15549	chr2	202700560	202700606	46	23.0	
15550	chr2	202750462	202751036	574	287.0	
15551	chr2	202760978	202761051	73	36.0	
15552	chr2	202762471	202763062	591	296.0	
15553	chr2	202831430	202832086	656	328.0	
15554	chr2	202848294	202849283	989	494.0	
15555	chr2	202870562	202872309	1747	874.0	
15556	chr2	202911091	202912911	1820	910.0	
15557	chr2	202950454	202951025	571	286.0	
15558	chr2	202965753	202966223	470	235.0	
15559	chr2	202996995	202997671	676	338.0	
15560	chr2	203013691	203016146	2455	1228.0	
15561	chr2	203018227	203018501	274	137.0	
15562	chr2	203225386	203225872	486	243.0	
15563	chr2	203238100	203240340	2240	1120.0	
15564	chr2	203309993	203310007	14	7.0	
15565	chr2	203327544	203329286	1742	871.0	
15566	chr2	203446141	203446343	202	101.0	
15567	chr2	203453819	203454286	467	234.0	
15568	chr2	203484190	203484870	680	340.0	
15569	chr2	203498099	203498591	492	246.0	
15570	chr2	203500866	203502236	1370	685.0	
15571	chr2	203533530	203536065	2535	1268.0	
15572	chr2	203569638	203570018	380	190.0	
15573	chr2	203591669	203592079	410	205.0	
15574	chr2	203598244	203598600	356	178.0	
15575	chr2	203636874	203637840	966	483.0	
15576	chr2	203649682	203651707	2025	1012.0	
15577	chr2	203656447	203657223	776	388.0	
15578	chr2	203658245	203658449	204	102.0	
15579	chr2	203659357	203660125	768	384.0	
15580	chr2	203673976	203674290	314	157.0	
15581	chr2	203683914	203684426	512	256.0	
15582	chr2	203688794	203690466	1672	836.0	
15583	chr2	203704355	203706999	2644	1322.0	
15584	chr2	203707534	203707950	416	208.0	
15585	chr2	203708736	203709297	561	280.0	
15586	chr2	203710446	203710492	46	23.0	
15587	chr2	203711518	203711631	113	56.0	
15588	chr2	203713636	203714122	486	243.0	
15589	chr2	203717602	203718693	1091	546.0	
15590	chr2	203719470	203721742	2272	1136.0	
15591	chr2	203733059	203733303	244	122.0	
15592	chr2	203739326	203742080	2754	1377.0	
15593	chr2	203763959	203764031	72	36.0	
15594	chr2	203782097	203782835	738	369.0	
15595	chr2	203786812	203787399	587	294.0	
15596	chr2	203787947	203788377	430	215.0	
15597	chr2	203796204	203796918	714	357.0	
15598	chr2	203802311	203802975	664	332.0	
15599	chr2	203803855	203804632	777	388.0	
15600	chr2	203811322	203812328	1006	503.0	
15601	chr2	203815006	203815912	906	453.0	
15602	chr2	203858214	203858514	300	150.0	
15603	chr2	203859302	203859775	473	236.0	
15604	chr2	203861190	203861493	303	152.0	
15605	chr2	203867378	203868232	854	427.0	
15606	chr2	203869120	203872101	2981	1490.0	
15607	chr2	203880555	203880897	342	171.0	
15608	chr2	203886553	203886930	377	188.0	
15609	chr2	203891341	203892118	777	388.0	
15610	chr2	203897257	203898040	783	392.0	
15611	chr2	203908247	203910092	1845	922.0	
15612	chr2	203914753	203915167	414	207.0	
15613	chr2	203928833	203929222	389	194.0	
15614	chr2	203933830	203935548	1718	859.0	
15615	chr2	203936323	203937209	886	443.0	
15616	chr2	203937840	203938777	937	468.0	
15617	chr2	203940172	203941242	1070	535.0	
15618	chr2	203943445	203944111	666	333.0	
15619	chr2	203946674	203946966	292	146.0	
15620	chr2	203948903	203949698	795	398.0	
15621	chr2	203951158	203952052	894	447.0	
15622	chr2	203987130	203987451	321	160.0	
15623	chr2	203988879	203989742	863	432.0	
15624	chr2	203992835	203993909	1074	537.0	
15625	chr2	203994714	203995132	418	209.0	
15626	chr2	204015418	204015839	421	210.0	
15627	chr2	204027104	204027455	351	176.0	
15628	chr2	204108206	204110875	2669	1334.0	
15629	chr2	204145155	204146082	927	464.0	
15630	chr2	204177856	204178341	485	242.0	
15631	chr2	204243027	204243554	527	264.0	
15632	chr2	204255588	204255840	252	126.0	
15633	chr2	204256863	204257346	483	242.0	
15634	chr2	204260062	204260490	428	214.0	
15635	chr2	204325375	204325783	408	204.0	
15636	chr2	204545287	204545779	492	246.0	
15637	chr2	204871626	204871911	285	142.0	
15638	chr2	204881835	204881988	153	76.0	
15639	chr2	204967152	204968162	1010	505.0	
15640	chr2	205076636	205077694	1058	529.0	
15641	chr2	205293578	205293912	334	167.0	
15642	chr2	205540073	205540272	199	100.0	
15643	chr2	205543859	205544250	391	196.0	
15644	chr2	205546134	205546824	690	345.0	
15645	chr2	205675947	205676238	291	146.0	
15646	chr2	205679922	205680422	500	250.0	
15647	chr2	205681815	205682976	1161	580.0	
15648	chr2	205698909	205700676	1767	884.0	
15649	chr2	205706619	205707576	957	478.0	
15650	chr2	205714197	205715006	809	404.0	
15651	chr2	205721935	205722434	499	250.0	
15652	chr2	205763671	205764277	606	303.0	
15653	chr2	205868811	205869188	377	188.0	
15654	chr2	205885622	205885949	327	164.0	
15655	chr2	205925366	205926274	908	454.0	
15656	chr2	205944310	205945158	848	424.0	
15657	chr2	205947994	205948487	493	246.0	
15658	chr2	205957681	205958112	431	216.0	
15659	chr2	206064050	206064514	464	232.0	
15660	chr2	206083463	206086677	3214	1607.0	
15661	chr2	206098498	206099378	880	440.0	
15662	chr2	206158654	206160855	2201	1100.0	
15663	chr2	206163259	206163448	189	94.0	
15664	chr2	206164036	206164657	621	310.0	
15665	chr2	206218767	206219207	440	220.0	
15666	chr2	206245113	206246535	1422	711.0	
15667	chr2	206260293	206260658	365	182.0	
15668	chr2	206274080	206275902	1822	911.0	
15669	chr2	206368869	206369622	753	376.0	
15670	chr2	206442752	206444114	1362	681.0	
15671	chr2	206530569	206531205	636	318.0	
15672	chr2	206693634	206694110	476	238.0	
15673	chr2	206713725	206714177	452	226.0	
15674	chr2	206764589	206766422	1833	916.0	
15675	chr2	206781442	206781983	541	270.0	
15676	chr2	206797949	206798444	495	248.0	
15677	chr2	206799133	206799398	265	132.0	
15678	chr2	206800413	206801128	715	358.0	
15679	chr2	206859179	206859819	640	320.0	
15680	chr2	206981729	206982077	348	174.0	
15681	chr2	206989348	206989759	411	206.0	
15682	chr2	206994067	206994168	101	50.0	
15683	chr2	207046596	207047288	692	346.0	
15684	chr2	207051453	207051967	514	257.0	
15685	chr2	207071897	207072157	260	130.0	
15686	chr2	207073937	207074536	599	300.0	
15687	chr2	207091920	207092321	401	200.0	
15688	chr2	207107491	207107887	396	198.0	
15689	chr2	207129107	207129292	185	92.0	
15690	chr2	207134124	207134239	115	58.0	
15691	chr2	207135262	207136459	1197	598.0	
15692	chr2	207139491	207140024	533	266.0	
15693	chr2	207141297	207144817	3520	1760.0	
15694	chr2	207149710	207150437	727	364.0	
15695	chr2	207152027	207152295	268	134.0	
15696	chr2	207155219	207156490	1271	636.0	
15697	chr2	207157801	207158069	268	134.0	
15698	chr2	207161440	207161589	149	74.0	
15699	chr2	207163047	207168096	5049	2524.0	
15700	chr2	207176247	207176670	423	212.0	
15701	chr2	207230410	207230976	566	283.0	
15702	chr2	207235637	207235806	169	84.0	
15703	chr2	207236466	207237054	588	294.0	
15704	chr2	207238844	207239778	934	467.0	
15705	chr2	207254557	207255469	912	456.0	
15706	chr2	207258296	207258644	348	174.0	
15707	chr2	207274852	207275214	362	181.0	
15708	chr2	207283048	207283760	712	356.0	
15709	chr2	207311162	207312027	865	432.0	
15710	chr2	207321590	207321869	279	140.0	
15711	chr2	207332477	207332963	486	243.0	
15712	chr2	207337146	207337543	397	198.0	
15713	chr2	207352938	207353344	406	203.0	
15714	chr2	207423777	207424332	555	278.0	
15715	chr2	207473190	207473315	125	62.0	
15716	chr2	207474810	207475323	513	256.0	
15717	chr2	207478508	207478917	409	204.0	
15718	chr2	207480639	207481294	655	328.0	
15719	chr2	207484699	207485103	404	202.0	
15720	chr2	207492225	207492702	477	238.0	
15721	chr2	207498619	207499615	996	498.0	
15722	chr2	207500365	207503708	3343	1672.0	
15723	chr2	207504742	207506179	1437	718.0	
15724	chr2	207506692	207506736	44	22.0	
15725	chr2	207521798	207522002	204	102.0	
15726	chr2	207525101	207525954	853	426.0	
15727	chr2	207526673	207533073	6400	3200.0	
15728	chr2	207533689	207534497	808	404.0	
15729	chr2	207537293	207537453	160	80.0	
15730	chr2	207556666	207557422	756	378.0	
15731	chr2	207619560	207620371	811	406.0	
15732	chr2	207621655	207621968	313	156.0	
15733	chr2	207623790	207628903	5113	2556.0	
15734	chr2	207632521	207633632	1111	556.0	
15735	chr2	207636005	207636235	230	115.0	
15736	chr2	207661982	207662864	882	441.0	
15737	chr2	207668982	207669410	428	214.0	
15738	chr2	207691126	207691567	441	220.0	
15739	chr2	207692161	207692628	467	234.0	
15740	chr2	207698278	207698850	572	286.0	
15741	chr2	207704221	207704488	267	134.0	
15742	chr2	207707006	207707351	345	172.0	
15743	chr2	207710574	207713012	2438	1219.0	
15744	chr2	207713936	207714043	107	54.0	
15745	chr2	207745959	207746507	548	274.0	
15746	chr2	207766875	207771498	4623	2312.0	
15747	chr2	207772440	207772840	400	200.0	
15748	chr2	207792102	207792647	545	272.0	
15749	chr2	207810657	207811331	674	337.0	
15750	chr2	207847735	207847890	155	78.0	
15751	chr2	207870042	207870261	219	110.0	
15752	chr2	207925656	207925959	303	152.0	
15753	chr2	207951969	207952464	495	248.0	
15754	chr2	207974211	207974605	394	197.0	
15755	chr2	207983425	207984142	717	358.0	
15756	chr2	208024921	208026303	1382	691.0	
15757	chr2	208031537	208032030	493	246.0	
15758	chr2	208034102	208034499	397	198.0	
15759	chr2	208040354	208041213	859	430.0	
15760	chr2	208064373	208065070	697	348.0	
15761	chr2	208072228	208072732	504	252.0	
15762	chr2	208124255	208124657	402	201.0	
15763	chr2	208150979	208151238	259	130.0	
15764	chr2	208172025	208172981	956	478.0	
15765	chr2	208175227	208175760	533	266.0	
15766	chr2	208183547	208183874	327	164.0	
15767	chr2	208252889	208255971	3082	1541.0	
15768	chr2	208265101	208267355	2254	1127.0	
15769	chr2	208268562	208269517	955	478.0	
15770	chr2	208294643	208294990	347	174.0	
15771	chr2	208311348	208311467	119	60.0	
15772	chr2	208315336	208315797	461	230.0	
15773	chr2	208320789	208321000	211	106.0	
15774	chr2	208359013	208360126	1113	556.0	
15775	chr2	208366624	208367159	535	268.0	
15776	chr2	208373469	208373815	346	173.0	
15777	chr2	208395155	208395669	514	257.0	
15778	chr2	208482533	208482934	401	200.0	
15779	chr2	209121682	209122079	397	198.0	
15780	chr2	209146403	209146826	423	212.0	
15781	chr2	209423425	209424557	1132	566.0	
15782	chr2	209425709	209425769	60	30.0	
15783	chr2	209526056	209526979	923	462.0	
15784	chr2	209619784	209620152	368	184.0	
15785	chr2	209771662	209771895	233	116.0	
15786	chr2	209790081	209790454	373	186.0	
15787	chr2	209960990	209961403	413	206.0	
15788	chr2	209977633	209978064	431	216.0	
15789	chr2	209985795	209986808	1013	506.0	
15790	chr2	210001842	210003818	1976	988.0	
15791	chr2	210004838	210005335	497	248.0	
15792	chr2	210007842	210008402	560	280.0	
15793	chr2	210047122	210047440	318	159.0	
15794	chr2	210162603	210162858	255	128.0	
15795	chr2	210169717	210172468	2751	1376.0	
15796	chr2	210181273	210181832	559	280.0	
15797	chr2	210195440	210195873	433	216.0	
15798	chr2	210199177	210199553	376	188.0	
15799	chr2	210442957	210443301	344	172.0	
15800	chr2	210445359	210445469	110	55.0	
15801	chr2	210461574	210461761	187	94.0	
15802	chr2	210475538	210477422	1884	942.0	
15803	chr2	210480115	210480433	318	159.0	
15804	chr2	210496540	210496847	307	154.0	
15805	chr2	210502990	210503357	367	184.0	
15806	chr2	210577541	210577869	328	164.0	
15807	chr2	211157874	211158214	340	170.0	
15808	chr2	211611014	211611672	658	329.0	
15809	chr2	212686305	212686706	401	200.0	
15810	chr2	212776910	212777368	458	229.0	
15811	chr2	212811418	212811568	150	75.0	
15812	chr2	212815358	212815868	510	255.0	
15813	chr2	212816445	212816562	117	58.0	
15814	chr2	212957198	212957323	125	62.0	
15815	chr2	212958378	212959226	848	424.0	
15816	chr2	212979771	212980278	507	254.0	
15817	chr2	213001297	213001906	609	304.0	
15818	chr2	213015708	213016251	543	272.0	
15819	chr2	213022227	213023212	985	492.0	
15820	chr2	213034726	213034828	102	51.0	
15821	chr2	213037472	213038402	930	465.0	
15822	chr2	213066041	213066543	502	251.0	
15823	chr2	213083233	213083571	338	169.0	
15824	chr2	213101798	213102091	293	146.0	
15825	chr2	213103976	213104884	908	454.0	
15826	chr2	213118747	213119976	1229	614.0	
15827	chr2	213125869	213126455	586	293.0	
15828	chr2	213129372	213129696	324	162.0	
15829	chr2	213145645	213145998	353	176.0	
15830	chr2	213147498	213147967	469	234.0	
15831	chr2	213148610	213152982	4372	2186.0	
15832	chr2	213153530	213154444	914	457.0	
15833	chr2	213157232	213157782	550	275.0	
15834	chr2	213232915	213233595	680	340.0	
15835	chr2	213246690	213247064	374	187.0	
15836	chr2	213251541	213251983	442	221.0	
15837	chr2	213283833	213285064	1231	616.0	
15838	chr2	213934760	213934837	77	38.0	
15839	chr2	214683682	214683990	308	154.0	
15840	chr2	214799979	214800282	303	152.0	
15841	chr2	214807691	214811091	3400	1700.0	
15842	chr2	215171103	215171635	532	266.0	
15843	chr2	215269832	215270238	406	203.0	
15844	chr2	215311275	215313050	1775	888.0	
15845	chr2	215396725	215396961	236	118.0	
15846	chr2	215435484	215436991	1507	754.0	
15847	chr2	215454472	215454824	352	176.0	
15848	chr2	215487024	215487328	304	152.0	
15849	chr2	215611856	215611980	124	62.0	
15850	chr2	215619993	215620478	485	242.0	
15851	chr2	215664719	215665304	585	292.0	
15852	chr2	215680768	215682655	1887	944.0	
15853	chr2	215696980	215697415	435	218.0	
15854	chr2	215700772	215701457	685	342.0	
15855	chr2	215711317	215711854	537	268.0	
15856	chr2	215713464	215713789	325	162.0	
15857	chr2	215724161	215724518	357	178.0	
15858	chr2	215728367	215729181	814	407.0	
15859	chr2	215738220	215738806	586	293.0	
15860	chr2	215748422	215748766	344	172.0	
15861	chr2	215749381	215750175	794	397.0	
15862	chr2	215764616	215765052	436	218.0	
15863	chr2	215793622	215794484	862	431.0	
15864	chr2	215811343	215812385	1042	521.0	
15865	chr2	215828466	215828949	483	242.0	
15866	chr2	215831409	215831895	486	243.0	
15867	chr2	215846033	215846715	682	341.0	
15868	chr2	215847775	215848239	464	232.0	
15869	chr2	215899142	215899416	274	137.0	
15870	chr2	215899984	215901324	1340	670.0	
15871	chr2	215903279	215903368	89	44.0	
15872	chr2	215903879	215904660	781	390.0	
15873	chr2	215920089	215920561	472	236.0	
15874	chr2	215931247	215931689	442	221.0	
15875	chr2	215949977	215950307	330	165.0	
15876	chr2	215979749	215980011	262	131.0	
15877	chr2	216004926	216005398	472	236.0	
15878	chr2	216006279	216006779	500	250.0	
15879	chr2	216012677	216014065	1388	694.0	
15880	chr2	216015672	216016916	1244	622.0	
15881	chr2	216017482	216017739	257	128.0	
15882	chr2	216023000	216023469	469	234.0	
15883	chr2	216033921	216034785	864	432.0	
15884	chr2	216057457	216058558	1101	550.0	
15885	chr2	216059553	216059846	293	146.0	
15886	chr2	216081191	216083259	2068	1034.0	
15887	chr2	216084116	216084985	869	434.0	
15888	chr2	216108538	216110761	2223	1112.0	
15889	chr2	216114186	216115627	1441	720.0	
15890	chr2	216120039	216120429	390	195.0	
15891	chr2	216139869	216140282	413	206.0	
15892	chr2	216183521	216183924	403	202.0	
15893	chr2	216206139	216206291	152	76.0	
15894	chr2	216222866	216222889	23	12.0	
15895	chr2	216328405	216328685	280	140.0	
15896	chr2	216349954	216350911	957	478.0	
15897	chr2	216352627	216353583	956	478.0	
15898	chr2	216371797	216372823	1026	513.0	
15899	chr2	216388262	216388721	459	230.0	
15900	chr2	216389476	216390031	555	278.0	
15901	chr2	216403936	216404428	492	246.0	
15902	chr2	216411655	216413294	1639	820.0	
15903	chr2	216475101	216476089	988	494.0	
15904	chr2	216477483	216478099	616	308.0	
15905	chr2	216485338	216487214	1876	938.0	
15906	chr2	216491797	216492426	629	314.0	
15907	chr2	216495909	216495918	9	4.0	
15908	chr2	216498160	216499995	1835	918.0	
15909	chr2	216516784	216517115	331	166.0	
15910	chr2	216519152	216519579	427	214.0	
15911	chr2	216535492	216535958	466	233.0	
15912	chr2	216554189	216554816	627	314.0	
15913	chr2	216555370	216555564	194	97.0	
15914	chr2	216606632	216607098	466	233.0	
15915	chr2	216633204	216633521	317	158.0	
15916	chr2	216666394	216667039	645	322.0	
15917	chr2	216682399	216682893	494	247.0	
15918	chr2	216683760	216684326	566	283.0	
15919	chr2	216691408	216693634	2226	1113.0	
15920	chr2	216694180	216694677	497	248.0	
15921	chr2	216698868	216699121	253	126.0	
15922	chr2	216777754	216778031	277	138.0	
15923	chr2	216866556	216866768	212	106.0	
15924	chr2	217064108	217064767	659	330.0	
15925	chr2	217071324	217071874	550	275.0	
15926	chr2	217075210	217075514	304	152.0	
15927	chr2	217085881	217086574	693	346.0	
15928	chr2	217088555	217089041	486	243.0	
15929	chr2	217089917	217090435	518	259.0	
15930	chr2	217161205	217161782	577	288.0	
15931	chr2	217162595	217162882	287	144.0	
15932	chr2	217218658	217219223	565	282.0	
15933	chr2	217220265	217220685	420	210.0	
15934	chr2	217222437	217223933	1496	748.0	
15935	chr2	217248613	217249028	415	208.0	
15936	chr2	217316725	217317179	454	227.0	
15937	chr2	217353804	217354025	221	110.0	
15938	chr2	217363474	217363862	388	194.0	
15939	chr2	217398765	217399356	591	296.0	
15940	chr2	217430969	217431179	210	105.0	
15941	chr2	217433590	217434551	961	480.0	
15942	chr2	217510739	217511146	407	204.0	
15943	chr2	217610302	217610962	660	330.0	
15944	chr2	217650789	217650912	123	62.0	
15945	chr2	217713411	217713909	498	249.0	
15946	chr2	217756471	217756968	497	248.0	
15947	chr2	217785207	217786091	884	442.0	
15948	chr2	217789120	217790938	1818	909.0	
15949	chr2	217798794	217799509	715	358.0	
15950	chr2	217846243	217846516	273	136.0	
15951	chr2	217850269	217851628	1359	680.0	
15952	chr2	217864955	217865503	548	274.0	
15953	chr2	217885968	217887124	1156	578.0	
15954	chr2	217899467	217900244	777	388.0	
15955	chr2	217902501	217903343	842	421.0	
15956	chr2	217906791	217907217	426	213.0	
15957	chr2	217913533	217913758	225	112.0	
15958	chr2	217928205	217929142	937	468.0	
15959	chr2	217934112	217935412	1300	650.0	
15960	chr2	217943321	217944287	966	483.0	
15961	chr2	217988298	217988959	661	330.0	
15962	chr2	217993814	217994269	455	228.0	
15963	chr2	218009972	218010841	869	434.0	
15964	chr2	218019447	218019868	421	210.0	
15965	chr2	218033836	218035369	1533	766.0	
15966	chr2	218036335	218036806	471	236.0	
15967	chr2	218041419	218041960	541	270.0	
15968	chr2	218046070	218046759	689	344.0	
15969	chr2	218047522	218048268	746	373.0	
15970	chr2	218063323	218064103	780	390.0	
15971	chr2	218066877	218067320	443	222.0	
15972	chr2	218068518	218069472	954	477.0	
15973	chr2	218073870	218074376	506	253.0	
15974	chr2	218081065	218081526	461	230.0	
15975	chr2	218091768	218092131	363	182.0	
15976	chr2	218125086	218126190	1104	552.0	
15977	chr2	218127512	218127960	448	224.0	
15978	chr2	218128973	218129517	544	272.0	
15979	chr2	218130368	218130843	475	238.0	
15980	chr2	218137572	218137899	327	164.0	
15981	chr2	218150106	218150168	62	31.0	
15982	chr2	218161750	218161991	241	120.0	
15983	chr2	218166559	218167319	760	380.0	
15984	chr2	218168809	218169338	529	264.0	
15985	chr2	218186162	218186927	765	382.0	
15986	chr2	218214148	218214494	346	173.0	
15987	chr2	218216127	218221456	5329	2664.0	
15988	chr2	218222552	218223797	1245	622.0	
15989	chr2	218225729	218226069	340	170.0	
15990	chr2	218228778	218231470	2692	1346.0	
15991	chr2	218252882	218253202	320	160.0	
15992	chr2	218255555	218255577	22	11.0	
15993	chr2	218256880	218258308	1428	714.0	
15994	chr2	218258893	218259739	846	423.0	
15995	chr2	218260781	218262294	1513	756.0	
15996	chr2	218263564	218264781	1217	608.0	
15997	chr2	218265385	218265701	316	158.0	
15998	chr2	218269208	218271478	2270	1135.0	
15999	chr2	218272231	218273437	1206	603.0	
16000	chr2	218275369	218275841	472	236.0	
16001	chr2	218283847	218294678	10831	5416.0	
16002	chr2	218301039	218301952	913	456.0	
16003	chr2	218313789	218314220	431	216.0	
16004	chr2	218315927	218317104	1177	588.0	
16005	chr2	218317856	218318228	372	186.0	
16006	chr2	218320727	218321138	411	206.0	
16007	chr2	218322055	218324577	2522	1261.0	
16008	chr2	218327322	218328373	1051	526.0	
16009	chr2	218329348	218330384	1036	518.0	
16010	chr2	218331852	218333871	2019	1010.0	
16011	chr2	218356381	218357293	912	456.0	
16012	chr2	218360320	218360993	673	336.0	
16013	chr2	218361976	218362285	309	154.0	
16014	chr2	218363274	218364184	910	455.0	
16015	chr2	218367049	218372344	5295	2648.0	
16016	chr2	218377856	218378639	783	392.0	
16017	chr2	218381366	218382689	1323	662.0	
16018	chr2	218383800	218384338	538	269.0	
16019	chr2	218386713	218388922	2209	1104.0	
16020	chr2	218389610	218390086	476	238.0	
16021	chr2	218391255	218391503	248	124.0	
16022	chr2	218392941	218402602	9661	4830.0	
16023	chr2	218403280	218403384	104	52.0	
16024	chr2	218404117	218407870	3753	1876.0	
16025	chr2	218412806	218413281	475	238.0	
16026	chr2	218438797	218438844	47	24.0	
16027	chr2	218466045	218466494	449	224.0	
16028	chr2	218471014	218473431	2417	1208.0	
16029	chr2	218516588	218517007	419	210.0	
16030	chr2	218567506	218570306	2800	1400.0	
16031	chr2	218571195	218571331	136	68.0	
16032	chr2	218623019	218623430	411	206.0	
16033	chr2	218648408	218649077	669	334.0	
16034	chr2	218658545	218660277	1732	866.0	
16035	chr2	218671153	218672755	1602	801.0	
16036	chr2	218678921	218679730	809	404.0	
16037	chr2	218687396	218687883	487	244.0	
16038	chr2	218710221	218711908	1687	844.0	
16039	chr2	218714035	218714408	373	186.0	
16040	chr2	218715303	218715732	429	214.0	
16041	chr2	218727822	218728247	425	212.0	
16042	chr2	218731509	218732044	535	268.0	
16043	chr2	218733181	218734581	1400	700.0	
16044	chr2	218742977	218743494	517	258.0	
16045	chr2	218744551	218745963	1412	706.0	
16046	chr2	218748797	218749410	613	306.0	
16047	chr2	218776002	218776836	834	417.0	
16048	chr2	218781586	218782619	1033	516.0	
16049	chr2	218806287	218806788	501	250.0	
16050	chr2	218820235	218820773	538	269.0	
16051	chr2	218839073	218839939	866	433.0	
16052	chr2	218847462	218848298	836	418.0	
16053	chr2	218852594	218853625	1031	516.0	
16054	chr2	218856622	218856623	1	0.0	
16055	chr2	218859066	218860161	1095	548.0	
16056	chr2	218860815	218861498	683	342.0	
16057	chr2	218870859	218872140	1281	640.0	
16058	chr2	218873402	218873960	558	279.0	
16059	chr2	218876362	218878046	1684	842.0	
16060	chr2	218879008	218884501	5493	2746.0	
16061	chr2	218886015	218886452	437	218.0	
16062	chr2	218890065	218890395	330	165.0	
16063	chr2	218891938	218898866	6928	3464.0	
16064	chr2	218908510	218909715	1205	602.0	
16065	chr2	218959143	218960074	931	466.0	
16066	chr2	218962833	218963234	401	200.0	
16067	chr2	218979690	218982531	2841	1420.0	
16068	chr2	218984261	218985150	889	444.0	
16069	chr2	218993079	218994040	961	480.0	
16070	chr2	218995767	218996732	965	482.0	
16071	chr2	219000588	219000748	160	80.0	
16072	chr2	219001327	219003449	2122	1061.0	
16073	chr2	219029605	219030244	639	320.0	
16074	chr2	219057518	219059020	1502	751.0	
16075	chr2	219060333	219061425	1092	546.0	
16076	chr2	219076415	219076416	1	0.0	
16077	chr2	219086265	219086567	302	151.0	
16078	chr2	219104102	219104511	409	204.0	
16079	chr2	219109387	219109956	569	284.0	
16080	chr2	219119395	219119833	438	219.0	
16081	chr2	219124259	219124828	569	284.0	
16082	chr2	219154981	219155489	508	254.0	
16083	chr2	219159737	219161441	1704	852.0	
16084	chr2	219171060	219171753	693	346.0	
16085	chr2	219175970	219179298	3328	1664.0	
16086	chr2	219182421	219182928	507	254.0	
16087	chr2	219187277	219187354	77	38.0	
16088	chr2	219200344	219201089	745	372.0	
16089	chr2	219205916	219207765	1849	924.0	
16090	chr2	219211061	219212169	1108	554.0	
16091	chr2	219217535	219219664	2129	1064.0	
16092	chr2	219225244	219225992	748	374.0	
16093	chr2	219228358	219230757	2399	1200.0	
16094	chr2	219243142	219244029	887	444.0	
16095	chr2	219244748	219255491	10743	5372.0	
16096	chr2	219277373	219282010	4637	2318.0	
16097	chr2	219283358	219283420	62	31.0	
16098	chr2	219286795	219288466	1671	836.0	
16099	chr2	219289632	219290128	496	248.0	
16100	chr2	219294327	219295542	1215	608.0	
16101	chr2	219296871	219297117	246	123.0	
16102	chr2	219298256	219299321	1065	532.0	
16103	chr2	219308071	219308780	709	354.0	
16104	chr2	219320804	219321162	358	179.0	
16105	chr2	219344718	219345087	369	184.0	
16106	chr2	219352197	219352896	699	350.0	
16107	chr2	219356782	219357264	482	241.0	
16108	chr2	219358234	219359113	879	440.0	
16109	chr2	219362524	219362954	430	215.0	
16110	chr2	219386818	219389257	2439	1220.0	
16111	chr2	219397046	219397418	372	186.0	
16112	chr2	219401756	219401995	239	120.0	locus_control_region
16113	chr2	219402700	219403362	662	331.0	"locus_control_region	region"
16114	chr2	219430796	219430895	99	50.0	enhancer
16115	chr2	219441324	219442494	1170	585.0	
16116	chr2	219459372	219459826	454	227.0	
16117	chr2	219476217	219476676	459	230.0	
16118	chr2	219484050	219485152	1102	551.0	
16119	chr2	219494947	219499477	4530	2265.0	
16120	chr2	219509174	219510588	1414	707.0	
16121	chr2	219521240	219521669	429	214.0	
16122	chr2	219529730	219530834	1104	552.0	
16123	chr2	219541288	219544934	3646	1823.0	
16124	chr2	219551048	219553336	2288	1144.0	
16125	chr2	219560274	219560810	536	268.0	
16126	chr2	219570441	219571560	1119	560.0	
16127	chr2	219578822	219579332	510	255.0	
16128	chr2	219597144	219598716	1572	786.0	
16129	chr2	219603710	219604281	571	286.0	
16130	chr2	219612875	219613342	467	234.0	
16131	chr2	219627289	219628005	716	358.0	
16132	chr2	219629083	219629479	396	198.0	
16133	chr2	219639162	219639571	409	204.0	
16134	chr2	219642055	219643196	1141	570.0	
16135	chr2	219685039	219685518	479	240.0	
16136	chr2	219689679	219690073	394	197.0	
16137	chr2	220687175	220687704	529	264.0	
16138	chr2	221203015	221203599	584	292.0	
16139	chr2	221420082	221420759	677	338.0	
16140	chr2	221465748	221466184	436	218.0	
16141	chr2	221517084	221519146	2062	1031.0	
16142	chr2	221520036	221521482	1446	723.0	
16143	chr2	221527560	221528256	696	348.0	
16144	chr2	221529556	221530719	1163	582.0	
16145	chr2	221555139	221555622	483	242.0	
16146	chr2	221570289	221574433	4144	2072.0	
16147	chr2	222295635	222295910	275	138.0	
16148	chr2	222299053	222299280	227	114.0	promoter
16149	chr2	222304293	222306485	2192	1096.0	
16150	chr2	222317927	222320657	2730	1365.0	
16151	chr2	222358834	222359270	436	218.0	
16152	chr2	222364235	222364857	622	311.0	
16153	chr2	222368149	222368271	122	61.0	
16154	chr2	222404269	222404991	722	361.0	
16155	chr2	222423511	222426558	3047	1524.0	
16156	chr2	222427457	222428101	644	322.0	
16157	chr2	222447111	222447560	449	224.0	
16158	chr2	222448763	222449198	435	218.0	
16159	chr2	222561811	222562226	415	208.0	
16160	chr2	222611720	222612027	307	154.0	
16161	chr2	222613718	222614117	399	200.0	
16162	chr2	222620865	222621332	467	234.0	
16163	chr2	222622839	222623378	539	270.0	
16164	chr2	222655144	222657192	2048	1024.0	
16165	chr2	222667853	222668847	994	497.0	
16166	chr2	222671302	222672196	894	447.0	
16167	chr2	222690345	222691198	853	426.0	
16168	chr2	222701722	222701949	227	114.0	
16169	chr2	222707325	222709978	2653	1326.0	
16170	chr2	222730620	222731517	897	448.0	
16171	chr2	222739977	222740212	235	118.0	
16172	chr2	222741245	222741721	476	238.0	
16173	chr2	222743325	222743841	516	258.0	
16174	chr2	222751265	222751659	394	197.0	
16175	chr2	222789187	222790155	968	484.0	
16176	chr2	222791834	222792363	529	264.0	
16177	chr2	222797599	222798501	902	451.0	
16178	chr2	222805557	222806433	876	438.0	
16179	chr2	222842425	222843053	628	314.0	
16180	chr2	222844237	222844993	756	378.0	
16181	chr2	222859945	222862604	2659	1330.0	
16182	chr2	222863316	222863515	199	100.0	
16183	chr2	222864319	222864732	413	206.0	
16184	chr2	222865653	222865660	7	4.0	
16185	chr2	222869112	222869629	517	258.0	
16186	chr2	222887034	222887131	97	48.0	
16187	chr2	222892208	222893167	959	480.0	
16188	chr2	222897943	222898356	413	206.0	
16189	chr2	222902774	222904056	1282	641.0	
16190	chr2	222909438	222909685	247	124.0	
16191	chr2	222912028	222912667	639	320.0	
16192	chr2	222939175	222939676	501	250.0	
16193	chr2	222955073	222955151	78	39.0	
16194	chr2	222971616	222972136	520	260.0	
16195	chr2	223043496	223043821	325	162.0	
16196	chr2	223460729	223461087	358	179.0	
16197	chr2	223465518	223466425	907	454.0	
16198	chr2	223467129	223467630	501	250.0	
16199	chr2	223727474	223727875	401	200.0	
16200	chr2	223759942	223762220	2278	1139.0	
16201	chr2	223779797	223780336	539	270.0	
16202	chr2	223787104	223787400	296	148.0	
16203	chr2	223797814	223798384	570	285.0	
16204	chr2	223835808	223838315	2507	1254.0	
16205	chr2	223865053	223866425	1372	686.0	
16206	chr2	223868133	223868319	186	93.0	
16207	chr2	223871212	223871684	472	236.0	
16208	chr2	223881760	223882394	634	317.0	
16209	chr2	223887021	223887464	443	222.0	
16210	chr2	223894227	223894228	1	0.0	
16211	chr2	223895610	223895802	192	96.0	
16212	chr2	223896714	223897219	505	252.0	
16213	chr2	223917426	223917631	205	102.0	
16214	chr2	223918419	223919129	710	355.0	
16215	chr2	223929318	223931038	1720	860.0	
16216	chr2	223934186	223934430	244	122.0	
16217	chr2	223939363	223939890	527	264.0	
16218	chr2	223941417	223942468	1051	526.0	
16219	chr2	223943974	223946136	2162	1081.0	
16220	chr2	223949503	223949583	80	40.0	
16221	chr2	223950921	223951168	247	124.0	
16222	chr2	223956446	223958035	1589	794.0	
16223	chr2	223959654	223960042	388	194.0	
16224	chr2	223970226	223970864	638	319.0	
16225	chr2	223993588	223994077	489	244.0	
16226	chr2	224025398	224026560	1162	581.0	
16227	chr2	224038195	224040468	2273	1136.0	
16228	chr2	224041465	224041811	346	173.0	
16229	chr2	224284315	224284705	390	195.0	
16230	chr2	224319084	224319485	401	200.0	
16231	chr2	224357255	224357824	569	284.0	
16232	chr2	224368995	224369439	444	222.0	
16233	chr2	224400891	224402441	1550	775.0	
16234	chr2	224405388	224406390	1002	501.0	
16235	chr2	224407271	224407505	234	117.0	
16236	chr2	224426680	224427077	397	198.0	
16237	chr2	224441182	224441349	167	84.0	
16238	chr2	224442064	224443084	1020	510.0	
16239	chr2	224449427	224449789	362	181.0	
16240	chr2	224489994	224490353	359	180.0	
16241	chr2	224518017	224518412	395	198.0	
16242	chr2	224520119	224520479	360	180.0	
16243	chr2	224521376	224522054	678	339.0	
16244	chr2	224523274	224524824	1550	775.0	
16245	chr2	224561308	224561588	280	140.0	
16246	chr2	224574422	224576720	2298	1149.0	
16247	chr2	224579233	224579861	628	314.0	
16248	chr2	224583124	224586921	3797	1898.0	
16249	chr2	224602729	224603404	675	338.0	
16250	chr2	224638180	224638726	546	273.0	
16251	chr2	224646236	224646630	394	197.0	
16252	chr2	224650801	224651240	439	220.0	
16253	chr2	224742434	224742774	340	170.0	
16254	chr2	224764340	224765018	678	339.0	
16255	chr2	224778373	224778861	488	244.0	
16256	chr2	224842935	224842942	7	4.0	
16257	chr2	224882461	224883001	540	270.0	
16258	chr2	224884155	224884720	565	282.0	
16259	chr2	224886005	224886550	545	272.0	
16260	chr2	224892579	224893117	538	269.0	
16261	chr2	224894063	224894953	890	445.0	
16262	chr2	224898286	224898570	284	142.0	
16263	chr2	224909827	224910620	793	396.0	
16264	chr2	224918929	224919851	922	461.0	
16265	chr2	224921885	224923773	1888	944.0	
16266	chr2	224925270	224928577	3307	1654.0	
16267	chr2	224929937	224931522	1585	792.0	
16268	chr2	224932565	224932847	282	141.0	
16269	chr2	224933443	224933723	280	140.0	
16270	chr2	224937707	224939162	1455	728.0	
16271	chr2	224943339	224946082	2743	1372.0	
16272	chr2	224946640	224947772	1132	566.0	
16273	chr2	224948626	224949422	796	398.0	
16274	chr2	224951683	224952178	495	248.0	
16275	chr2	224952910	224953911	1001	500.0	
16276	chr2	224957345	224959382	2037	1018.0	
16277	chr2	224969816	224970378	562	281.0	
16278	chr2	224971179	224971603	424	212.0	
16279	chr2	224973647	224974060	413	206.0	
16280	chr2	224976706	224977102	396	198.0	
16281	chr2	224982781	224983913	1132	566.0	
16282	chr2	224984623	224985065	442	221.0	
16283	chr2	224986378	224986909	531	266.0	
16284	chr2	225001726	225003107	1381	690.0	
16285	chr2	225008421	225009302	881	440.0	
16286	chr2	225025846	225027840	1994	997.0	
16287	chr2	225030135	225030686	551	276.0	
16288	chr2	225037461	225038503	1042	521.0	
16289	chr2	225040709	225043120	2411	1206.0	
16290	chr2	225052617	225053188	571	286.0	
16291	chr2	225112618	225113146	528	264.0	
16292	chr2	225171396	225171686	290	145.0	
16293	chr2	225270734	225271279	545	272.0	
16294	chr2	225282865	225283226	361	180.0	
16295	chr2	225303123	225303233	110	55.0	
16296	chr2	225464585	225465044	459	230.0	
16297	chr2	225660420	225660857	437	218.0	
16298	chr2	225668560	225669012	452	226.0	
16299	chr2	225889392	225889733	341	170.0	
16300	chr2	226002160	226002933	773	386.0	
16301	chr2	226030312	226031682	1370	685.0	
16302	chr2	226037789	226037791	2	1.0	
16303	chr2	226057884	226058305	421	210.0	
16304	chr2	226060258	226060348	90	45.0	
16305	chr2	226118316	226119321	1005	502.0	
16306	chr2	226122021	226122522	501	250.0	
16307	chr2	226136646	226137529	883	442.0	
16308	chr2	226139565	226140162	597	298.0	
16309	chr2	226215880	226216325	445	222.0	
16310	chr2	226307460	226307932	472	236.0	
16311	chr2	226325483	226325857	374	187.0	
16312	chr2	226333365	226333853	488	244.0	
16313	chr2	226423179	226424176	997	498.0	
16314	chr2	226439382	226439720	338	169.0	
16315	chr2	226650146	226650575	429	214.0	
16316	chr2	226772377	226773297	920	460.0	
16317	chr2	226790793	226792751	1958	979.0	
16318	chr2	226796897	226796901	4	2.0	
16319	chr2	226798187	226801835	3648	1824.0	
16320	chr2	226802413	226803040	627	314.0	
16321	chr2	226811024	226811451	427	214.0	
16322	chr2	226835162	226837092	1930	965.0	
16323	chr2	226838250	226838396	146	73.0	
16324	chr2	226839208	226839556	348	174.0	
16325	chr2	226843050	226843282	232	116.0	
16326	chr2	226875348	226876001	653	326.0	
16327	chr2	226905689	226906885	1196	598.0	
16328	chr2	226909268	226909442	174	87.0	
16329	chr2	226985344	226985718	374	187.0	
16330	chr2	227020456	227020725	269	134.0	
16331	chr2	227029736	227029782	46	23.0	
16332	chr2	227164061	227165156	1095	548.0	
16333	chr2	227238305	227238578	273	136.0	
16334	chr2	227320302	227320649	347	174.0	
16335	chr2	227322908	227323336	428	214.0	
16336	chr2	227324465	227326288	1823	912.0	
16337	chr2	227335726	227335939	213	106.0	
16338	chr2	227363799	227364112	313	156.0	
16339	chr2	227366715	227367301	586	293.0	
16340	chr2	227368629	227368996	367	184.0	
16341	chr2	227370336	227371414	1078	539.0	
16342	chr2	227385159	227386280	1121	560.0	
16343	chr2	227397585	227397937	352	176.0	
16344	chr2	227404247	227405116	869	434.0	
16345	chr2	227406064	227408227	2163	1082.0	
16346	chr2	227411396	227411689	293	146.0	
16347	chr2	227415496	227416636	1140	570.0	
16348	chr2	227436372	227437128	756	378.0	
16349	chr2	227450164	227451811	1647	824.0	
16350	chr2	227459873	227460593	720	360.0	
16351	chr2	227462569	227463023	454	227.0	
16352	chr2	227464362	227464994	632	316.0	
16353	chr2	227471480	227473460	1980	990.0	
16354	chr2	227479999	227480475	476	238.0	
16355	chr2	227482865	227483396	531	266.0	
16356	chr2	227489078	227489471	393	196.0	
16357	chr2	227500252	227500269	17	8.0	
16358	chr2	227503516	227503705	189	94.0	
16359	chr2	227509113	227509365	252	126.0	
16360	chr2	227516939	227517732	793	396.0	
16361	chr2	227568569	227568755	186	93.0	
16362	chr2	227608371	227608946	575	288.0	
16363	chr2	227658229	227658633	404	202.0	
16364	chr2	227766254	227766739	485	242.0	
16365	chr2	227774309	227774659	350	175.0	
16366	chr2	227783099	227783944	845	422.0	
16367	chr2	227805507	227805960	453	226.0	
16368	chr2	227813576	227814136	560	280.0	
16369	chr2	227816762	227817072	310	155.0	
16370	chr2	227817833	227819332	1499	750.0	
16371	chr2	227826210	227827075	865	432.0	
16372	chr2	227835126	227835690	564	282.0	
16373	chr2	227839644	227840225	581	290.0	
16374	chr2	227848459	227849245	786	393.0	
16375	chr2	227862244	227862644	400	200.0	
16376	chr2	227871373	227871944	571	286.0	
16377	chr2	227882101	227882804	703	352.0	
16378	chr2	227884369	227884848	479	240.0	
16379	chr2	227890739	227890842	103	52.0	
16380	chr2	229267415	229267430	15	8.0	
16381	chr2	229270702	229271583	881	440.0	
16382	chr2	229273491	229274164	673	336.0	
16383	chr2	229282817	229283751	934	467.0	
16384	chr2	229287582	229288317	735	368.0	
16385	chr2	229295077	229295250	173	86.0	
16386	chr2	229296027	229297780	1753	876.0	
16387	chr2	229300615	229301715	1100	550.0	
16388	chr2	229310391	229310835	444	222.0	
16389	chr2	229313332	229314467	1135	568.0	
16390	chr2	229330689	229331610	921	460.0	enhancer
16391	chr2	229333404	229333773	369	184.0	
16392	chr2	229335349	229335673	324	162.0	
16393	chr2	229342642	229342780	138	69.0	
16394	chr2	229350815	229351307	492	246.0	
16395	chr2	229408243	229409478	1235	618.0	enhancer
16396	chr2	229415746	229417005	1259	630.0	
16397	chr2	229445128	229445272	144	72.0	
16398	chr2	229587091	229587473	382	191.0	
16399	chr2	229713964	229715434	1470	735.0	
16400	chr2	229775611	229776061	450	225.0	
16401	chr2	229780581	229781398	817	408.0	
16402	chr2	229801078	229801591	513	256.0	
16403	chr2	229835830	229836313	483	242.0	
16404	chr2	229852491	229853016	525	262.0	
16405	chr2	229856462	229856779	317	158.0	
16406	chr2	229910662	229911200	538	269.0	
16407	chr2	229914176	229914543	367	184.0	
16408	chr2	229917458	229917775	317	158.0	
16409	chr2	229919711	229923344	3633	1816.0	
16410	chr2	230008144	230008597	453	226.0	
16411	chr2	230066900	230069182	2282	1141.0	
16412	chr2	230124414	230125543	1129	564.0	
16413	chr2	230160101	230160747	646	323.0	
16414	chr2	230170549	230170757	208	104.0	
16415	chr2	230202831	230203398	567	284.0	
16416	chr2	230204959	230205461	502	251.0	
16417	chr2	230206516	230207007	491	246.0	
16418	chr2	230209360	230210017	657	328.0	
16419	chr2	230218296	230220781	2485	1242.0	
16420	chr2	230222867	230223266	399	200.0	
16421	chr2	230224160	230227835	3675	1838.0	
16422	chr2	230230257	230230380	123	62.0	
16423	chr2	230234160	230234226	66	33.0	
16424	chr2	230254204	230255016	812	406.0	
16425	chr2	230257774	230258169	395	198.0	
16426	chr2	230262089	230262772	683	342.0	
16427	chr2	230318226	230320066	1840	920.0	
16428	chr2	230326511	230328046	1535	768.0	
16429	chr2	230330196	230330577	381	190.0	
16430	chr2	230335641	230335933	292	146.0	
16431	chr2	230344413	230344757	344	172.0	
16432	chr2	230347778	230348336	558	279.0	
16433	chr2	230362269	230362624	355	178.0	
16434	chr2	230409080	230410276	1196	598.0	
16435	chr2	230410816	230414047	3231	1616.0	
16436	chr2	230415531	230417118	1587	794.0	
16437	chr2	230418336	230418751	415	208.0	
16438	chr2	230423963	230424346	383	192.0	
16439	chr2	230430809	230431735	926	463.0	
16440	chr2	230434908	230435320	412	206.0	
16441	chr2	230439547	230440135	588	294.0	
16442	chr2	230441331	230442165	834	417.0	
16443	chr2	230447641	230448783	1142	571.0	
16444	chr2	230457076	230457880	804	402.0	
16445	chr2	230459305	230459610	305	152.0	
16446	chr2	230472280	230473830	1550	775.0	
16447	chr2	230564768	230565300	532	266.0	
16448	chr2	230575601	230576308	707	354.0	
16449	chr2	230582963	230583322	359	180.0	
16450	chr2	230589429	230590114	685	342.0	
16451	chr2	230601689	230601737	48	24.0	
16452	chr2	230602318	230603568	1250	625.0	
16453	chr2	230610998	230611963	965	482.0	
16454	chr2	230614880	230615288	408	204.0	
16455	chr2	230643380	230644622	1242	621.0	
16456	chr2	230657402	230657781	379	190.0	
16457	chr2	230658651	230662192	3541	1770.0	
16458	chr2	230663091	230664505	1414	707.0	
16459	chr2	230665040	230665781	741	370.0	
16460	chr2	230666901	230669879	2978	1489.0	
16461	chr2	230678355	230678825	470	235.0	
16462	chr2	230700420	230701001	581	290.0	
16463	chr2	230711240	230714696	3456	1728.0	
16464	chr2	230715221	230716040	819	410.0	
16465	chr2	230717720	230717859	139	70.0	
16466	chr2	230721712	230721994	282	141.0	
16467	chr2	230723190	230723930	740	370.0	
16468	chr2	230758600	230759501	901	450.0	
16469	chr2	230762308	230762707	399	200.0	
16470	chr2	230773058	230773449	391	196.0	
16471	chr2	230779208	230779516	308	154.0	
16472	chr2	230781310	230782132	822	411.0	
16473	chr2	230793622	230795012	1390	695.0	
16474	chr2	230797511	230799246	1735	868.0	
16475	chr2	230814641	230814927	286	143.0	
16476	chr2	230823888	230825120	1232	616.0	
16477	chr2	230828168	230828812	644	322.0	
16478	chr2	230847670	230848385	715	358.0	
16479	chr2	230849861	230850503	642	321.0	
16480	chr2	230861481	230861923	442	221.0	
16481	chr2	230864301	230867695	3394	1697.0	
16482	chr2	230872935	230874394	1459	730.0	
16483	chr2	230877086	230878587	1501	750.0	
16484	chr2	230883819	230883848	29	14.0	
16485	chr2	230885866	230885980	114	57.0	
16486	chr2	230893466	230893521	55	28.0	
16487	chr2	230894134	230894838	704	352.0	
16488	chr2	230902078	230902604	526	263.0	
16489	chr2	230905337	230905893	556	278.0	
16490	chr2	230913379	230914250	871	436.0	
16491	chr2	230924144	230926699	2555	1278.0	
16492	chr2	230931452	230932953	1501	750.0	
16493	chr2	230943441	230944235	794	397.0	
16494	chr2	230948064	230948279	215	108.0	
16495	chr2	230956785	230957780	995	498.0	
16496	chr2	230973720	230975061	1341	670.0	
16497	chr2	230976819	230977004	185	92.0	
16498	chr2	230980505	230980813	308	154.0	
16499	chr2	230981597	230982124	527	264.0	
16500	chr2	230986846	230987879	1033	516.0	
16501	chr2	231037530	231038235	705	352.0	
16502	chr2	231050596	231051298	702	351.0	
16503	chr2	231052367	231053666	1299	650.0	
16504	chr2	231056164	231057628	1464	732.0	
16505	chr2	231063544	231063594	50	25.0	
16506	chr2	231104086	231104538	452	226.0	
16507	chr2	231179934	231180259	325	162.0	
16508	chr2	231181633	231182473	840	420.0	
16509	chr2	231197810	231199255	1445	722.0	
16510	chr2	231227231	231227937	706	353.0	
16511	chr2	231241822	231242402	580	290.0	
16512	chr2	231280943	231281285	342	171.0	
16513	chr2	231294680	231295021	341	170.0	
16514	chr2	231297010	231297430	420	210.0	
16515	chr2	231299186	231300179	993	496.0	
16516	chr2	231300681	231301090	409	204.0	
16517	chr2	231311196	231311297	101	50.0	
16518	chr2	231315839	231316392	553	276.0	
16519	chr2	231321368	231322502	1134	567.0	
16520	chr2	231323429	231323556	127	64.0	
16521	chr2	231342255	231342810	555	278.0	
16522	chr2	231361114	231361425	311	156.0	
16523	chr2	231361963	231363204	1241	620.0	
16524	chr2	231365033	231365381	348	174.0	
16525	chr2	231383543	231384174	631	316.0	
16526	chr2	231386680	231386866	186	93.0	
16527	chr2	231390563	231392479	1916	958.0	
16528	chr2	231393088	231396732	3644	1822.0	
16529	chr2	231405442	231406193	751	376.0	
16530	chr2	231411904	231412828	924	462.0	
16531	chr2	231425332	231427545	2213	1106.0	
16532	chr2	231450558	231455668	5110	2555.0	
16533	chr2	231456448	231457431	983	492.0	
16534	chr2	231460244	231460874	630	315.0	
16535	chr2	231461495	231465764	4269	2134.0	
16536	chr2	231469365	231469929	564	282.0	
16537	chr2	231482456	231484473	2017	1008.0	
16538	chr2	231513816	231515335	1519	760.0	
16539	chr2	231517241	231518129	888	444.0	
16540	chr2	231521417	231521854	437	218.0	
16541	chr2	231523548	231524717	1169	584.0	
16542	chr2	231528229	231528718	489	244.0	
16543	chr2	231529770	231531188	1418	709.0	
16544	chr2	231545012	231546467	1455	728.0	
16545	chr2	231554062	231555492	1430	715.0	
16546	chr2	231557446	231558349	903	452.0	
16547	chr2	231563342	231563804	462	231.0	
16548	chr2	231596965	231597706	741	370.0	
16549	chr2	231601386	231602271	885	442.0	
16550	chr2	231602814	231606930	4116	2058.0	
16551	chr2	231611508	231615419	3911	1956.0	
16552	chr2	231621725	231621956	231	116.0	
16553	chr2	231640732	231641211	479	240.0	
16554	chr2	231642528	231643490	962	481.0	
16555	chr2	231648490	231649041	551	276.0	
16556	chr2	231651496	231651968	472	236.0	
16557	chr2	231661541	231663126	1585	792.0	enhancer
16558	chr2	231665893	231667331	1438	719.0	"enhancer	enhancer"
16559	chr2	231670918	231673490	2572	1286.0	enhancer
16560	chr2	231674417	231675830	1413	706.0	
16561	chr2	231677371	231678287	916	458.0	
16562	chr2	231680777	231681552	775	388.0	
16563	chr2	231686974	231687833	859	430.0	
16564	chr2	231693141	231693425	284	142.0	
16565	chr2	231705344	231718873	13529	6764.0	
16566	chr2	231720873	231721601	728	364.0	
16567	chr2	231780064	231782679	2615	1308.0	
16568	chr2	231785907	231787114	1207	604.0	
16569	chr2	231800528	231800905	377	188.0	
16570	chr2	231852235	231852676	441	220.0	
16571	chr2	231900421	231900885	464	232.0	
16572	chr2	231906009	231906514	505	252.0	
16573	chr2	231924974	231927518	2544	1272.0	
16574	chr2	231961005	231962370	1365	682.0	
16575	chr2	232075115	232075367	252	126.0	
16576	chr2	232142308	232142374	66	33.0	
16577	chr2	232219543	232219806	263	132.0	
16578	chr2	232292541	232293087	546	273.0	
16579	chr2	232293592	232294026	434	217.0	
16580	chr2	232309590	232311057	1467	734.0	
16581	chr2	232314769	232317317	2548	1274.0	
16582	chr2	232318853	232320523	1670	835.0	
16583	chr2	232321198	232322230	1032	516.0	
16584	chr2	232325658	232327680	2022	1011.0	
16585	chr2	232335607	232335652	45	22.0	
16586	chr2	232363637	232364369	732	366.0	
16587	chr2	232365553	232365924	371	186.0	
16588	chr2	232418916	232419171	255	128.0	
16589	chr2	232439459	232439825	366	183.0	
16590	chr2	232440416	232440982	566	283.0	
16591	chr2	232444322	232444830	508	254.0	
16592	chr2	232502588	232503422	834	417.0	
16593	chr2	232521838	232523058	1220	610.0	
16594	chr2	232523867	232524572	705	352.0	
16595	chr2	232529000	232529362	362	181.0	
16596	chr2	232538508	232539257	749	374.0	
16597	chr2	232541321	232541657	336	168.0	
16598	chr2	232547475	232547484	9	4.0	
16599	chr2	232549772	232551863	2091	1046.0	
16600	chr2	232554353	232554841	488	244.0	
16601	chr2	232562722	232562915	193	96.0	
16602	chr2	232587575	232587651	76	38.0	
16603	chr2	232605518	232606845	1327	664.0	
16604	chr2	232611523	232612117	594	297.0	
16605	chr2	232633071	232634032	961	480.0	
16606	chr2	232693353	232693490	137	68.0	
16607	chr2	232695604	232698481	2877	1438.0	
16608	chr2	232721908	232722044	136	68.0	
16609	chr2	232761324	232761710	386	193.0	
16610	chr2	232816715	232817078	363	182.0	
16611	chr2	232838253	232839019	766	383.0	
16612	chr2	232839571	232840165	594	297.0	
16613	chr2	232853122	232853540	418	209.0	
16614	chr2	232874385	232874391	6	3.0	
16615	chr2	232876178	232876953	775	388.0	
16616	chr2	232902155	232902273	118	59.0	
16617	chr2	232928246	232928357	111	56.0	
16618	chr2	232955751	232956251	500	250.0	
16619	chr2	233028934	233029204	270	135.0	
16620	chr2	233042038	233042340	302	151.0	
16621	chr2	233049261	233049894	633	316.0	
16622	chr2	233051566	233051978	412	206.0	
16623	chr2	233053863	233054561	698	349.0	
16624	chr2	233059175	233065397	6222	3111.0	
16625	chr2	233068621	233069246	625	312.0	
16626	chr2	233070499	233071072	573	286.0	
16627	chr2	233075115	233077205	2090	1045.0	
16628	chr2	233079102	233085470	6368	3184.0	
16629	chr2	233086353	233088690	2337	1168.0	
16630	chr2	233092205	233093603	1398	699.0	
16631	chr2	233099931	233101402	1471	736.0	
16632	chr2	233107845	233108034	189	94.0	
16633	chr2	233108852	233109278	426	213.0	
16634	chr2	233114448	233115022	574	287.0	
16635	chr2	233116906	233117449	543	272.0	
16636	chr2	233124499	233125266	767	384.0	
16637	chr2	233164184	233166784	2600	1300.0	
16638	chr2	233179915	233180415	500	250.0	
16639	chr2	233185585	233186480	895	448.0	
16640	chr2	233190885	233191473	588	294.0	
16641	chr2	233199714	233200336	622	311.0	
16642	chr2	233202269	233203522	1253	626.0	
16643	chr2	233207344	233207364	20	10.0	
16644	chr2	233208316	233209958	1642	821.0	
16645	chr2	233210750	233211039	289	144.0	
16646	chr2	233217743	233218276	533	266.0	
16647	chr2	233223523	233223927	404	202.0	
16648	chr2	233230773	233231530	757	378.0	
16649	chr2	233233788	233234658	870	435.0	
16650	chr2	233240813	233243097	2284	1142.0	
16651	chr2	233244461	233245076	615	308.0	
16652	chr2	233247451	233248232	781	390.0	
16653	chr2	233248827	233249454	627	314.0	
16654	chr2	233250920	233252629	1709	854.0	
16655	chr2	233262145	233262685	540	270.0	
16656	chr2	233267479	233269010	1531	766.0	
16657	chr2	233270316	233270952	636	318.0	
16658	chr2	233321934	233322298	364	182.0	
16659	chr2	233331081	233332463	1382	691.0	
16660	chr2	233333542	233334284	742	371.0	
16661	chr2	233339012	233339836	824	412.0	
16662	chr2	233348877	233349655	778	389.0	
16663	chr2	233350672	233351802	1130	565.0	
16664	chr2	233353209	233359429	6220	3110.0	
16665	chr2	233366181	233366512	331	166.0	
16666	chr2	233367588	233368090	502	251.0	
16667	chr2	233369933	233370053	120	60.0	
16668	chr2	233380050	233381432	1382	691.0	
16669	chr2	233384016	233386812	2796	1398.0	
16670	chr2	233387879	233387929	50	25.0	
16671	chr2	233399307	233400649	1342	671.0	
16672	chr2	233404190	233404944	754	377.0	
16673	chr2	233408703	233410583	1880	940.0	
16674	chr2	233413552	233413950	398	199.0	
16675	chr2	233418231	233420105	1874	937.0	
16676	chr2	233421750	233422680	930	465.0	
16677	chr2	233434972	233435360	388	194.0	
16678	chr2	233443432	233444164	732	366.0	
16679	chr2	233565911	233567049	1138	569.0	
16680	chr2	233711438	233711778	340	170.0	
16681	chr2	233851940	233852478	538	269.0	
16682	chr2	233853599	233855510	1911	956.0	
16683	chr2	233857261	233858097	836	418.0	
16684	chr2	233867944	233868655	711	356.0	
16685	chr2	233872114	233872492	378	189.0	
16686	chr2	233976618	233977651	1033	516.0	
16687	chr2	233990176	233991546	1370	685.0	
16688	chr2	234001359	234001798	439	220.0	
16689	chr2	234025267	234027259	1992	996.0	
16690	chr2	234032088	234033307	1219	610.0	
16691	chr2	234061957	234062308	351	176.0	
16692	chr2	234071674	234072131	457	228.0	
16693	chr2	234077686	234078022	336	168.0	
16694	chr2	234100660	234101188	528	264.0	
16695	chr2	234102181	234102388	207	104.0	
16696	chr2	234135582	234136420	838	419.0	
16697	chr2	234137289	234137820	531	266.0	
16698	chr2	234147430	234148015	585	292.0	
16699	chr2	234164387	234165132	745	372.0	
16700	chr2	234244018	234244131	113	56.0	
16701	chr2	234272323	234272802	479	240.0	
16702	chr2	234274033	234274625	592	296.0	
16703	chr2	234278569	234279377	808	404.0	
16704	chr2	234288643	234293431	4788	2394.0	
16705	chr2	234293991	234294382	391	196.0	
16706	chr2	234295567	234296407	840	420.0	
16707	chr2	234308393	234309502	1109	554.0	
16708	chr2	234335501	234336385	884	442.0	
16709	chr2	234348125	234348586	461	230.0	
16710	chr2	234368695	234369173	478	239.0	
16711	chr2	234404939	234405781	842	421.0	
16712	chr2	234414573	234415059	486	243.0	
16713	chr2	234420285	234420860	575	288.0	
16714	chr2	234421508	234428205	6697	3348.0	
16715	chr2	234437234	234437453	219	110.0	
16716	chr2	234438312	234438865	553	276.0	
16717	chr2	234444202	234447827	3625	1812.0	
16718	chr2	234452088	234455006	2918	1459.0	
16719	chr2	234455835	234455991	156	78.0	
16720	chr2	234459513	234460134	621	310.0	
16721	chr2	234462281	234462449	168	84.0	
16722	chr2	234463613	234464992	1379	690.0	
16723	chr2	234475013	234475647	634	317.0	
16724	chr2	234482889	234484649	1760	880.0	
16725	chr2	234486136	234486360	224	112.0	
16726	chr2	234488194	234501054	12860	6430.0	
16727	chr2	234544847	234545422	575	288.0	
16728	chr2	234550447	234550951	504	252.0	
16729	chr2	234571702	234572561	859	430.0	
16730	chr2	234881640	234882080	440	220.0	
16731	chr2	234951580	234952978	1398	699.0	
16732	chr2	234989189	234989689	500	250.0	
16733	chr2	234993150	234993902	752	376.0	
16734	chr2	234999997	235000332	335	168.0	
16735	chr2	235043840	235045829	1989	994.0	
16736	chr2	235046657	235047042	385	192.0	
16737	chr2	235050881	235051833	952	476.0	
16738	chr2	235054619	235055371	752	376.0	
16739	chr2	235271071	235271272	201	100.0	
16740	chr2	235390386	235390924	538	269.0	
16741	chr2	235493567	235495122	1555	778.0	
16742	chr2	235595437	235595740	303	152.0	
16743	chr2	235605738	235605801	63	32.0	
16744	chr2	235614472	235614706	234	117.0	
16745	chr2	235639453	235640218	765	382.0	
16746	chr2	235666204	235666922	718	359.0	
16747	chr2	235669166	235671659	2493	1246.0	
16748	chr2	235684977	235685533	556	278.0	
16749	chr2	235710242	235711035	793	396.0	
16750	chr2	235746237	235746737	500	250.0	
16751	chr2	235766157	235766603	446	223.0	
16752	chr2	235951941	235952342	401	200.0	
16753	chr2	235955013	235955147	134	67.0	
16754	chr2	236343543	236343927	384	192.0	
16755	chr2	236353023	236353439	416	208.0	
16756	chr2	236366198	236366956	758	379.0	
16757	chr2	236500139	236500594	455	228.0	
16758	chr2	236507173	236507880	707	354.0	
16759	chr2	236512716	236513573	857	428.0	
16760	chr2	236536558	236539079	2521	1260.0	
16761	chr2	236545098	236547301	2203	1102.0	
16762	chr2	236548460	236548493	33	16.0	
16763	chr2	236550754	236553192	2438	1219.0	
16764	chr2	236555119	236555184	65	32.0	
16765	chr2	236567581	236570172	2591	1296.0	
16766	chr2	236607357	236607977	620	310.0	
16767	chr2	236705249	236705824	575	288.0	
16768	chr2	236711312	236711899	587	294.0	
16769	chr2	236714997	236715473	476	238.0	
16770	chr2	236748134	236749190	1056	528.0	
16771	chr2	236753606	236753941	335	168.0	
16772	chr2	236787726	236788499	773	386.0	
16773	chr2	236866318	236867199	881	440.0	
16774	chr2	236871150	236872445	1295	648.0	
16775	chr2	236919277	236919347	70	35.0	
16776	chr2	236928656	236929159	503	252.0	
16777	chr2	236967785	236968589	804	402.0	
16778	chr2	236970037	236970422	385	192.0	
16779	chr2	236971525	236971835	310	155.0	
16780	chr2	236975804	236976877	1073	536.0	
16781	chr2	236988568	236989047	479	240.0	
16782	chr2	237025128	237025461	333	166.0	
16783	chr2	237027395	237027806	411	206.0	
16784	chr2	237072283	237072774	491	246.0	
16785	chr2	237085072	237086589	1517	758.0	
16786	chr2	237122258	237122595	337	168.0	
16787	chr2	237154052	237154460	408	204.0	
16788	chr2	237258169	237258611	442	221.0	
16789	chr2	237262796	237263582	786	393.0	
16790	chr2	237291008	237291955	947	474.0	
16791	chr2	237421424	237422005	581	290.0	
16792	chr2	237428108	237428573	465	232.0	
16793	chr2	237429138	237429960	822	411.0	
16794	chr2	237432279	237435623	3344	1672.0	
16795	chr2	237441487	237442032	545	272.0	
16796	chr2	237469542	237469760	218	109.0	
16797	chr2	237471460	237471873	413	206.0	
16798	chr2	237473984	237476228	2244	1122.0	
16799	chr2	237512671	237513223	552	276.0	
16800	chr2	237529507	237529975	468	234.0	
16801	chr2	237531128	237531365	237	118.0	
16802	chr2	237571705	237572458	753	376.0	
16803	chr2	237581592	237582182	590	295.0	
16804	chr2	237591167	237592032	865	432.0	
16805	chr2	237603338	237604363	1025	512.0	
16806	chr2	237614017	237614430	413	206.0	enhancer
16807	chr2	237617062	237617383	321	160.0	enhancer
16808	chr2	237624391	237625976	1585	792.0	
16809	chr2	237626828	237628332	1504	752.0	
16810	chr2	237636610	237636996	386	193.0	
16811	chr2	237653013	237653022	9	4.0	
16812	chr2	237662436	237663312	876	438.0	
16813	chr2	237669603	237669848	245	122.0	
16814	chr2	237671530	237672157	627	314.0	
16815	chr2	237672760	237675751	2991	1496.0	
16816	chr2	237676424	237678768	2344	1172.0	
16817	chr2	237685358	237685689	331	166.0	
16818	chr2	237686492	237698792	12300	6150.0	
16819	chr2	237699946	237709028	9082	4541.0	
16820	chr2	237709624	237709644	20	10.0	
16821	chr2	237712438	237713406	968	484.0	
16822	chr2	237715159	237716056	897	448.0	
16823	chr2	237717401	237717665	264	132.0	
16824	chr2	237722733	237722795	62	31.0	
16825	chr2	237723586	237724026	440	220.0	
16826	chr2	237725302	237726586	1284	642.0	
16827	chr2	237727215	237727922	707	354.0	
16828	chr2	237730628	237732043	1415	708.0	
16829	chr2	237732806	237733887	1081	540.0	
16830	chr2	237737085	237737135	50	25.0	
16831	chr2	237740692	237741192	500	250.0	
16832	chr2	237742121	237745452	3331	1666.0	
16833	chr2	237746862	237747075	213	106.0	
16834	chr2	237752717	237753203	486	243.0	
16835	chr2	237774627	237775143	516	258.0	
16836	chr2	237858277	237858940	663	332.0	
16837	chr2	237859481	237860166	685	342.0	
16838	chr2	237898211	237899377	1166	583.0	enhancer
16839	chr2	237901021	237901669	648	324.0	
16840	chr2	237902441	237902999	558	279.0	
16841	chr2	237904868	237906429	1561	780.0	
16842	chr2	237919515	237919972	457	228.0	
16843	chr2	237922824	237924111	1287	644.0	
16844	chr2	237931282	237931691	409	204.0	
16845	chr2	237941811	237942577	766	383.0	
16846	chr2	237955896	237956660	764	382.0	
16847	chr2	237966156	237969322	3166	1583.0	
16848	chr2	237980822	237981178	356	178.0	
16849	chr2	237998384	237999071	687	344.0	
16850	chr2	238003833	238003910	77	38.0	
16851	chr2	238025113	238025341	228	114.0	
16852	chr2	238027657	238028028	371	186.0	
16853	chr2	238060023	238061975	1952	976.0	
16854	chr2	238069057	238069647	590	295.0	
16855	chr2	238087131	238087658	527	264.0	
16856	chr2	238098344	238099555	1211	606.0	
16857	chr2	238100178	238100579	401	200.0	
16858	chr2	238107181	238107967	786	393.0	
16859	chr2	238108901	238109310	409	204.0	
16860	chr2	238127241	238127566	325	162.0	
16861	chr2	238136948	238137745	797	398.0	
16862	chr2	238139537	238139955	418	209.0	
16863	chr2	238141495	238142317	822	411.0	
16864	chr2	238158586	238159579	993	496.0	
16865	chr2	238160311	238161262	951	476.0	
16866	chr2	238162857	238163229	372	186.0	
16867	chr2	238170053	238170057	4	2.0	
16868	chr2	238183737	238184102	365	182.0	
16869	chr2	238185229	238185971	742	371.0	
16870	chr2	238202308	238204621	2313	1156.0	
16871	chr2	238220712	238221525	813	406.0	
16872	chr2	238231047	238232145	1098	549.0	
16873	chr2	238234022	238235899	1877	938.0	
16874	chr2	238238549	238241755	3206	1603.0	
16875	chr2	238256417	238257091	674	337.0	
16876	chr2	238263352	238264360	1008	504.0	
16877	chr2	238273289	238273810	521	260.0	
16878	chr2	238283780	238284169	389	194.0	
16879	chr2	238285785	238290919	5134	2567.0	
16880	chr2	238305261	238305268	7	4.0	
16881	chr2	238319788	238321362	1574	787.0	
16882	chr2	238357407	238357626	219	110.0	
16883	chr2	238370660	238371237	577	288.0	
16884	chr2	238376797	238377528	731	366.0	
16885	chr2	238379314	238379865	551	276.0	
16886	chr2	238381526	238383031	1505	752.0	
16887	chr2	238387305	238387856	551	276.0	
16888	chr2	238405755	238406393	638	319.0	
16889	chr2	238415253	238415256	3	2.0	
16890	chr2	238425889	238428158	2269	1134.0	
16891	chr2	238449816	238450225	409	204.0	
16892	chr2	238462763	238463245	482	241.0	
16893	chr2	238555025	238555120	95	48.0	
16894	chr2	238569520	238569921	401	200.0	
16895	chr2	238720158	238720527	369	184.0	
16896	chr2	238731751	238732542	791	396.0	
16897	chr2	238784990	238785370	380	190.0	
16898	chr2	238847792	238848207	415	208.0	
16899	chr2	238857986	238858377	391	196.0	
16900	chr2	238948089	238948262	173	86.0	
16901	chr2	238970455	238970896	441	220.0	
16902	chr2	239035189	239035725	536	268.0	
16903	chr2	239098076	239098885	809	404.0	
16904	chr2	239114878	239115043	165	82.0	
16905	chr2	239118441	239119869	1428	714.0	
16906	chr2	239137880	239138240	360	180.0	
16907	chr2	239143841	239144323	482	241.0	
16908	chr2	239150401	239151179	778	389.0	
16909	chr2	239210484	239210799	315	158.0	
16910	chr2	239216535	239217132	597	298.0	
16911	chr2	239220288	239220625	337	168.0	
16912	chr2	239221401	239223930	2529	1264.0	
16913	chr2	239225211	239225955	744	372.0	
16914	chr2	239230292	239231802	1510	755.0	
16915	chr2	239234315	239234806	491	246.0	
16916	chr2	239236777	239237166	389	194.0	
16917	chr2	239237767	239238057	290	145.0	
16918	chr2	239239689	239241917	2228	1114.0	
16919	chr2	239249738	239250839	1101	550.0	
16920	chr2	239252382	239254164	1782	891.0	
16921	chr2	239255247	239255650	403	202.0	
16922	chr2	239257452	239260399	2947	1474.0	
16923	chr2	239264234	239268925	4691	2346.0	
16924	chr2	239273249	239277105	3856	1928.0	
16925	chr2	239277751	239278152	401	200.0	
16926	chr2	239280234	239280661	427	214.0	
16927	chr2	239285032	239286021	989	494.0	
16928	chr2	239288758	239290031	1273	636.0	
16929	chr2	239293926	239294466	540	270.0	
16930	chr2	239295458	239296192	734	367.0	
16931	chr2	239297262	239299160	1898	949.0	
16932	chr2	239302844	239303677	833	416.0	
16933	chr2	239304185	239304646	461	230.0	
16934	chr2	239308682	239309716	1034	517.0	
16935	chr2	239311721	239312598	877	438.0	
16936	chr2	239319009	239319693	684	342.0	
16937	chr2	239321419	239323166	1747	874.0	
16938	chr2	239326749	239327558	809	404.0	
16939	chr2	239339662	239340492	830	415.0	
16940	chr2	239363780	239364602	822	411.0	
16941	chr2	239369429	239370606	1177	588.0	
16942	chr2	239378813	239379475	662	331.0	
16943	chr2	239380539	239382163	1624	812.0	
16944	chr2	239396947	239397747	800	400.0	
16945	chr2	239398903	239402419	3516	1758.0	
16946	chr2	239436580	239437554	974	487.0	
16947	chr2	239438923	239439285	362	181.0	
16948	chr2	239441016	239441770	754	377.0	
16949	chr2	239464709	239466367	1658	829.0	
16950	chr2	239496869	239496966	97	48.0	
16951	chr2	239500284	239501973	1689	844.0	
16952	chr2	239502847	239503207	360	180.0	
16953	chr2	239544876	239545607	731	366.0	
16954	chr2	239548538	239548859	321	160.0	
16955	chr2	239602067	239602856	789	394.0	
16956	chr2	239605882	239607160	1278	639.0	
16957	chr2	239609662	239610142	480	240.0	
16958	chr2	239622918	239623683	765	382.0	
16959	chr2	239625377	239626616	1239	620.0	
16960	chr2	239630256	239630898	642	321.0	
16961	chr2	239644032	239644468	436	218.0	
16962	chr2	239647183	239647584	401	200.0	
16963	chr2	239656112	239656557	445	222.0	
16964	chr2	239659324	239659888	564	282.0	
16965	chr2	239747278	239747731	453	226.0	
16966	chr2	239751662	239752027	365	182.0	
16967	chr2	239756800	239757271	471	236.0	
16968	chr2	239882204	239882685	481	240.0	
16969	chr2	239891748	239892060	312	156.0	
16970	chr2	239895625	239896168	543	272.0	
16971	chr2	239910807	239912295	1488	744.0	
16972	chr2	239927235	239928747	1512	756.0	
16973	chr2	239934405	239935066	661	330.0	
16974	chr2	239936889	239937692	803	402.0	
16975	chr2	239938306	239938567	261	130.0	
16976	chr2	239944920	239945704	784	392.0	
16977	chr2	239978247	239978947	700	350.0	
16978	chr2	239991672	239992124	452	226.0	
16979	chr2	240021285	240021967	682	341.0	
16980	chr2	240024608	240026309	1701	850.0	
16981	chr2	240060959	240061403	444	222.0	
16982	chr2	240135665	240137213	1548	774.0	
16983	chr2	240143533	240144374	841	420.0	
16984	chr2	240150196	240150577	381	190.0	
16985	chr2	240232830	240234341	1511	756.0	
16986	chr2	240251082	240251408	326	163.0	
16987	chr2	240434472	240436987	2515	1258.0	
16988	chr2	240437871	240438701	830	415.0	
16989	chr2	240452379	240453332	953	476.0	
16990	chr2	240454354	240454361	7	4.0	
16991	chr2	240473923	240474326	403	202.0	
16992	chr2	240513591	240514623	1032	516.0	
16993	chr2	240556615	240558649	2034	1017.0	
16994	chr2	240559445	240562396	2951	1476.0	enhancer
16995	chr2	240564189	240569917	5728	2864.0	
16996	chr2	240579026	240580605	1579	790.0	
16997	chr2	240584399	240587905	3506	1753.0	
16998	chr2	240595590	240596078	488	244.0	
16999	chr2	240604248	240604728	480	240.0	
17000	chr2	240611649	240612821	1172	586.0	
17001	chr2	240619501	240619853	352	176.0	
17002	chr2	240620752	240625801	5049	2524.0	
17003	chr2	240626534	240627434	900	450.0	
17004	chr2	240634764	240635151	387	194.0	
17005	chr2	240635816	240636268	452	226.0	
17006	chr2	240640983	240641305	322	161.0	
17007	chr2	240644752	240645130	378	189.0	
17008	chr2	240645969	240646850	881	440.0	
17009	chr2	240656140	240656701	561	280.0	
17010	chr2	240674870	240674967	97	48.0	
17011	chr2	240704643	240704859	216	108.0	
17012	chr2	240705410	240705622	212	106.0	
17013	chr2	240733735	240734212	477	238.0	
17014	chr2	240739716	240740371	655	328.0	
17015	chr2	240819963	240821399	1436	718.0	
17016	chr2	240831678	240833259	1581	790.0	
17017	chr2	240840468	240840864	396	198.0	
17018	chr2	240851089	240851786	697	348.0	
17019	chr2	240914297	240914772	475	238.0	
17020	chr2	240960456	240961423	967	484.0	
17021	chr2	240965353	240966282	929	464.0	
17022	chr2	240983296	240983917	621	310.0	
17023	chr2	240997195	240999379	2184	1092.0	
17024	chr2	241009463	241010526	1063	532.0	
17025	chr2	241012019	241012226	207	104.0	
17026	chr2	241035279	241037436	2157	1078.0	
17027	chr2	241041448	241042256	808	404.0	
17028	chr2	241063515	241064535	1020	510.0	
17029	chr2	241078327	241078868	541	270.0	
17030	chr2	241095541	241096200	659	330.0	
17031	chr2	241101248	241104401	3153	1576.0	
17032	chr2	241108450	241109838	1388	694.0	
17033	chr2	241110454	241111823	1369	684.0	
17034	chr2	241112505	241113086	581	290.0	
17035	chr2	241124084	241124217	133	66.0	
17036	chr2	241127573	241128080	507	254.0	
17037	chr2	241148379	241151151	2772	1386.0	
17038	chr2	241157100	241157216	116	58.0	
17039	chr2	241211448	241211590	142	71.0	
17040	chr2	241216398	241216567	169	84.0	
17041	chr2	241217140	241219092	1952	976.0	
17042	chr2	241242427	241242438	11	6.0	
17043	chr2	241271524	241273998	2474	1237.0	
17044	chr2	241298592	241299310	718	359.0	
17045	chr2	241299955	241300478	523	262.0	
17046	chr2	241305121	241305897	776	388.0	
17047	chr2	241309480	241310245	765	382.0	
17048	chr2	241314076	241317808	3732	1866.0	
17049	chr2	241324544	241325117	573	286.0	
17050	chr2	241336180	241336724	544	272.0	
17051	chr2	241354517	241357222	2705	1352.0	
17052	chr2	241358245	241358954	709	354.0	
17053	chr2	241374565	241375012	447	224.0	
17054	chr2	241392134	241392418	284	142.0	
17055	chr2	241443366	241444481	1115	558.0	
17056	chr2	241507479	241509700	2221	1110.0	
17057	chr2	241515564	241515726	162	81.0	
17058	chr2	241540804	241541628	824	412.0	
17059	chr2	241558840	241559585	745	372.0	
17060	chr2	241571256	241571426	170	85.0	
17061	chr2	241608905	241611020	2115	1058.0	
17062	chr2	241617246	241618301	1055	528.0	
17063	chr2	241620495	241620735	240	120.0	
17064	chr2	241636163	241638586	2423	1212.0	
17065	chr2	241659282	241659668	386	193.0	
17066	chr2	241665369	241665826	457	228.0	
17067	chr2	241670766	241670898	132	66.0	
17068	chr2	241673126	241673234	108	54.0	
17069	chr2	241686139	241688167	2028	1014.0	
17070	chr2	241700899	241703428	2529	1264.0	
17071	chr2	241724477	241724896	419	210.0	
17072	chr2	241732326	241733010	684	342.0	
17073	chr2	241733737	241735955	2218	1109.0	
17074	chr2	241739923	241741520	1597	798.0	
17075	chr2	241759046	241759683	637	318.0	
17076	chr2	241760857	241760949	92	46.0	
17077	chr2	241762205	241764551	2346	1173.0	
17078	chr2	241771991	241772635	644	322.0	
17079	chr2	241788549	241788991	442	221.0	
17080	chr2	241803254	241805201	1947	974.0	
17081	chr2	241813519	241814224	705	352.0	
17082	chr2	241842400	241844851	2451	1226.0	
17083	chr2	241853691	241854138	447	224.0	
17084	chr2	241857433	241861188	3755	1878.0	
17085	chr2	241863081	241869695	6614	3307.0	
17086	chr2	241870631	241872164	1533	766.0	
17087	chr2	241875663	241876177	514	257.0	
17088	chr2	241876825	241877374	549	274.0	
17089	chr2	241877917	241878621	704	352.0	
17090	chr2	241880770	241882839	2069	1034.0	
17091	chr2	241896539	241896938	399	200.0	
17092	chr2	241925334	241926170	836	418.0	
17093	chr2	241950744	241951216	472	236.0	
17094	chr2	241963363	241963925	562	281.0	
17095	chr2	241965759	241966630	871	436.0	
17096	chr2	241970928	241970931	3	2.0	
17097	chr2	241984913	241985650	737	368.0	
17098	chr2	241989194	241989467	273	136.0	
17099	chr2	242002997	242003342	345	172.0	
17100	chr2	242011126	242011605	479	240.0	
17101	chr2	242031408	242032244	836	418.0	
17102	chr2	242085376	242086759	1383	692.0	
17103	chr2	242087927	242089433	1506	753.0	
17104	chr2	242098241	242098965	724	362.0	
17105	chr2	242181999	242182258	259	130.0	
17106	chr3	278167	278761	594	297.0	
17107	chr3	1381413	1381471	58	29.0	
17108	chr3	2856260	2856547	287	144.0	
17109	chr3	3028021	3028602	581	290.0	
17110	chr3	3088989	3089376	387	194.0	
17111	chr3	3109712	3111182	1470	735.0	
17112	chr3	3119514	3119586	72	36.0	
17113	chr3	3126076	3128948	2872	1436.0	
17114	chr3	3133334	3133708	374	187.0	
17115	chr3	3135467	3136256	789	394.0	
17116	chr3	3150308	3150773	465	232.0	
17117	chr3	3170776	3171419	643	322.0	
17118	chr3	3172226	3174109	1883	942.0	
17119	chr3	3177884	3180306	2422	1211.0	
17120	chr3	3191746	3192783	1037	518.0	
17121	chr3	3200599	3201053	454	227.0	
17122	chr3	3201589	3202052	463	232.0	
17123	chr3	3297105	3297275	170	85.0	
17124	chr3	3578675	3579126	451	226.0	
17125	chr3	3632488	3632788	300	150.0	
17126	chr3	3646450	3646751	301	150.0	
17127	chr3	3666281	3666336	55	28.0	
17128	chr3	3798404	3801070	2666	1333.0	
17129	chr3	3817831	3818351	520	260.0	
17130	chr3	3998212	3998468	256	128.0	
17131	chr3	4061854	4062233	379	190.0	
17132	chr3	4064981	4065547	566	283.0	
17133	chr3	4071579	4071642	63	32.0	
17134	chr3	4270668	4271139	471	236.0	
17135	chr3	4290258	4290731	473	236.0	
17136	chr3	4302720	4304375	1655	828.0	
17137	chr3	4309534	4310033	499	250.0	
17138	chr3	4322572	4322973	401	200.0	
17139	chr3	4340576	4340761	185	92.0	
17140	chr3	4350718	4352008	1290	645.0	
17141	chr3	4394077	4394499	422	211.0	
17142	chr3	4421109	4421625	516	258.0	
17143	chr3	4451410	4451929	519	260.0	
17144	chr3	4462443	4462738	295	148.0	
17145	chr3	4466436	4467792	1356	678.0	
17146	chr3	4473956	4476213	2257	1128.0	
17147	chr3	4478060	4478745	685	342.0	
17148	chr3	4491817	4496350	4533	2266.0	
17149	chr3	4502997	4505441	2444	1222.0	
17150	chr3	4507122	4508113	991	496.0	
17151	chr3	4517592	4520776	3184	1592.0	
17152	chr3	4525552	4526221	669	334.0	
17153	chr3	4529192	4530332	1140	570.0	
17154	chr3	4533671	4534147	476	238.0	
17155	chr3	4547769	4548182	413	206.0	
17156	chr3	4571689	4572181	492	246.0	
17157	chr3	4582174	4582178	4	2.0	
17158	chr3	4584288	4585135	847	424.0	
17159	chr3	4601884	4602319	435	218.0	
17160	chr3	4628405	4628698	293	146.0	
17161	chr3	4633147	4633844	697	348.0	
17162	chr3	4711082	4712587	1505	752.0	
17163	chr3	4720641	4721073	432	216.0	
17164	chr3	4722080	4722446	366	183.0	
17165	chr3	4724128	4724375	247	124.0	
17166	chr3	4738656	4742096	3440	1720.0	
17167	chr3	4748452	4749385	933	466.0	
17168	chr3	4750389	4752665	2276	1138.0	
17169	chr3	4754340	4754632	292	146.0	
17170	chr3	4759406	4759757	351	176.0	
17171	chr3	4814279	4814949	670	335.0	
17172	chr3	4820587	4822748	2161	1080.0	
17173	chr3	4824856	4826308	1452	726.0	
17174	chr3	4827782	4828844	1062	531.0	
17175	chr3	4830459	4832161	1702	851.0	
17176	chr3	4833739	4835160	1421	710.0	
17177	chr3	4845657	4846419	762	381.0	
17178	chr3	4850077	4851676	1599	800.0	
17179	chr3	4864616	4864798	182	91.0	
17180	chr3	4866751	4870151	3400	1700.0	
17181	chr3	4888938	4889860	922	461.0	
17182	chr3	4898654	4898914	260	130.0	
17183	chr3	4907933	4908032	99	50.0	
17184	chr3	4950274	4950880	606	303.0	
17185	chr3	4965944	4966471	527	264.0	
17186	chr3	4973283	4973550	267	134.0	
17187	chr3	4976013	4987633	11620	5810.0	
17188	chr3	4988240	4988257	17	8.0	
17189	chr3	4989990	4990670	680	340.0	
17190	chr3	5002121	5003119	998	499.0	
17191	chr3	5006502	5007534	1032	516.0	
17192	chr3	5010714	5013974	3260	1630.0	
17193	chr3	5016212	5017157	945	472.0	
17194	chr3	5017897	5018418	521	260.0	
17195	chr3	5019344	5020533	1189	594.0	
17196	chr3	5026003	5027400	1397	698.0	
17197	chr3	5032028	5032235	207	104.0	
17198	chr3	5037752	5038562	810	405.0	
17199	chr3	5053562	5054501	939	470.0	
17200	chr3	5055263	5056122	859	430.0	
17201	chr3	5057366	5058283	917	458.0	
17202	chr3	5121745	5124104	2359	1180.0	
17203	chr3	5124881	5125116	235	118.0	
17204	chr3	5126572	5126973	401	200.0	
17205	chr3	5136389	5137491	1102	551.0	
17206	chr3	5139418	5140669	1251	626.0	
17207	chr3	5144276	5144854	578	289.0	
17208	chr3	5169318	5169537	219	110.0	
17209	chr3	5181672	5182258	586	293.0	
17210	chr3	5183597	5183998	401	200.0	
17211	chr3	5185326	5189935	4609	2304.0	
17212	chr3	5190526	5190610	84	42.0	
17213	chr3	5191833	5193269	1436	718.0	
17214	chr3	5194506	5198400	3894	1947.0	
17215	chr3	5199109	5200178	1069	534.0	
17216	chr3	5205406	5205874	468	234.0	
17217	chr3	5305355	5305749	394	197.0	
17218	chr3	5376795	5377050	255	128.0	
17219	chr3	5423071	5423921	850	425.0	
17220	chr3	5426264	5426823	559	280.0	
17221	chr3	5431758	5432204	446	223.0	
17222	chr3	5463916	5464506	590	295.0	
17223	chr3	5465209	5465547	338	169.0	
17224	chr3	5466075	5466476	401	200.0	
17225	chr3	5494894	5495216	322	161.0	
17226	chr3	5579290	5580299	1009	504.0	
17227	chr3	5644954	5645485	531	266.0	
17228	chr3	5656907	5657842	935	468.0	
17229	chr3	5731122	5731315	193	96.0	
17230	chr3	5974803	5975035	232	116.0	
17231	chr3	6250145	6250536	391	196.0	
17232	chr3	7607652	7608092	440	220.0	
17233	chr3	7615126	7615199	73	36.0	
17234	chr3	7682724	7683348	624	312.0	
17235	chr3	7692904	7693143	239	120.0	
17236	chr3	7759385	7760073	688	344.0	
17237	chr3	7876654	7877396	742	371.0	
17238	chr3	8094567	8094747	180	90.0	
17239	chr3	8111129	8111631	502	251.0	
17240	chr3	8301987	8302345	358	179.0	
17241	chr3	8324709	8325198	489	244.0	
17242	chr3	8329009	8329392	383	192.0	
17243	chr3	8356749	8357995	1246	623.0	
17244	chr3	8417121	8417843	722	361.0	
17245	chr3	8488919	8489229	310	155.0	
17246	chr3	8501121	8502131	1010	505.0	
17247	chr3	8530125	8530450	325	162.0	
17248	chr3	8622890	8623308	418	209.0	
17249	chr3	8629333	8629898	565	282.0	
17250	chr3	8658225	8658886	661	330.0	
17251	chr3	8712511	8712735	224	112.0	
17252	chr3	8769316	8769735	419	210.0	
17253	chr3	8864462	8865045	583	292.0	
17254	chr3	8954989	8955273	284	142.0	
17255	chr3	8959416	8960160	744	372.0	
17256	chr3	8962348	8964125	1777	888.0	
17257	chr3	8970747	8971622	875	438.0	
17258	chr3	8972559	8972941	382	191.0	
17259	chr3	8982577	8982580	3	2.0	
17260	chr3	8987620	8988372	752	376.0	
17261	chr3	9087811	9088338	527	264.0	
17262	chr3	9168388	9168390	2	1.0	
17263	chr3	9180138	9180598	460	230.0	
17264	chr3	9248247	9250298	2051	1026.0	
17265	chr3	9302267	9303029	762	381.0	
17266	chr3	9352899	9354968	2069	1034.0	
17267	chr3	9362406	9363830	1424	712.0	
17268	chr3	9384141	9385072	931	466.0	
17269	chr3	9386172	9386454	282	141.0	
17270	chr3	9390452	9391511	1059	530.0	
17271	chr3	9393497	9394005	508	254.0	
17272	chr3	9394600	9400194	5594	2797.0	
17273	chr3	9404657	9405111	454	227.0	
17274	chr3	9410127	9410921	794	397.0	
17275	chr3	9422688	9423539	851	426.0	
17276	chr3	9452371	9452909	538	269.0	
17277	chr3	9500468	9500981	513	256.0	
17278	chr3	9503153	9503640	487	244.0	
17279	chr3	9642463	9643091	628	314.0	
17280	chr3	9648722	9650844	2122	1061.0	
17281	chr3	9653811	9654282	471	236.0	
17282	chr3	9691088	9691499	411	206.0	
17283	chr3	9703058	9705271	2213	1106.0	
17284	chr3	9715165	9717261	2096	1048.0	
17285	chr3	9726855	9727888	1033	516.0	
17286	chr3	9730462	9733137	2675	1338.0	
17287	chr3	9734851	9735331	480	240.0	
17288	chr3	9749169	9751225	2056	1028.0	
17289	chr3	9752378	9752618	240	120.0	
17290	chr3	9754718	9755022	304	152.0	
17291	chr3	9767300	9767894	594	297.0	
17292	chr3	9769346	9770539	1193	596.0	
17293	chr3	9778984	9780821	1837	918.0	
17294	chr3	9786995	9787196	201	100.0	
17295	chr3	9791858	9793963	2105	1052.0	
17296	chr3	9795122	9795913	791	396.0	
17297	chr3	9808118	9811098	2980	1490.0	
17298	chr3	9827227	9827639	412	206.0	
17299	chr3	9838162	9838598	436	218.0	
17300	chr3	9843080	9845120	2040	1020.0	
17301	chr3	9848737	9849212	475	238.0	
17302	chr3	9861830	9863264	1434	717.0	
17303	chr3	9864401	9864857	456	228.0	
17304	chr3	9889887	9891613	1726	863.0	
17305	chr3	9901819	9903008	1189	594.0	
17306	chr3	9912275	9912829	554	277.0	
17307	chr3	9914859	9917511	2652	1326.0	
17308	chr3	9932176	9935450	3274	1637.0	
17309	chr3	9936151	9936404	253	126.0	
17310	chr3	9945337	9947149	1812	906.0	
17311	chr3	9951215	9952792	1577	788.0	
17312	chr3	9976882	9977509	627	314.0	
17313	chr3	9978292	9978411	119	60.0	
17314	chr3	9979694	9980336	642	321.0	
17315	chr3	9982826	9983441	615	308.0	
17316	chr3	9986088	9987876	1788	894.0	
17317	chr3	10008529	10009769	1240	620.0	
17318	chr3	10010403	10011885	1482	741.0	
17319	chr3	10015084	10016068	984	492.0	
17320	chr3	10018003	10018136	133	66.0	
17321	chr3	10023530	10024151	621	310.0	
17322	chr3	10025627	10027219	1592	796.0	
17323	chr3	10114951	10116634	1683	842.0	
17324	chr3	10141173	10143659	2486	1243.0	"mobile_genetic_element	recombination_feature	mobile_genetic_element	recombination_feature	mobile_genetic_element	recombination_feature"
17325	chr3	10145647	10146166	519	260.0	mobile_genetic_element
17326	chr3	10149193	10149745	552	276.0	"mobile_genetic_element	recombination_feature	mobile_genetic_element	recombination_feature"
17327	chr3	10162231	10162588	357	178.0	"recombination_feature	recombination_feature"
17328	chr3	10164233	10166024	1791	896.0	"recombination_feature	recombination_feature	recombination_feature	sequence_feature	mobile_genetic_element	recombination_feature	sequence_feature"
17329	chr3	10167207	10167694	487	244.0	"recombination_feature	recombination_feature	mobile_genetic_element	recombination_feature"
17330	chr3	10171155	10171264	109	54.0	
17331	chr3	10173356	10174593	1237	618.0	
17332	chr3	10181524	10181906	382	191.0	
17333	chr3	10185791	10186811	1020	510.0	
17334	chr3	10187349	10187461	112	56.0	
17335	chr3	10188968	10190353	1385	692.0	
17336	chr3	10191745	10197092	5347	2674.0	
17337	chr3	10198346	10200027	1681	840.0	"recombination_feature	sequence_feature	recombination_feature	mobile_genetic_element	recombination_feature"
17338	chr3	10205441	10205796	355	178.0	
17339	chr3	10211780	10212727	947	474.0	
17340	chr3	10220577	10221176	599	300.0	
17341	chr3	10223587	10225715	2128	1064.0	
17342	chr3	10228484	10229101	617	308.0	
17343	chr3	10231893	10232685	792	396.0	
17344	chr3	10238122	10238866	744	372.0	
17345	chr3	10241665	10243074	1409	704.0	
17346	chr3	10244145	10244261	116	58.0	
17347	chr3	10247729	10250186	2457	1228.0	
17348	chr3	10255021	10255144	123	62.0	recombination_feature
17349	chr3	10263460	10264519	1059	530.0	"recombination_feature	recombination_feature"
17350	chr3	10284409	10285046	637	318.0	
17351	chr3	10286648	10287374	726	363.0	
17352	chr3	10292457	10293526	1069	534.0	
17353	chr3	10294074	10294584	510	255.0	
17354	chr3	10299795	10299844	49	24.0	
17355	chr3	10319737	10322733	2996	1498.0	
17356	chr3	10344113	10344713	600	300.0	
17357	chr3	10370424	10370836	412	206.0	
17358	chr3	10388455	10388570	115	58.0	
17359	chr3	10389929	10390626	697	348.0	
17360	chr3	10395674	10396075	401	200.0	
17361	chr3	10419992	10420254	262	131.0	
17362	chr3	10437163	10438079	916	458.0	
17363	chr3	10460077	10460605	528	264.0	
17364	chr3	10551839	10552973	1134	567.0	
17365	chr3	10594886	10595358	472	236.0	
17366	chr3	10603355	10604054	699	350.0	
17367	chr3	10738596	10739277	681	340.0	
17368	chr3	10758589	10758917	328	164.0	
17369	chr3	10846265	10846857	592	296.0	
17370	chr3	10945623	10946061	438	219.0	
17371	chr3	11059472	11059941	469	234.0	
17372	chr3	11060675	11061162	487	244.0	
17373	chr3	11072679	11073006	327	164.0	
17374	chr3	11077357	11078068	711	356.0	
17375	chr3	11078797	11079650	853	426.0	
17376	chr3	11085171	11085427	256	128.0	
17377	chr3	11096535	11096938	403	202.0	
17378	chr3	11140144	11140848	704	352.0	
17379	chr3	11154586	11154784	198	99.0	
17380	chr3	11155472	11155668	196	98.0	
17381	chr3	11159270	11160110	840	420.0	
17382	chr3	11217302	11217771	469	234.0	
17383	chr3	11223464	11223894	430	215.0	
17384	chr3	11225075	11226221	1146	573.0	
17385	chr3	11227497	11227995	498	249.0	
17386	chr3	11236581	11237015	434	217.0	
17387	chr3	11271694	11274998	3304	1652.0	
17388	chr3	11275861	11276295	434	217.0	
17389	chr3	11278860	11279245	385	192.0	
17390	chr3	11282480	11283528	1048	524.0	
17391	chr3	11287985	11289899	1914	957.0	
17392	chr3	11290810	11292230	1420	710.0	
17393	chr3	11300863	11301420	557	278.0	
17394	chr3	11306797	11307337	540	270.0	
17395	chr3	11334921	11335443	522	261.0	
17396	chr3	11367139	11367426	287	144.0	
17397	chr3	11379223	11379565	342	171.0	
17398	chr3	11455861	11456384	523	262.0	
17399	chr3	11537379	11537679	300	150.0	
17400	chr3	11544246	11544752	506	253.0	
17401	chr3	11570662	11571466	804	402.0	
17402	chr3	11582445	11582983	538	269.0	
17403	chr3	11591336	11591597	261	130.0	
17404	chr3	11601737	11602178	441	220.0	
17405	chr3	11624035	11625066	1031	516.0	
17406	chr3	11634017	11634629	612	306.0	
17407	chr3	11641455	11644336	2881	1440.0	
17408	chr3	11651964	11652311	347	174.0	
17409	chr3	11718336	11721038	2702	1351.0	
17410	chr3	11724737	11725162	425	212.0	
17411	chr3	11769994	11771267	1273	636.0	
17412	chr3	11784340	11785565	1225	612.0	
17413	chr3	11803927	11804417	490	245.0	
17414	chr3	11845715	11848003	2288	1144.0	
17415	chr3	12004019	12004603	584	292.0	
17416	chr3	12134972	12135489	517	258.0	
17417	chr3	12139465	12139496	31	16.0	
17418	chr3	12148104	12148624	520	260.0	
17419	chr3	12158263	12159034	771	386.0	
17420	chr3	12170042	12170784	742	371.0	
17421	chr3	12175825	12176271	446	223.0	
17422	chr3	12178016	12178502	486	243.0	
17423	chr3	12186886	12188595	1709	854.0	
17424	chr3	12193295	12194660	1365	682.0	
17425	chr3	12226261	12226320	59	30.0	
17426	chr3	12229602	12229610	8	4.0	
17427	chr3	12232970	12233322	352	176.0	
17428	chr3	12253925	12254290	365	182.0	
17429	chr3	12276915	12277012	97	48.0	
17430	chr3	12287528	12289079	1551	776.0	
17431	chr3	12303509	12304446	937	468.0	
17432	chr3	12323252	12323637	385	192.0	
17433	chr3	12325900	12326354	454	227.0	
17434	chr3	12328602	12328910	308	154.0	
17435	chr3	12336082	12336544	462	231.0	
17436	chr3	12350116	12351591	1475	738.0	
17437	chr3	12353722	12354879	1157	578.0	
17438	chr3	12356865	12357476	611	306.0	
17439	chr3	12393788	12396013	2225	1112.0	
17440	chr3	12405615	12406208	593	296.0	
17441	chr3	12413832	12414227	395	198.0	
17442	chr3	12427526	12427920	394	197.0	
17443	chr3	12451441	12451834	393	196.0	
17444	chr3	12458756	12459582	826	413.0	
17445	chr3	12462249	12463352	1103	552.0	
17446	chr3	12479605	12480469	864	432.0	
17447	chr3	12483497	12485250	1753	876.0	
17448	chr3	12486901	12487326	425	212.0	
17449	chr3	12503540	12503988	448	224.0	
17450	chr3	12553750	12554467	717	358.0	
17451	chr3	12556240	12558120	1880	940.0	
17452	chr3	12590055	12590574	519	260.0	
17453	chr3	12607142	12607498	356	178.0	
17454	chr3	12613229	12613549	320	160.0	
17455	chr3	12625709	12626145	436	218.0	
17456	chr3	12647317	12648796	1479	740.0	
17457	chr3	12662065	12664959	2894	1447.0	
17458	chr3	12676192	12676979	787	394.0	
17459	chr3	12681449	12682993	1544	772.0	
17460	chr3	12706340	12706931	591	296.0	
17461	chr3	12707618	12707736	118	59.0	
17462	chr3	12719688	12720981	1293	646.0	
17463	chr3	12735047	12735199	152	76.0	
17464	chr3	12749451	12749766	315	158.0	
17465	chr3	12783298	12783401	103	52.0	
17466	chr3	12787294	12787958	664	332.0	
17467	chr3	12796237	12797321	1084	542.0	
17468	chr3	12809541	12811295	1754	877.0	
17469	chr3	12831405	12831422	17	8.0	
17470	chr3	12833615	12833899	284	142.0	
17471	chr3	12836693	12836793	100	50.0	
17472	chr3	12839388	12842503	3115	1558.0	
17473	chr3	12867870	12869632	1762	881.0	
17474	chr3	12870664	12871477	813	406.0	
17475	chr3	12875913	12876552	639	320.0	
17476	chr3	12881986	12882163	177	88.0	
17477	chr3	12885219	12885266	47	24.0	
17478	chr3	12886045	12886775	730	365.0	
17479	chr3	12891641	12892615	974	487.0	
17480	chr3	12894883	12897784	2901	1450.0	
17481	chr3	12902590	12904094	1504	752.0	
17482	chr3	12915864	12916849	985	492.0	
17483	chr3	12920967	12921088	121	60.0	
17484	chr3	12947087	12947912	825	412.0	
17485	chr3	12949079	12950011	932	466.0	
17486	chr3	12952545	12952682	137	68.0	
17487	chr3	12954663	12955751	1088	544.0	
17488	chr3	12959760	12961094	1334	667.0	
17489	chr3	12963483	12964710	1227	614.0	
17490	chr3	12966470	12968578	2108	1054.0	
17491	chr3	12969324	12969668	344	172.0	
17492	chr3	12970444	12970590	146	73.0	
17493	chr3	12972361	12972767	406	203.0	
17494	chr3	12973737	12974368	631	316.0	
17495	chr3	12975034	12975294	260	130.0	
17496	chr3	12981856	12982019	163	82.0	
17497	chr3	12982639	12983246	607	304.0	
17498	chr3	12984091	12984832	741	370.0	
17499	chr3	12991827	12991843	16	8.0	
17500	chr3	12992579	12996320	3741	1870.0	
17501	chr3	12998636	13000128	1492	746.0	
17502	chr3	13002271	13007446	5175	2588.0	
17503	chr3	13008160	13017054	8894	4447.0	
17504	chr3	13020560	13022826	2266	1133.0	
17505	chr3	13025078	13025599	521	260.0	
17506	chr3	13040058	13041433	1375	688.0	
17507	chr3	13045555	13046910	1355	678.0	
17508	chr3	13069248	13070662	1414	707.0	
17509	chr3	13072131	13074277	2146	1073.0	
17510	chr3	13075238	13075736	498	249.0	
17511	chr3	13078148	13078588	440	220.0	
17512	chr3	13083793	13084362	569	284.0	
17513	chr3	13086454	13087029	575	288.0	
17514	chr3	13087783	13088546	763	382.0	
17515	chr3	13091878	13092751	873	436.0	
17516	chr3	13110449	13111450	1001	500.0	
17517	chr3	13149733	13150077	344	172.0	
17518	chr3	13189590	13190161	571	286.0	
17519	chr3	13233780	13235464	1684	842.0	
17520	chr3	13281882	13281884	2	1.0	
17521	chr3	13282636	13283513	877	438.0	
17522	chr3	13301358	13301898	540	270.0	
17523	chr3	13308419	13308894	475	238.0	
17524	chr3	13331775	13332683	908	454.0	
17525	chr3	13343504	13344051	547	274.0	
17526	chr3	13346165	13347743	1578	789.0	
17527	chr3	13348628	13349695	1067	534.0	
17528	chr3	13352418	13354556	2138	1069.0	
17529	chr3	13386298	13386478	180	90.0	
17530	chr3	13391313	13391733	420	210.0	
17531	chr3	13413406	13416912	3506	1753.0	
17532	chr3	13417553	13421896	4343	2172.0	
17533	chr3	13428143	13428802	659	330.0	
17534	chr3	13451152	13453379	2227	1114.0	"enhancer	sequence_feature"
17535	chr3	13455106	13455396	290	145.0	
17536	chr3	13461467	13462047	580	290.0	
17537	chr3	13479106	13481110	2004	1002.0	
17538	chr3	13484980	13486527	1547	774.0	
17539	chr3	13493430	13493529	99	50.0	
17540	chr3	13494436	13494800	364	182.0	
17541	chr3	13495491	13496891	1400	700.0	
17542	chr3	13544326	13544901	575	288.0	
17543	chr3	13548724	13550713	1989	994.0	
17544	chr3	13621387	13622307	920	460.0	
17545	chr3	13647336	13648867	1531	766.0	
17546	chr3	13650124	13651611	1487	744.0	
17547	chr3	13653557	13653976	419	210.0	
17548	chr3	13654638	13655874	1236	618.0	
17549	chr3	13657622	13658400	778	389.0	
17550	chr3	13866035	13867288	1253	626.0	
17551	chr3	13877951	13881204	3253	1626.0	
17552	chr3	13885328	13885884	556	278.0	
17553	chr3	13890395	13892095	1700	850.0	
17554	chr3	13894890	13897000	2110	1055.0	
17555	chr3	14123647	14126723	3076	1538.0	
17556	chr3	14128029	14128604	575	288.0	
17557	chr3	14134210	14134374	164	82.0	
17558	chr3	14141099	14147517	6418	3209.0	
17559	chr3	14152686	14153029	343	172.0	
17560	chr3	14175277	14176367	1090	545.0	
17561	chr3	14177496	14179728	2232	1116.0	
17562	chr3	14203362	14203892	530	265.0	
17563	chr3	14216234	14216609	375	188.0	
17564	chr3	14225454	14225839	385	192.0	
17565	chr3	14232676	14233036	360	180.0	
17566	chr3	14261104	14261576	472	236.0	
17567	chr3	14303607	14303711	104	52.0	
17568	chr3	14319477	14320204	727	364.0	
17569	chr3	14329464	14329790	326	163.0	
17570	chr3	14363890	14364351	461	230.0	
17571	chr3	14366238	14366717	479	240.0	
17572	chr3	14371496	14372381	885	442.0	
17573	chr3	14377533	14378651	1118	559.0	
17574	chr3	14384037	14384526	489	244.0	
17575	chr3	14388126	14388652	526	263.0	
17576	chr3	14391086	14391784	698	349.0	
17577	chr3	14397297	14397985	688	344.0	
17578	chr3	14400417	14400826	409	204.0	
17579	chr3	14401821	14405015	3194	1597.0	
17580	chr3	14405741	14406569	828	414.0	
17581	chr3	14410280	14411523	1243	622.0	
17582	chr3	14413375	14414032	657	328.0	
17583	chr3	14418320	14419549	1229	614.0	
17584	chr3	14423399	14423408	9	4.0	
17585	chr3	14424076	14426693	2617	1308.0	
17586	chr3	14428198	14429945	1747	874.0	
17587	chr3	14431087	14435028	3941	1970.0	
17588	chr3	14436586	14437236	650	325.0	
17589	chr3	14439171	14440510	1339	670.0	
17590	chr3	14453759	14454200	441	220.0	
17591	chr3	14461626	14462142	516	258.0	
17592	chr3	14467789	14468503	714	357.0	
17593	chr3	14508851	14509329	478	239.0	
17594	chr3	14548262	14548602	340	170.0	
17595	chr3	14598300	14598520	220	110.0	
17596	chr3	14633761	14634279	518	259.0	
17597	chr3	14650508	14652798	2290	1145.0	
17598	chr3	14689695	14689947	252	126.0	
17599	chr3	14691291	14691747	456	228.0	
17600	chr3	14791340	14791682	342	171.0	
17601	chr3	14806533	14807022	489	244.0	
17602	chr3	14823368	14823562	194	97.0	
17603	chr3	14916078	14916159	81	40.0	
17604	chr3	14920882	14921783	901	450.0	
17605	chr3	14925630	14926075	445	222.0	
17606	chr3	14946611	14949172	2561	1280.0	
17607	chr3	14959060	14959955	895	448.0	
17608	chr3	14980662	14981109	447	224.0	
17609	chr3	14988941	14989535	594	297.0	
17610	chr3	15050286	15050833	547	274.0	
17611	chr3	15051467	15052128	661	330.0	
17612	chr3	15054874	15055659	785	392.0	
17613	chr3	15064244	15065997	1753	876.0	
17614	chr3	15097719	15099978	2259	1130.0	
17615	chr3	15102461	15102462	1	0.0	
17616	chr3	15107974	15108723	749	374.0	
17617	chr3	15118529	15119259	730	365.0	
17618	chr3	15202533	15203333	800	400.0	
17619	chr3	15205487	15207576	2089	1044.0	
17620	chr3	15216128	15216277	149	74.0	
17621	chr3	15217232	15217641	409	204.0	
17622	chr3	15241311	15241770	459	230.0	
17623	chr3	15267558	15270577	3019	1510.0	
17624	chr3	15271360	15273859	2499	1250.0	
17625	chr3	15275025	15276647	1622	811.0	
17626	chr3	15287442	15288217	775	388.0	
17627	chr3	15289693	15291188	1495	748.0	
17628	chr3	15291695	15296287	4592	2296.0	
17629	chr3	15300186	15301171	985	492.0	
17630	chr3	15304030	15304697	667	334.0	
17631	chr3	15305278	15305641	363	182.0	
17632	chr3	15306295	15306778	483	242.0	
17633	chr3	15310654	15311041	387	194.0	
17634	chr3	15313413	15313944	531	266.0	
17635	chr3	15314984	15315438	454	227.0	
17636	chr3	15320328	15320927	599	300.0	
17637	chr3	15330291	15330561	270	135.0	
17638	chr3	15331395	15333257	1862	931.0	
17639	chr3	15339853	15340219	366	183.0	
17640	chr3	15342815	15343573	758	379.0	
17641	chr3	15345314	15346230	916	458.0	
17642	chr3	15347126	15348076	950	475.0	
17643	chr3	15350874	15350915	41	20.0	
17644	chr3	15356607	15357154	547	274.0	
17645	chr3	15360677	15363032	2355	1178.0	
17646	chr3	15377813	15378882	1069	534.0	
17647	chr3	15384825	15385225	400	200.0	
17648	chr3	15398825	15399282	457	228.0	
17649	chr3	15399923	15400419	496	248.0	
17650	chr3	15405056	15405871	815	408.0	
17651	chr3	15409075	15409849	774	387.0	
17652	chr3	15426899	15429119	2220	1110.0	
17653	chr3	15438805	15439767	962	481.0	
17654	chr3	15440665	15441465	800	400.0	
17655	chr3	15461129	15461595	466	233.0	
17656	chr3	15467177	15468255	1078	539.0	
17657	chr3	15500037	15500697	660	330.0	
17658	chr3	15504979	15505107	128	64.0	
17659	chr3	15517189	15517599	410	205.0	
17660	chr3	15520141	15522029	1888	944.0	
17661	chr3	15529174	15529322	148	74.0	
17662	chr3	15535809	15536146	337	168.0	
17663	chr3	15536934	15537256	322	161.0	
17664	chr3	15555873	15558212	2339	1170.0	
17665	chr3	15600643	15602717	2074	1037.0	
17666	chr3	15623612	15624516	904	452.0	
17667	chr3	15630035	15630841	806	403.0	
17668	chr3	15635978	15636785	807	404.0	
17669	chr3	15647204	15648175	971	486.0	
17670	chr3	15667428	15668061	633	316.0	
17671	chr3	15681631	15682122	491	246.0	
17672	chr3	15682825	15683518	693	346.0	
17673	chr3	15686054	15686212	158	79.0	
17674	chr3	15768872	15769323	451	226.0	
17675	chr3	15794122	15794940	818	409.0	
17676	chr3	15795715	15796388	673	336.0	
17677	chr3	15797032	15798390	1358	679.0	
17678	chr3	15804569	15804909	340	170.0	
17679	chr3	15805522	15806394	872	436.0	
17680	chr3	15809181	15809310	129	64.0	
17681	chr3	15812143	15812603	460	230.0	
17682	chr3	15815755	15816046	291	146.0	
17683	chr3	15816880	15817281	401	200.0	
17684	chr3	15858714	15861002	2288	1144.0	
17685	chr3	16048627	16049104	477	238.0	
17686	chr3	16178288	16178760	472	236.0	
17687	chr3	16181264	16181933	669	334.0	
17688	chr3	16247070	16248005	935	468.0	
17689	chr3	16249391	16249740	349	174.0	
17690	chr3	16253484	16254172	688	344.0	
17691	chr3	16262100	16262589	489	244.0	
17692	chr3	16264043	16265900	1857	928.0	
17693	chr3	16268034	16268651	617	308.0	
17694	chr3	16285822	16291923	6101	3050.0	
17695	chr3	16295591	16295634	43	22.0	
17696	chr3	16299819	16302183	2364	1182.0	
17697	chr3	16304631	16305835	1204	602.0	
17698	chr3	16309418	16310258	840	420.0	
17699	chr3	16311545	16312775	1230	615.0	
17700	chr3	16313477	16313778	301	150.0	
17701	chr3	16314676	16315030	354	177.0	
17702	chr3	16316777	16318363	1586	793.0	
17703	chr3	16318880	16319790	910	455.0	
17704	chr3	16322021	16323029	1008	504.0	
17705	chr3	16328021	16328422	401	200.0	
17706	chr3	16335777	16336337	560	280.0	
17707	chr3	16337747	16339687	1940	970.0	
17708	chr3	16359288	16359742	454	227.0	
17709	chr3	16371367	16371765	398	199.0	
17710	chr3	16372296	16373627	1331	666.0	
17711	chr3	16374456	16375302	846	423.0	
17712	chr3	16377004	16377978	974	487.0	
17713	chr3	16431222	16431595	373	186.0	
17714	chr3	16433585	16434032	447	224.0	
17715	chr3	16462622	16463197	575	288.0	
17716	chr3	16467311	16468877	1566	783.0	
17717	chr3	16476529	16476952	423	212.0	
17718	chr3	16481077	16483613	2536	1268.0	
17719	chr3	16496197	16496431	234	117.0	
17720	chr3	16498174	16498820	646	323.0	
17721	chr3	16504094	16504827	733	366.0	
17722	chr3	16508179	16508187	8	4.0	
17723	chr3	16508735	16509001	266	133.0	
17724	chr3	16509754	16510223	469	234.0	
17725	chr3	16511376	16515104	3728	1864.0	
17726	chr3	16515644	16517272	1628	814.0	
17727	chr3	16521097	16521524	427	214.0	
17728	chr3	16522937	16523083	146	73.0	
17729	chr3	16523828	16524011	183	92.0	
17730	chr3	16529266	16529657	391	196.0	
17731	chr3	16546290	16546333	43	22.0	
17732	chr3	16550501	16551420	919	460.0	
17733	chr3	16590018	16590232	214	107.0	
17734	chr3	16601034	16601667	633	316.0	
17735	chr3	16617257	16617501	244	122.0	
17736	chr3	16697638	16698232	594	297.0	
17737	chr3	16704859	16705351	492	246.0	
17738	chr3	16788592	16789893	1301	650.0	
17739	chr3	16795631	16795971	340	170.0	
17740	chr3	16796940	16796965	25	12.0	
17741	chr3	16801078	16802920	1842	921.0	
17742	chr3	16824002	16824604	602	301.0	
17743	chr3	16828686	16829307	621	310.0	
17744	chr3	16841173	16843540	2367	1184.0	
17745	chr3	16846647	16847093	446	223.0	
17746	chr3	16849094	16850275	1181	590.0	
17747	chr3	16866613	16867072	459	230.0	
17748	chr3	16869682	16869956	274	137.0	
17749	chr3	16875986	16876648	662	331.0	
17750	chr3	16883277	16886954	3677	1838.0	
17751	chr3	16887794	16889736	1942	971.0	
17752	chr3	16897368	16897950	582	291.0	
17753	chr3	16899036	16899394	358	179.0	
17754	chr3	16900624	16901901	1277	638.0	
17755	chr3	16904557	16905405	848	424.0	
17756	chr3	16906829	16907542	713	356.0	
17757	chr3	16912411	16912795	384	192.0	
17758	chr3	16927728	16927849	121	60.0	
17759	chr3	16936224	16936622	398	199.0	
17760	chr3	16992220	16992774	554	277.0	
17761	chr3	16996209	16996226	17	8.0	
17762	chr3	17006475	17006851	376	188.0	
17763	chr3	17021732	17021760	28	14.0	
17764	chr3	17022795	17023628	833	416.0	
17765	chr3	17032612	17032797	185	92.0	
17766	chr3	17033536	17033937	401	200.0	
17767	chr3	17035087	17035092	5	2.0	
17768	chr3	17039594	17039902	308	154.0	
17769	chr3	17052350	17052815	465	232.0	
17770	chr3	17054371	17054445	74	37.0	
17771	chr3	17074548	17075738	1190	595.0	
17772	chr3	17087515	17088164	649	324.0	
17773	chr3	17088840	17089435	595	298.0	
17774	chr3	17151254	17152637	1383	692.0	
17775	chr3	17154994	17155346	352	176.0	
17776	chr3	17179720	17180283	563	282.0	
17777	chr3	17182375	17182492	117	58.0	
17778	chr3	17190636	17191114	478	239.0	
17779	chr3	17195190	17196670	1480	740.0	
17780	chr3	17233237	17233835	598	299.0	
17781	chr3	17258884	17259160	276	138.0	
17782	chr3	17322449	17322605	156	78.0	
17783	chr3	17330160	17330267	107	54.0	
17784	chr3	17384949	17385336	387	194.0	
17785	chr3	17399177	17399566	389	194.0	
17786	chr3	17412885	17413357	472	236.0	
17787	chr3	17626398	17626779	381	190.0	
17788	chr3	17632470	17632768	298	149.0	
17789	chr3	17645183	17645396	213	106.0	
17790	chr3	17693325	17693726	401	200.0	
17791	chr3	17733035	17733506	471	236.0	
17792	chr3	17739473	17739834	361	180.0	
17793	chr3	17740672	17743576	2904	1452.0	
17794	chr3	17747362	17747982	620	310.0	
17795	chr3	17749272	17750297	1025	512.0	
17796	chr3	17774305	17775310	1005	502.0	
17797	chr3	17779386	17780737	1351	676.0	
17798	chr3	17841153	17841653	500	250.0	
17799	chr3	17850526	17850860	334	167.0	
17800	chr3	17874737	17875019	282	141.0	
17801	chr3	17894641	17894805	164	82.0	
17802	chr3	17971048	17971309	261	130.0	
17803	chr3	18111859	18112096	237	118.0	
17804	chr3	18127223	18128167	944	472.0	enhancer
17805	chr3	18208780	18209328	548	274.0	
17806	chr3	18223486	18224202	716	358.0	
17807	chr3	18335282	18335462	180	90.0	
17808	chr3	18345139	18345143	4	2.0	
17809	chr3	18369694	18369729	35	18.0	
17810	chr3	18372856	18373488	632	316.0	
17811	chr3	18383060	18383410	350	175.0	
17812	chr3	18389024	18389617	593	296.0	
17813	chr3	18401612	18403016	1404	702.0	
17814	chr3	18409378	18409567	189	94.0	
17815	chr3	18410228	18410572	344	172.0	
17816	chr3	18411531	18412205	674	337.0	
17817	chr3	18415891	18416268	377	188.0	
17818	chr3	18418377	18418411	34	17.0	
17819	chr3	18422872	18427146	4274	2137.0	
17820	chr3	18428085	18428121	36	18.0	
17821	chr3	18428787	18429756	969	484.0	
17822	chr3	18430286	18431642	1356	678.0	
17823	chr3	18438303	18439723	1420	710.0	
17824	chr3	18440353	18440808	455	228.0	
17825	chr3	18442767	18446819	4052	2026.0	
17826	chr3	18499243	18499816	573	286.0	
17827	chr3	18527808	18528071	263	132.0	
17828	chr3	18556449	18557015	566	283.0	
17829	chr3	18559287	18559863	576	288.0	
17830	chr3	18609320	18609474	154	77.0	
17831	chr3	18657903	18658209	306	153.0	
17832	chr3	18679147	18679847	700	350.0	
17833	chr3	18687316	18687706	390	195.0	
17834	chr3	18712871	18713539	668	334.0	
17835	chr3	18716161	18716393	232	116.0	
17836	chr3	18723178	18726286	3108	1554.0	
17837	chr3	18738759	18741985	3226	1613.0	
17838	chr3	18743815	18744170	355	178.0	
17839	chr3	18745082	18746045	963	482.0	
17840	chr3	18747269	18747919	650	325.0	
17841	chr3	18757802	18758591	789	394.0	
17842	chr3	18778567	18778874	307	154.0	
17843	chr3	18786588	18787267	679	340.0	
17844	chr3	18789440	18790628	1188	594.0	
17845	chr3	18891599	18892075	476	238.0	
17846	chr3	18988629	18988993	364	182.0	
17847	chr3	19146514	19148702	2188	1094.0	
17848	chr3	19149436	19149745	309	154.0	
17849	chr3	19229902	19230239	337	168.0	
17850	chr3	19540283	19540320	37	18.0	
17851	chr3	19866716	19867133	417	208.0	
17852	chr3	19885379	19885823	444	222.0	
17853	chr3	19901916	19902263	347	174.0	
17854	chr3	19930932	19932312	1380	690.0	
17855	chr3	19946137	19948820	2683	1342.0	
17856	chr3	19949780	19950143	363	182.0	
17857	chr3	19957027	19957172	145	72.0	
17858	chr3	19958698	19958735	37	18.0	
17859	chr3	20038539	20044542	6003	3002.0	
17860	chr3	20047960	20048238	278	139.0	
17861	chr3	20048954	20049565	611	306.0	
17862	chr3	20054376	20055723	1347	674.0	
17863	chr3	20057214	20057551	337	168.0	
17864	chr3	20060809	20061766	957	478.0	
17865	chr3	20081058	20081622	564	282.0	
17866	chr3	20103743	20104812	1069	534.0	
17867	chr3	20125653	20126562	909	454.0	
17868	chr3	20160256	20160542	286	143.0	
17869	chr3	20185036	20187718	2682	1341.0	
17870	chr3	20269527	20269856	329	164.0	
17871	chr3	20280342	20280607	265	132.0	
17872	chr3	20340300	20340716	416	208.0	
17873	chr3	21484435	21485257	822	411.0	
17874	chr3	21508191	21508866	675	338.0	
17875	chr3	21509667	21510227	560	280.0	
17876	chr3	22564113	22564505	392	196.0	
17877	chr3	22713797	22714383	586	293.0	
17878	chr3	23068051	23068335	284	142.0	
17879	chr3	23071490	23072362	872	436.0	
17880	chr3	23112445	23112867	422	211.0	
17881	chr3	23113731	23114281	550	275.0	
17882	chr3	23175726	23176034	308	154.0	
17883	chr3	23202282	23204489	2207	1104.0	
17884	chr3	23210126	23210420	294	147.0	
17885	chr3	23220970	23221797	827	414.0	
17886	chr3	23239358	23239575	217	108.0	
17887	chr3	23254634	23255320	686	343.0	
17888	chr3	23324748	23325162	414	207.0	
17889	chr3	23329761	23329910	149	74.0	
17890	chr3	23341435	23341785	350	175.0	
17891	chr3	23403003	23403600	597	298.0	
17892	chr3	23442546	23443100	554	277.0	
17893	chr3	23455066	23455416	350	175.0	
17894	chr3	23612057	23612425	368	184.0	
17895	chr3	23650353	23650730	377	188.0	
17896	chr3	23659225	23659600	375	188.0	
17897	chr3	23672017	23672131	114	57.0	
17898	chr3	23723877	23724414	537	268.0	
17899	chr3	23727237	23727652	415	208.0	
17900	chr3	23739455	23741488	2033	1016.0	
17901	chr3	23746472	23746751	279	140.0	
17902	chr3	23748362	23749307	945	472.0	
17903	chr3	23750779	23751206	427	214.0	
17904	chr3	23758443	23758717	274	137.0	
17905	chr3	23761056	23762728	1672	836.0	
17906	chr3	23797696	23797849	153	76.0	
17907	chr3	23804467	23807730	3263	1632.0	
17908	chr3	23808311	23812270	3959	1980.0	
17909	chr3	23819955	23820377	422	211.0	
17910	chr3	23826283	23826682	399	200.0	
17911	chr3	23829471	23829939	468	234.0	
17912	chr3	23836365	23836909	544	272.0	
17913	chr3	23857030	23857938	908	454.0	
17914	chr3	23888526	23889748	1222	611.0	
17915	chr3	23915532	23919028	3496	1748.0	
17916	chr3	23919775	23921677	1902	951.0	
17917	chr3	23928557	23928820	263	132.0	
17918	chr3	23943666	23946883	3217	1608.0	
17919	chr3	23949377	23950888	1511	756.0	
17920	chr3	23952519	23953091	572	286.0	
17921	chr3	23958991	23959602	611	306.0	
17922	chr3	23981901	23982142	241	120.0	
17923	chr3	23987323	23987854	531	266.0	
17924	chr3	23998933	23999340	407	204.0	
17925	chr3	24185905	24186243	338	169.0	
17926	chr3	24237995	24238449	454	227.0	
17927	chr3	24483785	24484250	465	232.0	
17928	chr3	24494011	24495937	1926	963.0	
17929	chr3	24502750	24504027	1277	638.0	
17930	chr3	24507457	24507856	399	200.0	
17931	chr3	24521237	24522414	1177	588.0	
17932	chr3	24680482	24680906	424	212.0	
17933	chr3	24686734	24687055	321	160.0	
17934	chr3	25428154	25428188	34	17.0	
17935	chr3	25460674	25461249	575	288.0	
17936	chr3	25593943	25594524	581	290.0	
17937	chr3	25603645	25604653	1008	504.0	
17938	chr3	25647797	25648685	888	444.0	
17939	chr3	25655517	25656091	574	287.0	
17940	chr3	25661970	25662146	176	88.0	
17941	chr3	25662792	25666205	3413	1706.0	
17942	chr3	25695673	25696394	721	360.0	
17943	chr3	25768786	25769272	486	243.0	
17944	chr3	25781207	25784556	3349	1674.0	
17945	chr3	25789465	25790911	1446	723.0	
17946	chr3	25856880	25857363	483	242.0	
17947	chr3	25911461	25912341	880	440.0	
17948	chr3	27134135	27134597	462	231.0	
17949	chr3	27171051	27171626	575	288.0	
17950	chr3	27312036	27312498	462	231.0	
17951	chr3	27345512	27345958	446	223.0	
17952	chr3	27349851	27349974	123	62.0	
17953	chr3	27357607	27358120	513	256.0	
17954	chr3	27359151	27359645	494	247.0	
17955	chr3	27368632	27370107	1475	738.0	
17956	chr3	27454863	27455404	541	270.0	
17957	chr3	27467480	27468002	522	261.0	
17958	chr3	27476569	27476730	161	80.0	
17959	chr3	27479239	27480704	1465	732.0	
17960	chr3	27482550	27485490	2940	1470.0	
17961	chr3	27509335	27509862	527	264.0	
17962	chr3	27521325	27522125	800	400.0	
17963	chr3	27528882	27529113	231	116.0	
17964	chr3	27533168	27534830	1662	831.0	
17965	chr3	27544376	27544903	527	264.0	
17966	chr3	27553903	27555154	1251	626.0	
17967	chr3	27560645	27561277	632	316.0	
17968	chr3	27565457	27565793	336	168.0	
17969	chr3	27590268	27591474	1206	603.0	
17970	chr3	27607255	27607318	63	32.0	
17971	chr3	27632404	27633614	1210	605.0	
17972	chr3	27639243	27639905	662	331.0	
17973	chr3	27659135	27659690	555	278.0	
17974	chr3	27661874	27662208	334	167.0	
17975	chr3	27666424	27667258	834	417.0	
17976	chr3	27668230	27668636	406	203.0	
17977	chr3	27669724	27670023	299	150.0	
17978	chr3	27673925	27674047	122	61.0	
17979	chr3	27680773	27681898	1125	562.0	
17980	chr3	27699085	27699391	306	153.0	
17981	chr3	27711808	27717784	5976	2988.0	
17982	chr3	27719318	27724519	5201	2600.0	
17983	chr3	27728302	27730568	2266	1133.0	
17984	chr3	27840812	27841223	411	206.0	
17985	chr3	27861005	27861716	711	356.0	
17986	chr3	27877639	27878159	520	260.0	
17987	chr3	27880976	27882232	1256	628.0	
17988	chr3	27900226	27900916	690	345.0	
17989	chr3	27903473	27903782	309	154.0	
17990	chr3	27905586	27906113	527	264.0	
17991	chr3	27976819	27977433	614	307.0	
17992	chr3	28151854	28152164	310	155.0	
17993	chr3	28171937	28172429	492	246.0	
17994	chr3	28200611	28200904	293	146.0	
17995	chr3	28210917	28211359	442	221.0	
17996	chr3	28234524	28234907	383	192.0	
17997	chr3	28240675	28242337	1662	831.0	
17998	chr3	28242944	28244886	1942	971.0	
17999	chr3	28250953	28252901	1948	974.0	
18000	chr3	28255025	28255411	386	193.0	
18001	chr3	28286528	28287225	697	348.0	
18002	chr3	28291024	28291334	310	155.0	
18003	chr3	28294980	28296384	1404	702.0	
18004	chr3	28308242	28308451	209	104.0	
18005	chr3	28317408	28317895	487	244.0	
18006	chr3	28326153	28327131	978	489.0	
18007	chr3	28328297	28329004	707	354.0	
18008	chr3	28342299	28342930	631	316.0	
18009	chr3	28346969	28349990	3021	1510.0	
18010	chr3	28376331	28376925	594	297.0	
18011	chr3	28916855	28917072	217	108.0	
18012	chr3	28989576	28990066	490	245.0	
18013	chr3	29153884	29154118	234	117.0	
18014	chr3	29240397	29240445	48	24.0	
18015	chr3	29280599	29281792	1193	596.0	
18016	chr3	29324057	29324710	653	326.0	
18017	chr3	29618920	29619271	351	176.0	
18018	chr3	29649860	29650225	365	182.0	
18019	chr3	29758999	29759154	155	78.0	
18020	chr3	29771589	29771920	331	166.0	
18021	chr3	30012953	30013344	391	196.0	
18022	chr3	30042253	30042651	398	199.0	
18023	chr3	30112954	30113258	304	152.0	
18024	chr3	30161360	30161727	367	184.0	
18025	chr3	30180169	30180740	571	286.0	
18026	chr3	30199100	30199482	382	191.0	
18027	chr3	30221535	30222017	482	241.0	
18028	chr3	30226555	30227066	511	256.0	
18029	chr3	30227784	30228461	677	338.0	
18030	chr3	30269697	30270436	739	370.0	
18031	chr3	30289296	30290113	817	408.0	
18032	chr3	30319678	30320202	524	262.0	
18033	chr3	30332496	30332979	483	242.0	
18034	chr3	30353980	30354894	914	457.0	
18035	chr3	30355615	30356004	389	194.0	
18036	chr3	30421191	30421753	562	281.0	
18037	chr3	30436024	30436219	195	98.0	
18038	chr3	30473254	30473836	582	291.0	
18039	chr3	30475255	30475578	323	162.0	
18040	chr3	30502705	30503063	358	179.0	
18041	chr3	30511538	30511898	360	180.0	
18042	chr3	30578400	30579112	712	356.0	
18043	chr3	30597478	30597484	6	3.0	
18044	chr3	30598942	30599069	127	64.0	
18045	chr3	30602887	30603317	430	215.0	
18046	chr3	30603844	30608738	4894	2447.0	
18047	chr3	30609764	30613825	4061	2030.0	
18048	chr3	30614431	30615286	855	428.0	
18049	chr3	30616433	30616917	484	242.0	
18050	chr3	30617858	30618847	989	494.0	
18051	chr3	30620068	30621147	1079	540.0	
18052	chr3	30621751	30623789	2038	1019.0	
18053	chr3	30626386	30626776	390	195.0	
18054	chr3	30628264	30632419	4155	2078.0	
18055	chr3	30635125	30635149	24	12.0	
18056	chr3	30635703	30636375	672	336.0	
18057	chr3	30637487	30637855	368	184.0	
18058	chr3	30638725	30639138	413	206.0	
18059	chr3	30639840	30645496	5656	2828.0	
18060	chr3	30646243	30647350	1107	554.0	
18061	chr3	30648422	30650056	1634	817.0	
18062	chr3	30652886	30653505	619	310.0	
18063	chr3	30654681	30656141	1460	730.0	
18064	chr3	30657675	30659507	1832	916.0	
18065	chr3	30661106	30661811	705	352.0	
18066	chr3	30664074	30665777	1703	852.0	
18067	chr3	30666583	30667696	1113	556.0	
18068	chr3	30669381	30669783	402	201.0	
18069	chr3	30672402	30672418	16	8.0	
18070	chr3	30673687	30674040	353	176.0	
18071	chr3	30681645	30683103	1458	729.0	
18072	chr3	30685409	30685890	481	240.0	
18073	chr3	30689165	30689566	401	200.0	
18074	chr3	30693089	30693982	893	446.0	
18075	chr3	30751582	30751917	335	168.0	
18076	chr3	30752929	30753383	454	227.0	
18077	chr3	30760311	30760462	151	76.0	
18078	chr3	30764921	30765247	326	163.0	
18079	chr3	30768680	30769100	420	210.0	
18080	chr3	30778984	30779386	402	201.0	
18081	chr3	30948428	30948830	402	201.0	
18082	chr3	31132227	31132238	11	6.0	
18083	chr3	31157054	31157636	582	291.0	
18084	chr3	31209617	31209883	266	133.0	
18085	chr3	31210448	31210544	96	48.0	
18086	chr3	31212492	31214472	1980	990.0	
18087	chr3	31220415	31220801	386	193.0	
18088	chr3	31225988	31227837	1849	924.0	
18089	chr3	31230374	31231047	673	336.0	
18090	chr3	31232021	31233304	1283	642.0	
18091	chr3	31233922	31234743	821	410.0	
18092	chr3	31253690	31254300	610	305.0	
18093	chr3	31265598	31266556	958	479.0	
18094	chr3	31268891	31269131	240	120.0	
18095	chr3	31448497	31448927	430	215.0	
18096	chr3	31456349	31456735	386	193.0	
18097	chr3	31461717	31463163	1446	723.0	
18098	chr3	31472820	31473154	334	167.0	
18099	chr3	31502688	31503355	667	334.0	
18100	chr3	31521903	31522644	741	370.0	
18101	chr3	31531318	31534830	3512	1756.0	
18102	chr3	31536147	31536929	782	391.0	
18103	chr3	31541100	31541530	430	215.0	
18104	chr3	31544533	31545130	597	298.0	
18105	chr3	31546385	31546457	72	36.0	
18106	chr3	31547323	31548016	693	346.0	
18107	chr3	31550272	31551154	882	441.0	
18108	chr3	31562392	31562897	505	252.0	
18109	chr3	31565184	31565653	469	234.0	
18110	chr3	31567000	31567403	403	202.0	
18111	chr3	31572864	31573783	919	460.0	
18112	chr3	31575487	31575854	367	184.0	
18113	chr3	31581668	31582025	357	178.0	
18114	chr3	31629078	31629207	129	64.0	
18115	chr3	31635714	31635829	115	58.0	
18116	chr3	31636800	31637493	693	346.0	
18117	chr3	31662003	31662172	169	84.0	
18118	chr3	31670119	31670693	574	287.0	
18119	chr3	31671996	31672514	518	259.0	
18120	chr3	31695518	31695904	386	193.0	
18121	chr3	31713856	31714208	352	176.0	
18122	chr3	31768791	31769146	355	178.0	
18123	chr3	31803142	31803514	372	186.0	
18124	chr3	31880148	31880367	219	110.0	
18125	chr3	31918095	31918577	482	241.0	
18126	chr3	31952131	31952683	552	276.0	
18127	chr3	31980415	31981945	1530	765.0	
18128	chr3	32010012	32010316	304	152.0	
18129	chr3	32019023	32019501	478	239.0	
18130	chr3	32026654	32026802	148	74.0	
18131	chr3	32105846	32107745	1899	950.0	
18132	chr3	32113622	32115626	2004	1002.0	
18133	chr3	32120461	32120951	490	245.0	
18134	chr3	32138620	32138798	178	89.0	
18135	chr3	32144060	32144542	482	241.0	
18136	chr3	32145389	32147140	1751	876.0	
18137	chr3	32175590	32176041	451	226.0	
18138	chr3	32176983	32178315	1332	666.0	
18139	chr3	32237820	32240504	2684	1342.0	
18140	chr3	32249374	32249854	480	240.0	
18141	chr3	32288754	32289240	486	243.0	
18142	chr3	32296337	32297831	1494	747.0	
18143	chr3	32303199	32303764	565	282.0	
18144	chr3	32313857	32313932	75	38.0	
18145	chr3	32334632	32335111	479	240.0	
18146	chr3	32335735	32336097	362	181.0	
18147	chr3	32340041	32340519	478	239.0	
18148	chr3	32352419	32352671	252	126.0	
18149	chr3	32371417	32372217	800	400.0	
18150	chr3	32374812	32375696	884	442.0	
18151	chr3	32384861	32385769	908	454.0	
18152	chr3	32391127	32394724	3597	1798.0	
18153	chr3	32395379	32395897	518	259.0	
18154	chr3	32398050	32399687	1637	818.0	
18155	chr3	32400484	32402558	2074	1037.0	
18156	chr3	32403124	32403147	23	12.0	
18157	chr3	32403837	32404061	224	112.0	
18158	chr3	32406322	32407340	1018	509.0	
18159	chr3	32408793	32409199	406	203.0	
18160	chr3	32414309	32415231	922	461.0	
18161	chr3	32419717	32421064	1347	674.0	
18162	chr3	32421833	32422599	766	383.0	
18163	chr3	32423560	32424963	1403	702.0	
18164	chr3	32426378	32426380	2	1.0	
18165	chr3	32427765	32429216	1451	726.0	
18166	chr3	32430639	32433770	3131	1566.0	
18167	chr3	32436293	32436738	445	222.0	
18168	chr3	32438862	32439543	681	340.0	
18169	chr3	32443486	32443883	397	198.0	
18170	chr3	32449113	32449432	319	160.0	
18171	chr3	32457699	32458809	1110	555.0	
18172	chr3	32459379	32461154	1775	888.0	
18173	chr3	32461961	32462992	1031	516.0	
18174	chr3	32467382	32468625	1243	622.0	
18175	chr3	32469769	32470170	401	200.0	
18176	chr3	32470718	32471662	944	472.0	
18177	chr3	32473032	32473501	469	234.0	
18178	chr3	32477551	32478310	759	380.0	
18179	chr3	32484359	32485105	746	373.0	
18180	chr3	32493719	32494523	804	402.0	
18181	chr3	32496345	32496428	83	42.0	
18182	chr3	32498091	32498934	843	422.0	
18183	chr3	32500921	32503501	2580	1290.0	
18184	chr3	32509878	32510587	709	354.0	
18185	chr3	32516180	32517213	1033	516.0	
18186	chr3	32569472	32571608	2136	1068.0	
18187	chr3	32572968	32573338	370	185.0	
18188	chr3	32575353	32575920	567	284.0	
18189	chr3	32577426	32578391	965	482.0	
18190	chr3	32664753	32665213	460	230.0	
18191	chr3	32684144	32686116	1972	986.0	
18192	chr3	32686712	32687240	528	264.0	
18193	chr3	32698642	32698933	291	146.0	
18194	chr3	32701435	32701836	401	200.0	
18195	chr3	32733730	32733923	193	96.0	
18196	chr3	32758063	32758409	346	173.0	
18197	chr3	32780774	32781945	1171	586.0	
18198	chr3	32814340	32814770	430	215.0	
18199	chr3	32816717	32817553	836	418.0	
18200	chr3	32818195	32818596	401	200.0	
18201	chr3	32842675	32843073	398	199.0	
18202	chr3	32873478	32873950	472	236.0	
18203	chr3	32882788	32883109	321	160.0	
18204	chr3	32903012	32903322	310	155.0	
18205	chr3	32947443	32948323	880	440.0	
18206	chr3	32951413	32951814	401	200.0	
18207	chr3	32960480	32961552	1072	536.0	
18208	chr3	32963794	32964342	548	274.0	
18209	chr3	32973960	32974279	319	160.0	
18210	chr3	33006296	33006408	112	56.0	
18211	chr3	33008214	33008702	488	244.0	
18212	chr3	33019693	33019801	108	54.0	
18213	chr3	33023188	33023587	399	200.0	
18214	chr3	33030733	33031292	559	280.0	
18215	chr3	33044664	33045122	458	229.0	
18216	chr3	33047613	33048903	1290	645.0	
18217	chr3	33050142	33050467	325	162.0	
18218	chr3	33054320	33056496	2176	1088.0	
18219	chr3	33060586	33061008	422	211.0	
18220	chr3	33061792	33062178	386	193.0	
18221	chr3	33062854	33064228	1374	687.0	
18222	chr3	33064888	33065363	475	238.0	
18223	chr3	33067446	33067884	438	219.0	
18224	chr3	33074402	33074926	524	262.0	
18225	chr3	33089320	33090034	714	357.0	
18226	chr3	33095515	33097877	2362	1181.0	
18227	chr3	33106953	33107213	260	130.0	
18228	chr3	33111206	33111600	394	197.0	
18229	chr3	33113429	33115759	2330	1165.0	
18230	chr3	33131514	33132107	593	296.0	
18231	chr3	33149101	33149838	737	368.0	
18232	chr3	33164259	33164285	26	13.0	
18233	chr3	33372599	33373261	662	331.0	
18234	chr3	33385398	33385772	374	187.0	
18235	chr3	33417069	33417490	421	210.0	
18236	chr3	33420002	33420416	414	207.0	
18237	chr3	33425533	33425539	6	3.0	
18238	chr3	33428637	33429000	363	182.0	
18239	chr3	33430085	33430267	182	91.0	
18240	chr3	33431528	33431820	292	146.0	
18241	chr3	33432888	33433162	274	137.0	
18242	chr3	33434437	33434533	96	48.0	
18243	chr3	33435609	33435740	131	66.0	
18244	chr3	33437294	33437625	331	166.0	
18245	chr3	33438153	33441771	3618	1809.0	
18246	chr3	33446278	33446822	544	272.0	
18247	chr3	33575283	33575673	390	195.0	
18248	chr3	33636034	33636435	401	200.0	
18249	chr3	33645243	33645709	466	233.0	
18250	chr3	33658811	33659939	1128	564.0	
18251	chr3	33664115	33664669	554	277.0	
18252	chr3	33712903	33713025	122	61.0	
18253	chr3	33716202	33719153	2951	1476.0	
18254	chr3	33746387	33747109	722	361.0	
18255	chr3	33747872	33748273	401	200.0	
18256	chr3	33749494	33749891	397	198.0	
18257	chr3	33787167	33787837	670	335.0	
18258	chr3	33791489	33792321	832	416.0	
18259	chr3	33797741	33799603	1862	931.0	
18260	chr3	33807029	33807472	443	222.0	
18261	chr3	33848832	33849323	491	246.0	
18262	chr3	33883439	33883895	456	228.0	
18263	chr3	34016963	34017597	634	317.0	
18264	chr3	34200624	34200928	304	152.0	
18265	chr3	34264868	34264975	107	54.0	
18266	chr3	34360791	34361032	241	120.0	
18267	chr3	34361765	34362451	686	343.0	
18268	chr3	34364285	34364814	529	264.0	
18269	chr3	34396438	34396568	130	65.0	
18270	chr3	35639284	35639881	597	298.0	
18271	chr3	35664678	35664886	208	104.0	
18272	chr3	35745901	35746153	252	126.0	
18273	chr3	35932940	35933259	319	160.0	
18274	chr3	36095488	36095567	79	40.0	
18275	chr3	36380161	36380641	480	240.0	
18276	chr3	36393583	36393885	302	151.0	
18277	chr3	36453267	36453993	726	363.0	
18278	chr3	36482334	36482578	244	122.0	
18279	chr3	36494625	36495169	544	272.0	
18280	chr3	36707523	36708062	539	270.0	
18281	chr3	36729431	36729890	459	230.0	
18282	chr3	36787216	36787863	647	324.0	
18283	chr3	36792438	36792447	9	4.0	
18284	chr3	36842961	36844081	1120	560.0	
18285	chr3	36864236	36864777	541	270.0	
18286	chr3	36868625	36869311	686	343.0	
18287	chr3	36875981	36877226	1245	622.0	
18288	chr3	36878110	36878250	140	70.0	
18289	chr3	36891617	36892018	401	200.0	
18290	chr3	36892836	36893909	1073	536.0	
18291	chr3	36894668	36896341	1673	836.0	
18292	chr3	36900698	36901338	640	320.0	
18293	chr3	36903212	36903613	401	200.0	
18294	chr3	36904633	36907164	2531	1266.0	
18295	chr3	36907676	36909211	1535	768.0	
18296	chr3	36911927	36913321	1394	697.0	
18297	chr3	36917826	36918494	668	334.0	
18298	chr3	36922676	36923825	1149	574.0	
18299	chr3	36943625	36945993	2368	1184.0	
18300	chr3	36957781	36959340	1559	780.0	
18301	chr3	36969532	36970422	890	445.0	
18302	chr3	36987960	36989671	1711	856.0	
18303	chr3	36990582	36990696	114	57.0	
18304	chr3	36991249	36991567	318	159.0	
18305	chr3	36992090	36994740	2650	1325.0	
18306	chr3	37024959	37025384	425	212.0	
18307	chr3	37136108	37136445	337	168.0	
18308	chr3	37144824	37146103	1279	640.0	
18309	chr3	37147659	37148073	414	207.0	
18310	chr3	37162807	37163389	582	291.0	
18311	chr3	37173878	37173994	116	58.0	
18312	chr3	37174588	37177488	2900	1450.0	
18313	chr3	37212785	37213642	857	428.0	
18314	chr3	37216325	37217892	1567	784.0	
18315	chr3	37228069	37228367	298	149.0	
18316	chr3	37235945	37236478	533	266.0	
18317	chr3	37242576	37244675	2099	1050.0	
18318	chr3	37247283	37247567	284	142.0	
18319	chr3	37256441	37256816	375	188.0	
18320	chr3	37301980	37302476	496	248.0	
18321	chr3	37325103	37325332	229	114.0	
18322	chr3	37375842	37376105	263	132.0	
18323	chr3	37386795	37387049	254	127.0	
18324	chr3	37430762	37431480	718	359.0	
18325	chr3	37451545	37453085	1540	770.0	
18326	chr3	37457374	37457755	381	190.0	
18327	chr3	37458440	37458601	161	80.0	
18328	chr3	37493067	37493435	368	184.0	
18329	chr3	37494286	37494639	353	176.0	
18330	chr3	37510686	37511142	456	228.0	
18331	chr3	37556711	37557393	682	341.0	
18332	chr3	37737002	37737062	60	30.0	
18333	chr3	37772786	37773066	280	140.0	
18334	chr3	37779588	37779915	327	164.0	
18335	chr3	37855288	37855857	569	284.0	
18336	chr3	37859957	37863117	3160	1580.0	
18337	chr3	37913544	37913918	374	187.0	
18338	chr3	37955816	37956474	658	329.0	
18339	chr3	37957275	37957488	213	106.0	
18340	chr3	37967206	37967717	511	256.0	
18341	chr3	37974408	37975280	872	436.0	
18342	chr3	37979727	37980906	1179	590.0	
18343	chr3	37987865	37988734	869	434.0	
18344	chr3	37993349	37995001	1652	826.0	
18345	chr3	37995648	37999887	4239	2120.0	
18346	chr3	38001515	38001846	331	166.0	
18347	chr3	38003090	38005168	2078	1039.0	
18348	chr3	38009946	38010458	512	256.0	
18349	chr3	38022031	38026087	4056	2028.0	
18350	chr3	38028006	38028034	28	14.0	
18351	chr3	38028780	38031795	3015	1508.0	
18352	chr3	38038270	38040640	2370	1185.0	
18353	chr3	38043536	38043823	287	144.0	
18354	chr3	38083237	38086690	3453	1726.0	
18355	chr3	38101844	38102865	1021	510.0	
18356	chr3	38108682	38109261	579	290.0	
18357	chr3	38115005	38115351	346	173.0	
18358	chr3	38117539	38118834	1295	648.0	
18359	chr3	38131560	38132023	463	232.0	
18360	chr3	38135450	38139978	4528	2264.0	
18361	chr3	38147382	38148795	1413	706.0	
18362	chr3	38149649	38150177	528	264.0	
18363	chr3	38151365	38152596	1231	616.0	
18364	chr3	38153817	38154473	656	328.0	
18365	chr3	38163143	38163502	359	180.0	
18366	chr3	38164231	38167892	3661	1830.0	
18367	chr3	38168888	38169477	589	294.0	
18368	chr3	38173764	38174720	956	478.0	
18369	chr3	38202874	38203363	489	244.0	
18370	chr3	38204760	38205006	246	123.0	
18371	chr3	38205560	38205733	173	86.0	
18372	chr3	38207167	38207732	565	282.0	
18373	chr3	38228135	38228299	164	82.0	
18374	chr3	38268049	38268948	899	450.0	
18375	chr3	38311391	38311918	527	264.0	
18376	chr3	38313755	38314099	344	172.0	
18377	chr3	38346225	38347458	1233	616.0	
18378	chr3	38348790	38349377	587	294.0	
18379	chr3	38374152	38374718	566	283.0	
18380	chr3	38426769	38427170	401	200.0	
18381	chr3	38438382	38439072	690	345.0	
18382	chr3	38453104	38456073	2969	1484.0	
18383	chr3	38479598	38480266	668	334.0	
18384	chr3	38495712	38497094	1382	691.0	
18385	chr3	38519530	38520185	655	328.0	
18386	chr3	38521320	38521972	652	326.0	
18387	chr3	38649056	38651808	2752	1376.0	
18388	chr3	38655684	38656101	417	208.0	
18389	chr3	38834114	38834426	312	156.0	
18390	chr3	38950599	38950954	355	178.0	
18391	chr3	38960985	38961391	406	203.0	
18392	chr3	38986121	38986311	190	95.0	
18393	chr3	38999915	39000391	476	238.0	
18394	chr3	39025139	39025575	436	218.0	
18395	chr3	39030800	39031191	391	196.0	
18396	chr3	39049951	39050513	562	281.0	
18397	chr3	39051279	39053057	1778	889.0	
18398	chr3	39065069	39065633	564	282.0	
18399	chr3	39086096	39086546	450	225.0	
18400	chr3	39098293	39098495	202	101.0	
18401	chr3	39100856	39104415	3559	1780.0	
18402	chr3	39106298	39109197	2899	1450.0	
18403	chr3	39110015	39110424	409	204.0	
18404	chr3	39126400	39128833	2433	1216.0	
18405	chr3	39129628	39154821	25193	12596.0	
18406	chr3	39155573	39156260	687	344.0	
18407	chr3	39166084	39167661	1577	788.0	
18408	chr3	39175995	39178508	2513	1256.0	
18409	chr3	39180170	39182274	2104	1052.0	
18410	chr3	39182835	39183267	432	216.0	
18411	chr3	39183944	39184597	653	326.0	
18412	chr3	39189529	39190532	1003	502.0	
18413	chr3	39208382	39208883	501	250.0	
18414	chr3	39216062	39216844	782	391.0	
18415	chr3	39220617	39221256	639	320.0	
18416	chr3	39222390	39223241	851	426.0	
18417	chr3	39232279	39232675	396	198.0	
18418	chr3	39234441	39235214	773	386.0	
18419	chr3	39241377	39242159	782	391.0	
18420	chr3	39249313	39250857	1544	772.0	
18421	chr3	39255142	39257464	2322	1161.0	
18422	chr3	39260796	39261773	977	488.0	
18423	chr3	39262803	39264506	1703	852.0	
18424	chr3	39267194	39268736	1542	771.0	
18425	chr3	39271326	39272853	1527	764.0	
18426	chr3	39276674	39277095	421	210.0	
18427	chr3	39278051	39278525	474	237.0	
18428	chr3	39279798	39282037	2239	1120.0	
18429	chr3	39284326	39284964	638	319.0	
18430	chr3	39288050	39289012	962	481.0	
18431	chr3	39290302	39290413	111	56.0	
18432	chr3	39291601	39292474	873	436.0	
18433	chr3	39317594	39317899	305	152.0	
18434	chr3	39358227	39358708	481	240.0	
18435	chr3	39361266	39362043	777	388.0	
18436	chr3	39377981	39378564	583	292.0	
18437	chr3	39383002	39384931	1929	964.0	
18438	chr3	39385466	39385921	455	228.0	
18439	chr3	39387469	39387911	442	221.0	
18440	chr3	39388706	39389485	779	390.0	
18441	chr3	39405912	39407709	1797	898.0	
18442	chr3	39408494	39409435	941	470.0	
18443	chr3	39416219	39416260	41	20.0	
18444	chr3	39417312	39417976	664	332.0	
18445	chr3	39447794	39448294	500	250.0	
18446	chr3	39498620	39498955	335	168.0	
18447	chr3	39639240	39639750	510	255.0	
18448	chr3	40191805	40192280	475	238.0	
18449	chr3	40229252	40230373	1121	560.0	
18450	chr3	40290364	40290832	468	234.0	
18451	chr3	40299406	40300514	1108	554.0	
18452	chr3	40308813	40310975	2162	1081.0	
18453	chr3	40313993	40314920	927	464.0	
18454	chr3	40316876	40317529	653	326.0	
18455	chr3	40327519	40328046	527	264.0	
18456	chr3	40386913	40387387	474	237.0	
18457	chr3	40452236	40454003	1767	884.0	
18458	chr3	40456541	40458128	1587	794.0	
18459	chr3	40459702	40460088	386	193.0	
18460	chr3	40463996	40464958	962	481.0	
18461	chr3	40476499	40477909	1410	705.0	
18462	chr3	40483158	40483544	386	193.0	
18463	chr3	40505589	40506748	1159	580.0	
18464	chr3	40524187	40525851	1664	832.0	
18465	chr3	40580473	40580962	489	244.0	
18466	chr3	40584477	40584967	490	245.0	
18467	chr3	40623365	40624776	1411	706.0	
18468	chr3	40714995	40715369	374	187.0	
18469	chr3	40718497	40719096	599	300.0	
18470	chr3	40762679	40763212	533	266.0	
18471	chr3	40769939	40770549	610	305.0	
18472	chr3	40798463	40799049	586	293.0	
18473	chr3	40800372	40800767	395	198.0	
18474	chr3	40930030	40930473	443	222.0	
18475	chr3	40971054	40972333	1279	640.0	
18476	chr3	41031378	41031750	372	186.0	
18477	chr3	41116870	41118786	1916	958.0	
18478	chr3	41137526	41138426	900	450.0	
18479	chr3	41190536	41190856	320	160.0	
18480	chr3	41198453	41201346	2893	1446.0	
18481	chr3	41201949	41203357	1408	704.0	
18482	chr3	41205831	41205863	32	16.0	
18483	chr3	41206428	41208046	1618	809.0	
18484	chr3	41210330	41211448	1118	559.0	
18485	chr3	41212764	41213491	727	364.0	
18486	chr3	41214044	41214385	341	170.0	
18487	chr3	41215061	41215935	874	437.0	
18488	chr3	41216897	41217406	509	254.0	
18489	chr3	41221064	41222915	1851	926.0	
18490	chr3	41224168	41224496	328	164.0	
18491	chr3	41227128	41227239	111	56.0	
18492	chr3	41238799	41239528	729	364.0	
18493	chr3	41242049	41246084	4035	2018.0	
18494	chr3	41352586	41352844	258	129.0	
18495	chr3	41405463	41405828	365	182.0	
18496	chr3	41419081	41420090	1009	504.0	
18497	chr3	41424818	41424947	129	64.0	
18498	chr3	41572726	41573009	283	142.0	
18499	chr3	41581808	41581928	120	60.0	
18500	chr3	41881159	41881671	512	256.0	
18501	chr3	41960730	41963122	2392	1196.0	
18502	chr3	41987466	41987947	481	240.0	
18503	chr3	41997933	41998271	338	169.0	
18504	chr3	42010971	42011172	201	100.0	
18505	chr3	42012029	42016283	4254	2127.0	
18506	chr3	42023419	42023710	291	146.0	
18507	chr3	42025022	42026052	1030	515.0	
18508	chr3	42048453	42048963	510	255.0	
18509	chr3	42057502	42058054	552	276.0	
18510	chr3	42061008	42062104	1096	548.0	
18511	chr3	42066377	42068308	1931	966.0	
18512	chr3	42071947	42072813	866	433.0	
18513	chr3	42080281	42081186	905	452.0	
18514	chr3	42081842	42082525	683	342.0	
18515	chr3	42092149	42092208	59	30.0	
18516	chr3	42099392	42100395	1003	502.0	
18517	chr3	42101017	42101548	531	266.0	
18518	chr3	42114075	42114599	524	262.0	
18519	chr3	42118898	42119920	1022	511.0	
18520	chr3	42159616	42160374	758	379.0	
18521	chr3	42164604	42165074	470	235.0	
18522	chr3	42191082	42191631	549	274.0	
18523	chr3	42192460	42193280	820	410.0	
18524	chr3	42213447	42214342	895	448.0	
18525	chr3	42216364	42217340	976	488.0	
18526	chr3	42247448	42248094	646	323.0	
18527	chr3	42264728	42264973	245	122.0	
18528	chr3	42369189	42369686	497	248.0	
18529	chr3	42375179	42375543	364	182.0	
18530	chr3	42388391	42388698	307	154.0	
18531	chr3	42443785	42444283	498	249.0	
18532	chr3	42476431	42476595	164	82.0	
18533	chr3	42487041	42487614	573	286.0	
18534	chr3	42490177	42490738	561	280.0	
18535	chr3	42491908	42492911	1003	502.0	
18536	chr3	42501115	42505206	4091	2046.0	
18537	chr3	42507509	42508263	754	377.0	
18538	chr3	42511806	42512096	290	145.0	
18539	chr3	42518775	42519381	606	303.0	
18540	chr3	42524676	42525419	743	372.0	
18541	chr3	42526489	42527606	1117	558.0	
18542	chr3	42529251	42530211	960	480.0	
18543	chr3	42536302	42536867	565	282.0	
18544	chr3	42539480	42540345	865	432.0	
18545	chr3	42547363	42548019	656	328.0	
18546	chr3	42555857	42556977	1120	560.0	
18547	chr3	42557830	42558280	450	225.0	
18548	chr3	42572217	42572719	502	251.0	
18549	chr3	42580271	42583137	2866	1433.0	
18550	chr3	42589872	42591981	2109	1054.0	
18551	chr3	42599827	42602319	2492	1246.0	
18552	chr3	42611171	42611305	134	67.0	
18553	chr3	42613301	42613929	628	314.0	
18554	chr3	42635055	42635528	473	236.0	
18555	chr3	42637971	42639689	1718	859.0	
18556	chr3	42652421	42656675	4254	2127.0	
18557	chr3	42659071	42659468	397	198.0	
18558	chr3	42663715	42664385	670	335.0	
18559	chr3	42683872	42684331	459	230.0	
18560	chr3	42701348	42701873	525	262.0	
18561	chr3	42744030	42744734	704	352.0	
18562	chr3	42747492	42748049	557	278.0	
18563	chr3	42749891	42750421	530	265.0	
18564	chr3	42755677	42756071	394	197.0	
18565	chr3	42760311	42760858	547	274.0	
18566	chr3	42761801	42762708	907	454.0	
18567	chr3	42764887	42765320	433	216.0	
18568	chr3	42766373	42766709	336	168.0	
18569	chr3	42770425	42770614	189	94.0	
18570	chr3	42772272	42773789	1517	758.0	
18571	chr3	42780620	42781431	811	406.0	
18572	chr3	42803338	42805538	2200	1100.0	
18573	chr3	42811401	42811897	496	248.0	
18574	chr3	42831174	42831837	663	332.0	
18575	chr3	42839576	42840224	648	324.0	
18576	chr3	42846888	42847876	988	494.0	
18577	chr3	42880465	42881770	1305	652.0	
18578	chr3	42905894	42906604	710	355.0	
18579	chr3	42935546	42935841	295	148.0	
18580	chr3	42961586	42962006	420	210.0	
18581	chr3	42979084	42979827	743	372.0	
18582	chr3	43011341	43018206	6865	3432.0	
18583	chr3	43023682	43024982	1300	650.0	
18584	chr3	43036726	43037320	594	297.0	
18585	chr3	43071255	43071671	416	208.0	
18586	chr3	43105116	43106612	1496	748.0	
18587	chr3	43162042	43163789	1747	874.0	
18588	chr3	43178901	43181825	2924	1462.0	
18589	chr3	43194112	43195055	943	472.0	
18590	chr3	43198425	43198638	213	106.0	
18591	chr3	43215743	43216078	335	168.0	
18592	chr3	43222603	43223022	419	210.0	
18593	chr3	43223653	43224067	414	207.0	
18594	chr3	43243941	43244392	451	226.0	
18595	chr3	43247016	43247229	213	106.0	
18596	chr3	43255654	43257471	1817	908.0	
18597	chr3	43285941	43291822	5881	2940.0	
18598	chr3	43292510	43293122	612	306.0	
18599	chr3	43296389	43297469	1080	540.0	
18600	chr3	43298103	43299125	1022	511.0	
18601	chr3	43302377	43302636	259	130.0	
18602	chr3	43307836	43308164	328	164.0	
18603	chr3	43317367	43317934	567	284.0	
18604	chr3	43326392	43327991	1599	800.0	
18605	chr3	43343198	43343714	516	258.0	
18606	chr3	43345534	43348171	2637	1318.0	
18607	chr3	43369746	43370462	716	358.0	
18608	chr3	43377874	43378596	722	361.0	
18609	chr3	43387669	43387722	53	26.0	
18610	chr3	43388834	43390639	1805	902.0	
18611	chr3	43406138	43406289	151	76.0	
18612	chr3	43477362	43478727	1365	682.0	
18613	chr3	43499189	43499711	522	261.0	
18614	chr3	43503027	43503548	521	260.0	
18615	chr3	43544216	43544621	405	202.0	
18616	chr3	43608679	43609070	391	196.0	
18617	chr3	43621063	43622972	1909	954.0	
18618	chr3	43638827	43638891	64	32.0	
18619	chr3	43641334	43642007	673	336.0	
18620	chr3	43646285	43646844	559	280.0	
18621	chr3	43689886	43693165	3279	1640.0	
18622	chr3	43695482	43696344	862	431.0	
18623	chr3	43699887	43700324	437	218.0	
18624	chr3	43707856	43709840	1984	992.0	
18625	chr3	43712145	43712434	289	144.0	
18626	chr3	43713444	43714176	732	366.0	
18627	chr3	43715997	43716347	350	175.0	
18628	chr3	43755508	43755961	453	226.0	
18629	chr3	43769151	43771246	2095	1048.0	
18630	chr3	43773130	43774183	1053	526.0	
18631	chr3	43855711	43856048	337	168.0	
18632	chr3	43894305	43894352	47	24.0	
18633	chr3	43907420	43907786	366	183.0	
18634	chr3	43994957	43995483	526	263.0	
18635	chr3	43996309	43997400	1091	546.0	
18636	chr3	43998699	43999313	614	307.0	
18637	chr3	44045732	44046348	616	308.0	
18638	chr3	44058363	44059024	661	330.0	
18639	chr3	44198582	44199106	524	262.0	
18640	chr3	44208110	44208531	421	210.0	
18641	chr3	44235745	44236341	596	298.0	
18642	chr3	44323340	44323796	456	228.0	
18643	chr3	44330162	44330177	15	8.0	
18644	chr3	44337536	44339400	1864	932.0	
18645	chr3	44355680	44355977	297	148.0	
18646	chr3	44439196	44441198	2002	1001.0	
18647	chr3	44476109	44478323	2214	1107.0	
18648	chr3	44509443	44511531	2088	1044.0	
18649	chr3	44516201	44516563	362	181.0	
18650	chr3	44518130	44518605	475	238.0	
18651	chr3	44530114	44530287	173	86.0	
18652	chr3	44532703	44533264	561	280.0	
18653	chr3	44554687	44556118	1431	716.0	
18654	chr3	44584517	44585442	925	462.0	
18655	chr3	44624544	44625677	1133	566.0	
18656	chr3	44648440	44649113	673	336.0	
18657	chr3	44685034	44685888	854	427.0	
18658	chr3	44712365	44713054	689	344.0	
18659	chr3	44729121	44730032	911	456.0	
18660	chr3	44761030	44762400	1370	685.0	
18661	chr3	44861159	44862831	1672	836.0	
18662	chr3	44865163	44866174	1011	506.0	
18663	chr3	44913860	44914333	473	236.0	
18664	chr3	44954504	44955517	1013	506.0	
18665	chr3	44966909	44967455	546	273.0	
18666	chr3	44968989	44970120	1131	566.0	
18667	chr3	44975017	44977323	2306	1153.0	
18668	chr3	44981240	44982167	927	464.0	
18669	chr3	44984236	44984802	566	283.0	
18670	chr3	44988103	44988488	385	192.0	
18671	chr3	44991402	44991627	225	112.0	
18672	chr3	44992553	44992959	406	203.0	
18673	chr3	45005616	45006311	695	348.0	
18674	chr3	45011867	45012416	549	274.0	
18675	chr3	45020515	45020977	462	231.0	
18676	chr3	45025125	45025154	29	14.0	
18677	chr3	45034530	45036410	1880	940.0	
18678	chr3	45037363	45038344	981	490.0	
18679	chr3	45040595	45041987	1392	696.0	
18680	chr3	45043440	45044146	706	353.0	
18681	chr3	45054540	45055941	1401	700.0	
18682	chr3	45064342	45065547	1205	602.0	
18683	chr3	45076205	45076766	561	280.0	
18684	chr3	45098555	45098638	83	42.0	
18685	chr3	45100918	45101444	526	263.0	
18686	chr3	45105625	45106354	729	364.0	
18687	chr3	45109763	45110806	1043	522.0	
18688	chr3	45117718	45118382	664	332.0	
18689	chr3	45133623	45134408	785	392.0	
18690	chr3	45139124	45139176	52	26.0	
18691	chr3	45144212	45144744	532	266.0	
18692	chr3	45145531	45146849	1318	659.0	
18693	chr3	45163519	45163929	410	205.0	
18694	chr3	45166805	45168060	1255	628.0	
18695	chr3	45205181	45205484	303	152.0	
18696	chr3	45210322	45211031	709	354.0	
18697	chr3	45224825	45226873	2048	1024.0	
18698	chr3	45252861	45253200	339	170.0	
18699	chr3	45362859	45363116	257	128.0	
18700	chr3	45367392	45367703	311	156.0	
18701	chr3	45387934	45389532	1598	799.0	
18702	chr3	45464366	45464972	606	303.0	
18703	chr3	45497763	45498475	712	356.0	
18704	chr3	45507779	45508199	420	210.0	
18705	chr3	45511419	45512061	642	321.0	
18706	chr3	45537640	45538523	883	442.0	
18707	chr3	45544419	45546028	1609	804.0	
18708	chr3	45546878	45548537	1659	830.0	
18709	chr3	45553268	45554759	1491	746.0	
18710	chr3	45560278	45560645	367	184.0	
18711	chr3	45565300	45566711	1411	706.0	
18712	chr3	45567547	45568403	856	428.0	
18713	chr3	45590908	45591263	355	178.0	
18714	chr3	45592792	45597920	5128	2564.0	
18715	chr3	45599754	45600690	936	468.0	
18716	chr3	45608616	45609281	665	332.0	
18717	chr3	45611761	45612053	292	146.0	
18718	chr3	45623282	45623829	547	274.0	
18719	chr3	45624501	45625044	543	272.0	
18720	chr3	45628786	45629330	544	272.0	
18721	chr3	45631397	45631954	557	278.0	
18722	chr3	45639866	45640468	602	301.0	
18723	chr3	45645754	45647904	2150	1075.0	
18724	chr3	45653641	45655059	1418	709.0	
18725	chr3	45655874	45657235	1361	680.0	
18726	chr3	45659804	45660593	789	394.0	
18727	chr3	45664247	45665941	1694	847.0	
18728	chr3	45676571	45677521	950	475.0	
18729	chr3	45679684	45680171	487	244.0	
18730	chr3	45688089	45691076	2987	1494.0	
18731	chr3	45691931	45692127	196	98.0	
18732	chr3	45692977	45694838	1861	930.0	
18733	chr3	45695704	45696062	358	179.0	
18734	chr3	45724962	45725235	273	136.0	
18735	chr3	45741734	45742132	398	199.0	
18736	chr3	45761085	45761554	469	234.0	
18737	chr3	45795807	45796830	1023	512.0	
18738	chr3	45841141	45842718	1577	788.0	
18739	chr3	45865148	45865515	367	184.0	
18740	chr3	45869786	45870698	912	456.0	
18741	chr3	45880901	45881949	1048	524.0	
18742	chr3	45892608	45893303	695	348.0	
18743	chr3	45905020	45905234	214	107.0	
18744	chr3	45908090	45908744	654	327.0	
18745	chr3	45911519	45912223	704	352.0	
18746	chr3	45915041	45916699	1658	829.0	
18747	chr3	45928855	45929600	745	372.0	
18748	chr3	45932021	45932690	669	334.0	
18749	chr3	45938538	45939609	1071	536.0	
18750	chr3	45942270	45943834	1564	782.0	
18751	chr3	45944756	45945266	510	255.0	
18752	chr3	45946720	45947229	509	254.0	
18753	chr3	45950357	45951627	1270	635.0	
18754	chr3	45958166	45958899	733	366.0	
18755	chr3	45962010	45962376	366	183.0	
18756	chr3	45964175	45964515	340	170.0	
18757	chr3	45965280	45966161	881	440.0	
18758	chr3	45972313	45973148	835	418.0	
18759	chr3	45975863	45977285	1422	711.0	
18760	chr3	45978385	45978810	425	212.0	
18761	chr3	45987918	45988739	821	410.0	
18762	chr3	45992179	45996704	4525	2262.0	
18763	chr3	46017611	46018258	647	324.0	
18764	chr3	46046216	46046661	445	222.0	
18765	chr3	46059033	46059904	871	436.0	
18766	chr3	46063319	46063669	350	175.0	
18767	chr3	46064859	46066296	1437	718.0	
18768	chr3	46067899	46068994	1095	548.0	
18769	chr3	46070385	46071175	790	395.0	
18770	chr3	46076614	46076958	344	172.0	
18771	chr3	46078551	46079412	861	430.0	
18772	chr3	46087862	46088304	442	221.0	
18773	chr3	46088909	46091451	2542	1271.0	
18774	chr3	46093587	46093733	146	73.0	
18775	chr3	46095024	46095945	921	460.0	
18776	chr3	46097505	46099050	1545	772.0	
18777	chr3	46100619	46101643	1024	512.0	
18778	chr3	46102389	46102858	469	234.0	
18779	chr3	46107448	46109992	2544	1272.0	
18780	chr3	46110515	46111669	1154	577.0	
18781	chr3	46114337	46114715	378	189.0	
18782	chr3	46117036	46117141	105	52.0	
18783	chr3	46130328	46131091	763	382.0	
18784	chr3	46132523	46133040	517	258.0	
18785	chr3	46135458	46135918	460	230.0	
18786	chr3	46141828	46142254	426	213.0	
18787	chr3	46143858	46144488	630	315.0	
18788	chr3	46183248	46183833	585	292.0	
18789	chr3	46184550	46184799	249	124.0	
18790	chr3	46186711	46187465	754	377.0	
18791	chr3	46191704	46192254	550	275.0	
18792	chr3	46193357	46193905	548	274.0	
18793	chr3	46206695	46209104	2409	1204.0	
18794	chr3	46209634	46210121	487	244.0	
18795	chr3	46212162	46213784	1622	811.0	
18796	chr3	46221434	46223449	2015	1008.0	
18797	chr3	46228233	46228729	496	248.0	
18798	chr3	46236238	46236768	530	265.0	
18799	chr3	46242085	46242565	480	240.0	
18800	chr3	46245187	46245535	348	174.0	
18801	chr3	46269485	46269808	323	162.0	
18802	chr3	46276431	46277151	720	360.0	
18803	chr3	46279917	46280617	700	350.0	
18804	chr3	46283990	46285601	1611	806.0	
18805	chr3	46289914	46290404	490	245.0	
18806	chr3	46293284	46294390	1106	553.0	
18807	chr3	46297571	46301934	4363	2182.0	
18808	chr3	46312579	46313482	903	452.0	
18809	chr3	46316196	46316720	524	262.0	
18810	chr3	46317953	46318665	712	356.0	
18811	chr3	46321344	46321928	584	292.0	
18812	chr3	46324230	46324319	89	44.0	
18813	chr3	46348849	46350575	1726	863.0	
18814	chr3	46353098	46354659	1561	780.0	
18815	chr3	46359729	46362286	2557	1278.0	
18816	chr3	46368292	46372910	4618	2309.0	
18817	chr3	46375608	46376214	606	303.0	
18818	chr3	46378332	46378825	493	246.0	
18819	chr3	46380754	46381307	553	276.0	
18820	chr3	46383408	46384382	974	487.0	
18821	chr3	46386293	46386539	246	123.0	
18822	chr3	46393499	46393950	451	226.0	
18823	chr3	46395169	46396597	1428	714.0	
18824	chr3	46399611	46399859	248	124.0	
18825	chr3	46404812	46408030	3218	1609.0	
18826	chr3	46440756	46441444	688	344.0	
18827	chr3	46442551	46443013	462	231.0	
18828	chr3	46447262	46447985	723	362.0	
18829	chr3	46462036	46462511	475	238.0	
18830	chr3	46469721	46470041	320	160.0	
18831	chr3	46478428	46478829	401	200.0	
18832	chr3	46488571	46489377	806	403.0	
18833	chr3	46496866	46497116	250	125.0	
18834	chr3	46538397	46539935	1538	769.0	
18835	chr3	46541839	46542187	348	174.0	
18836	chr3	46558111	46559014	903	452.0	
18837	chr3	46566005	46566496	491	246.0	
18838	chr3	46629584	46630555	971	486.0	
18839	chr3	46663947	46663976	29	14.0	
18840	chr3	46692650	46696640	3990	1995.0	
18841	chr3	46699036	46699200	164	82.0	
18842	chr3	46699752	46700367	615	308.0	
18843	chr3	46701235	46701702	467	234.0	
18844	chr3	46704760	46705621	861	430.0	
18845	chr3	46717792	46718167	375	188.0	
18846	chr3	46812112	46812936	824	412.0	
18847	chr3	46829661	46830068	407	204.0	
18848	chr3	46845203	46846716	1513	756.0	
18849	chr3	46860446	46860592	146	73.0	
18850	chr3	46865209	46865394	185	92.0	
18851	chr3	46866507	46867177	670	335.0	
18852	chr3	46881654	46883624	1970	985.0	
18853	chr3	46892156	46892968	812	406.0	
18854	chr3	46894943	46895787	844	422.0	
18855	chr3	46898529	46899025	496	248.0	
18856	chr3	46903747	46904013	266	133.0	
18857	chr3	46909144	46910269	1125	562.0	
18858	chr3	46913666	46914034	368	184.0	
18859	chr3	46923427	46924093	666	333.0	
18860	chr3	46926130	46928782	2652	1326.0	
18861	chr3	46929388	46932178	2790	1395.0	
18862	chr3	46932835	46933018	183	92.0	
18863	chr3	46934763	46936641	1878	939.0	
18864	chr3	46938694	46940094	1400	700.0	
18865	chr3	46947065	46949834	2769	1384.0	
18866	chr3	46953045	46954504	1459	730.0	
18867	chr3	46955425	46956529	1104	552.0	
18868	chr3	46958975	46960542	1567	784.0	
18869	chr3	46964362	46964544	182	91.0	
18870	chr3	46965071	46965788	717	358.0	
18871	chr3	46966854	46967192	338	169.0	
18872	chr3	46971695	46972806	1111	556.0	
18873	chr3	46974334	46975048	714	357.0	
18874	chr3	46975786	46977467	1681	840.0	
18875	chr3	46978829	46982788	3959	1980.0	
18876	chr3	46985104	46985432	328	164.0	
18877	chr3	46986874	46991178	4304	2152.0	
18878	chr3	46998160	46999131	971	486.0	
18879	chr3	47006153	47006265	112	56.0	
18880	chr3	47007089	47011574	4485	2242.0	
18881	chr3	47012265	47013297	1032	516.0	
18882	chr3	47016794	47018173	1379	690.0	
18883	chr3	47030981	47031548	567	284.0	
18884	chr3	47037579	47038703	1124	562.0	
18885	chr3	47050593	47051019	426	213.0	
18886	chr3	47056912	47057817	905	452.0	
18887	chr3	47082487	47082988	501	250.0	
18888	chr3	47083728	47084304	576	288.0	
18889	chr3	47141165	47141502	337	168.0	
18890	chr3	47159368	47159822	454	227.0	
18891	chr3	47161940	47165596	3656	1828.0	
18892	chr3	47175946	47176010	64	32.0	
18893	chr3	47225108	47226106	998	499.0	
18894	chr3	47227477	47228904	1427	714.0	
18895	chr3	47250558	47251003	445	222.0	
18896	chr3	47266696	47267112	416	208.0	
18897	chr3	47280698	47285495	4797	2398.0	
18898	chr3	47286786	47287101	315	158.0	
18899	chr3	47288939	47289845	906	453.0	
18900	chr3	47296759	47297363	604	302.0	
18901	chr3	47299605	47299704	99	50.0	
18902	chr3	47314767	47315470	703	352.0	
18903	chr3	47323693	47324692	999	500.0	
18904	chr3	47347048	47347787	739	370.0	
18905	chr3	47362507	47363424	917	458.0	
18906	chr3	47371116	47371583	467	234.0	
18907	chr3	47372605	47372729	124	62.0	
18908	chr3	47377139	47377714	575	288.0	
18909	chr3	47380011	47382223	2212	1106.0	
18910	chr3	47412484	47412812	328	164.0	
18911	chr3	47418917	47419175	258	129.0	
18912	chr3	47420635	47422771	2136	1068.0	
18913	chr3	47464502	47464999	497	248.0	
18914	chr3	47465828	47466515	687	344.0	
18915	chr3	47474901	47476657	1756	878.0	
18916	chr3	47512536	47514202	1666	833.0	
18917	chr3	47521993	47522875	882	441.0	
18918	chr3	47577559	47579590	2031	1016.0	
18919	chr3	47635027	47635920	893	446.0	
18920	chr3	47780100	47782836	2736	1368.0	
18921	chr3	47788496	47789883	1387	694.0	
18922	chr3	47799773	47800092	319	160.0	
18923	chr3	47802099	47804053	1954	977.0	
18924	chr3	47824468	47825781	1313	656.0	
18925	chr3	47837627	47838102	475	238.0	
18926	chr3	47850033	47850388	355	178.0	
18927	chr3	47893964	47894316	352	176.0	
18928	chr3	47985374	47985822	448	224.0	
18929	chr3	47989858	47990529	671	336.0	
18930	chr3	48087256	48089794	2538	1269.0	
18931	chr3	48112332	48113106	774	387.0	
18932	chr3	48151444	48151914	470	235.0	
18933	chr3	48158105	48158461	356	178.0	
18934	chr3	48187389	48189202	1813	906.0	
18935	chr3	48194382	48194882	500	250.0	
18936	chr3	48222295	48223854	1559	780.0	
18937	chr3	48227014	48227306	292	146.0	
18938	chr3	48232594	48233840	1246	623.0	
18939	chr3	48239425	48239914	489	244.0	
18940	chr3	48240591	48242155	1564	782.0	
18941	chr3	48247253	48247933	680	340.0	
18942	chr3	48268127	48269684	1557	778.0	
18943	chr3	48273557	48274078	521	260.0	
18944	chr3	48300002	48302328	2326	1163.0	
18945	chr3	48307097	48307268	171	86.0	
18946	chr3	48335011	48335704	693	346.0	
18947	chr3	48366479	48366957	478	239.0	
18948	chr3	48400773	48401350	577	288.0	
18949	chr3	48428500	48430494	1994	997.0	
18950	chr3	48435647	48436832	1185	592.0	
18951	chr3	48439521	48441332	1811	906.0	
18952	chr3	48446032	48448063	2031	1016.0	
18953	chr3	48464998	48467611	2613	1306.0	
18954	chr3	48468986	48468990	4	2.0	
18955	chr3	48470048	48470328	280	140.0	
18956	chr3	48471949	48473880	1931	966.0	
18957	chr3	48477958	48480002	2044	1022.0	
18958	chr3	48502805	48505221	2416	1208.0	
18959	chr3	48507318	48508362	1044	522.0	
18960	chr3	48514730	48515227	497	248.0	
18961	chr3	48518809	48519210	401	200.0	
18962	chr3	48527379	48529150	1771	886.0	
18963	chr3	48532573	48533099	526	263.0	
18964	chr3	48543128	48544495	1367	684.0	
18965	chr3	48546476	48546631	155	78.0	
18966	chr3	48548518	48549401	883	442.0	
18967	chr3	48553388	48553744	356	178.0	
18968	chr3	48556127	48561779	5652	2826.0	
18969	chr3	48563518	48564796	1278	639.0	
18970	chr3	48565562	48566598	1036	518.0	
18971	chr3	48594878	48596069	1191	596.0	
18972	chr3	48608845	48610188	1343	672.0	
18973	chr3	48614000	48614599	599	300.0	
18974	chr3	48634336	48636397	2061	1030.0	
18975	chr3	48655134	48657472	2338	1169.0	
18976	chr3	48661227	48664696	3469	1734.0	
18977	chr3	48679910	48680133	223	112.0	
18978	chr3	48684472	48687003	2531	1266.0	
18979	chr3	48714508	48715783	1275	638.0	
18980	chr3	48716408	48718145	1737	868.0	
18981	chr3	48736882	48737721	839	420.0	
18982	chr3	48739761	48740398	637	318.0	
18983	chr3	48742004	48742637	633	316.0	
18984	chr3	48748438	48749285	847	424.0	
18985	chr3	48751005	48751243	238	119.0	
18986	chr3	48765441	48765616	175	88.0	
18987	chr3	48769779	48770503	724	362.0	
18988	chr3	48788558	48788976	418	209.0	
18989	chr3	48809364	48810057	693	346.0	
18990	chr3	48811963	48813091	1128	564.0	
18991	chr3	48846865	48848849	1984	992.0	
18992	chr3	48859307	48859620	313	156.0	
18993	chr3	48879931	48880091	160	80.0	
18994	chr3	48896837	48899843	3006	1503.0	
18995	chr3	48904490	48904894	404	202.0	
18996	chr3	48917900	48920413	2513	1256.0	
18997	chr3	48926616	48927178	562	281.0	
18998	chr3	48927902	48928343	441	220.0	
18999	chr3	48931219	48932312	1093	546.0	
19000	chr3	48932912	48933329	417	208.0	
19001	chr3	48935616	48935953	337	168.0	
19002	chr3	48952459	48952938	479	240.0	
19003	chr3	48987568	48988308	740	370.0	
19004	chr3	48989318	48991758	2440	1220.0	
19005	chr3	49006278	49008996	2718	1359.0	
19006	chr3	49011752	49015042	3290	1645.0	
19007	chr3	49015657	49019173	3516	1758.0	
19008	chr3	49019722	49026967	7245	3622.0	
19009	chr3	49027855	49030162	2307	1154.0	
19010	chr3	49035258	49035730	472	236.0	
19011	chr3	49068357	49068433	76	38.0	
19012	chr3	49092593	49095117	2524	1262.0	
19013	chr3	49103996	49105449	1453	726.0	
19014	chr3	49120017	49121956	1939	970.0	
19015	chr3	49122501	49122635	134	67.0	
19016	chr3	49123636	49124000	364	182.0	
19017	chr3	49125394	49125404	10	5.0	
19018	chr3	49132454	49132918	464	232.0	
19019	chr3	49133457	49134022	565	282.0	
19020	chr3	49158001	49158856	855	428.0	
19021	chr3	49162149	49162451	302	151.0	
19022	chr3	49165317	49166939	1622	811.0	
19023	chr3	49170740	49173049	2309	1154.0	
19024	chr3	49238171	49239261	1090	545.0	
19025	chr3	49244926	49244976	50	25.0	
19026	chr3	49248169	49249514	1345	672.0	
19027	chr3	49255027	49255368	341	170.0	
19028	chr3	49276409	49278144	1735	868.0	
19029	chr3	49295429	49295931	502	251.0	
19030	chr3	49332931	49333643	712	356.0	
19031	chr3	49338906	49341367	2461	1230.0	
19032	chr3	49341988	49342303	315	158.0	
19033	chr3	49343184	49343509	325	162.0	
19034	chr3	49344568	49346484	1916	958.0	
19035	chr3	49347364	49347985	621	310.0	
19036	chr3	49349598	49349653	55	28.0	
19037	chr3	49350817	49353455	2638	1319.0	
19038	chr3	49356854	49359296	2442	1221.0	
19039	chr3	49373646	49374198	552	276.0	
19040	chr3	49377394	49378008	614	307.0	
19041	chr3	49385971	49386850	879	440.0	
19042	chr3	49388505	49388723	218	109.0	
19043	chr3	49397397	49397867	470	235.0	
19044	chr3	49401041	49401711	670	335.0	
19045	chr3	49406922	49407474	552	276.0	
19046	chr3	49410428	49413095	2667	1334.0	
19047	chr3	49415460	49416974	1514	757.0	
19048	chr3	49421166	49422679	1513	756.0	
19049	chr3	49428210	49430259	2049	1024.0	
19050	chr3	49443788	49444733	945	472.0	
19051	chr3	49445763	49446147	384	192.0	
19052	chr3	49448831	49449555	724	362.0	
19053	chr3	49465205	49465700	495	248.0	
19054	chr3	49469355	49471453	2098	1049.0	
19055	chr3	49476594	49476932	338	169.0	
19056	chr3	49494994	49495447	453	226.0	
19057	chr3	49500706	49501428	722	361.0	
19058	chr3	49539370	49540788	1418	709.0	
19059	chr3	49553823	49555387	1564	782.0	
19060	chr3	49603080	49603524	444	222.0	
19061	chr3	49665870	49666078	208	104.0	
19062	chr3	49671292	49672472	1180	590.0	
19063	chr3	49673049	49675040	1991	996.0	
19064	chr3	49686047	49687346	1299	650.0	
19065	chr3	49688768	49690363	1595	798.0	
19066	chr3	49703173	49704009	836	418.0	
19067	chr3	49712707	49713100	393	196.0	
19068	chr3	49718668	49721510	2842	1421.0	
19069	chr3	49722236	49725892	3656	1828.0	
19070	chr3	49727148	49727385	237	118.0	
19071	chr3	49785493	49787546	2053	1026.0	
19072	chr3	49789877	49790657	780	390.0	
19073	chr3	49802083	49806840	4757	2378.0	
19074	chr3	49807549	49807804	255	128.0	
19075	chr3	49813023	49814419	1396	698.0	
19076	chr3	49838952	49839844	892	446.0	
19077	chr3	49855954	49857321	1367	684.0	
19078	chr3	49869221	49870186	965	482.0	
19079	chr3	49872889	49873297	408	204.0	
19080	chr3	49903411	49904585	1174	587.0	
19081	chr3	49905530	49906838	1308	654.0	
19082	chr3	49918118	49918640	522	261.0	
19083	chr3	49929099	49930506	1407	704.0	
19084	chr3	49937228	49937475	247	124.0	
19085	chr3	49939454	49941267	1813	906.0	
19086	chr3	49942647	49943029	382	191.0	
19087	chr3	49946725	49947093	368	184.0	
19088	chr3	50075158	50075579	421	210.0	
19089	chr3	50078790	50078879	89	44.0	
19090	chr3	50081960	50083081	1121	560.0	
19091	chr3	50088244	50090073	1829	914.0	
19092	chr3	50090611	50091017	406	203.0	
19093	chr3	50111721	50112154	433	216.0	
19094	chr3	50120217	50122304	2087	1044.0	
19095	chr3	50122925	50123646	721	360.0	
19096	chr3	50126090	50127194	1104	552.0	
19097	chr3	50128322	50128324	2	1.0	
19098	chr3	50138524	50138925	401	200.0	
19099	chr3	50143774	50144165	391	196.0	
19100	chr3	50154155	50156116	1961	980.0	
19101	chr3	50158400	50158402	2	1.0	
19102	chr3	50170601	50171166	565	282.0	
19103	chr3	50173676	50174040	364	182.0	
19104	chr3	50189287	50189704	417	208.0	
19105	chr3	50190924	50191352	428	214.0	
19106	chr3	50192343	50193206	863	432.0	
19107	chr3	50193810	50195549	1739	870.0	
19108	chr3	50204950	50206388	1438	719.0	
19109	chr3	50225761	50228641	2880	1440.0	
19110	chr3	50230036	50230978	942	471.0	
19111	chr3	50233834	50234297	463	232.0	
19112	chr3	50234810	50240017	5207	2604.0	
19113	chr3	50240919	50247659	6740	3370.0	
19114	chr3	50248348	50250600	2252	1126.0	
19115	chr3	50251372	50251976	604	302.0	
19116	chr3	50253079	50255837	2758	1379.0	
19117	chr3	50256482	50262960	6478	3239.0	
19118	chr3	50263694	50265183	1489	744.0	
19119	chr3	50265732	50269328	3596	1798.0	
19120	chr3	50270681	50270886	205	102.0	
19121	chr3	50272729	50276646	3917	1958.0	
19122	chr3	50291499	50293413	1914	957.0	
19123	chr3	50295439	50296016	577	288.0	
19124	chr3	50296524	50300962	4438	2219.0	
19125	chr3	50316493	50317438	945	472.0	
19126	chr3	50318486	50319206	720	360.0	
19127	chr3	50320368	50325917	5549	2774.0	
19128	chr3	50327552	50328985	1433	716.0	
19129	chr3	50333546	50334866	1320	660.0	
19130	chr3	50335447	50344290	8843	4422.0	
19131	chr3	50345008	50346340	1332	666.0	
19132	chr3	50347036	50348044	1008	504.0	
19133	chr3	50349979	50351707	1728	864.0	
19134	chr3	50352723	50353397	674	337.0	
19135	chr3	50356475	50356959	484	242.0	
19136	chr3	50357708	50357855	147	74.0	
19137	chr3	50358645	50360291	1646	823.0	
19138	chr3	50364380	50366868	2488	1244.0	
19139	chr3	50367541	50367570	29	14.0	
19140	chr3	50368928	50369041	113	56.0	
19141	chr3	50375590	50375690	100	50.0	
19142	chr3	50395423	50395901	478	239.0	
19143	chr3	50427826	50428682	856	428.0	
19144	chr3	50429852	50431006	1154	577.0	
19145	chr3	50435655	50436822	1167	584.0	
19146	chr3	50447064	50447987	923	462.0	
19147	chr3	50449672	50451376	1704	852.0	
19148	chr3	50466065	50466611	546	273.0	
19149	chr3	50468005	50468084	79	40.0	
19150	chr3	50472570	50474083	1513	756.0	
19151	chr3	50479111	50479366	255	128.0	
19152	chr3	50480496	50480854	358	179.0	
19153	chr3	50496605	50496613	8	4.0	
19154	chr3	50502266	50504432	2166	1083.0	
19155	chr3	50515399	50516356	957	478.0	
19156	chr3	50519411	50519951	540	270.0	
19157	chr3	50525895	50526440	545	272.0	
19158	chr3	50542194	50543045	851	426.0	
19159	chr3	50549693	50550576	883	442.0	
19160	chr3	50554535	50554875	340	170.0	
19161	chr3	50566822	50570314	3492	1746.0	
19162	chr3	50571002	50571069	67	34.0	
19163	chr3	50571736	50574963	3227	1614.0	
19164	chr3	50588124	50588999	875	438.0	
19165	chr3	50590260	50593130	2870	1435.0	
19166	chr3	50600592	50603145	2553	1276.0	enhancer
19167	chr3	50604800	50606992	2192	1096.0	
19168	chr3	50607620	50608625	1005	502.0	
19169	chr3	50609248	50614715	5467	2734.0	
19170	chr3	50615657	50618630	2973	1486.0	
19171	chr3	50619823	50621334	1511	756.0	
19172	chr3	50623717	50624723	1006	503.0	
19173	chr3	50625231	50625558	327	164.0	
19174	chr3	50627199	50628187	988	494.0	
19175	chr3	50632325	50633191	866	433.0	
19176	chr3	50652692	50653195	503	252.0	
19177	chr3	50654852	50655583	731	366.0	
19178	chr3	50662942	50663758	816	408.0	
19179	chr3	50665566	50665951	385	192.0	
19180	chr3	50673980	50675736	1756	878.0	
19181	chr3	50971345	50972270	925	462.0	
19182	chr3	51024478	51026130	1652	826.0	
19183	chr3	51243998	51244157	159	80.0	
19184	chr3	51257741	51258334	593	296.0	
19185	chr3	51311146	51311301	155	78.0	
19186	chr3	51371887	51372383	496	248.0	
19187	chr3	51384083	51386260	2177	1088.0	
19188	chr3	51387379	51387624	245	122.0	
19189	chr3	51389094	51389951	857	428.0	
19190	chr3	51390488	51393841	3353	1676.0	
19191	chr3	51395051	51395189	138	69.0	
19192	chr3	51396353	51396735	382	191.0	
19193	chr3	51400393	51400416	23	12.0	
19194	chr3	51401682	51402388	706	353.0	
19195	chr3	51498833	51500960	2127	1064.0	
19196	chr3	51501790	51502809	1019	510.0	
19197	chr3	51538068	51539914	1846	923.0	
19198	chr3	51637844	51638290	446	223.0	
19199	chr3	51642464	51642795	331	166.0	
19200	chr3	51657199	51657669	470	235.0	
19201	chr3	51668877	51672703	3826	1913.0	
19202	chr3	51680879	51682723	1844	922.0	
19203	chr3	51685126	51685251	125	62.0	
19204	chr3	51685893	51687390	1497	748.0	
19205	chr3	51693068	51693250	182	91.0	
19206	chr3	51706684	51707180	496	248.0	
19207	chr3	51719044	51719588	544	272.0	
19208	chr3	51739162	51739477	315	158.0	
19209	chr3	51742945	51743471	526	263.0	
19210	chr3	51799867	51800325	458	229.0	
19211	chr3	51929411	51929754	343	172.0	
19212	chr3	51941169	51943557	2388	1194.0	
19213	chr3	51953328	51954519	1191	596.0	
19214	chr3	51955175	51956957	1782	891.0	
19215	chr3	51966775	51968667	1892	946.0	
19216	chr3	51973281	51978217	4936	2468.0	
19217	chr3	51981647	51984628	2981	1490.0	
19218	chr3	51994838	51996623	1785	892.0	
19219	chr3	52001257	52002316	1059	530.0	
19220	chr3	52006038	52006113	75	38.0	
19221	chr3	52036830	52037194	364	182.0	
19222	chr3	52045833	52045848	15	8.0	
19223	chr3	52051842	52058349	6507	3254.0	
19224	chr3	52062155	52063219	1064	532.0	
19225	chr3	52070519	52072379	1860	930.0	
19226	chr3	52076895	52077308	413	206.0	
19227	chr3	52086023	52086024	1	0.0	
19228	chr3	52086987	52087429	442	221.0	
19229	chr3	52088259	52088999	740	370.0	
19230	chr3	52110004	52110030	26	13.0	
19231	chr3	52119765	52120511	746	373.0	
19232	chr3	52121335	52123721	2386	1193.0	
19233	chr3	52135038	52135042	4	2.0	
19234	chr3	52143854	52145056	1202	601.0	
19235	chr3	52153652	52155490	1838	919.0	
19236	chr3	52174795	52175459	664	332.0	
19237	chr3	52178354	52178502	148	74.0	
19238	chr3	52182066	52182554	488	244.0	
19239	chr3	52185861	52186268	407	204.0	
19240	chr3	52189097	52189491	394	197.0	
19241	chr3	52195632	52196582	950	475.0	
19242	chr3	52197291	52199222	1931	966.0	
19243	chr3	52200989	52201673	684	342.0	
19244	chr3	52202354	52203198	844	422.0	
19245	chr3	52210528	52211119	591	296.0	
19246	chr3	52216726	52219272	2546	1273.0	
19247	chr3	52219975	52221071	1096	548.0	
19248	chr3	52221761	52222710	949	474.0	
19249	chr3	52225211	52226778	1567	784.0	
19250	chr3	52231094	52233254	2160	1080.0	
19251	chr3	52236504	52241422	4918	2459.0	
19252	chr3	52243552	52250574	7022	3511.0	
19253	chr3	52252416	52254433	2017	1008.0	
19254	chr3	52262433	52262747	314	157.0	
19255	chr3	52269810	52273859	4049	2024.0	
19256	chr3	52274920	52280385	5465	2732.0	
19257	chr3	52281860	52282684	824	412.0	
19258	chr3	52286846	52288686	1840	920.0	
19259	chr3	52291364	52291873	509	254.0	
19260	chr3	52299674	52300468	794	397.0	
19261	chr3	52307419	52308204	785	392.0	
19262	chr3	52310690	52311431	741	370.0	
19263	chr3	52313301	52314750	1449	724.0	
19264	chr3	52317202	52318240	1038	519.0	
19265	chr3	52339470	52340164	694	347.0	
19266	chr3	52372888	52373581	693	346.0	
19267	chr3	52384059	52384390	331	166.0	
19268	chr3	52390171	52390175	4	2.0	
19269	chr3	52409279	52412702	3423	1712.0	
19270	chr3	52428464	52428977	513	256.0	enhancer
19271	chr3	52432849	52433310	461	230.0	
19272	chr3	52436613	52437182	569	284.0	
19273	chr3	52444701	52445722	1021	510.0	
19274	chr3	52446603	52447623	1020	510.0	
19275	chr3	52454429	52457435	3006	1503.0	
19276	chr3	52458856	52459638	782	391.0	
19277	chr3	52463368	52463954	586	293.0	
19278	chr3	52471869	52472389	520	260.0	
19279	chr3	52475914	52476613	699	350.0	
19280	chr3	52490745	52491441	696	348.0	
19281	chr3	52494818	52496240	1422	711.0	
19282	chr3	52497820	52499458	1638	819.0	
19283	chr3	52532336	52534407	2071	1036.0	
19284	chr3	52535794	52538272	2478	1239.0	
19285	chr3	52539022	52539422	400	200.0	
19286	chr3	52670575	52671532	957	478.0	
19287	chr3	52681574	52682333	759	380.0	
19288	chr3	52683698	52684005	307	154.0	
19289	chr3	52685082	52686725	1643	822.0	
19290	chr3	52697351	52697518	167	84.0	
19291	chr3	52704413	52706793	2380	1190.0	
19292	chr3	52707508	52707822	314	157.0	
19293	chr3	52715774	52715839	65	32.0	
19294	chr3	52720862	52721879	1017	508.0	
19295	chr3	52742380	52742790	410	205.0	
19296	chr3	52752280	52752675	395	198.0	
19297	chr3	52762659	52763819	1160	580.0	
19298	chr3	52770315	52771696	1381	690.0	
19299	chr3	52775243	52775783	540	270.0	
19300	chr3	52778208	52778509	301	150.0	
19301	chr3	52779159	52780239	1080	540.0	
19302	chr3	52781863	52781997	134	67.0	
19303	chr3	52798857	52799452	595	298.0	
19304	chr3	52838756	52839205	449	224.0	
19305	chr3	52845678	52846108	430	215.0	
19306	chr3	52851300	52851791	491	246.0	
19307	chr3	52891070	52894104	3034	1517.0	
19308	chr3	52895413	52898223	2810	1405.0	
19309	chr3	52914927	52915777	850	425.0	
19310	chr3	52920838	52921294	456	228.0	
19311	chr3	52923997	52924315	318	159.0	
19312	chr3	52926972	52927157	185	92.0	
19313	chr3	52934551	52935094	543	272.0	
19314	chr3	52983208	52984358	1150	575.0	
19315	chr3	53018117	53018945	828	414.0	
19316	chr3	53031060	53031464	404	202.0	
19317	chr3	53035765	53036350	585	292.0	
19318	chr3	53044344	53047498	3154	1577.0	
19319	chr3	53071836	53073991	2155	1078.0	
19320	chr3	53092857	53093479	622	311.0	
19321	chr3	53102529	53105247	2718	1359.0	
19322	chr3	53109729	53110651	922	461.0	
19323	chr3	53113676	53115148	1472	736.0	
19324	chr3	53122812	53123397	585	292.0	
19325	chr3	53129623	53131545	1922	961.0	
19326	chr3	53134470	53135298	828	414.0	
19327	chr3	53137692	53138261	569	284.0	
19328	chr3	53140361	53141844	1483	742.0	
19329	chr3	53142755	53143712	957	478.0	
19330	chr3	53146976	53147660	684	342.0	
19331	chr3	53152247	53152582	335	168.0	
19332	chr3	53156540	53156731	191	96.0	
19333	chr3	53157385	53157725	340	170.0	
19334	chr3	53158629	53159648	1019	510.0	
19335	chr3	53160241	53164086	3845	1922.0	
19336	chr3	53165181	53165520	339	170.0	
19337	chr3	53166108	53171188	5080	2540.0	
19338	chr3	53171938	53172845	907	454.0	
19339	chr3	53180475	53181359	884	442.0	
19340	chr3	53194692	53197541	2849	1424.0	
19341	chr3	53212177	53212733	556	278.0	
19342	chr3	53216731	53216973	242	121.0	
19343	chr3	53217991	53218783	792	396.0	
19344	chr3	53219798	53220523	725	362.0	
19345	chr3	53223288	53223417	129	64.0	
19346	chr3	53235951	53236767	816	408.0	
19347	chr3	53239851	53240196	345	172.0	
19348	chr3	53242574	53243320	746	373.0	
19349	chr3	53249344	53250484	1140	570.0	
19350	chr3	53252023	53253164	1141	570.0	
19351	chr3	53254001	53256706	2705	1352.0	
19352	chr3	53257602	53257726	124	62.0	
19353	chr3	53262262	53262474	212	106.0	
19354	chr3	53269685	53270903	1218	609.0	
19355	chr3	53287124	53287355	231	116.0	
19356	chr3	53299481	53300159	678	339.0	
19357	chr3	53327867	53328411	544	272.0	
19358	chr3	53346516	53348377	1861	930.0	
19359	chr3	53350586	53351082	496	248.0	
19360	chr3	53374943	53375435	492	246.0	
19361	chr3	53406979	53407293	314	157.0	
19362	chr3	53518361	53519440	1079	540.0	
19363	chr3	53613014	53613930	916	458.0	
19364	chr3	53696996	53697076	80	40.0	
19365	chr3	53710063	53710590	527	264.0	
19366	chr3	53717078	53717108	30	15.0	
19367	chr3	53748413	53750652	2239	1120.0	
19368	chr3	53753478	53754782	1304	652.0	
19369	chr3	53834419	53834887	468	234.0	
19370	chr3	53845582	53846608	1026	513.0	
19371	chr3	53880733	53883960	3227	1614.0	
19372	chr3	53884695	53885654	959	480.0	
19373	chr3	53886974	53887713	739	370.0	
19374	chr3	53889136	53892809	3673	1836.0	
19375	chr3	53921388	53921583	195	98.0	
19376	chr3	53938642	53938938	296	148.0	
19377	chr3	53996398	53996477	79	40.0	
19378	chr3	54853828	54854163	335	168.0	
19379	chr3	54951390	54951810	420	210.0	
19380	chr3	54963669	54964158	489	244.0	
19381	chr3	54967458	54968364	906	453.0	
19382	chr3	54986110	54986761	651	326.0	
19383	chr3	54988712	54989616	904	452.0	
19384	chr3	54999250	54999564	314	157.0	
19385	chr3	55160493	55160718	225	112.0	
19386	chr3	55485065	55485495	430	215.0	
19387	chr3	55615677	55616358	681	340.0	
19388	chr3	55620216	55620866	650	325.0	
19389	chr3	55623729	55624876	1147	574.0	
19390	chr3	55625617	55626554	937	468.0	
19391	chr3	55632027	55632318	291	146.0	
19392	chr3	55664390	55664577	187	94.0	
19393	chr3	56157598	56158149	551	276.0	
19394	chr3	56303576	56303785	209	104.0	
19395	chr3	56494597	56495170	573	286.0	
19396	chr3	56556498	56558410	1912	956.0	
19397	chr3	56591350	56591738	388	194.0	
19398	chr3	56593410	56594116	706	353.0	
19399	chr3	56682023	56683950	1927	964.0	
19400	chr3	56692416	56695676	3260	1630.0	
19401	chr3	56702413	56703137	724	362.0	
19402	chr3	56704630	56705063	433	216.0	
19403	chr3	56711591	56711767	176	88.0	
19404	chr3	56721446	56721788	342	171.0	
19405	chr3	56724799	56726640	1841	920.0	
19406	chr3	56732144	56733432	1288	644.0	
19407	chr3	56735198	56736009	811	406.0	
19408	chr3	56753028	56753682	654	327.0	
19409	chr3	56754303	56756808	2505	1252.0	
19410	chr3	56758367	56759406	1039	520.0	
19411	chr3	56775627	56776258	631	316.0	
19412	chr3	56782726	56784897	2171	1086.0	
19413	chr3	56785658	56786079	421	210.0	
19414	chr3	56787367	56788950	1583	792.0	
19415	chr3	56789753	56791498	1745	872.0	
19416	chr3	56792065	56792549	484	242.0	
19417	chr3	56795134	56797068	1934	967.0	
19418	chr3	56798076	56798522	446	223.0	
19419	chr3	56799107	56802907	3800	1900.0	
19420	chr3	56827179	56827478	299	150.0	
19421	chr3	56855875	56856280	405	202.0	
19422	chr3	56860962	56861225	263	132.0	
19423	chr3	56878112	56878400	288	144.0	
19424	chr3	56886942	56887842	900	450.0	
19425	chr3	56890816	56891141	325	162.0	
19426	chr3	56915768	56919514	3746	1873.0	
19427	chr3	56921616	56922529	913	456.0	
19428	chr3	56923519	56924534	1015	508.0	
19429	chr3	56928254	56929197	943	472.0	
19430	chr3	56970612	56970839	227	114.0	
19431	chr3	56980646	56981302	656	328.0	
19432	chr3	56986111	56986218	107	54.0	
19433	chr3	56988644	56989515	871	436.0	
19434	chr3	56995293	56996032	739	370.0	
19435	chr3	57017625	57017821	196	98.0	
19436	chr3	57059522	57060861	1339	670.0	
19437	chr3	57064528	57064835	307	154.0	
19438	chr3	57068326	57069200	874	437.0	
19439	chr3	57078204	57079658	1454	727.0	
19440	chr3	57094012	57094405	393	196.0	
19441	chr3	57100022	57100510	488	244.0	
19442	chr3	57159178	57159590	412	206.0	
19443	chr3	57162408	57162590	182	91.0	
19444	chr3	57164027	57165713	1686	843.0	
19445	chr3	57169722	57170632	910	455.0	
19446	chr3	57196910	57197319	409	204.0	
19447	chr3	57226264	57226395	131	66.0	
19448	chr3	57227065	57229699	2634	1317.0	
19449	chr3	57463784	57464182	398	199.0	
19450	chr3	57555407	57557913	2506	1253.0	
19451	chr3	57566117	57566372	255	128.0	
19452	chr3	57567267	57571167	3900	1950.0	
19453	chr3	57573504	57574063	559	280.0	
19454	chr3	57574770	57574972	202	101.0	
19455	chr3	57576905	57577168	263	132.0	
19456	chr3	57579023	57579844	821	410.0	
19457	chr3	57582444	57583639	1195	598.0	
19458	chr3	57584286	57587143	2857	1428.0	
19459	chr3	57587946	57589856	1910	955.0	
19460	chr3	57590570	57590874	304	152.0	
19461	chr3	57591522	57599380	7858	3929.0	
19462	chr3	57616197	57616489	292	146.0	
19463	chr3	57671135	57672004	869	434.0	
19464	chr3	57673093	57673548	455	228.0	
19465	chr3	57681712	57682122	410	205.0	
19466	chr3	57689559	57689710	151	76.0	
19467	chr3	57690525	57690685	160	80.0	
19468	chr3	57691425	57693645	2220	1110.0	
19469	chr3	57706412	57706815	403	202.0	
19470	chr3	57729429	57730049	620	310.0	
19471	chr3	57732294	57732351	57	28.0	
19472	chr3	57755228	57757663	2435	1218.0	
19473	chr3	57778575	57778807	232	116.0	
19474	chr3	57791203	57791682	479	240.0	
19475	chr3	57803543	57803985	442	221.0	
19476	chr3	57805747	57805883	136	68.0	
19477	chr3	57814785	57815484	699	350.0	
19478	chr3	57816808	57817199	391	196.0	
19479	chr3	57840544	57840771	227	114.0	
19480	chr3	57951325	57951847	522	261.0	
19481	chr3	57956052	57956492	440	220.0	
19482	chr3	57959085	57960395	1310	655.0	"enhancer	sequence_feature"
19483	chr3	57962039	57962281	242	121.0	
19484	chr3	57972827	57972879	52	26.0	
19485	chr3	57974689	57975173	484	242.0	"sequence_feature	enhancer"
19486	chr3	57980561	57980753	192	96.0	
19487	chr3	57981415	57984526	3111	1556.0	
19488	chr3	57985729	57986145	416	208.0	
19489	chr3	57998593	57999286	693	346.0	
19490	chr3	58000637	58000984	347	174.0	
19491	chr3	58007687	58010403	2716	1358.0	
19492	chr3	58034660	58035633	973	486.0	
19493	chr3	58038857	58039158	301	150.0	
19494	chr3	58041452	58042161	709	354.0	
19495	chr3	58051233	58051364	131	66.0	
19496	chr3	58052533	58052612	79	40.0	
19497	chr3	58074319	58074779	460	230.0	
19498	chr3	58081952	58082429	477	238.0	
19499	chr3	58085692	58085796	104	52.0	
19500	chr3	58115804	58117010	1206	603.0	
19501	chr3	58120468	58120615	147	74.0	
19502	chr3	58161845	58162118	273	136.0	
19503	chr3	58167280	58167778	498	249.0	
19504	chr3	58173828	58174199	371	186.0	
19505	chr3	58177438	58178595	1157	578.0	
19506	chr3	58181611	58182425	814	407.0	
19507	chr3	58187465	58188174	709	354.0	
19508	chr3	58196321	58196962	641	320.0	
19509	chr3	58203002	58203257	255	128.0	
19510	chr3	58214518	58215461	943	472.0	
19511	chr3	58217083	58218119	1036	518.0	
19512	chr3	58232437	58233145	708	354.0	
19513	chr3	58236758	58238942	2184	1092.0	
19514	chr3	58260363	58260826	463	232.0	
19515	chr3	58272136	58272511	375	188.0	
19516	chr3	58300084	58300496	412	206.0	
19517	chr3	58305694	58308423	2729	1364.0	
19518	chr3	58317842	58318243	401	200.0	
19519	chr3	58320850	58321591	741	370.0	
19520	chr3	58332285	58334155	1870	935.0	
19521	chr3	58334762	58335955	1193	596.0	
19522	chr3	58349744	58351227	1483	742.0	
19523	chr3	58351964	58352333	369	184.0	
19524	chr3	58353854	58356613	2759	1380.0	
19525	chr3	58414466	58415072	606	303.0	
19526	chr3	58432975	58434543	1568	784.0	
19527	chr3	58463303	58464277	974	487.0	
19528	chr3	58470921	58472051	1130	565.0	
19529	chr3	58474383	58475009	626	313.0	
19530	chr3	58478230	58479319	1089	544.0	
19531	chr3	58483006	58484469	1463	732.0	
19532	chr3	58485793	58486244	451	226.0	
19533	chr3	58486993	58487687	694	347.0	
19534	chr3	58489994	58490190	196	98.0	
19535	chr3	58490929	58493179	2250	1125.0	
19536	chr3	58525780	58527115	1335	668.0	
19537	chr3	58532499	58533388	889	444.0	
19538	chr3	58568558	58569039	481	240.0	
19539	chr3	58584699	58585798	1099	550.0	
19540	chr3	58629900	58630565	665	332.0	
19541	chr3	58640579	58641055	476	238.0	
19542	chr3	58666575	58667185	610	305.0	
19543	chr3	58682870	58683340	470	235.0	
19544	chr3	58899487	58899888	401	200.0	
19545	chr3	59049445	59050577	1132	566.0	
19546	chr3	59052750	59053218	468	234.0	
19547	chr3	59135183	59135436	253	126.0	
19548	chr3	59212110	59212537	427	214.0	
19549	chr3	59234896	59235973	1077	538.0	
19550	chr3	59249010	59249587	577	288.0	
19551	chr3	59262222	59262584	362	181.0	
19552	chr3	59286561	59287636	1075	538.0	
19553	chr3	59300513	59301350	837	418.0	
19554	chr3	59313290	59313773	483	242.0	
19555	chr3	59332860	59333024	164	82.0	
19556	chr3	59334514	59335141	627	314.0	
19557	chr3	59368981	59369219	238	119.0	
19558	chr3	59372503	59372551	48	24.0	
19559	chr3	59385963	59386880	917	458.0	
19560	chr3	59388400	59388929	529	264.0	
19561	chr3	59424540	59425065	525	262.0	
19562	chr3	59425892	59428047	2155	1078.0	
19563	chr3	59444037	59444789	752	376.0	
19564	chr3	59450896	59452593	1697	848.0	
19565	chr3	59480353	59480861	508	254.0	
19566	chr3	59515172	59515509	337	168.0	
19567	chr3	59575320	59575834	514	257.0	
19568	chr3	59709693	59710542	849	424.0	
19569	chr3	59772678	59773406	728	364.0	
19570	chr3	59783719	59784017	298	149.0	
19571	chr3	59809883	59810153	270	135.0	
19572	chr3	59839813	59840236	423	212.0	
19573	chr3	59857484	59858219	735	368.0	
19574	chr3	59873833	59873964	131	66.0	
19575	chr3	59876668	59876943	275	138.0	
19576	chr3	59884382	59884836	454	227.0	
19577	chr3	59940696	59941078	382	191.0	
19578	chr3	59957255	59957270	15	8.0	
19579	chr3	59985676	59986213	537	268.0	
19580	chr3	60010104	60011602	1498	749.0	
19581	chr3	60017463	60018174	711	356.0	
19582	chr3	60048024	60049098	1074	537.0	
19583	chr3	60056520	60056763	243	122.0	
19584	chr3	60064656	60065836	1180	590.0	
19585	chr3	60076277	60076674	397	198.0	
19586	chr3	60079027	60079428	401	200.0	
19587	chr3	60080633	60080979	346	173.0	
19588	chr3	60081580	60082274	694	347.0	
19589	chr3	60087054	60087064	10	5.0	
19590	chr3	60854566	60855639	1073	536.0	
19591	chr3	60992404	60992781	377	188.0	
19592	chr3	61008169	61009563	1394	697.0	
19593	chr3	61249701	61252180	2479	1240.0	
19594	chr3	61358383	61358867	484	242.0	
19595	chr3	61381807	61382138	331	166.0	
19596	chr3	61894972	61895476	504	252.0	
19597	chr3	62188717	62189244	527	264.0	
19598	chr3	62287487	62287738	251	126.0	
19599	chr3	62318503	62319707	1204	602.0	
19600	chr3	63343608	63344225	617	308.0	
19601	chr3	63349594	63349978	384	192.0	
19602	chr3	63351191	63351540	349	174.0	
19603	chr3	63679475	63679529	54	27.0	
19604	chr3	63757456	63757486	30	15.0	
19605	chr3	63807877	63808649	772	386.0	
19606	chr3	63818498	63818999	501	250.0	
19607	chr3	63862745	63865250	2505	1252.0	
19608	chr3	63874736	63875175	439	220.0	
19609	chr3	63909973	63913612	3639	1820.0	"repeat_region	sequence_feature"
19610	chr3	63921792	63922874	1082	541.0	
19611	chr3	63925189	63925224	35	18.0	
19612	chr3	63927357	63928357	1000	500.0	
19613	chr3	63933375	63935407	2032	1016.0	
19614	chr3	63937410	63938334	924	462.0	
19615	chr3	63939203	63939575	372	186.0	
19616	chr3	63951453	63951932	479	240.0	
19617	chr3	63959997	63960747	750	375.0	
19618	chr3	63961755	63962282	527	264.0	
19619	chr3	63967496	63969292	1796	898.0	
19620	chr3	63969859	63970335	476	238.0	
19621	chr3	63975722	63977568	1846	923.0	
19622	chr3	63978163	63978307	144	72.0	
19623	chr3	63978827	63981335	2508	1254.0	
19624	chr3	63982486	63982870	384	192.0	
19625	chr3	63992693	63992751	58	29.0	
19626	chr3	63993383	63994230	847	424.0	
19627	chr3	63995029	63995505	476	238.0	
19628	chr3	64021914	64024139	2225	1112.0	
19629	chr3	64030509	64031294	785	392.0	
19630	chr3	64484338	64484855	517	258.0	
19631	chr3	65732386	65732426	40	20.0	
19632	chr3	66220316	66221646	1330	665.0	
19633	chr3	66253986	66254442	456	228.0	
19634	chr3	66267095	66267403	308	154.0	
19635	chr3	66276474	66277147	673	336.0	
19636	chr3	66287315	66287420	105	52.0	
19637	chr3	66297486	66299004	1518	759.0	
19638	chr3	66301943	66304805	2862	1431.0	
19639	chr3	66306111	66307484	1373	686.0	
19640	chr3	66311855	66312553	698	349.0	
19641	chr3	66353906	66354434	528	264.0	
19642	chr3	66355470	66355781	311	156.0	
19643	chr3	66372585	66373087	502	251.0	
19644	chr3	66377869	66378686	817	408.0	
19645	chr3	66386397	66386532	135	68.0	
19646	chr3	66387107	66387212	105	52.0	
19647	chr3	66393195	66394719	1524	762.0	
19648	chr3	66397706	66398178	472	236.0	
19649	chr3	66407527	66408193	666	333.0	
19650	chr3	66439685	66440083	398	199.0	
19651	chr3	66456506	66457337	831	416.0	
19652	chr3	66472297	66473399	1102	551.0	
19653	chr3	66480647	66482259	1612	806.0	
19654	chr3	66483297	66483885	588	294.0	
19655	chr3	66488601	66488766	165	82.0	
19656	chr3	66490212	66490665	453	226.0	
19657	chr3	66496876	66498020	1144	572.0	
19658	chr3	66499194	66502240	3046	1523.0	
19659	chr3	66582546	66583368	822	411.0	
19660	chr3	66644575	66644935	360	180.0	
19661	chr3	66816080	66816515	435	218.0	
19662	chr3	66822236	66822696	460	230.0	
19663	chr3	66856542	66856880	338	169.0	
19664	chr3	66895804	66895881	77	38.0	
19665	chr3	66905096	66905540	444	222.0	
19666	chr3	66938423	66938646	223	112.0	
19667	chr3	66971724	66972705	981	490.0	
19668	chr3	66990158	66990743	585	292.0	
19669	chr3	66997421	66999390	1969	984.0	
19670	chr3	66999920	67000629	709	354.0	
19671	chr3	67016729	67016906	177	88.0	
19672	chr3	67018464	67018653	189	94.0	
19673	chr3	67048211	67048871	660	330.0	
19674	chr3	67083191	67083743	552	276.0	
19675	chr3	67113707	67114251	544	272.0	
19676	chr3	67290339	67290943	604	302.0	
19677	chr3	67384779	67385143	364	182.0	
19678	chr3	67593960	67594277	317	158.0	
19679	chr3	67602208	67602535	327	164.0	
19680	chr3	67653365	67657632	4267	2134.0	
19681	chr3	67662721	67663147	426	213.0	
19682	chr3	67674087	67674438	351	176.0	
19683	chr3	67685440	67686148	708	354.0	
19684	chr3	67790013	67790459	446	223.0	
19685	chr3	67947744	67948748	1004	502.0	
19686	chr3	68007589	68008388	799	400.0	
19687	chr3	68057372	68058397	1025	512.0	
19688	chr3	68072103	68072413	310	155.0	
19689	chr3	68088051	68088972	921	460.0	
19690	chr3	68090387	68090804	417	208.0	
19691	chr3	68127742	68127805	63	32.0	
19692	chr3	68876104	68876512	408	204.0	
19693	chr3	69012628	69014345	1717	858.0	
19694	chr3	69033395	69033906	511	256.0	
19695	chr3	69050864	69053089	2225	1112.0	
19696	chr3	69058170	69059242	1072	536.0	
19697	chr3	69065364	69065729	365	182.0	
19698	chr3	69078066	69078724	658	329.0	
19699	chr3	69079240	69080901	1661	830.0	
19700	chr3	69081504	69082031	527	264.0	
19701	chr3	69082623	69083486	863	432.0	
19702	chr3	69084133	69088627	4494	2247.0	
19703	chr3	69091248	69093011	1763	882.0	
19704	chr3	69093647	69096384	2737	1368.0	
19705	chr3	69097356	69097794	438	219.0	
19706	chr3	69120809	69121348	539	270.0	
19707	chr3	69161548	69162067	519	260.0	
19708	chr3	69197723	69200709	2986	1493.0	
19709	chr3	69206347	69206714	367	184.0	
19710	chr3	69212320	69212922	602	301.0	
19711	chr3	69235918	69236265	347	174.0	
19712	chr3	69249942	69250422	480	240.0	
19713	chr3	69281950	69282669	719	360.0	
19714	chr3	69288366	69288741	375	188.0	
19715	chr3	69306098	69307040	942	471.0	
19716	chr3	69320703	69322041	1338	669.0	
19717	chr3	69324317	69325079	762	381.0	
19718	chr3	69326666	69327466	800	400.0	
19719	chr3	69328676	69329039	363	182.0	
19720	chr3	69330837	69331410	573	286.0	
19721	chr3	69339779	69340246	467	234.0	
19722	chr3	69352317	69352681	364	182.0	
19723	chr3	69353286	69354179	893	446.0	
19724	chr3	69368202	69368804	602	301.0	
19725	chr3	69370155	69370699	544	272.0	
19726	chr3	69385594	69386929	1335	668.0	
19727	chr3	69389504	69389922	418	209.0	
19728	chr3	69410266	69410784	518	259.0	
19729	chr3	69433955	69433963	8	4.0	
19730	chr3	69435948	69436076	128	64.0	
19731	chr3	69439673	69440085	412	206.0	
19732	chr3	69458845	69459211	366	183.0	
19733	chr3	69500525	69501042	517	258.0	
19734	chr3	69524834	69525207	373	186.0	
19735	chr3	69540880	69542976	2096	1048.0	
19736	chr3	69558805	69559398	593	296.0	
19737	chr3	69560769	69561283	514	257.0	
19738	chr3	69564012	69564348	336	168.0	
19739	chr3	69736071	69736209	138	69.0	
19740	chr3	69738340	69740831	2491	1246.0	"promoter	protein_binding_site	protein_binding_site"
19741	chr3	69747825	69748901	1076	538.0	
19742	chr3	69752302	69752593	291	146.0	
19743	chr3	69764099	69765011	912	456.0	
19744	chr3	69777125	69777685	560	280.0	
19745	chr3	69791090	69791427	337	168.0	
19746	chr3	69792110	69792276	166	83.0	
19747	chr3	69982881	69983282	401	200.0	
19748	chr3	69994957	69995328	371	186.0	
19749	chr3	70006160	70006424	264	132.0	
19750	chr3	70010360	70010720	360	180.0	
19751	chr3	70053277	70053559	282	141.0	
19752	chr3	70120412	70120736	324	162.0	
19753	chr3	70179335	70179345	10	5.0	
19754	chr3	70550694	70551193	499	250.0	
19755	chr3	70833218	70834018	800	400.0	
19756	chr3	70980592	70981064	472	236.0	
19757	chr3	70990096	70990915	819	410.0	
19758	chr3	71006757	71007271	514	257.0	
19759	chr3	71008444	71009322	878	439.0	
19760	chr3	71010518	71012029	1511	756.0	
19761	chr3	71026989	71027571	582	291.0	
19762	chr3	71031218	71032383	1165	582.0	
19763	chr3	71039264	71039803	539	270.0	
19764	chr3	71045727	71046261	534	267.0	
19765	chr3	71050326	71051334	1008	504.0	enhancer
19766	chr3	71057053	71057950	897	448.0	
19767	chr3	71060495	71060842	347	174.0	
19768	chr3	71062549	71067401	4852	2426.0	
19769	chr3	71067931	71068604	673	336.0	
19770	chr3	71069643	71071322	1679	840.0	
19771	chr3	71075806	71075859	53	26.0	
19772	chr3	71078818	71079192	374	187.0	
19773	chr3	71080769	71080841	72	36.0	
19774	chr3	71083756	71084122	366	183.0	
19775	chr3	71086884	71088295	1411	706.0	
19776	chr3	71090203	71090676	473	236.0	
19777	chr3	71100334	71100627	293	146.0	
19778	chr3	71117798	71118003	205	102.0	
19779	chr3	71127072	71127971	899	450.0	
19780	chr3	71129060	71131479	2419	1210.0	
19781	chr3	71142417	71142681	264	132.0	
19782	chr3	71186025	71186416	391	196.0	
19783	chr3	71208405	71208504	99	50.0	
19784	chr3	71210303	71211007	704	352.0	
19785	chr3	71225951	71227782	1831	916.0	
19786	chr3	71247774	71247944	170	85.0	
19787	chr3	71248458	71249625	1167	584.0	
19788	chr3	71304032	71304077	45	22.0	
19789	chr3	71304702	71306314	1612	806.0	
19790	chr3	71309465	71309782	317	158.0	
19791	chr3	71310507	71311037	530	265.0	
19792	chr3	71345645	71345649	4	2.0	
19793	chr3	71348059	71348647	588	294.0	
19794	chr3	71356173	71356665	492	246.0	
19795	chr3	71360598	71361103	505	252.0	
19796	chr3	71372443	71373572	1129	564.0	
19797	chr3	71376948	71377023	75	38.0	
19798	chr3	71384999	71385390	391	196.0	
19799	chr3	71388699	71389107	408	204.0	
19800	chr3	71389846	71390757	911	456.0	
19801	chr3	71391322	71393474	2152	1076.0	
19802	chr3	71394970	71395388	418	209.0	
19803	chr3	71396199	71398783	2584	1292.0	enhancer
19804	chr3	71402950	71403336	386	193.0	
19805	chr3	71415540	71417401	1861	930.0	
19806	chr3	71421424	71423463	2039	1020.0	
19807	chr3	71428683	71429610	927	464.0	
19808	chr3	71432258	71433201	943	472.0	
19809	chr3	71438854	71445485	6631	3316.0	
19810	chr3	71447223	71448107	884	442.0	
19811	chr3	71451002	71452117	1115	558.0	
19812	chr3	71454068	71457035	2967	1484.0	
19813	chr3	71464661	71464983	322	161.0	
19814	chr3	71478562	71479009	447	224.0	
19815	chr3	71486833	71487866	1033	516.0	
19816	chr3	71488451	71490037	1586	793.0	
19817	chr3	71490956	71491884	928	464.0	
19818	chr3	71492462	71494655	2193	1096.0	
19819	chr3	71495937	71497063	1126	563.0	
19820	chr3	71504082	71504719	637	318.0	
19821	chr3	71511894	71512637	743	372.0	
19822	chr3	71513377	71513689	312	156.0	
19823	chr3	71515587	71516099	512	256.0	
19824	chr3	71525389	71525778	389	194.0	
19825	chr3	71532774	71533394	620	310.0	
19826	chr3	71542313	71543730	1417	708.0	
19827	chr3	71546754	71548554	1800	900.0	
19828	chr3	71563800	71564201	401	200.0	
19829	chr3	71568309	71568538	229	114.0	
19830	chr3	71577058	71577479	421	210.0	
19831	chr3	71579844	71580313	469	234.0	
19832	chr3	71580912	71586981	6069	3034.0	
19833	chr3	71629362	71630392	1030	515.0	
19834	chr3	71652814	71653177	363	182.0	
19835	chr3	71681132	71681760	628	314.0	
19836	chr3	71702203	71703459	1256	628.0	
19837	chr3	71708690	71709091	401	200.0	
19838	chr3	71710738	71711400	662	331.0	
19839	chr3	71717988	71718709	721	360.0	
19840	chr3	71721237	71726878	5641	2820.0	
19841	chr3	71728738	71730615	1877	938.0	
19842	chr3	71753371	71755603	2232	1116.0	
19843	chr3	71759340	71759883	543	272.0	
19844	chr3	71779685	71780479	794	397.0	
19845	chr3	71784204	71786130	1926	963.0	
19846	chr3	71796359	71796407	48	24.0	
19847	chr3	71805137	71805698	561	280.0	
19848	chr3	71806691	71807135	444	222.0	
19849	chr3	71842079	71843471	1392	696.0	
19850	chr3	71858676	71859587	911	456.0	
19851	chr3	71875115	71876008	893	446.0	
19852	chr3	71896680	71897152	472	236.0	
19853	chr3	71905158	71906059	901	450.0	
19854	chr3	71906745	71907446	701	350.0	
19855	chr3	71917520	71918068	548	274.0	
19856	chr3	71955499	71955855	356	178.0	
19857	chr3	71973286	71973807	521	260.0	
19858	chr3	71976003	71976688	685	342.0	
19859	chr3	71982332	71983098	766	383.0	
19860	chr3	71985249	71985411	162	81.0	
19861	chr3	71987858	71988309	451	226.0	
19862	chr3	71994086	71994580	494	247.0	
19863	chr3	72008426	72009130	704	352.0	
19864	chr3	72010006	72010548	542	271.0	
19865	chr3	72031357	72032906	1549	774.0	
19866	chr3	72042723	72043946	1223	612.0	
19867	chr3	72048590	72048739	149	74.0	
19868	chr3	72077580	72078403	823	412.0	
19869	chr3	72079640	72080744	1104	552.0	
19870	chr3	72081506	72083303	1797	898.0	
19871	chr3	72086196	72087267	1071	536.0	
19872	chr3	72088504	72088753	249	124.0	
19873	chr3	72090289	72090342	53	26.0	
19874	chr3	72092003	72092041	38	19.0	
19875	chr3	72092671	72102969	10298	5149.0	
19876	chr3	72109889	72110370	481	240.0	
19877	chr3	72121341	72121801	460	230.0	
19878	chr3	72126473	72126896	423	212.0	
19879	chr3	72127738	72128301	563	282.0	
19880	chr3	72135120	72135125	5	2.0	
19881	chr3	72141354	72142373	1019	510.0	
19882	chr3	72144724	72145157	433	216.0	
19883	chr3	72163698	72164869	1171	586.0	
19884	chr3	72175397	72175714	317	158.0	
19885	chr3	72176455	72178094	1639	820.0	
19886	chr3	72182205	72182545	340	170.0	
19887	chr3	72185595	72185932	337	168.0	
19888	chr3	72214380	72214956	576	288.0	
19889	chr3	72255808	72256554	746	373.0	
19890	chr3	72258594	72259157	563	282.0	
19891	chr3	72269461	72271671	2210	1105.0	
19892	chr3	72274411	72275380	969	484.0	
19893	chr3	72289025	72289893	868	434.0	
19894	chr3	72310084	72311363	1279	640.0	
19895	chr3	72336991	72337382	391	196.0	
19896	chr3	72338897	72339676	779	390.0	
19897	chr3	72344253	72344711	458	229.0	
19898	chr3	72345577	72345894	317	158.0	
19899	chr3	72346415	72347037	622	311.0	
19900	chr3	72347761	72348508	747	374.0	
19901	chr3	72362016	72362091	75	38.0	
19902	chr3	72375590	72375946	356	178.0	
19903	chr3	72381148	72381420	272	136.0	
19904	chr3	72391925	72392019	94	47.0	
19905	chr3	72409016	72409113	97	48.0	
19906	chr3	72412584	72412724	140	70.0	
19907	chr3	72420324	72420427	103	52.0	
19908	chr3	72421361	72421498	137	68.0	
19909	chr3	72426641	72427985	1344	672.0	
19910	chr3	72429535	72430402	867	434.0	
19911	chr3	72432344	72432682	338	169.0	
19912	chr3	72434993	72435042	49	24.0	
19913	chr3	72437978	72440943	2965	1482.0	
19914	chr3	72442636	72443505	869	434.0	
19915	chr3	72444553	72448041	3488	1744.0	
19916	chr3	72455213	72455704	491	246.0	
19917	chr3	72473358	72473750	392	196.0	
19918	chr3	72482680	72483407	727	364.0	
19919	chr3	72487323	72487844	521	260.0	
19920	chr3	72490667	72491125	458	229.0	
19921	chr3	72495981	72496710	729	364.0	
19922	chr3	72497405	72498027	622	311.0	
19923	chr3	72519966	72520321	355	178.0	
19924	chr3	72523057	72524198	1141	570.0	
19925	chr3	72533466	72533942	476	238.0	
19926	chr3	72538490	72538513	23	12.0	
19927	chr3	72549105	72549154	49	24.0	
19928	chr3	72549880	72550293	413	206.0	
19929	chr3	72557847	72558503	656	328.0	
19930	chr3	72559375	72559817	442	221.0	
19931	chr3	72582254	72582597	343	172.0	
19932	chr3	72593980	72594865	885	442.0	
19933	chr3	72618681	72619169	488	244.0	
19934	chr3	72625388	72626130	742	371.0	
19935	chr3	72628984	72629685	701	350.0	
19936	chr3	72636905	72637733	828	414.0	
19937	chr3	72657610	72658153	543	272.0	
19938	chr3	72666106	72666574	468	234.0	
19939	chr3	72738334	72740071	1737	868.0	
19940	chr3	72748668	72749029	361	180.0	
19941	chr3	72756655	72757488	833	416.0	
19942	chr3	72821202	72822797	1595	798.0	
19943	chr3	72847402	72849372	1970	985.0	
19944	chr3	72886849	72888615	1766	883.0	
19945	chr3	72894889	72895461	572	286.0	
19946	chr3	72938441	72939252	811	406.0	
19947	chr3	72965593	72966461	868	434.0	
19948	chr3	72977015	72977770	755	378.0	
19949	chr3	72982591	72983358	767	384.0	
19950	chr3	72996151	72998114	1963	982.0	
19951	chr3	72999889	73000397	508	254.0	
19952	chr3	73029055	73029715	660	330.0	
19953	chr3	73056323	73056688	365	182.0	
19954	chr3	73085958	73086526	568	284.0	
19955	chr3	73093637	73094662	1025	512.0	
19956	chr3	73101020	73101513	493	246.0	
19957	chr3	73110488	73111667	1179	590.0	
19958	chr3	73448707	73449337	630	315.0	
19959	chr3	73502702	73503006	304	152.0	
19960	chr3	73765877	73766473	596	298.0	
19961	chr3	75192047	75192432	385	192.0	
19962	chr3	75221635	75221781	146	73.0	
19963	chr3	75224594	75224937	343	172.0	
19964	chr3	75241718	75242023	305	152.0	
19965	chr3	75342459	75342765	306	153.0	
19966	chr3	75422026	75422562	536	268.0	
19967	chr3	75429360	75430387	1027	514.0	
19968	chr3	75432809	75433406	597	298.0	
19969	chr3	75434233	75436588	2355	1178.0	
19970	chr3	75784825	75786143	1318	659.0	
19971	chr3	78268776	78269145	369	184.0	
19972	chr3	78645639	78646065	426	213.0	
19973	chr3	81485307	81486008	701	350.0	
19974	chr3	81490429	81490953	524	262.0	
19975	chr3	81491905	81492588	683	342.0	
19976	chr3	81503132	81503354	222	111.0	
19977	chr3	81582036	81582347	311	156.0	
19978	chr3	81760477	81762287	1810	905.0	
19979	chr3	81763050	81763243	193	96.0	
19980	chr3	81782482	81782999	517	258.0	
19981	chr3	81824012	81824482	470	235.0	
19982	chr3	81838507	81838855	348	174.0	
19983	chr3	81908639	81908780	141	70.0	
19984	chr3	81910218	81910662	444	222.0	
19985	chr3	82129231	82130567	1336	668.0	
19986	chr3	82132958	82133409	451	226.0	
19987	chr3	84710273	84710681	408	204.0	
19988	chr3	84958444	84959442	998	499.0	
19989	chr3	87083010	87083131	121	60.0	
19990	chr3	87088806	87090042	1236	618.0	
19991	chr3	87167887	87168268	381	190.0	
19992	chr3	87173887	87174073	186	93.0	
19993	chr3	87226418	87228182	1764	882.0	
19994	chr3	87260134	87260579	445	222.0	
19995	chr3	87271274	87271754	480	240.0	
19996	chr3	87298053	87298519	466	233.0	
19997	chr3	87350559	87351041	482	241.0	
19998	chr3	87706127	87706619	492	246.0	
19999	chr3	87771192	87771913	721	360.0	
20000	chr3	87780709	87781287	578	289.0	
20001	chr3	87792283	87793647	1364	682.0	
20002	chr3	87858966	87859614	648	324.0	
20003	chr3	87997217	87998466	1249	624.0	
20004	chr3	88000917	88001223	306	153.0	
20005	chr3	88003110	88003575	465	232.0	
20006	chr3	88005019	88005511	492	246.0	
20007	chr3	88018967	88019409	442	221.0	
20008	chr3	88030194	88030655	461	230.0	
20009	chr3	88031457	88032504	1047	524.0	
20010	chr3	88057646	88060302	2656	1328.0	
20011	chr3	88061737	88062199	462	231.0	
20012	chr3	88113507	88114013	506	253.0	
20013	chr3	88117830	88117953	123	62.0	
20014	chr3	88148936	88151582	2646	1323.0	
20015	chr3	88152827	88153212	385	192.0	
20016	chr3	88180397	88180776	379	190.0	
20017	chr3	88203470	88203956	486	243.0	
20018	chr3	89098945	89099349	404	202.0	
20019	chr3	89107388	89107928	540	270.0	
20020	chr3	90405736	90405859	123	62.0	
20021	chr3	93841621	93841820	199	100.0	
20022	chr3	93973065	93974344	1279	640.0	
20023	chr3	93979394	93980951	1557	778.0	
20024	chr3	94004247	94004776	529	264.0	
20025	chr3	94011463	94011705	242	121.0	
20026	chr3	94036942	94037338	396	198.0	
20027	chr3	94062136	94064873	2737	1368.0	
20028	chr3	94069017	94069623	606	303.0	
20029	chr3	94080467	94080858	391	196.0	
20030	chr3	94083317	94083507	190	95.0	
20031	chr3	94092068	94092482	414	207.0	
20032	chr3	94098361	94098972	611	306.0	
20033	chr3	94249517	94249893	376	188.0	
20034	chr3	95705744	95706514	770	385.0	
20035	chr3	95721865	95722325	460	230.0	
20036	chr3	96813330	96813492	162	81.0	
20037	chr3	97719076	97719606	530	265.0	
20038	chr3	97763913	97765420	1507	754.0	
20039	chr3	97793193	97793859	666	333.0	
20040	chr3	97815694	97815944	250	125.0	
20041	chr3	97821023	97822977	1954	977.0	
20042	chr3	97823654	97824037	383	192.0	
20043	chr3	97872161	97872537	376	188.0	
20044	chr3	97910140	97911509	1369	684.0	
20045	chr3	97940068	97940246	178	89.0	
20046	chr3	97952115	97952940	825	412.0	
20047	chr3	97954309	97954829	520	260.0	
20048	chr3	97957565	97958295	730	365.0	
20049	chr3	97971397	97972896	1499	750.0	
20050	chr3	97974200	97974784	584	292.0	
20051	chr3	97990580	97991661	1081	540.0	
20052	chr3	98003586	98003730	144	72.0	
20053	chr3	98022979	98023676	697	348.0	
20054	chr3	98038981	98040066	1085	542.0	
20055	chr3	98180380	98180747	367	184.0	
20056	chr3	98188524	98188890	366	183.0	
20057	chr3	98329355	98329941	586	293.0	
20058	chr3	98333991	98334392	401	200.0	
20059	chr3	98343898	98344283	385	192.0	
20060	chr3	98513163	98513612	449	224.0	
20061	chr3	98521538	98523622	2084	1042.0	
20062	chr3	98525486	98525936	450	225.0	
20063	chr3	98540354	98540813	459	230.0	
20064	chr3	98546126	98546293	167	84.0	
20065	chr3	98551855	98552208	353	176.0	
20066	chr3	98553555	98554213	658	329.0	
20067	chr3	98555626	98557832	2206	1103.0	
20068	chr3	98562025	98565126	3101	1550.0	
20069	chr3	98565890	98566093	203	102.0	
20070	chr3	98567673	98568301	628	314.0	
20071	chr3	98573359	98573854	495	248.0	
20072	chr3	98585273	98585718	445	222.0	
20073	chr3	98587672	98588026	354	177.0	
20074	chr3	98592642	98594636	1994	997.0	
20075	chr3	98596613	98597533	920	460.0	
20076	chr3	98602011	98602538	527	264.0	
20077	chr3	98612891	98613509	618	309.0	
20078	chr3	98651051	98651341	290	145.0	
20079	chr3	98657399	98657854	455	228.0	
20080	chr3	98692734	98693540	806	403.0	
20081	chr3	98730249	98730742	493	246.0	
20082	chr3	98732034	98734206	2172	1086.0	
20083	chr3	98760850	98762094	1244	622.0	
20084	chr3	98762923	98764860	1937	968.0	
20085	chr3	98769513	98770931	1418	709.0	
20086	chr3	98778114	98779565	1451	726.0	
20087	chr3	98786410	98787105	695	348.0	
20088	chr3	98809555	98809956	401	200.0	
20089	chr3	98812822	98813193	371	186.0	
20090	chr3	98817421	98817914	493	246.0	
20091	chr3	98900631	98902608	1977	988.0	
20092	chr3	99499402	99499572	170	85.0	
20093	chr3	99505758	99506464	706	353.0	
20094	chr3	99753379	99753538	159	80.0	
20095	chr3	99789397	99789695	298	149.0	
20096	chr3	99808077	99808804	727	364.0	
20097	chr3	99816904	99819109	2205	1102.0	
20098	chr3	99831744	99832486	742	371.0	
20099	chr3	99843274	99843617	343	172.0	
20100	chr3	99875519	99876832	1313	656.0	
20101	chr3	99878035	99878436	401	200.0	
20102	chr3	99895323	99896791	1468	734.0	
20103	chr3	99901246	99901761	515	258.0	
20104	chr3	100043330	100043334	4	2.0	
20105	chr3	100044265	100045012	747	374.0	
20106	chr3	100047497	100048407	910	455.0	
20107	chr3	100060770	100061119	349	174.0	
20108	chr3	100068701	100069377	676	338.0	
20109	chr3	100072514	100074329	1815	908.0	
20110	chr3	100084430	100084773	343	172.0	
20111	chr3	100090345	100090733	388	194.0	
20112	chr3	100209941	100211158	1217	608.0	
20113	chr3	100254130	100254620	490	245.0	
20114	chr3	100260044	100261871	1827	914.0	
20115	chr3	100289437	100289664	227	114.0	
20116	chr3	100316460	100317215	755	378.0	
20117	chr3	100333977	100335945	1968	984.0	
20118	chr3	100399953	100402236	2283	1142.0	
20119	chr3	100419344	100419839	495	248.0	
20120	chr3	100462910	100463346	436	218.0	
20121	chr3	100465859	100466709	850	425.0	
20122	chr3	100491869	100493088	1219	610.0	
20123	chr3	100519198	100519282	84	42.0	
20124	chr3	100521011	100522022	1011	506.0	
20125	chr3	100561431	100561783	352	176.0	
20126	chr3	100590173	100590983	810	405.0	
20127	chr3	100602718	100603990	1272	636.0	
20128	chr3	100634749	100635135	386	193.0	
20129	chr3	100641370	100641827	457	228.0	
20130	chr3	100650737	100651361	624	312.0	
20131	chr3	100665263	100665582	319	160.0	
20132	chr3	100708604	100711223	2619	1310.0	
20133	chr3	100761260	100761562	302	151.0	
20134	chr3	100893063	100893594	531	266.0	
20135	chr3	100898837	100898852	15	8.0	
20136	chr3	100899714	100899804	90	45.0	
20137	chr3	101070233	101070674	441	220.0	
20138	chr3	101216833	101217068	235	118.0	
20139	chr3	101379563	101380451	888	444.0	
20140	chr3	101381770	101382247	477	238.0	
20141	chr3	101383160	101383925	765	382.0	
20142	chr3	101389846	101390684	838	419.0	
20143	chr3	101424483	101424716	233	116.0	
20144	chr3	101466670	101467688	1018	509.0	
20145	chr3	101512032	101514080	2048	1024.0	
20146	chr3	101518010	101519170	1160	580.0	
20147	chr3	101520883	101521875	992	496.0	
20148	chr3	101530485	101530867	382	191.0	
20149	chr3	101542934	101543293	359	180.0	
20150	chr3	101544302	101544703	401	200.0	
20151	chr3	101559731	101560042	311	156.0	
20152	chr3	101561109	101562825	1716	858.0	
20153	chr3	101570939	101571701	762	381.0	
20154	chr3	101573139	101575359	2220	1110.0	
20155	chr3	101635954	101636855	901	450.0	
20156	chr3	101643697	101644657	960	480.0	
20157	chr3	101648577	101648880	303	152.0	
20158	chr3	101675529	101678600	3071	1536.0	
20159	chr3	101679839	101681917	2078	1039.0	
20160	chr3	101683762	101687987	4225	2112.0	
20161	chr3	101689194	101689749	555	278.0	
20162	chr3	101690880	101691379	499	250.0	
20163	chr3	101693516	101694007	491	246.0	
20164	chr3	101695681	101696241	560	280.0	
20165	chr3	101707353	101707505	152	76.0	
20166	chr3	101719600	101720165	565	282.0	
20167	chr3	101721031	101721314	283	142.0	
20168	chr3	101722124	101722959	835	418.0	
20169	chr3	101724066	101726047	1981	990.0	
20170	chr3	101753421	101753921	500	250.0	
20171	chr3	101769334	101769580	246	123.0	
20172	chr3	101778403	101781100	2697	1348.0	
20173	chr3	101784623	101785773	1150	575.0	
20174	chr3	101791634	101792305	671	336.0	
20175	chr3	101802919	101803863	944	472.0	
20176	chr3	101808939	101810094	1155	578.0	
20177	chr3	101813722	101814166	444	222.0	
20178	chr3	101818026	101818433	407	204.0	
20179	chr3	101819623	101820343	720	360.0	
20180	chr3	101824893	101824921	28	14.0	
20181	chr3	101826081	101830248	4167	2084.0	
20182	chr3	101833429	101834506	1077	538.0	
20183	chr3	101836914	101837760	846	423.0	
20184	chr3	101846824	101870372	23548	11774.0	
20185	chr3	101873117	101874104	987	494.0	
20186	chr3	101875982	101876674	692	346.0	
20187	chr3	101879846	101880304	458	229.0	
20188	chr3	101898094	101899562	1468	734.0	
20189	chr3	101901847	101902680	833	416.0	
20190	chr3	101924602	101924943	341	170.0	
20191	chr3	101936216	101937413	1197	598.0	
20192	chr3	101938242	101939006	764	382.0	
20193	chr3	101940362	101941539	1177	588.0	
20194	chr3	101942320	101943403	1083	542.0	
20195	chr3	101965980	101966670	690	345.0	
20196	chr3	101972377	101972433	56	28.0	
20197	chr3	101987895	101989040	1145	572.0	
20198	chr3	102018461	102019030	569	284.0	
20199	chr3	102020595	102021019	424	212.0	
20200	chr3	102025452	102025989	537	268.0	
20201	chr3	102026594	102027022	428	214.0	
20202	chr3	102030624	102031471	847	424.0	
20203	chr3	102036065	102036387	322	161.0	
20204	chr3	102038453	102038906	453	226.0	
20205	chr3	102057721	102058629	908	454.0	
20206	chr3	102059530	102059781	251	126.0	
20207	chr3	102078846	102079226	380	190.0	
20208	chr3	102114159	102115001	842	421.0	
20209	chr3	102124321	102124602	281	140.0	
20210	chr3	102130052	102130353	301	150.0	
20211	chr3	102180316	102180508	192	96.0	
20212	chr3	102223093	102223615	522	261.0	
20213	chr3	102224174	102224606	432	216.0	
20214	chr3	102225340	102225815	475	238.0	
20215	chr3	102228977	102230378	1401	700.0	
20216	chr3	102233955	102234365	410	205.0	
20217	chr3	102532877	102533363	486	243.0	
20218	chr3	102536479	102536880	401	200.0	
20219	chr3	102619456	102619696	240	120.0	
20220	chr3	102673520	102673907	387	194.0	
20221	chr3	104291816	104291999	183	92.0	
20222	chr3	104521796	104522487	691	346.0	
20223	chr3	104526919	104527543	624	312.0	
20224	chr3	104564075	104564444	369	184.0	
20225	chr3	104717244	104717567	323	162.0	
20226	chr3	105140240	105140508	268	134.0	
20227	chr3	105327981	105328022	41	20.0	
20228	chr3	105351717	105352304	587	294.0	
20229	chr3	105353323	105354139	816	408.0	
20230	chr3	105355541	105356192	651	326.0	
20231	chr3	105365469	105370243	4774	2387.0	
20232	chr3	105385912	105386387	475	238.0	
20233	chr3	105388277	105388367	90	45.0	
20234	chr3	105505120	105505586	466	233.0	
20235	chr3	105518791	105519227	436	218.0	
20236	chr3	105686240	105686750	510	255.0	
20237	chr3	105722963	105723678	715	358.0	
20238	chr3	105730991	105731153	162	81.0	
20239	chr3	105739872	105740235	363	182.0	
20240	chr3	105746129	105747517	1388	694.0	
20241	chr3	105752368	105754598	2230	1115.0	
20242	chr3	105755458	105755750	292	146.0	
20243	chr3	105764419	105765442	1023	512.0	
20244	chr3	105767226	105767602	376	188.0	
20245	chr3	105772606	105773044	438	219.0	
20246	chr3	105774793	105774833	40	20.0	
20247	chr3	105792306	105792672	366	183.0	
20248	chr3	105798453	105798927	474	237.0	
20249	chr3	105801497	105801781	284	142.0	
20250	chr3	105806152	105806837	685	342.0	
20251	chr3	105811491	105811962	471	236.0	
20252	chr3	105823221	105823540	319	160.0	
20253	chr3	105827899	105831241	3342	1671.0	
20254	chr3	105832628	105833091	463	232.0	
20255	chr3	105836542	105837705	1163	582.0	
20256	chr3	105844034	105844412	378	189.0	
20257	chr3	105850712	105850995	283	142.0	
20258	chr3	105853817	105854571	754	377.0	
20259	chr3	105862092	105862963	871	436.0	
20260	chr3	105866463	105870056	3593	1796.0	
20261	chr3	105876649	105877718	1069	534.0	
20262	chr3	105882288	105883287	999	500.0	
20263	chr3	105907008	105908205	1197	598.0	
20264	chr3	105959653	105960132	479	240.0	
20265	chr3	105970291	105970672	381	190.0	
20266	chr3	105987818	105988189	371	186.0	
20267	chr3	105997764	105998652	888	444.0	
20268	chr3	106033641	106034007	366	183.0	
20269	chr3	106068541	106069231	690	345.0	
20270	chr3	106172740	106173193	453	226.0	
20271	chr3	106176520	106177299	779	390.0	
20272	chr3	106184794	106185453	659	330.0	
20273	chr3	106206069	106206599	530	265.0	
20274	chr3	106255762	106256334	572	286.0	
20275	chr3	106302584	106302823	239	120.0	
20276	chr3	106334206	106334576	370	185.0	
20277	chr3	106338431	106339260	829	414.0	
20278	chr3	106386178	106386324	146	73.0	
20279	chr3	106533992	106534786	794	397.0	
20280	chr3	106560406	106560780	374	187.0	
20281	chr3	106609661	106610111	450	225.0	
20282	chr3	106999131	106999587	456	228.0	
20283	chr3	107064459	107064819	360	180.0	
20284	chr3	107235603	107236312	709	354.0	
20285	chr3	107240065	107241642	1577	788.0	
20286	chr3	107271817	107272143	326	163.0	
20287	chr3	107421131	107421600	469	234.0	
20288	chr3	107425044	107425503	459	230.0	
20289	chr3	107429640	107432570	2930	1465.0	
20290	chr3	107522258	107526387	4129	2064.0	
20291	chr3	107574684	107575038	354	177.0	
20292	chr3	107598718	107600032	1314	657.0	
20293	chr3	107600770	107601171	401	200.0	
20294	chr3	107629705	107629842	137	68.0	
20295	chr3	107630611	107631177	566	283.0	
20296	chr3	107633666	107633971	305	152.0	
20297	chr3	107643209	107643389	180	90.0	
20298	chr3	107650775	107651260	485	242.0	
20299	chr3	107660360	107660763	403	202.0	
20300	chr3	107661413	107662518	1105	552.0	
20301	chr3	107675013	107675740	727	364.0	
20302	chr3	107676718	107677107	389	194.0	
20303	chr3	107681380	107681749	369	184.0	
20304	chr3	107684550	107685089	539	270.0	
20305	chr3	107690474	107691077	603	302.0	
20306	chr3	107697748	107698054	306	153.0	
20307	chr3	107739549	107739574	25	12.0	
20308	chr3	107741359	107741431	72	36.0	
20309	chr3	107796814	107797171	357	178.0	
20310	chr3	107846268	107846571	303	152.0	
20311	chr3	107861910	107862380	470	235.0	
20312	chr3	107927246	107928493	1247	624.0	
20313	chr3	107938242	107938398	156	78.0	
20314	chr3	107955118	107955119	1	0.0	
20315	chr3	107975876	107976251	375	188.0	
20316	chr3	107978704	107978793	89	44.0	
20317	chr3	107981840	107982307	467	234.0	
20318	chr3	107985410	107985957	547	274.0	
20319	chr3	107986944	107987749	805	402.0	
20320	chr3	107988465	107990118	1653	826.0	
20321	chr3	108001531	108001681	150	75.0	
20322	chr3	108004629	108005135	506	253.0	
20323	chr3	108006335	108007184	849	424.0	
20324	chr3	108035730	108036161	431	216.0	
20325	chr3	108036907	108037424	517	258.0	
20326	chr3	108061970	108062635	665	332.0	
20327	chr3	108071340	108071782	442	221.0	
20328	chr3	108085142	108086273	1131	566.0	
20329	chr3	108087321	108094001	6680	3340.0	
20330	chr3	108096734	108097128	394	197.0	
20331	chr3	108097955	108098145	190	95.0	
20332	chr3	108099221	108101738	2517	1258.0	
20333	chr3	108102398	108102902	504	252.0	
20334	chr3	108123946	108126447	2501	1250.0	
20335	chr3	108127059	108127991	932	466.0	
20336	chr3	108128838	108128846	8	4.0	
20337	chr3	108130579	108134990	4411	2206.0	
20338	chr3	108136817	108137288	471	236.0	
20339	chr3	108153351	108153798	447	224.0	
20340	chr3	108216042	108216155	113	56.0	
20341	chr3	108219611	108220761	1150	575.0	
20342	chr3	108221324	108224456	3132	1566.0	
20343	chr3	108292466	108294306	1840	920.0	
20344	chr3	108295457	108295799	342	171.0	
20345	chr3	108311746	108312147	401	200.0	
20346	chr3	108322307	108322753	446	223.0	
20347	chr3	108345829	108346956	1127	564.0	
20348	chr3	108394749	108394850	101	50.0	
20349	chr3	108406113	108407189	1076	538.0	
20350	chr3	108407840	108408350	510	255.0	
20351	chr3	108477481	108477947	466	233.0	
20352	chr3	108489634	108490186	552	276.0	
20353	chr3	108527854	108528145	291	146.0	
20354	chr3	108528687	108529298	611	306.0	
20355	chr3	108546335	108546738	403	202.0	
20356	chr3	108552488	108553003	515	258.0	
20357	chr3	108588635	108590915	2280	1140.0	
20358	chr3	108602445	108604158	1713	856.0	
20359	chr3	108662084	108662741	657	328.0	
20360	chr3	108669295	108669599	304	152.0	
20361	chr3	108722772	108722969	197	98.0	
20362	chr3	108780221	108780658	437	218.0	
20363	chr3	108805972	108806967	995	498.0	
20364	chr3	108818288	108818866	578	289.0	
20365	chr3	108820613	108820971	358	179.0	
20366	chr3	108822128	108822909	781	390.0	
20367	chr3	108824158	108824557	399	200.0	
20368	chr3	108833583	108835698	2115	1058.0	
20369	chr3	108838468	108838756	288	144.0	
20370	chr3	108862839	108863613	774	387.0	
20371	chr3	108914753	108915458	705	352.0	
20372	chr3	109023674	109024066	392	196.0	
20373	chr3	109050620	109050959	339	170.0	
20374	chr3	109059264	109059692	428	214.0	
20375	chr3	109081851	109082401	550	275.0	
20376	chr3	109532397	109533210	813	406.0	
20377	chr3	109563185	109563546	361	180.0	
20378	chr3	109731846	109732302	456	228.0	
20379	chr3	109804637	109805319	682	341.0	
20380	chr3	109806621	109807638	1017	508.0	
20381	chr3	110314505	110314987	482	241.0	
20382	chr3	110626493	110627250	757	378.0	
20383	chr3	111067766	111068378	612	306.0	
20384	chr3	111069127	111072997	3870	1935.0	
20385	chr3	111073824	111073825	1	0.0	
20386	chr3	111238806	111239368	562	281.0	
20387	chr3	111311215	111312279	1064	532.0	
20388	chr3	111324110	111324823	713	356.0	
20389	chr3	111392688	111393373	685	342.0	
20390	chr3	111538698	111540333	1635	818.0	
20391	chr3	111541631	111549432	7801	3900.0	
20392	chr3	111550703	111550851	148	74.0	
20393	chr3	111572099	111572354	255	128.0	
20394	chr3	111577749	111578257	508	254.0	
20395	chr3	111603687	111604112	425	212.0	
20396	chr3	111608241	111608817	576	288.0	
20397	chr3	111609575	111611170	1595	798.0	
20398	chr3	111615878	111617261	1383	692.0	
20399	chr3	111621656	111621918	262	131.0	
20400	chr3	111662940	111663286	346	173.0	
20401	chr3	111667269	111669689	2420	1210.0	
20402	chr3	111672289	111677391	5102	2551.0	
20403	chr3	111691240	111691731	491	246.0	
20404	chr3	111695580	111696031	451	226.0	
20405	chr3	111712298	111712803	505	252.0	
20406	chr3	111715979	111716244	265	132.0	
20407	chr3	111717201	111718121	920	460.0	
20408	chr3	111761354	111761529	175	88.0	
20409	chr3	111831930	111832270	340	170.0	
20410	chr3	111851448	111851781	333	166.0	
20411	chr3	111858861	111861038	2177	1088.0	
20412	chr3	111904397	111905247	850	425.0	
20413	chr3	111967432	111968248	816	408.0	
20414	chr3	111978459	111980049	1590	795.0	
20415	chr3	111989031	111989546	515	258.0	
20416	chr3	111998691	111999658	967	484.0	
20417	chr3	112002362	112002876	514	257.0	
20418	chr3	112013307	112013984	677	338.0	
20419	chr3	112043530	112044078	548	274.0	
20420	chr3	112071802	112073067	1265	632.0	
20421	chr3	112074912	112075605	693	346.0	
20422	chr3	112085282	112085287	5	2.0	
20423	chr3	112085791	112086993	1202	601.0	
20424	chr3	112090361	112090854	493	246.0	
20425	chr3	112097412	112097800	388	194.0	
20426	chr3	112111548	112112277	729	364.0	
20427	chr3	112117916	112118615	699	350.0	
20428	chr3	112120303	112120743	440	220.0	
20429	chr3	112127538	112128045	507	254.0	
20430	chr3	112128607	112130345	1738	869.0	
20431	chr3	112132489	112133784	1295	648.0	
20432	chr3	112134721	112135144	423	212.0	
20433	chr3	112136905	112137535	630	315.0	
20434	chr3	112143788	112144063	275	138.0	
20435	chr3	112261777	112262038	261	130.0	
20436	chr3	112293267	112294427	1160	580.0	
20437	chr3	112297526	112297968	442	221.0	
20438	chr3	112303462	112304807	1345	672.0	
20439	chr3	112320748	112321046	298	149.0	
20440	chr3	112327328	112327823	495	248.0	
20441	chr3	112332877	112334283	1406	703.0	
20442	chr3	112335442	112335450	8	4.0	
20443	chr3	112348985	112349289	304	152.0	
20444	chr3	112357896	112358916	1020	510.0	
20445	chr3	112364315	112364706	391	196.0	
20446	chr3	112372385	112372639	254	127.0	
20447	chr3	112376999	112377383	384	192.0	
20448	chr3	112378912	112379601	689	344.0	
20449	chr3	112382819	112382900	81	40.0	
20450	chr3	112391750	112391939	189	94.0	
20451	chr3	112413105	112413198	93	46.0	
20452	chr3	112426211	112426255	44	22.0	
20453	chr3	112437383	112437985	602	301.0	
20454	chr3	112459867	112459986	119	60.0	
20455	chr3	112460640	112460656	16	8.0	
20456	chr3	112463310	112464812	1502	751.0	
20457	chr3	112473189	112473969	780	390.0	
20458	chr3	112474777	112475123	346	173.0	
20459	chr3	112482928	112482978	50	25.0	
20460	chr3	112496285	112496728	443	222.0	
20461	chr3	112497950	112500147	2197	1098.0	
20462	chr3	112504131	112504544	413	206.0	
20463	chr3	112514561	112514957	396	198.0	
20464	chr3	112519018	112519851	833	416.0	
20465	chr3	112531336	112531741	405	202.0	
20466	chr3	112539900	112540227	327	164.0	
20467	chr3	112555609	112556438	829	414.0	
20468	chr3	112557937	112558409	472	236.0	
20469	chr3	112560755	112563470	2715	1358.0	
20470	chr3	112569523	112569574	51	26.0	
20471	chr3	112572648	112573120	472	236.0	
20472	chr3	112579080	112579856	776	388.0	
20473	chr3	112582242	112582626	384	192.0	
20474	chr3	112642807	112644186	1379	690.0	
20475	chr3	112672202	112673434	1232	616.0	
20476	chr3	112676384	112677500	1116	558.0	
20477	chr3	112710012	112710040	28	14.0	
20478	chr3	112734656	112735324	668	334.0	
20479	chr3	112736862	112737349	487	244.0	
20480	chr3	112739825	112739929	104	52.0	
20481	chr3	112740829	112741172	343	172.0	
20482	chr3	112755783	112756591	808	404.0	
20483	chr3	112767004	112767716	712	356.0	
20484	chr3	112773780	112774424	644	322.0	
20485	chr3	112776025	112776471	446	223.0	
20486	chr3	112777865	112778155	290	145.0	
20487	chr3	112782727	112782845	118	59.0	
20488	chr3	112794481	112795182	701	350.0	
20489	chr3	112804174	112804382	208	104.0	
20490	chr3	112813396	112814744	1348	674.0	
20491	chr3	112817826	112818908	1082	541.0	
20492	chr3	112847637	112848668	1031	516.0	
20493	chr3	112856475	112857003	528	264.0	
20494	chr3	112857683	112859136	1453	726.0	
20495	chr3	112860884	112861320	436	218.0	
20496	chr3	112873628	112874017	389	194.0	
20497	chr3	112931768	112932152	384	192.0	
20498	chr3	112965667	112967077	1410	705.0	
20499	chr3	112967663	112968306	643	322.0	
20500	chr3	112973183	112975481	2298	1149.0	
20501	chr3	112979163	112979648	485	242.0	
20502	chr3	112982865	112983096	231	116.0	
20503	chr3	112984407	112984966	559	280.0	
20504	chr3	112990393	112991810	1417	708.0	
20505	chr3	113002462	113003280	818	409.0	
20506	chr3	113005227	113006708	1481	740.0	
20507	chr3	113018271	113020251	1980	990.0	
20508	chr3	113035315	113035835	520	260.0	
20509	chr3	113051100	113051848	748	374.0	
20510	chr3	113054482	113055628	1146	573.0	
20511	chr3	113063502	113063819	317	158.0	
20512	chr3	113103527	113103923	396	198.0	
20513	chr3	113140858	113141257	399	200.0	
20514	chr3	113212160	113212803	643	322.0	
20515	chr3	113223939	113224362	423	212.0	
20516	chr3	113275803	113276836	1033	516.0	
20517	chr3	113288010	113288496	486	243.0	
20518	chr3	113441291	113441811	520	260.0	
20519	chr3	113485017	113485717	700	350.0	
20520	chr3	113494076	113495439	1363	682.0	
20521	chr3	113513975	113516593	2618	1309.0	
20522	chr3	113531790	113535052	3262	1631.0	
20523	chr3	113535853	113536313	460	230.0	
20524	chr3	113552612	113553269	657	328.0	
20525	chr3	113560800	113561322	522	261.0	
20526	chr3	113577621	113578286	665	332.0	
20527	chr3	113606671	113607412	741	370.0	
20528	chr3	113614331	113614843	512	256.0	
20529	chr3	113620163	113620408	245	122.0	
20530	chr3	113625363	113627326	1963	982.0	
20531	chr3	113630953	113631598	645	322.0	
20532	chr3	113659040	113659614	574	287.0	
20533	chr3	113676152	113676713	561	280.0	
20534	chr3	113695158	113698037	2879	1440.0	
20535	chr3	113698798	113699407	609	304.0	
20536	chr3	113736284	113737276	992	496.0	
20537	chr3	113741071	113742667	1596	798.0	
20538	chr3	113743190	113748085	4895	2448.0	
20539	chr3	113748762	113749603	841	420.0	
20540	chr3	113754458	113755070	612	306.0	
20541	chr3	113783392	113784289	897	448.0	
20542	chr3	113788520	113789078	558	279.0	
20543	chr3	113830186	113831305	1119	560.0	
20544	chr3	113838330	113839429	1099	550.0	
20545	chr3	113844629	113845035	406	203.0	
20546	chr3	113912507	113913369	862	431.0	
20547	chr3	113947210	113949084	1874	937.0	
20548	chr3	113985451	113986019	568	284.0	
20549	chr3	114005299	114005964	665	332.0	
20550	chr3	114055780	114057608	1828	914.0	
20551	chr3	114092120	114093038	918	459.0	
20552	chr3	114105561	114105841	280	140.0	
20553	chr3	114111036	114111799	763	382.0	
20554	chr3	114152184	114153213	1029	514.0	
20555	chr3	114155487	114155549	62	31.0	
20556	chr3	114178794	114178965	171	86.0	
20557	chr3	114179611	114179939	328	164.0	
20558	chr3	114213073	114215726	2653	1326.0	
20559	chr3	114217363	114217547	184	92.0	
20560	chr3	114220499	114222296	1797	898.0	
20561	chr3	114222884	114223699	815	408.0	
20562	chr3	114226001	114226972	971	486.0	
20563	chr3	114231345	114233291	1946	973.0	
20564	chr3	114237396	114237753	357	178.0	
20565	chr3	114285611	114286625	1014	507.0	
20566	chr3	114290433	114292043	1610	805.0	
20567	chr3	114293795	114295713	1918	959.0	
20568	chr3	114296344	114298032	1688	844.0	
20569	chr3	114298627	114298629	2	1.0	
20570	chr3	114299322	114300473	1151	576.0	
20571	chr3	114307187	114309459	2272	1136.0	
20572	chr3	114314218	114314772	554	277.0	
20573	chr3	114315593	114316209	616	308.0	
20574	chr3	114318265	114318693	428	214.0	
20575	chr3	114323862	114324218	356	178.0	
20576	chr3	114327697	114327717	20	10.0	
20577	chr3	114332330	114333461	1131	566.0	
20578	chr3	114338608	114339301	693	346.0	
20579	chr3	114383705	114384714	1009	504.0	
20580	chr3	114389125	114389534	409	204.0	
20581	chr3	114418480	114419331	851	426.0	
20582	chr3	114428120	114428620	500	250.0	
20583	chr3	114451111	114451599	488	244.0	
20584	chr3	114454087	114455191	1104	552.0	
20585	chr3	114456730	114457018	288	144.0	
20586	chr3	114500035	114500473	438	219.0	
20587	chr3	114519372	114519933	561	280.0	
20588	chr3	114686660	114686939	279	140.0	
20589	chr3	114697294	114698787	1493	746.0	
20590	chr3	114746539	114746876	337	168.0	
20591	chr3	114759400	114759596	196	98.0	
20592	chr3	114809714	114810299	585	292.0	
20593	chr3	114827602	114827725	123	62.0	
20594	chr3	114863778	114864164	386	193.0	
20595	chr3	115040650	115041054	404	202.0	
20596	chr3	115092077	115092817	740	370.0	
20597	chr3	115097377	115097808	431	216.0	
20598	chr3	115099976	115100791	815	408.0	
20599	chr3	115145692	115148765	3073	1536.0	
20600	chr3	115164358	115166119	1761	880.0	
20601	chr3	115187076	115187500	424	212.0	
20602	chr3	115217568	115217994	426	213.0	enhancer
20603	chr3	115264124	115264407	283	142.0	
20604	chr3	115275996	115276280	284	142.0	
20605	chr3	115279917	115280967	1050	525.0	
20606	chr3	115512588	115513809	1221	610.0	
20607	chr3	115652840	115653078	238	119.0	
20608	chr3	115658023	115659730	1707	854.0	
20609	chr3	115660651	115661017	366	183.0	
20610	chr3	115667839	115667877	38	19.0	
20611	chr3	115692825	115693352	527	264.0	
20612	chr3	115783738	115785529	1791	896.0	
20613	chr3	115790873	115791024	151	76.0	
20614	chr3	115792194	115792737	543	272.0	
20615	chr3	115814714	115815212	498	249.0	
20616	chr3	115819660	115820412	752	376.0	
20617	chr3	116020430	116020895	465	232.0	
20618	chr3	116038458	116039009	551	276.0	
20619	chr3	116758216	116758586	370	185.0	
20620	chr3	116770779	116771247	468	234.0	
20621	chr3	116808977	116809631	654	327.0	
20622	chr3	117019074	117019538	464	232.0	
20623	chr3	117035723	117037023	1300	650.0	
20624	chr3	117054970	117055806	836	418.0	
20625	chr3	117063802	117064507	705	352.0	
20626	chr3	117084194	117084789	595	298.0	
20627	chr3	117347053	117347353	300	150.0	
20628	chr3	117427986	117428667	681	340.0	
20629	chr3	117439608	117440489	881	440.0	
20630	chr3	117450093	117450336	243	122.0	
20631	chr3	117553403	117553946	543	272.0	
20632	chr3	117566956	117567263	307	154.0	
20633	chr3	117603208	117603347	139	70.0	
20634	chr3	117722786	117723312	526	263.0	
20635	chr3	117997438	117997846	408	204.0	
20636	chr3	118817738	118818056	318	159.0	
20637	chr3	118851426	118852301	875	438.0	
20638	chr3	118882313	118882798	485	242.0	
20639	chr3	118884612	118885362	750	375.0	
20640	chr3	118949336	118949784	448	224.0	
20641	chr3	118955843	118956458	615	308.0	
20642	chr3	119034180	119035339	1159	580.0	
20643	chr3	119098657	119098736	79	40.0	
20644	chr3	119145367	119145784	417	208.0	
20645	chr3	119207247	119207522	275	138.0	
20646	chr3	119218956	119219626	670	335.0	
20647	chr3	119236687	119237379	692	346.0	
20648	chr3	119238631	119242120	3489	1744.0	
20649	chr3	119257921	119259364	1443	722.0	
20650	chr3	119274716	119275373	657	328.0	
20651	chr3	119289331	119289892	561	280.0	
20652	chr3	119292578	119297045	4467	2234.0	
20653	chr3	119297559	119298594	1035	518.0	
20654	chr3	119300749	119302324	1575	788.0	
20655	chr3	119302990	119303520	530	265.0	
20656	chr3	119305212	119305832	620	310.0	
20657	chr3	119311627	119311922	295	148.0	
20658	chr3	119322067	119324175	2108	1054.0	
20659	chr3	119343494	119344075	581	290.0	
20660	chr3	119351980	119353741	1761	880.0	
20661	chr3	119357140	119357540	400	200.0	
20662	chr3	119359637	119359928	291	146.0	
20663	chr3	119437944	119438273	329	164.0	
20664	chr3	119457125	119457711	586	293.0	
20665	chr3	119462750	119464539	1789	894.0	
20666	chr3	119467998	119470149	2151	1076.0	
20667	chr3	119497790	119499656	1866	933.0	
20668	chr3	119508314	119508837	523	262.0	
20669	chr3	119555097	119555855	758	379.0	
20670	chr3	119559293	119560191	898	449.0	
20671	chr3	119562162	119563109	947	474.0	
20672	chr3	119570060	119570992	932	466.0	
20673	chr3	119579194	119580706	1512	756.0	
20674	chr3	119582026	119582607	581	290.0	
20675	chr3	119585799	119586022	223	112.0	
20676	chr3	119588013	119589771	1758	879.0	
20677	chr3	119596405	119596765	360	180.0	
20678	chr3	119600694	119601112	418	209.0	
20679	chr3	119627339	119629534	2195	1098.0	
20680	chr3	119630475	119631191	716	358.0	
20681	chr3	119632409	119632429	20	10.0	
20682	chr3	119637702	119639628	1926	963.0	
20683	chr3	119658285	119658701	416	208.0	
20684	chr3	119664905	119665360	455	228.0	
20685	chr3	119676405	119678126	1721	860.0	
20686	chr3	119681287	119681678	391	196.0	
20687	chr3	119690051	119690452	401	200.0	
20688	chr3	119700290	119701221	931	466.0	
20689	chr3	119702349	119703531	1182	591.0	
20690	chr3	119809288	119810746	1458	729.0	
20691	chr3	119820972	119821423	451	226.0	
20692	chr3	119891891	119892547	656	328.0	
20693	chr3	119894192	119894504	312	156.0	
20694	chr3	119937143	119937653	510	255.0	
20695	chr3	120033566	120033999	433	216.0	
20696	chr3	120052259	120052530	271	136.0	
20697	chr3	120072980	120073328	348	174.0	
20698	chr3	120078975	120079134	159	80.0	
20699	chr3	120088616	120089064	448	224.0	
20700	chr3	120090490	120091237	747	374.0	
20701	chr3	120092062	120096433	4371	2186.0	
20702	chr3	120147036	120147510	474	237.0	
20703	chr3	120161754	120162371	617	308.0	
20704	chr3	120177937	120178256	319	160.0	
20705	chr3	120202942	120203674	732	366.0	
20706	chr3	120205452	120205690	238	119.0	
20707	chr3	120244166	120244683	517	258.0	
20708	chr3	120344301	120344812	511	256.0	
20709	chr3	120348067	120350148	2081	1040.0	
20710	chr3	120416765	120418092	1327	664.0	
20711	chr3	120418825	120419315	490	245.0	
20712	chr3	120450335	120451042	707	354.0	
20713	chr3	120499097	120499286	189	94.0	
20714	chr3	120507223	120507239	16	8.0	
20715	chr3	120557746	120560158	2412	1206.0	
20716	chr3	120560990	120561701	711	356.0	
20717	chr3	120567633	120568095	462	231.0	
20718	chr3	120595622	120598169	2547	1274.0	
20719	chr3	120615761	120616229	468	234.0	
20720	chr3	120642504	120642894	390	195.0	
20721	chr3	120678232	120678897	665	332.0	
20722	chr3	120688195	120688462	267	134.0	
20723	chr3	120719112	120720232	1120	560.0	
20724	chr3	120741735	120743818	2083	1042.0	
20725	chr3	120781073	120781464	391	196.0	
20726	chr3	120794957	120795507	550	275.0	
20727	chr3	120907964	120908405	441	220.0	
20728	chr3	121431772	121432641	869	434.0	
20729	chr3	121545214	121547321	2107	1054.0	
20730	chr3	121548567	121549142	575	288.0	
20731	chr3	121654521	121655113	592	296.0	
20732	chr3	121659288	121661801	2513	1256.0	
20733	chr3	121667305	121667782	477	238.0	
20734	chr3	121718110	121718633	523	262.0	
20735	chr3	121748516	121750638	2122	1061.0	
20736	chr3	121768508	121768807	299	150.0	
20737	chr3	121809328	121809584	256	128.0	
20738	chr3	121817768	121818131	363	182.0	
20739	chr3	121834019	121836868	2849	1424.0	
20740	chr3	121863905	121864176	271	136.0	
20741	chr3	121957565	121958185	620	310.0	
20742	chr3	121990132	121990231	99	50.0	
20743	chr3	121992690	121992977	287	144.0	
20744	chr3	121994649	121995967	1318	659.0	
20745	chr3	121997417	121999304	1887	944.0	
20746	chr3	122002948	122005449	2501	1250.0	
20747	chr3	122022034	122022482	448	224.0	
20748	chr3	122030253	122030987	734	367.0	
20749	chr3	122052942	122053333	391	196.0	
20750	chr3	122055097	122056228	1131	566.0	
20751	chr3	122057721	122058072	351	176.0	
20752	chr3	122060038	122060486	448	224.0	
20753	chr3	122063805	122064803	998	499.0	
20754	chr3	122066821	122068262	1441	720.0	
20755	chr3	122074429	122075331	902	451.0	
20756	chr3	122077023	122078308	1285	642.0	
20757	chr3	122085614	122086068	454	227.0	
20758	chr3	122088428	122088893	465	232.0	
20759	chr3	122091521	122092927	1406	703.0	
20760	chr3	122100847	122102645	1798	899.0	
20761	chr3	122123644	122124189	545	272.0	
20762	chr3	122232854	122234177	1323	662.0	
20763	chr3	122245731	122246660	929	464.0	
20764	chr3	122247178	122248245	1067	534.0	
20765	chr3	122255771	122256213	442	221.0	
20766	chr3	122258684	122259214	530	265.0	
20767	chr3	122263951	122264364	413	206.0	
20768	chr3	122271283	122271985	702	351.0	
20769	chr3	122272900	122273866	966	483.0	
20770	chr3	122295061	122296113	1052	526.0	
20771	chr3	122299847	122300294	447	224.0	
20772	chr3	122322428	122322737	309	154.0	
20773	chr3	122324832	122325469	637	318.0	
20774	chr3	122356439	122356467	28	14.0	
20775	chr3	122382704	122384871	2167	1084.0	
20776	chr3	122392845	122393332	487	244.0	
20777	chr3	122408980	122409846	866	433.0	
20778	chr3	122415174	122417102	1928	964.0	
20779	chr3	122497328	122497939	611	306.0	
20780	chr3	122502175	122502504	329	164.0	
20781	chr3	122513607	122515498	1891	946.0	
20782	chr3	122539061	122539318	257	128.0	
20783	chr3	122560554	122561325	771	386.0	
20784	chr3	122563462	122565169	1707	854.0	
20785	chr3	122572819	122573463	644	322.0	
20786	chr3	122575995	122578658	2663	1332.0	
20787	chr3	122589443	122589591	148	74.0	
20788	chr3	122609914	122610475	561	280.0	
20789	chr3	122678152	122683514	5362	2681.0	
20790	chr3	122687295	122687693	398	199.0	
20791	chr3	122688972	122689550	578	289.0	
20792	chr3	122694995	122695405	410	205.0	
20793	chr3	122698170	122698683	513	256.0	
20794	chr3	122721373	122721872	499	250.0	
20795	chr3	122754789	122755361	572	286.0	
20796	chr3	122758908	122759665	757	378.0	
20797	chr3	122762263	122762270	7	4.0	
20798	chr3	122767632	122768488	856	428.0	
20799	chr3	122769255	122770014	759	380.0	
20800	chr3	122770688	122770890	202	101.0	
20801	chr3	122773852	122774967	1115	558.0	
20802	chr3	122788673	122788722	49	24.0	
20803	chr3	122792984	122796262	3278	1639.0	
20804	chr3	122797206	122797758	552	276.0	
20805	chr3	122800733	122801051	318	159.0	
20806	chr3	122825421	122825863	442	221.0	
20807	chr3	122890150	122890507	357	178.0	
20808	chr3	122921712	122922497	785	392.0	
20809	chr3	122938926	122939644	718	359.0	
20810	chr3	122941202	122941630	428	214.0	
20811	chr3	122942872	122943275	403	202.0	
20812	chr3	122952386	122952917	531	266.0	
20813	chr3	122975352	122976033	681	340.0	
20814	chr3	123025973	123028902	2929	1464.0	
20815	chr3	123036556	123037087	531	266.0	
20816	chr3	123066673	123068031	1358	679.0	
20817	chr3	123072155	123072647	492	246.0	
20818	chr3	123105534	123105972	438	219.0	
20819	chr3	123152586	123153276	690	345.0	
20820	chr3	123154028	123154875	847	424.0	
20821	chr3	123190528	123190999	471	236.0	
20822	chr3	123194730	123194802	72	36.0	
20823	chr3	123201193	123203059	1866	933.0	
20824	chr3	123258833	123259232	399	200.0	
20825	chr3	123328762	123329254	492	246.0	
20826	chr3	123421541	123421937	396	198.0	
20827	chr3	123447866	123450214	2348	1174.0	
20828	chr3	123489387	123489788	401	200.0	
20829	chr3	123492089	123492612	523	262.0	
20830	chr3	123522931	123523358	427	214.0	
20831	chr3	123559049	123559496	447	224.0	
20832	chr3	123582901	123582916	15	8.0	
20833	chr3	123584094	123586688	2594	1297.0	
20834	chr3	123605192	123605483	291	146.0	
20835	chr3	123610404	123610701	297	148.0	
20836	chr3	123618281	123619453	1172	586.0	
20837	chr3	123642292	123642777	485	242.0	
20838	chr3	123652304	123652769	465	232.0	
20839	chr3	123693594	123694031	437	218.0	
20840	chr3	123719150	123719467	317	158.0	
20841	chr3	123723518	123723979	461	230.0	
20842	chr3	123757298	123757647	349	174.0	
20843	chr3	123884160	123884749	589	294.0	
20844	chr3	123960434	123961925	1491	746.0	
20845	chr3	123979749	123980362	613	306.0	
20846	chr3	124032748	124033779	1031	516.0	
20847	chr3	124131696	124132097	401	200.0	
20848	chr3	124550405	124550771	366	183.0	
20849	chr3	124559799	124560243	444	222.0	
20850	chr3	124564902	124565295	393	196.0	
20851	chr3	124584389	124585103	714	357.0	
20852	chr3	124619872	124621061	1189	594.0	
20853	chr3	124639633	124640208	575	288.0	
20854	chr3	124650748	124651120	372	186.0	
20855	chr3	124651975	124652323	348	174.0	
20856	chr3	124671012	124671622	610	305.0	
20857	chr3	124688788	124689263	475	238.0	
20858	chr3	124729773	124731218	1445	722.0	
20859	chr3	124761014	124761852	838	419.0	
20860	chr3	124768840	124769132	292	146.0	
20861	chr3	124784727	124785129	402	201.0	
20862	chr3	124815850	124816216	366	183.0	
20863	chr3	124829611	124830494	883	442.0	
20864	chr3	124834930	124835765	835	418.0	
20865	chr3	124863270	124863695	425	212.0	
20866	chr3	124876434	124876731	297	148.0	
20867	chr3	124878592	124879280	688	344.0	
20868	chr3	124886250	124887986	1736	868.0	
20869	chr3	124901184	124901776	592	296.0	
20870	chr3	124926645	124927159	514	257.0	
20871	chr3	124928596	124929017	421	210.0	
20872	chr3	124942006	124942051	45	22.0	
20873	chr3	124985332	124985705	373	186.0	
20874	chr3	124995377	124996187	810	405.0	
20875	chr3	125002165	125002878	713	356.0	
20876	chr3	125018714	125019690	976	488.0	
20877	chr3	125022220	125022603	383	192.0	
20878	chr3	125032494	125032752	258	129.0	
20879	chr3	125037485	125037905	420	210.0	
20880	chr3	125051476	125056757	5281	2640.0	
20881	chr3	125069399	125069874	475	238.0	
20882	chr3	125078759	125079111	352	176.0	
20883	chr3	125119493	125120403	910	455.0	
20884	chr3	125121570	125122086	516	258.0	
20885	chr3	125125747	125126171	424	212.0	
20886	chr3	125132808	125133072	264	132.0	
20887	chr3	125136648	125136661	13	6.0	
20888	chr3	125141007	125143182	2175	1088.0	
20889	chr3	125145978	125147828	1850	925.0	
20890	chr3	125148608	125149299	691	346.0	
20891	chr3	125150466	125150947	481	240.0	
20892	chr3	125154615	125156239	1624	812.0	
20893	chr3	125163703	125165588	1885	942.0	
20894	chr3	125202224	125202567	343	172.0	
20895	chr3	125212490	125212991	501	250.0	
20896	chr3	125214767	125215084	317	158.0	
20897	chr3	125221022	125221260	238	119.0	
20898	chr3	125221870	125222292	422	211.0	
20899	chr3	125257498	125257974	476	238.0	
20900	chr3	125310510	125311292	782	391.0	
20901	chr3	125316974	125317239	265	132.0	
20902	chr3	125356772	125357863	1091	546.0	
20903	chr3	125374192	125376350	2158	1079.0	
20904	chr3	125381745	125382056	311	156.0	
20905	chr3	125437766	125438240	474	237.0	
20906	chr3	125519391	125520896	1505	752.0	
20907	chr3	125585578	125586079	501	250.0	
20908	chr3	125589805	125590159	354	177.0	
20909	chr3	125591290	125591812	522	261.0	
20910	chr3	125593853	125596425	2572	1286.0	
20911	chr3	125632722	125633767	1045	522.0	
20912	chr3	125634547	125634923	376	188.0	
20913	chr3	125644225	125644772	547	274.0	
20914	chr3	125670910	125671470	560	280.0	
20915	chr3	125697988	125698375	387	194.0	
20916	chr3	125742865	125743278	413	206.0	
20917	chr3	125766167	125767325	1158	579.0	
20918	chr3	125835961	125837158	1197	598.0	
20919	chr3	125915007	125917463	2456	1228.0	
20920	chr3	125921707	125922188	481	240.0	
20921	chr3	125929103	125929568	465	232.0	
20922	chr3	125972068	125972952	884	442.0	
20923	chr3	125990116	125991167	1051	526.0	
20924	chr3	126026398	126026520	122	61.0	
20925	chr3	126081517	126082363	846	423.0	
20926	chr3	126083265	126084826	1561	780.0	
20927	chr3	126085879	126085925	46	23.0	
20928	chr3	126129702	126129840	138	69.0	
20929	chr3	126134091	126134563	472	236.0	
20930	chr3	126246322	126246410	88	44.0	
20931	chr3	126258573	126258998	425	212.0	
20932	chr3	126260753	126261379	626	313.0	
20933	chr3	126267550	126267942	392	196.0	
20934	chr3	126355685	126358475	2790	1395.0	
20935	chr3	126388944	126389808	864	432.0	
20936	chr3	126399198	126399759	561	280.0	
20937	chr3	126464449	126464916	467	234.0	
20938	chr3	126465837	126467242	1405	702.0	
20939	chr3	126468255	126468656	401	200.0	
20940	chr3	126472117	126473079	962	481.0	
20941	chr3	126473640	126473992	352	176.0	
20942	chr3	126474656	126476969	2313	1156.0	
20943	chr3	126487241	126487437	196	98.0	
20944	chr3	126522049	126522708	659	330.0	
20945	chr3	126523792	126525031	1239	620.0	
20946	chr3	126528800	126531008	2208	1104.0	
20947	chr3	126540354	126541016	662	331.0	
20948	chr3	126607164	126607663	499	250.0	
20949	chr3	126654452	126655474	1022	511.0	
20950	chr3	126678981	126679710	729	364.0	
20951	chr3	126703441	126705062	1621	810.0	
20952	chr3	126731094	126731388	294	147.0	
20953	chr3	126752190	126752628	438	219.0	
20954	chr3	126908777	126909146	369	184.0	
20955	chr3	126910858	126912538	1680	840.0	
20956	chr3	126918348	126918885	537	268.0	
20957	chr3	126925106	126925898	792	396.0	
20958	chr3	126935760	126936119	359	180.0	
20959	chr3	126961264	126961311	47	24.0	
20960	chr3	126981316	126984874	3558	1779.0	
20961	chr3	126985459	126985837	378	189.0	
20962	chr3	127206159	127206536	377	188.0	
20963	chr3	127223985	127224518	533	266.0	
20964	chr3	127226752	127227647	895	448.0	
20965	chr3	127288952	127289255	303	152.0	
20966	chr3	127299121	127299837	716	358.0	
20967	chr3	127307212	127307871	659	330.0	
20968	chr3	127324838	127325309	471	236.0	
20969	chr3	127455504	127455971	467	234.0	
20970	chr3	127483936	127484297	361	180.0	
20971	chr3	127543991	127544842	851	426.0	
20972	chr3	127546964	127548456	1492	746.0	
20973	chr3	127560313	127560864	551	276.0	
20974	chr3	127574700	127575993	1293	646.0	
20975	chr3	127589092	127593060	3968	1984.0	
20976	chr3	127597574	127599086	1512	756.0	
20977	chr3	127609718	127609951	233	116.0	
20978	chr3	127626062	127627035	973	486.0	
20979	chr3	127628475	127630611	2136	1068.0	
20980	chr3	127637481	127637992	511	256.0	
20981	chr3	127652089	127652738	649	324.0	
20982	chr3	127671288	127674704	3416	1708.0	
20983	chr3	127678588	127679011	423	212.0	
20984	chr3	127683549	127684080	531	266.0	
20985	chr3	127690880	127691230	350	175.0	
20986	chr3	127694341	127694797	456	228.0	
20987	chr3	127696095	127698117	2022	1011.0	
20988	chr3	127729365	127730044	679	340.0	
20989	chr3	127732994	127733546	552	276.0	
20990	chr3	127734646	127735153	507	254.0	
20991	chr3	127735912	127736693	781	390.0	
20992	chr3	127750233	127750997	764	382.0	
20993	chr3	127753752	127755731	1979	990.0	
20994	chr3	127761250	127762425	1175	588.0	
20995	chr3	127768292	127769078	786	393.0	
20996	chr3	127770780	127771382	602	301.0	
20997	chr3	127775371	127776013	642	321.0	
20998	chr3	127778019	127778324	305	152.0	
20999	chr3	127791126	127791475	349	174.0	
21000	chr3	127821571	127821767	196	98.0	
21001	chr3	127822499	127823682	1183	592.0	
21002	chr3	127831798	127832257	459	230.0	
21003	chr3	127908075	127909357	1282	641.0	
21004	chr3	127911862	127911889	27	14.0	
21005	chr3	127971037	127971320	283	142.0	
21006	chr3	128051393	128053378	1985	992.0	
21007	chr3	128054405	128054694	289	144.0	
21008	chr3	128055352	128055503	151	76.0	
21009	chr3	128067884	128068613	729	364.0	
21010	chr3	128072015	128072830	815	408.0	
21011	chr3	128073444	128074221	777	388.0	
21012	chr3	128074916	128078043	3127	1564.0	
21013	chr3	128094909	128095755	846	423.0	
21014	chr3	128112307	128113265	958	479.0	
21015	chr3	128114006	128114818	812	406.0	
21016	chr3	128123109	128124888	1779	890.0	
21017	chr3	128133294	128133933	639	320.0	
21018	chr3	128144862	128145780	918	459.0	
21019	chr3	128151845	128154408	2563	1282.0	
21020	chr3	128155632	128155980	348	174.0	
21021	chr3	128168923	128169201	278	139.0	
21022	chr3	128170972	128171234	262	131.0	
21023	chr3	128195786	128196156	370	185.0	
21024	chr3	128226804	128227195	391	196.0	
21025	chr3	128242872	128243599	727	364.0	
21026	chr3	128295038	128295699	661	330.0	
21027	chr3	128316232	128317132	900	450.0	
21028	chr3	128321897	128322460	563	282.0	
21029	chr3	128387717	128388292	575	288.0	
21030	chr3	128415195	128417197	2002	1001.0	
21031	chr3	128426196	128426980	784	392.0	
21032	chr3	128432955	128433145	190	95.0	
21033	chr3	128448404	128448831	427	214.0	
21034	chr3	128466984	128467623	639	320.0	
21035	chr3	128482883	128484056	1173	586.0	
21036	chr3	128486438	128493643	7205	3602.0	
21037	chr3	128497189	128498318	1129	564.0	
21038	chr3	128523408	128524097	689	344.0	
21039	chr3	128555328	128555648	320	160.0	
21040	chr3	128572567	128573049	482	241.0	
21041	chr3	128584347	128584859	512	256.0	
21042	chr3	128591738	128592502	764	382.0	
21043	chr3	128595362	128596018	656	328.0	
21044	chr3	128603645	128604097	452	226.0	
21045	chr3	128604642	128604672	30	15.0	
21046	chr3	128607750	128608990	1240	620.0	
21047	chr3	128616419	128620546	4127	2064.0	
21048	chr3	128623963	128623990	27	14.0	
21049	chr3	128646959	128647142	183	92.0	
21050	chr3	128648953	128649029	76	38.0	
21051	chr3	128649588	128651829	2241	1120.0	
21052	chr3	128653566	128654828	1262	631.0	
21053	chr3	128655582	128655901	319	160.0	
21054	chr3	128656462	128656881	419	210.0	
21055	chr3	128667667	128668078	411	206.0	
21056	chr3	128670993	128671764	771	386.0	
21057	chr3	128674169	128675409	1240	620.0	
21058	chr3	128679325	128682243	2918	1459.0	
21059	chr3	128683594	128685487	1893	946.0	
21060	chr3	128697352	128699156	1804	902.0	
21061	chr3	128701465	128702185	720	360.0	
21062	chr3	128704360	128704884	524	262.0	
21063	chr3	128714867	128715688	821	410.0	
21064	chr3	128718864	128719353	489	244.0	
21065	chr3	128725403	128732084	6681	3340.0	
21066	chr3	128732615	128732912	297	148.0	
21067	chr3	128733465	128736407	2942	1471.0	
21068	chr3	128737180	128737824	644	322.0	
21069	chr3	128738679	128738685	6	3.0	
21070	chr3	128740669	128740832	163	82.0	
21071	chr3	128742330	128744128	1798	899.0	
21072	chr3	128744647	128744935	288	144.0	
21073	chr3	128745598	128746305	707	354.0	
21074	chr3	128747905	128749714	1809	904.0	
21075	chr3	128750666	128752037	1371	686.0	
21076	chr3	128753684	128754391	707	354.0	
21077	chr3	128756711	128756966	255	128.0	
21078	chr3	128757872	128760551	2679	1340.0	
21079	chr3	128764001	128764423	422	211.0	
21080	chr3	128767132	128767820	688	344.0	
21081	chr3	128784210	128784723	513	256.0	
21082	chr3	128787180	128789881	2701	1350.0	
21083	chr3	128794391	128795693	1302	651.0	
21084	chr3	128800502	128800657	155	78.0	
21085	chr3	128802021	128802167	146	73.0	
21086	chr3	128803429	128805146	1717	858.0	
21087	chr3	128805669	128807085	1416	708.0	
21088	chr3	128809589	128810108	519	260.0	
21089	chr3	128814491	128814954	463	232.0	
21090	chr3	128845091	128846991	1900	950.0	
21091	chr3	128854428	128855000	572	286.0	
21092	chr3	128864306	128865067	761	380.0	
21093	chr3	128875313	128876006	693	346.0	
21094	chr3	128878401	128880519	2118	1059.0	
21095	chr3	128922763	128924030	1267	634.0	
21096	chr3	128950599	128950960	361	180.0	
21097	chr3	128969995	128970993	998	499.0	
21098	chr3	128973975	128974656	681	340.0	
21099	chr3	128991210	128991898	688	344.0	
21100	chr3	128993500	128994863	1363	682.0	
21101	chr3	128996052	128996835	783	392.0	
21102	chr3	129001061	129002515	1454	727.0	
21103	chr3	129003445	129004260	815	408.0	
21104	chr3	129005661	129005763	102	51.0	
21105	chr3	129013511	129014166	655	328.0	
21106	chr3	129014862	129017894	3032	1516.0	
21107	chr3	129026352	129027872	1520	760.0	
21108	chr3	129034655	129035020	365	182.0	
21109	chr3	129045418	129046342	924	462.0	
21110	chr3	129053131	129054111	980	490.0	
21111	chr3	129058409	129058764	355	178.0	
21112	chr3	129067773	129070416	2643	1322.0	
21113	chr3	129086059	129087381	1322	661.0	
21114	chr3	129112326	129112761	435	218.0	
21115	chr3	129116370	129116934	564	282.0	
21116	chr3	129118535	129125396	6861	3430.0	
21117	chr3	129126510	129127215	705	352.0	
21118	chr3	129159899	129163271	3372	1686.0	
21119	chr3	129164439	129164859	420	210.0	
21120	chr3	129177417	129178021	604	302.0	
21121	chr3	129179696	129179963	267	134.0	
21122	chr3	129180509	129184727	4218	2109.0	
21123	chr3	129195670	129196377	707	354.0	
21124	chr3	129197517	129197930	413	206.0	
21125	chr3	129211859	129212110	251	126.0	
21126	chr3	129224653	129225473	820	410.0	
21127	chr3	129226359	129226850	491	246.0	
21128	chr3	129227735	129228304	569	284.0	
21129	chr3	129229031	129231426	2395	1198.0	
21130	chr3	129233260	129234238	978	489.0	
21131	chr3	129238476	129239604	1128	564.0	
21132	chr3	129240687	129240768	81	40.0	
21133	chr3	129245437	129246424	987	494.0	
21134	chr3	129248777	129250625	1848	924.0	
21135	chr3	129276350	129280342	3992	1996.0	
21136	chr3	129281681	129283379	1698	849.0	
21137	chr3	129304216	129306251	2035	1018.0	
21138	chr3	129307734	129307800	66	33.0	
21139	chr3	129308602	129308707	105	52.0	
21140	chr3	129310276	129317329	7053	3526.0	
21141	chr3	129323898	129324222	324	162.0	
21142	chr3	129328639	129329061	422	211.0	
21143	chr3	129330425	129330773	348	174.0	
21144	chr3	129343614	129344365	751	376.0	
21145	chr3	129348773	129349163	390	195.0	
21146	chr3	129365305	129365650	345	172.0	
21147	chr3	129383234	129383738	504	252.0	
21148	chr3	129398699	129400461	1762	881.0	
21149	chr3	129424020	129424746	726	363.0	
21150	chr3	129427817	129430056	2239	1120.0	
21151	chr3	129439094	129441741	2647	1324.0	
21152	chr3	129444043	129444667	624	312.0	
21153	chr3	129481690	129482399	709	354.0	
21154	chr3	129485852	129485905	53	26.0	
21155	chr3	129489170	129490915	1745	872.0	
21156	chr3	129503819	129503826	7	4.0	
21157	chr3	129523422	129523670	248	124.0	
21158	chr3	129525215	129526823	1608	804.0	"sequence_feature	sequence_feature"
21159	chr3	129549352	129549855	503	252.0	
21160	chr3	129552984	129554188	1204	602.0	
21161	chr3	129558092	129559139	1047	524.0	
21162	chr3	129567867	129568329	462	231.0	
21163	chr3	129575651	129578977	3326	1663.0	
21164	chr3	129592578	129594562	1984	992.0	
21165	chr3	129596466	129597437	971	486.0	
21166	chr3	129599236	129600299	1063	532.0	
21167	chr3	129603606	129604216	610	305.0	
21168	chr3	129605044	129609079	4035	2018.0	
21169	chr3	129614792	129615305	513	256.0	
21170	chr3	129615886	129617353	1467	734.0	
21171	chr3	129618383	129620344	1961	980.0	
21172	chr3	129624440	129624886	446	223.0	
21173	chr3	129625864	129628576	2712	1356.0	
21174	chr3	129633757	129634195	438	219.0	
21175	chr3	129650240	129650605	365	182.0	
21176	chr3	129690305	129690871	566	283.0	
21177	chr3	129695361	129695595	234	117.0	
21178	chr3	129794017	129794483	466	233.0	
21179	chr3	129822183	129823171	988	494.0	
21180	chr3	129824890	129825375	485	242.0	
21181	chr3	129827698	129828225	527	264.0	
21182	chr3	129829509	129829955	446	223.0	
21183	chr3	129855809	129856308	499	250.0	
21184	chr3	129890110	129890604	494	247.0	
21185	chr3	129891739	129894337	2598	1299.0	
21186	chr3	129911053	129911756	703	352.0	
21187	chr3	129921723	129922204	481	240.0	
21188	chr3	129934446	129934939	493	246.0	
21189	chr3	129936591	129937350	759	380.0	
21190	chr3	129942147	129942692	545	272.0	
21191	chr3	129950745	129950796	51	26.0	
21192	chr3	129954522	129954946	424	212.0	
21193	chr3	129958589	129959378	789	394.0	
21194	chr3	129974660	129975933	1273	636.0	
21195	chr3	130002238	130003468	1230	615.0	
21196	chr3	130093590	130095024	1434	717.0	
21197	chr3	130098301	130098729	428	214.0	
21198	chr3	130105913	130106457	544	272.0	
21199	chr3	130110696	130113084	2388	1194.0	
21200	chr3	130178991	130180223	1232	616.0	
21201	chr3	130354293	130354889	596	298.0	
21202	chr3	130414605	130414663	58	29.0	
21203	chr3	130699818	130700086	268	134.0	
21204	chr3	130707879	130708307	428	214.0	
21205	chr3	130727068	130727593	525	262.0	
21206	chr3	130737686	130737731	45	22.0	
21207	chr3	130745930	130748601	2671	1336.0	
21208	chr3	130759673	130760327	654	327.0	
21209	chr3	130820838	130821418	580	290.0	
21210	chr3	130838888	130839589	701	350.0	
21211	chr3	130849029	130849375	346	173.0	
21212	chr3	130849971	130851143	1172	586.0	
21213	chr3	130857344	130858139	795	398.0	
21214	chr3	130892643	130895349	2706	1353.0	
21215	chr3	130896111	130896128	17	8.0	
21216	chr3	130964041	130964183	142	71.0	
21217	chr3	131020070	131020666	596	298.0	
21218	chr3	131025745	131027539	1794	897.0	
21219	chr3	131033407	131033895	488	244.0	
21220	chr3	131042235	131042751	516	258.0	
21221	chr3	131174758	131175104	346	173.0	
21222	chr3	131360912	131362550	1638	819.0	
21223	chr3	131371262	131372093	831	416.0	
21224	chr3	131380764	131382536	1772	886.0	
21225	chr3	131386254	131387493	1239	620.0	
21226	chr3	131388196	131388566	370	185.0	
21227	chr3	131402489	131402957	468	234.0	
21228	chr3	131502243	131503721	1478	739.0	
21229	chr3	131504368	131505753	1385	692.0	
21230	chr3	131630225	131630308	83	42.0	
21231	chr3	131794748	131796061	1313	656.0	
21232	chr3	131955396	131955751	355	178.0	
21233	chr3	131960185	131960863	678	339.0	
21234	chr3	132006825	132006924	99	50.0	
21235	chr3	132029256	132029695	439	220.0	
21236	chr3	132034815	132035355	540	270.0	
21237	chr3	132180301	132180618	317	158.0	
21238	chr3	132242874	132243168	294	147.0	
21239	chr3	132253228	132253629	401	200.0	
21240	chr3	132283227	132284175	948	474.0	
21241	chr3	132290774	132291343	569	284.0	
21242	chr3	132316862	132317929	1067	534.0	
21243	chr3	132325610	132325845	235	118.0	
21244	chr3	132342922	132343424	502	251.0	
21245	chr3	132352484	132352989	505	252.0	
21246	chr3	132399267	132399716	449	224.0	
21247	chr3	132407056	132407417	361	180.0	
21248	chr3	132416575	132419324	2749	1374.0	
21249	chr3	132445757	132446227	470	235.0	
21250	chr3	132535982	132536442	460	230.0	
21251	chr3	132542882	132543392	510	255.0	
21252	chr3	132545479	132545932	453	226.0	
21253	chr3	132642211	132642624	413	206.0	
21254	chr3	132659015	132661377	2362	1181.0	
21255	chr3	132721515	132723558	2043	1022.0	
21256	chr3	132726172	132726963	791	396.0	
21257	chr3	133211444	133211845	401	200.0	
21258	chr3	133413797	133413861	64	32.0	
21259	chr3	133423452	133424230	778	389.0	
21260	chr3	133441731	133442443	712	356.0	
21261	chr3	133447904	133449139	1235	618.0	
21262	chr3	133466438	133466967	529	264.0	
21263	chr3	133474907	133476024	1117	558.0	
21264	chr3	133487888	133488377	489	244.0	
21265	chr3	133490492	133491656	1164	582.0	
21266	chr3	133492424	133492431	7	4.0	
21267	chr3	133506056	133507135	1079	540.0	
21268	chr3	133561753	133562041	288	144.0	
21269	chr3	133571931	133577261	5330	2665.0	
21270	chr3	133578380	133579272	892	446.0	
21271	chr3	133589429	133589640	211	106.0	
21272	chr3	133592986	133593368	382	191.0	
21273	chr3	133620099	133620457	358	179.0	
21274	chr3	133661250	133662700	1450	725.0	
21275	chr3	133663504	133664332	828	414.0	
21276	chr3	133799693	133800552	859	430.0	
21277	chr3	133803413	133803774	361	180.0	
21278	chr3	133805125	133806756	1631	816.0	
21279	chr3	133818739	133819263	524	262.0	
21280	chr3	133927097	133928196	1099	550.0	
21281	chr3	134197643	134198073	430	215.0	
21282	chr3	134212823	134213680	857	428.0	
21283	chr3	134224332	134224949	617	308.0	
21284	chr3	134239805	134239808	3	2.0	
21285	chr3	134249477	134251383	1906	953.0	
21286	chr3	134253817	134254188	371	186.0	
21287	chr3	134255443	134255755	312	156.0	
21288	chr3	134294163	134294924	761	380.0	
21289	chr3	134308078	134308873	795	398.0	
21290	chr3	134312472	134313350	878	439.0	
21291	chr3	134364126	134364803	677	338.0	
21292	chr3	134374246	134374836	590	295.0	
21293	chr3	134378391	134378755	364	182.0	
21294	chr3	134473729	134474440	711	356.0	
21295	chr3	134479482	134479951	469	234.0	
21296	chr3	134483190	134483927	737	368.0	
21297	chr3	134484859	134487997	3138	1569.0	
21298	chr3	134492275	134492892	617	308.0	
21299	chr3	134511576	134511774	198	99.0	
21300	chr3	134535565	134536042	477	238.0	
21301	chr3	134543160	134543478	318	159.0	
21302	chr3	134544384	134545150	766	383.0	
21303	chr3	134562272	134562777	505	252.0	
21304	chr3	134594527	134594840	313	156.0	
21305	chr3	134597603	134597878	275	138.0	
21306	chr3	134598642	134599185	543	272.0	
21307	chr3	134600784	134601489	705	352.0	
21308	chr3	134605736	134607360	1624	812.0	
21309	chr3	134621898	134622182	284	142.0	
21310	chr3	134640929	134641279	350	175.0	
21311	chr3	134755201	134755491	290	145.0	
21312	chr3	134790121	134790127	6	3.0	
21313	chr3	134794809	134795709	900	450.0	
21314	chr3	134840019	134840396	377	188.0	
21315	chr3	134852613	134853485	872	436.0	
21316	chr3	134864631	134865021	390	195.0	
21317	chr3	134918349	134918826	477	238.0	
21318	chr3	134931494	134931732	238	119.0	
21319	chr3	135226074	135226539	465	232.0	
21320	chr3	135228250	135229342	1092	546.0	
21321	chr3	135784597	135784921	324	162.0	
21322	chr3	135965131	135966561	1430	715.0	
21323	chr3	136071326	136071662	336	168.0	
21324	chr3	136075177	136075679	502	251.0	
21325	chr3	136078890	136078929	39	20.0	
21326	chr3	136141460	136141491	31	16.0	
21327	chr3	136163652	136164063	411	206.0	
21328	chr3	136171045	136171617	572	286.0	
21329	chr3	136178930	136179345	415	208.0	
21330	chr3	136182492	136183086	594	297.0	
21331	chr3	136185965	136186728	763	382.0	
21332	chr3	136188569	136188980	411	206.0	
21333	chr3	136190165	136190410	245	122.0	
21334	chr3	136191133	136197876	6743	3372.0	
21335	chr3	136249580	136251696	2116	1058.0	
21336	chr3	136391545	136392042	497	248.0	
21337	chr3	136543369	136543804	435	218.0	
21338	chr3	136549480	136549838	358	179.0	
21339	chr3	136595233	136596399	1166	583.0	
21340	chr3	136616165	136616525	360	180.0	
21341	chr3	136619638	136619881	243	122.0	
21342	chr3	136624449	136624756	307	154.0	
21343	chr3	136626324	136627060	736	368.0	
21344	chr3	136690572	136692445	1873	936.0	
21345	chr3	136694212	136694838	626	313.0	
21346	chr3	136708292	136708969	677	338.0	
21347	chr3	136712811	136714730	1919	960.0	
21348	chr3	136728460	136729294	834	417.0	
21349	chr3	136730998	136731360	362	181.0	
21350	chr3	136734290	136734802	512	256.0	
21351	chr3	136736645	136737445	800	400.0	
21352	chr3	136746864	136747619	755	378.0	
21353	chr3	136749098	136753743	4645	2322.0	
21354	chr3	136758052	136758887	835	418.0	
21355	chr3	136786741	136787812	1071	536.0	
21356	chr3	136818163	136820547	2384	1192.0	
21357	chr3	136856606	136857060	454	227.0	
21358	chr3	136858197	136858914	717	358.0	
21359	chr3	136860594	136863451	2857	1428.0	
21360	chr3	136878362	136878721	359	180.0	
21361	chr3	136882100	136883008	908	454.0	
21362	chr3	136885350	136886266	916	458.0	
21363	chr3	136899974	136900316	342	171.0	
21364	chr3	136909155	136909651	496	248.0	
21365	chr3	136919568	136920246	678	339.0	
21366	chr3	136921166	136922305	1139	570.0	
21367	chr3	136930325	136930640	315	158.0	
21368	chr3	136932531	136933346	815	408.0	
21369	chr3	136938486	136938500	14	7.0	
21370	chr3	136994841	136995174	333	166.0	
21371	chr3	137013672	137014710	1038	519.0	
21372	chr3	137032355	137033071	716	358.0	
21373	chr3	137105337	137105622	285	142.0	
21374	chr3	137971135	137971535	400	200.0	
21375	chr3	138068499	138069037	538	269.0	
21376	chr3	138078950	138079521	571	286.0	
21377	chr3	138082701	138082863	162	81.0	
21378	chr3	138114860	138115745	885	442.0	
21379	chr3	138118816	138119311	495	248.0	
21380	chr3	138125455	138126290	835	418.0	
21381	chr3	138135059	138135567	508	254.0	
21382	chr3	138136105	138138345	2240	1120.0	
21383	chr3	138173922	138175193	1271	636.0	
21384	chr3	138180551	138181233	682	341.0	
21385	chr3	138186381	138188632	2251	1126.0	
21386	chr3	138213420	138213759	339	170.0	
21387	chr3	138219227	138219699	472	236.0	
21388	chr3	138222045	138223276	1231	616.0	
21389	chr3	138327823	138328141	318	159.0	
21390	chr3	138328854	138330405	1551	776.0	
21391	chr3	138331447	138331521	74	37.0	
21392	chr3	138332378	138332898	520	260.0	
21393	chr3	138347266	138349104	1838	919.0	
21394	chr3	138367344	138368393	1049	524.0	
21395	chr3	138370944	138371558	614	307.0	
21396	chr3	138381842	138382440	598	299.0	
21397	chr3	138410534	138411026	492	246.0	
21398	chr3	138412850	138413626	776	388.0	
21399	chr3	138417467	138417951	484	242.0	
21400	chr3	138434310	138434930	620	310.0	
21401	chr3	138479397	138479685	288	144.0	
21402	chr3	138494189	138494669	480	240.0	
21403	chr3	138578100	138578685	585	292.0	
21404	chr3	138593536	138595470	1934	967.0	
21405	chr3	138608146	138610226	2080	1040.0	
21406	chr3	138686740	138687144	404	202.0	
21407	chr3	138689123	138689333	210	105.0	
21408	chr3	138699168	138699574	406	203.0	
21409	chr3	138726173	138726469	296	148.0	
21410	chr3	138744151	138744704	553	276.0	
21411	chr3	138780615	138781777	1162	581.0	
21412	chr3	138786608	138787418	810	405.0	
21413	chr3	138805947	138805971	24	12.0	
21414	chr3	138815126	138815526	400	200.0	
21415	chr3	138818193	138818793	600	300.0	
21416	chr3	138825545	138825547	2	1.0	
21417	chr3	138831957	138832160	203	102.0	
21418	chr3	138833135	138835619	2484	1242.0	
21419	chr3	138842310	138843044	734	367.0	
21420	chr3	138846487	138846934	447	224.0	
21421	chr3	138862472	138863750	1278	639.0	
21422	chr3	138873497	138873979	482	241.0	
21423	chr3	138875605	138876358	753	376.0	
21424	chr3	138881201	138881446	245	122.0	
21425	chr3	138888629	138889187	558	279.0	
21426	chr3	138890646	138891669	1023	512.0	
21427	chr3	138901477	138901985	508	254.0	
21428	chr3	138914804	138916568	1764	882.0	
21429	chr3	138923270	138924043	773	386.0	
21430	chr3	138935752	138940079	4327	2164.0	
21431	chr3	138941234	138941642	408	204.0	
21432	chr3	138943064	138943239	175	88.0	
21433	chr3	138944029	138947695	3666	1833.0	
21434	chr3	138949687	138950715	1028	514.0	
21435	chr3	139111794	139112271	477	238.0	
21436	chr3	139117371	139117684	313	156.0	
21437	chr3	139251499	139251955	456	228.0	
21438	chr3	139329034	139329974	940	470.0	
21439	chr3	139343400	139344812	1412	706.0	
21440	chr3	139388831	139390458	1627	814.0	
21441	chr3	139427504	139428032	528	264.0	
21442	chr3	139520376	139521646	1270	635.0	
21443	chr3	139539537	139540075	538	269.0	
21444	chr3	139571533	139571934	401	200.0	
21445	chr3	139572771	139573405	634	317.0	
21446	chr3	139629084	139629386	302	151.0	
21447	chr3	139676716	139678314	1598	799.0	
21448	chr3	139679441	139679702	261	130.0	
21449	chr3	140453993	140454058	65	32.0	
21450	chr3	140716081	140716938	857	428.0	
21451	chr3	140770835	140771546	711	356.0	
21452	chr3	140816305	140816967	662	331.0	
21453	chr3	140832899	140833162	263	132.0	
21454	chr3	140843034	140843907	873	436.0	
21455	chr3	140863648	140864044	396	198.0	
21456	chr3	140898274	140898733	459	230.0	
21457	chr3	140922642	140923022	380	190.0	
21458	chr3	140941173	140943246	2073	1036.0	
21459	chr3	140945010	140945206	196	98.0	
21460	chr3	140974935	140975356	421	210.0	
21461	chr3	140999983	141000479	496	248.0	
21462	chr3	141011457	141011965	508	254.0	
21463	chr3	141013542	141013741	199	100.0	
21464	chr3	141017526	141018114	588	294.0	
21465	chr3	141051018	141051308	290	145.0	
21466	chr3	141076327	141077320	993	496.0	
21467	chr3	141105839	141106192	353	176.0	
21468	chr3	141191960	141192899	939	470.0	
21469	chr3	141217966	141218887	921	460.0	
21470	chr3	141230703	141234787	4084	2042.0	
21471	chr3	141243127	141243831	704	352.0	
21472	chr3	141255804	141256401	597	298.0	
21473	chr3	141261900	141262104	204	102.0	
21474	chr3	141266320	141267924	1604	802.0	
21475	chr3	141268526	141268543	17	8.0	
21476	chr3	141275184	141275266	82	41.0	
21477	chr3	141279159	141279787	628	314.0	
21478	chr3	141294399	141294706	307	154.0	
21479	chr3	141300487	141300805	318	159.0	
21480	chr3	141302706	141304289	1583	792.0	
21481	chr3	141306745	141307980	1235	618.0	
21482	chr3	141311035	141312617	1582	791.0	
21483	chr3	141313340	141313573	233	116.0	
21484	chr3	141320940	141321182	242	121.0	
21485	chr3	141336885	141337519	634	317.0	
21486	chr3	141360813	141361337	524	262.0	
21487	chr3	141368144	141368714	570	285.0	
21488	chr3	141369911	141370980	1069	534.0	
21489	chr3	141379158	141379910	752	376.0	
21490	chr3	141386246	141386374	128	64.0	
21491	chr3	141388720	141389159	439	220.0	
21492	chr3	141400264	141400795	531	266.0	
21493	chr3	141401645	141404214	2569	1284.0	
21494	chr3	141409211	141414806	5595	2798.0	
21495	chr3	141426442	141426722	280	140.0	
21496	chr3	141440948	141442085	1137	568.0	
21497	chr3	141451920	141452677	757	378.0	
21498	chr3	141454705	141455407	702	351.0	
21499	chr3	141460005	141460875	870	435.0	
21500	chr3	141474148	141474815	667	334.0	
21501	chr3	141476009	141476477	468	234.0	
21502	chr3	141483329	141484194	865	432.0	
21503	chr3	141485265	141488501	3236	1618.0	
21504	chr3	141489010	141489755	745	372.0	
21505	chr3	141493108	141493659	551	276.0	
21506	chr3	141498192	141500464	2272	1136.0	
21507	chr3	141507561	141507846	285	142.0	
21508	chr3	141511372	141511741	369	184.0	
21509	chr3	141525013	141525325	312	156.0	
21510	chr3	141528879	141529007	128	64.0	
21511	chr3	141529800	141530749	949	474.0	
21512	chr3	141539414	141539827	413	206.0	
21513	chr3	141544622	141545532	910	455.0	
21514	chr3	141552587	141553591	1004	502.0	
21515	chr3	141557994	141558578	584	292.0	
21516	chr3	141561376	141561850	474	237.0	
21517	chr3	141576285	141576865	580	290.0	
21518	chr3	141644698	141645442	744	372.0	
21519	chr3	141646708	141647296	588	294.0	
21520	chr3	141659700	141660663	963	482.0	
21521	chr3	141677696	141678083	387	194.0	
21522	chr3	141679700	141680280	580	290.0	
21523	chr3	141686410	141687333	923	462.0	
21524	chr3	141690002	141691122	1120	560.0	
21525	chr3	141708334	141708697	363	182.0	
21526	chr3	141736866	141740794	3928	1964.0	
21527	chr3	141788131	141788561	430	215.0	
21528	chr3	141795778	141798695	2917	1458.0	
21529	chr3	141845409	141845773	364	182.0	
21530	chr3	141849376	141849886	510	255.0	
21531	chr3	141851355	141851883	528	264.0	
21532	chr3	141852875	141853987	1112	556.0	
21533	chr3	141854613	141855027	414	207.0	
21534	chr3	141863112	141865007	1895	948.0	
21535	chr3	141875000	141879775	4775	2388.0	
21536	chr3	141880967	141882112	1145	572.0	
21537	chr3	141882829	141883029	200	100.0	
21538	chr3	141884400	141885012	612	306.0	
21539	chr3	141885572	141889713	4141	2070.0	
21540	chr3	141890292	141890846	554	277.0	
21541	chr3	141892649	141893398	749	374.0	
21542	chr3	141893933	141895451	1518	759.0	
21543	chr3	141896018	141896047	29	14.0	
21544	chr3	141896989	141897245	256	128.0	
21545	chr3	141898535	141898608	73	36.0	
21546	chr3	141900075	141901187	1112	556.0	
21547	chr3	141901982	141902357	375	188.0	
21548	chr3	141903221	141904221	1000	500.0	
21549	chr3	141905026	141905557	531	266.0	
21550	chr3	141907494	141907509	15	8.0	
21551	chr3	141908489	141908795	306	153.0	
21552	chr3	141909560	141910116	556	278.0	
21553	chr3	141912642	141913862	1220	610.0	
21554	chr3	141920300	141920375	75	38.0	
21555	chr3	141923380	141923440	60	30.0	
21556	chr3	141929012	141929233	221	110.0	
21557	chr3	141941097	141941251	154	77.0	
21558	chr3	141962508	141962979	471	236.0	
21559	chr3	142022342	142022678	336	168.0	
21560	chr3	142027712	142028866	1154	577.0	
21561	chr3	142115893	142116283	390	195.0	
21562	chr3	142126145	142126573	428	214.0	
21563	chr3	142148366	142150194	1828	914.0	
21564	chr3	142152636	142152717	81	40.0	
21565	chr3	142224753	142226105	1352	676.0	
21566	chr3	142269715	142271141	1426	713.0	
21567	chr3	142275349	142277322	1973	986.0	
21568	chr3	142279778	142280592	814	407.0	
21569	chr3	142338152	142338376	224	112.0	
21570	chr3	142445540	142446418	878	439.0	
21571	chr3	142447010	142448719	1709	854.0	
21572	chr3	142508418	142509214	796	398.0	
21573	chr3	142574774	142575272	498	249.0	
21574	chr3	142577637	142579973	2336	1168.0	
21575	chr3	142586728	142587424	696	348.0	
21576	chr3	142595673	142597109	1436	718.0	
21577	chr3	142723510	142725181	1671	836.0	
21578	chr3	142828649	142829132	483	242.0	
21579	chr3	142850274	142851093	819	410.0	
21580	chr3	142888374	142889222	848	424.0	
21581	chr3	142904968	142905464	496	248.0	
21582	chr3	142929194	142929257	63	32.0	
21583	chr3	142963445	142964164	719	360.0	
21584	chr3	142976611	142977038	427	214.0	
21585	chr3	142987058	142987499	441	220.0	
21586	chr3	142993155	142993214	59	30.0	
21587	chr3	142993755	142994579	824	412.0	
21588	chr3	143000745	143002815	2070	1035.0	
21589	chr3	143016313	143016719	406	203.0	
21590	chr3	143036393	143037073	680	340.0	
21591	chr3	143060823	143061334	511	256.0	
21592	chr3	143081935	143082855	920	460.0	
21593	chr3	143084936	143085540	604	302.0	
21594	chr3	143118663	143124110	5447	2724.0	
21595	chr3	143124839	143125334	495	248.0	
21596	chr3	143134979	143135971	992	496.0	
21597	chr3	143158588	143158989	401	200.0	
21598	chr3	143163820	143163908	88	44.0	
21599	chr3	143164456	143166117	1661	830.0	
21600	chr3	143170002	143171708	1706	853.0	
21601	chr3	143180435	143180866	431	216.0	
21602	chr3	143183390	143183434	44	22.0	
21603	chr3	143216738	143217187	449	224.0	
21604	chr3	143235827	143236898	1071	536.0	
21605	chr3	143247258	143247301	43	22.0	
21606	chr3	143280953	143281421	468	234.0	
21607	chr3	143294456	143294508	52	26.0	
21608	chr3	143298853	143299263	410	205.0	
21609	chr3	143301432	143301958	526	263.0	
21610	chr3	143324202	143324601	399	200.0	
21611	chr3	143329571	143329875	304	152.0	
21612	chr3	143348722	143349095	373	186.0	
21613	chr3	143423749	143424102	353	176.0	
21614	chr3	143431071	143431812	741	370.0	
21615	chr3	143443625	143445377	1752	876.0	
21616	chr3	143450722	143451137	415	208.0	
21617	chr3	143473146	143473519	373	186.0	
21618	chr3	143528868	143529385	517	258.0	
21619	chr3	143565953	143566409	456	228.0	
21620	chr3	143586048	143586473	425	212.0	
21621	chr3	143595420	143595865	445	222.0	
21622	chr3	143600714	143601210	496	248.0	
21623	chr3	143644508	143644834	326	163.0	
21624	chr3	143669518	143669810	292	146.0	
21625	chr3	143674005	143674814	809	404.0	
21626	chr3	143751363	143752542	1179	590.0	
21627	chr3	143775318	143775807	489	244.0	
21628	chr3	143805955	143807310	1355	678.0	
21629	chr3	143811650	143811962	312	156.0	
21630	chr3	143814156	143815247	1091	546.0	
21631	chr3	143820868	143821199	331	166.0	
21632	chr3	143825450	143826813	1363	682.0	
21633	chr3	143831188	143831686	498	249.0	
21634	chr3	143847639	143848926	1287	644.0	
21635	chr3	143855297	143855377	80	40.0	
21636	chr3	143881150	143881549	399	200.0	
21637	chr3	143885766	143886226	460	230.0	
21638	chr3	143921185	143921609	424	212.0	
21639	chr3	143924781	143924962	181	90.0	
21640	chr3	143951330	143951806	476	238.0	
21641	chr3	143956990	143957491	501	250.0	
21642	chr3	143963988	143964328	340	170.0	
21643	chr3	143970499	143974204	3705	1852.0	
21644	chr3	143975547	143975966	419	210.0	
21645	chr3	143977188	143978395	1207	604.0	
21646	chr3	143998087	143998852	765	382.0	
21647	chr3	144028651	144029463	812	406.0	
21648	chr3	144086046	144086109	63	32.0	
21649	chr3	144109856	144110409	553	276.0	
21650	chr3	144128220	144128668	448	224.0	
21651	chr3	144660120	144660511	391	196.0	
21652	chr3	144809445	144809776	331	166.0	
21653	chr3	144866526	144866624	98	49.0	
21654	chr3	146148676	146148867	191	96.0	
21655	chr3	146160991	146161701	710	355.0	
21656	chr3	146189545	146189962	417	208.0	
21657	chr3	146250977	146251036	59	30.0	
21658	chr3	146468931	146470188	1257	628.0	
21659	chr3	146497772	146498617	845	422.0	
21660	chr3	146506424	146507223	799	400.0	
21661	chr3	146540164	146540748	584	292.0	
21662	chr3	146541762	146545194	3432	1716.0	
21663	chr3	146547273	146547715	442	221.0	
21664	chr3	146549881	146550601	720	360.0	
21665	chr3	146551127	146551437	310	155.0	
21666	chr3	146553947	146554417	470	235.0	
21667	chr3	146557643	146558179	536	268.0	
21668	chr3	146558821	146559268	447	224.0	
21669	chr3	146577673	146578046	373	186.0	
21670	chr3	146582069	146582373	304	152.0	
21671	chr3	147699130	147699574	444	222.0	
21672	chr3	147705519	147706178	659	330.0	
21673	chr3	148309429	148309772	343	172.0	
21674	chr3	148319152	148320039	887	444.0	
21675	chr3	148727282	148727639	357	178.0	
21676	chr3	148757470	148757986	516	258.0	
21677	chr3	148784986	148785442	456	228.0	
21678	chr3	148861346	148861631	285	142.0	
21679	chr3	148943423	148943998	575	288.0	
21680	chr3	148947257	148947667	410	205.0	
21681	chr3	148955445	148955894	449	224.0	
21682	chr3	148957656	148957999	343	172.0	
21683	chr3	148962473	148962900	427	214.0	
21684	chr3	148974804	148975124	320	160.0	
21685	chr3	148990170	148993080	2910	1455.0	
21686	chr3	148994058	148994059	1	0.0	
21687	chr3	148998627	148999540	913	456.0	
21688	chr3	149000137	149000618	481	240.0	
21689	chr3	149004068	149004256	188	94.0	
21690	chr3	149009368	149010516	1148	574.0	
21691	chr3	149043039	149043252	213	106.0	
21692	chr3	149085473	149087160	1687	844.0	
21693	chr3	149095396	149095938	542	271.0	
21694	chr3	149120015	149120872	857	428.0	
21695	chr3	149128651	149130886	2235	1118.0	
21696	chr3	149131415	149132451	1036	518.0	
21697	chr3	149145053	149146828	1775	888.0	
21698	chr3	149152334	149152841	507	254.0	
21699	chr3	149203702	149204231	529	264.0	
21700	chr3	149224681	149225732	1051	526.0	
21701	chr3	149243436	149243957	521	260.0	
21702	chr3	149245536	149246344	808	404.0	
21703	chr3	149252512	149252638	126	63.0	
21704	chr3	149273016	149273752	736	368.0	
21705	chr3	149277128	149277960	832	416.0	
21706	chr3	149291242	149291418	176	88.0	
21707	chr3	149292699	149293105	406	203.0	
21708	chr3	149298187	149298559	372	186.0	
21709	chr3	149300191	149300471	280	140.0	
21710	chr3	149339942	149340266	324	162.0	
21711	chr3	149342642	149343268	626	313.0	
21712	chr3	149352422	149352917	495	248.0	
21713	chr3	149371088	149371526	438	219.0	
21714	chr3	149373653	149374083	430	215.0	
21715	chr3	149374891	149375146	255	128.0	
21716	chr3	149377806	149377873	67	34.0	
21717	chr3	149387034	149387375	341	170.0	
21718	chr3	149393337	149394134	797	398.0	
21719	chr3	149420355	149420686	331	166.0	
21720	chr3	149442915	149443197	282	141.0	
21721	chr3	149448034	149449010	976	488.0	
21722	chr3	149464756	149465163	407	204.0	
21723	chr3	149473564	149474142	578	289.0	
21724	chr3	149476045	149476781	736	368.0	
21725	chr3	149480336	149481506	1170	585.0	
21726	chr3	149487637	149487708	71	36.0	
21727	chr3	149494142	149494576	434	217.0	
21728	chr3	149507401	149508503	1102	551.0	
21729	chr3	149512259	149512679	420	210.0	
21730	chr3	149532666	149533199	533	266.0	
21731	chr3	149623921	149624185	264	132.0	
21732	chr3	149657549	149658807	1258	629.0	
21733	chr3	149701713	149701867	154	77.0	
21734	chr3	149717455	149717731	276	138.0	
21735	chr3	149751538	149753191	1653	826.0	
21736	chr3	149763856	149764256	400	200.0	
21737	chr3	149765780	149766095	315	158.0	
21738	chr3	149771643	149772088	445	222.0	
21739	chr3	149781115	149781839	724	362.0	
21740	chr3	149783474	149783967	493	246.0	
21741	chr3	149808114	149808842	728	364.0	
21742	chr3	149809731	149810031	300	150.0	
21743	chr3	149812082	149814592	2510	1255.0	
21744	chr3	149815265	149815812	547	274.0	
21745	chr3	149816735	149817531	796	398.0	
21746	chr3	149848199	149848675	476	238.0	
21747	chr3	149879875	149880251	376	188.0	
21748	chr3	149881875	149882232	357	178.0	
21749	chr3	149934690	149934879	189	94.0	
21750	chr3	149936699	149937170	471	236.0	
21751	chr3	149947302	149947573	271	136.0	
21752	chr3	149967047	149967555	508	254.0	
21753	chr3	149969712	149972101	2389	1194.0	
21754	chr3	150184092	150184585	493	246.0	
21755	chr3	150221215	150222035	820	410.0	
21756	chr3	150223156	150223951	795	398.0	
21757	chr3	150227913	150228119	206	103.0	
21758	chr3	150253623	150253970	347	174.0	
21759	chr3	150273255	150273861	606	303.0	
21760	chr3	150286478	150286942	464	232.0	
21761	chr3	150372767	150373142	375	188.0	
21762	chr3	150384470	150386127	1657	828.0	
21763	chr3	150407293	150413528	6235	3118.0	
21764	chr3	150414159	150416335	2176	1088.0	
21765	chr3	150417310	150418534	1224	612.0	
21766	chr3	150419056	150420457	1401	700.0	
21767	chr3	150421357	150422635	1278	639.0	
21768	chr3	150425284	150430953	5669	2834.0	
21769	chr3	150433343	150434670	1327	664.0	
21770	chr3	150441507	150442104	597	298.0	
21771	chr3	150443171	150443177	6	3.0	
21772	chr3	150450996	150451219	223	112.0	
21773	chr3	150451721	150451950	229	114.0	
21774	chr3	150495116	150496023	907	454.0	
21775	chr3	150528457	150528812	355	178.0	
21776	chr3	150538008	150539617	1609	804.0	
21777	chr3	150540838	150542166	1328	664.0	
21778	chr3	150542813	150547736	4923	2462.0	
21779	chr3	150598646	150599983	1337	668.0	
21780	chr3	150602602	150604504	1902	951.0	
21781	chr3	150605827	150606892	1065	532.0	
21782	chr3	150609941	150610347	406	203.0	
21783	chr3	150619581	150620448	867	434.0	
21784	chr3	150635036	150636484	1448	724.0	
21785	chr3	150656450	150656663	213	106.0	
21786	chr3	150681019	150681380	361	180.0	
21787	chr3	150699206	150699628	422	211.0	
21788	chr3	150702497	150704497	2000	1000.0	
21789	chr3	150721204	150721964	760	380.0	
21790	chr3	150737301	150738671	1370	685.0	
21791	chr3	150739476	150740428	952	476.0	
21792	chr3	150747798	150748738	940	470.0	
21793	chr3	150751338	150751499	161	80.0	
21794	chr3	150755933	150756334	401	200.0	
21795	chr3	150758275	150758282	7	4.0	
21796	chr3	150759264	150765172	5908	2954.0	
21797	chr3	150766312	150766693	381	190.0	
21798	chr3	150787683	150788366	683	342.0	
21799	chr3	150865029	150865921	892	446.0	
21800	chr3	150889103	150891014	1911	956.0	
21801	chr3	150899449	150899724	275	138.0	
21802	chr3	150925626	150926377	751	376.0	
21803	chr3	151085132	151087461	2329	1164.0	
21804	chr3	151135432	151136231	799	400.0	
21805	chr3	151145924	151146848	924	462.0	
21806	chr3	151156591	151157057	466	233.0	
21807	chr3	151168215	151171914	3699	1850.0	
21808	chr3	151183268	151183669	401	200.0	
21809	chr3	151199625	151200216	591	296.0	
21810	chr3	151200746	151201734	988	494.0	
21811	chr3	151202431	151203503	1072	536.0	
21812	chr3	151204635	151205222	587	294.0	
21813	chr3	151209772	151210007	235	118.0	
21814	chr3	151210688	151211503	815	408.0	
21815	chr3	151225542	151226627	1085	542.0	
21816	chr3	151227318	151228694	1376	688.0	
21817	chr3	151230344	151231327	983	492.0	
21818	chr3	151265524	151266541	1017	508.0	
21819	chr3	151268539	151269385	846	423.0	
21820	chr3	151275146	151275388	242	121.0	
21821	chr3	151276213	151277213	1000	500.0	
21822	chr3	151278050	151278971	921	460.0	
21823	chr3	151282839	151283534	695	348.0	
21824	chr3	151290707	151291002	295	148.0	
21825	chr3	151305198	151305883	685	342.0	
21826	chr3	151318848	151319405	557	278.0	
21827	chr3	151322553	151322959	406	203.0	
21828	chr3	151327584	151329832	2248	1124.0	
21829	chr3	151330346	151331491	1145	572.0	
21830	chr3	151345783	151347942	2159	1080.0	
21831	chr3	151350950	151352069	1119	560.0	
21832	chr3	151356771	151357481	710	355.0	
21833	chr3	151362749	151363384	635	318.0	
21834	chr3	151379387	151379588	201	100.0	
21835	chr3	151382740	151383048	308	154.0	
21836	chr3	151383987	151384018	31	16.0	
21837	chr3	151384618	151385189	571	286.0	
21838	chr3	151387456	151388353	897	448.0	
21839	chr3	151395881	151395929	48	24.0	
21840	chr3	151398910	151399261	351	176.0	
21841	chr3	151421979	151422298	319	160.0	
21842	chr3	151439557	151440026	469	234.0	
21843	chr3	151445246	151445721	475	238.0	
21844	chr3	151468271	151468659	388	194.0	
21845	chr3	151553839	151554316	477	238.0	
21846	chr3	151556603	151556962	359	180.0	
21847	chr3	151584616	151585012	396	198.0	
21848	chr3	151751359	151751387	28	14.0	
21849	chr3	151837104	151837404	300	150.0	
21850	chr3	151838954	151839385	431	216.0	
21851	chr3	151852387	151852493	106	53.0	
21852	chr3	151871359	151872201	842	421.0	
21853	chr3	151873481	151873673	192	96.0	
21854	chr3	151875687	151876302	615	308.0	
21855	chr3	151879842	151880089	247	124.0	
21856	chr3	151890588	151891088	500	250.0	
21857	chr3	151895525	151895866	341	170.0	
21858	chr3	151918261	151918635	374	187.0	
21859	chr3	152071924	152072359	435	218.0	
21860	chr3	152096496	152096819	323	162.0	
21861	chr3	152100452	152101025	573	286.0	
21862	chr3	152104784	152105401	617	308.0	
21863	chr3	152177801	152178195	394	197.0	
21864	chr3	152183415	152183972	557	278.0	
21865	chr3	152192014	152194634	2620	1310.0	
21866	chr3	152196719	152201831	5112	2556.0	
21867	chr3	152202967	152203425	458	229.0	
21868	chr3	152204981	152205856	875	438.0	
21869	chr3	152213103	152213639	536	268.0	
21870	chr3	152217964	152218670	706	353.0	
21871	chr3	152223717	152224135	418	209.0	
21872	chr3	152236718	152237331	613	306.0	
21873	chr3	152241010	152244690	3680	1840.0	
21874	chr3	152245567	152246222	655	328.0	
21875	chr3	152252656	152254445	1789	894.0	
21876	chr3	152255273	152255604	331	166.0	
21877	chr3	152256881	152259199	2318	1159.0	
21878	chr3	152264424	152264706	282	141.0	
21879	chr3	152266181	152271846	5665	2832.0	
21880	chr3	152272641	152273367	726	363.0	
21881	chr3	152275198	152275856	658	329.0	
21882	chr3	152276557	152277471	914	457.0	
21883	chr3	152278635	152281880	3245	1622.0	
21884	chr3	152282903	152283945	1042	521.0	
21885	chr3	152284526	152286057	1531	766.0	
21886	chr3	152286835	152287385	550	275.0	
21887	chr3	152288175	152288575	400	200.0	
21888	chr3	152290696	152293418	2722	1361.0	
21889	chr3	152295279	152297357	2078	1039.0	
21890	chr3	152298213	152299946	1733	866.0	
21891	chr3	152301658	152302964	1306	653.0	
21892	chr3	152304165	152304734	569	284.0	
21893	chr3	152305318	152306393	1075	538.0	
21894	chr3	152308096	152310363	2267	1134.0	
21895	chr3	152314646	152315045	399	200.0	
21896	chr3	152315754	152316618	864	432.0	
21897	chr3	152317212	152317726	514	257.0	
21898	chr3	152319227	152319534	307	154.0	
21899	chr3	152322790	152324342	1552	776.0	
21900	chr3	152327409	152327434	25	12.0	
21901	chr3	152328847	152329245	398	199.0	
21902	chr3	152332647	152333023	376	188.0	
21903	chr3	152334898	152335536	638	319.0	
21904	chr3	152345301	152345483	182	91.0	
21905	chr3	152352569	152352840	271	136.0	
21906	chr3	152356845	152357882	1037	518.0	
21907	chr3	152359662	152359957	295	148.0	
21908	chr3	152372943	152373781	838	419.0	
21909	chr3	152376389	152377513	1124	562.0	
21910	chr3	152379939	152380389	450	225.0	
21911	chr3	152382277	152383710	1433	716.0	
21912	chr3	152384454	152384781	327	164.0	
21913	chr3	152394606	152394745	139	70.0	
21914	chr3	152398578	152399811	1233	616.0	
21915	chr3	152402638	152404187	1549	774.0	
21916	chr3	152406043	152406973	930	465.0	
21917	chr3	152419612	152420341	729	364.0	
21918	chr3	152425438	152427547	2109	1054.0	
21919	chr3	152428335	152429246	911	456.0	
21920	chr3	152434055	152434514	459	230.0	
21921	chr3	152436746	152437064	318	159.0	
21922	chr3	152442967	152444445	1478	739.0	
21923	chr3	152452416	152452865	449	224.0	
21924	chr3	152466226	152467438	1212	606.0	
21925	chr3	152471129	152472969	1840	920.0	
21926	chr3	152474637	152475038	401	200.0	
21927	chr3	152524531	152524930	399	200.0	
21928	chr3	152595988	152596500	512	256.0	
21929	chr3	152769520	152769863	343	172.0	
21930	chr3	152834472	152835972	1500	750.0	
21931	chr3	152856946	152857579	633	316.0	
21932	chr3	152865618	152866265	647	324.0	
21933	chr3	152870103	152870479	376	188.0	
21934	chr3	152885096	152885444	348	174.0	
21935	chr3	153026224	153026321	97	48.0	
21936	chr3	153042949	153043648	699	350.0	
21937	chr3	153058416	153058634	218	109.0	
21938	chr3	153070077	153070591	514	257.0	
21939	chr3	153091080	153091306	226	113.0	
21940	chr3	153113551	153113827	276	138.0	
21941	chr3	153130484	153130977	493	246.0	
21942	chr3	153137581	153139148	1567	784.0	
21943	chr3	153140757	153141207	450	225.0	
21944	chr3	153159901	153167727	7826	3913.0	
21945	chr3	153174100	153174556	456	228.0	
21946	chr3	153181033	153181325	292	146.0	
21947	chr3	153209382	153211143	1761	880.0	
21948	chr3	153221373	153223014	1641	820.0	
21949	chr3	153242821	153243305	484	242.0	
21950	chr3	153244792	153245327	535	268.0	
21951	chr3	153246469	153247990	1521	760.0	
21952	chr3	153250151	153250804	653	326.0	
21953	chr3	153284221	153286278	2057	1028.0	
21954	chr3	153289311	153289788	477	238.0	
21955	chr3	153290311	153291715	1404	702.0	
21956	chr3	153293300	153293579	279	140.0	
21957	chr3	153319931	153319961	30	15.0	
21958	chr3	153373450	153374130	680	340.0	
21959	chr3	153462586	153462931	345	172.0	
21960	chr3	153591935	153592154	219	110.0	
21961	chr3	153595255	153595578	323	162.0	
21962	chr3	153614558	153614914	356	178.0	
21963	chr3	153621702	153622567	865	432.0	
21964	chr3	153624163	153624897	734	367.0	
21965	chr3	153628702	153628845	143	72.0	
21966	chr3	153643486	153643897	411	206.0	
21967	chr3	153679717	153680206	489	244.0	
21968	chr3	153768636	153769328	692	346.0	
21969	chr3	154120916	154122699	1783	892.0	
21970	chr3	154123219	154123346	127	64.0	
21971	chr3	154133005	154133452	447	224.0	
21972	chr3	154178114	154178652	538	269.0	
21973	chr3	154188863	154189496	633	316.0	
21974	chr3	154252964	154253474	510	255.0	
21975	chr3	154317596	154318061	465	232.0	
21976	chr3	154319505	154320536	1031	516.0	
21977	chr3	154321665	154322081	416	208.0	
21978	chr3	154323357	154325395	2038	1019.0	
21979	chr3	154334916	154335283	367	184.0	
21980	chr3	154585057	154585328	271	136.0	
21981	chr3	154717954	154718538	584	292.0	
21982	chr3	154783302	154784055	753	376.0	
21983	chr3	154794385	154795939	1554	777.0	
21984	chr3	154954796	154955074	278	139.0	
21985	chr3	154970847	154971187	340	170.0	
21986	chr3	154972010	154972297	287	144.0	
21987	chr3	155001334	155002039	705	352.0	
21988	chr3	155018798	155019321	523	262.0	
21989	chr3	155026867	155027584	717	358.0	
21990	chr3	155033010	155033398	388	194.0	
21991	chr3	155079510	155080411	901	450.0	
21992	chr3	155124726	155125690	964	482.0	
21993	chr3	155323117	155323437	320	160.0	
21994	chr3	155334940	155334950	10	5.0	
21995	chr3	155581526	155582026	500	250.0	
21996	chr3	155664797	155665239	442	221.0	
21997	chr3	155702008	155702251	243	122.0	
21998	chr3	155737753	155738197	444	222.0	
21999	chr3	155743965	155745565	1600	800.0	
22000	chr3	155805094	155806776	1682	841.0	
22001	chr3	155835746	155835924	178	89.0	
22002	chr3	155853267	155855472	2205	1102.0	
22003	chr3	155859822	155860289	467	234.0	
22004	chr3	155862316	155863207	891	446.0	
22005	chr3	155869571	155872412	2841	1420.0	
22006	chr3	155908121	155908482	361	180.0	
22007	chr3	156043872	156044228	356	178.0	
22008	chr3	156149165	156149385	220	110.0	
22009	chr3	156150430	156150943	513	256.0	
22010	chr3	156151789	156152290	501	250.0	
22011	chr3	156160514	156161606	1092	546.0	
22012	chr3	156291661	156291977	316	158.0	
22013	chr3	156298949	156299415	466	233.0	
22014	chr3	156300941	156301383	442	221.0	
22015	chr3	156303383	156303664	281	140.0	
22016	chr3	156317417	156317729	312	156.0	
22017	chr3	156323438	156323807	369	184.0	
22018	chr3	156382759	156382770	11	6.0	
22019	chr3	156445845	156445987	142	71.0	
22020	chr3	156448344	156448654	310	155.0	
22021	chr3	156450031	156450326	295	148.0	
22022	chr3	156460334	156460750	416	208.0	
22023	chr3	156483283	156484976	1693	846.0	
22024	chr3	156509526	156510157	631	316.0	
22025	chr3	156524126	156525241	1115	558.0	
22026	chr3	156540959	156541492	533	266.0	
22027	chr3	156554023	156555871	1848	924.0	
22028	chr3	156576778	156577398	620	310.0	
22029	chr3	156579311	156579780	469	234.0	
22030	chr3	156586926	156587775	849	424.0	
22031	chr3	156605661	156607330	1669	834.0	
22032	chr3	156636036	156636101	65	32.0	
22033	chr3	156642819	156644405	1586	793.0	
22034	chr3	156661009	156661626	617	308.0	
22035	chr3	156663826	156665785	1959	980.0	
22036	chr3	156668162	156668877	715	358.0	
22037	chr3	156670709	156671821	1112	556.0	
22038	chr3	156673375	156678634	5259	2630.0	
22039	chr3	156679420	156679874	454	227.0	
22040	chr3	156680435	156682040	1605	802.0	
22041	chr3	156685051	156686407	1356	678.0	
22042	chr3	156686927	156687736	809	404.0	
22043	chr3	156688793	156691672	2879	1440.0	
22044	chr3	156698026	156698859	833	416.0	
22045	chr3	156700281	156700508	227	114.0	
22046	chr3	156701041	156703000	1959	980.0	
22047	chr3	156704400	156704461	61	30.0	
22048	chr3	156705483	156706633	1150	575.0	
22049	chr3	156707625	156707997	372	186.0	
22050	chr3	156709580	156709584	4	2.0	
22051	chr3	156722186	156722407	221	110.0	
22052	chr3	156792971	156793347	376	188.0	
22053	chr3	156796109	156796574	465	232.0	
22054	chr3	156812486	156813546	1060	530.0	
22055	chr3	156815281	156818155	2874	1437.0	
22056	chr3	156824012	156824552	540	270.0	
22057	chr3	156825449	156827458	2009	1004.0	
22058	chr3	156978345	156979051	706	353.0	
22059	chr3	156985988	156985992	4	2.0	
22060	chr3	157029298	157029916	618	309.0	
22061	chr3	157064263	157064790	527	264.0	
22062	chr3	157066865	157067986	1121	560.0	
22063	chr3	157081302	157082465	1163	582.0	
22064	chr3	157088200	157091590	3390	1695.0	
22065	chr3	157101413	157101916	503	252.0	
22066	chr3	157103295	157103672	377	188.0	
22067	chr3	157105238	157105685	447	224.0	
22068	chr3	157113898	157114158	260	130.0	
22069	chr3	157119329	157119905	576	288.0	
22070	chr3	157128026	157132681	4655	2328.0	
22071	chr3	157134434	157134974	540	270.0	
22072	chr3	157136857	157138238	1381	690.0	
22073	chr3	157140794	157150500	9706	4853.0	
22074	chr3	157151031	157161828	10797	5398.0	
22075	chr3	157162641	157163444	803	402.0	
22076	chr3	157170792	157171437	645	322.0	
22077	chr3	157174085	157176619	2534	1267.0	
22078	chr3	157201635	157202108	473	236.0	
22079	chr3	157226214	157226544	330	165.0	
22080	chr3	157239015	157239623	608	304.0	
22081	chr3	157429677	157430115	438	219.0	
22082	chr3	157436361	157438435	2074	1037.0	
22083	chr3	157445832	157446344	512	256.0	
22084	chr3	157452087	157452612	525	262.0	
22085	chr3	157469318	157469964	646	323.0	
22086	chr3	157493645	157493951	306	153.0	
22087	chr3	157572675	157572710	35	18.0	
22088	chr3	157606523	157606976	453	226.0	
22089	chr3	157611179	157611363	184	92.0	
22090	chr3	157617980	157618611	631	316.0	
22091	chr3	158094483	158095457	974	487.0	
22092	chr3	158097402	158098694	1292	646.0	
22093	chr3	158103104	158104339	1235	618.0	
22094	chr3	158104899	158107524	2625	1312.0	
22095	chr3	158109443	158110919	1476	738.0	
22096	chr3	158168023	158168651	628	314.0	
22097	chr3	158352572	158352974	402	201.0	
22098	chr3	158539439	158539817	378	189.0	
22099	chr3	158570658	158572780	2122	1061.0	
22100	chr3	158641926	158642453	527	264.0	
22101	chr3	158644137	158645115	978	489.0	
22102	chr3	158659619	158660159	540	270.0	
22103	chr3	158671813	158673213	1400	700.0	
22104	chr3	158711941	158712165	224	112.0	
22105	chr3	158722778	158723589	811	406.0	
22106	chr3	158727491	158728399	908	454.0	
22107	chr3	158731777	158732904	1127	564.0	
22108	chr3	158747079	158747525	446	223.0	
22109	chr3	158791235	158791745	510	255.0	
22110	chr3	158794911	158795367	456	228.0	
22111	chr3	158799389	158799520	131	66.0	
22112	chr3	158801146	158803098	1952	976.0	
22113	chr3	158808715	158810098	1383	692.0	
22114	chr3	158810699	158811643	944	472.0	
22115	chr3	158819233	158819773	540	270.0	
22116	chr3	158845761	158846172	411	206.0	
22117	chr3	158847324	158847502	178	89.0	
22118	chr3	159185860	159186060	200	100.0	
22119	chr3	159260265	159260438	173	86.0	
22120	chr3	159762838	159765566	2728	1364.0	
22121	chr3	159828758	159828803	45	22.0	
22122	chr3	159832000	159832461	461	230.0	
22123	chr3	159839835	159840282	447	224.0	
22124	chr3	159850494	159850846	352	176.0	
22125	chr3	159853030	159853259	229	114.0	
22126	chr3	159854553	159854888	335	168.0	
22127	chr3	159884750	159885152	402	201.0	
22128	chr3	159887971	159888031	60	30.0	
22129	chr3	159902593	159903033	440	220.0	
22130	chr3	159904396	159905102	706	353.0	
22131	chr3	159907822	159908237	415	208.0	
22132	chr3	159911172	159911691	519	260.0	
22133	chr3	159919843	159920278	435	218.0	
22134	chr3	159922812	159923380	568	284.0	
22135	chr3	159923949	159924314	365	182.0	
22136	chr3	159928542	159930284	1742	871.0	
22137	chr3	159938739	159939093	354	177.0	
22138	chr3	159941238	159941876	638	319.0	
22139	chr3	159944820	159945049	229	114.0	
22140	chr3	159948449	159948832	383	192.0	
22141	chr3	159950515	159950914	399	200.0	
22142	chr3	159953068	159953749	681	340.0	
22143	chr3	159977388	159977627	239	120.0	
22144	chr3	159987987	159990635	2648	1324.0	
22145	chr3	160003487	160003994	507	254.0	
22146	chr3	160006460	160006957	497	248.0	
22147	chr3	160011991	160012765	774	387.0	
22148	chr3	160027771	160027914	143	72.0	
22149	chr3	160032163	160032631	468	234.0	
22150	chr3	160099864	160100147	283	142.0	
22151	chr3	160105883	160106413	530	265.0	
22152	chr3	160125334	160125816	482	241.0	
22153	chr3	160129378	160130319	941	470.0	
22154	chr3	160134525	160135621	1096	548.0	
22155	chr3	160210939	160211212	273	136.0	
22156	chr3	160224275	160224303	28	14.0	
22157	chr3	160225159	160226852	1693	846.0	
22158	chr3	160368844	160369135	291	146.0	
22159	chr3	160398597	160402176	3579	1790.0	
22160	chr3	160404160	160404439	279	140.0	
22161	chr3	160413539	160414090	551	276.0	
22162	chr3	160448750	160450609	1859	930.0	
22163	chr3	160485517	160486024	507	254.0	
22164	chr3	160561262	160562027	765	382.0	
22165	chr3	160563284	160563335	51	26.0	
22166	chr3	160564004	160566525	2521	1260.0	
22167	chr3	160707405	160707779	374	187.0	
22168	chr3	160754222	160757828	3606	1803.0	
22169	chr3	160780166	160780651	485	242.0	
22170	chr3	160801367	160802285	918	459.0	
22171	chr3	160837514	160838013	499	250.0	
22172	chr3	160941806	160942321	515	258.0	
22173	chr3	160956809	160957166	357	178.0	
22174	chr3	160980719	160981793	1074	537.0	
22175	chr3	160982507	160982908	401	200.0	
22176	chr3	160986178	160986415	237	118.0	
22177	chr3	161034958	161036324	1366	683.0	
22178	chr3	161069575	161070330	755	378.0	
22179	chr3	161081688	161082111	423	212.0	
22180	chr3	161104673	161105604	931	466.0	
22181	chr3	161220724	161222418	1694	847.0	
22182	chr3	161273659	161274008	349	174.0	
22183	chr3	161274669	161275083	414	207.0	
22184	chr3	161305364	161305771	407	204.0	
22185	chr3	161310428	161311783	1355	678.0	
22186	chr3	161349750	161350357	607	304.0	
22187	chr3	161371346	161373243	1897	948.0	
22188	chr3	161388748	161390119	1371	686.0	
22189	chr3	161394104	161395790	1686	843.0	
22190	chr3	161406642	161406929	287	144.0	
22191	chr3	161409002	161409416	414	207.0	
22192	chr3	161423901	161424355	454	227.0	
22193	chr3	161488239	161488770	531	266.0	
22194	chr3	161489337	161489863	526	263.0	
22195	chr3	161854531	161854549	18	9.0	
22196	chr3	165206972	165207047	75	38.0	
22197	chr3	167379714	167380731	1017	508.0	
22198	chr3	167406929	167407233	304	152.0	
22199	chr3	167502426	167502736	310	155.0	
22200	chr3	167520619	167521446	827	414.0	
22201	chr3	167653670	167654238	568	284.0	
22202	chr3	167684372	167685183	811	406.0	
22203	chr3	167691346	167691769	423	212.0	
22204	chr3	167733913	167736469	2556	1278.0	
22205	chr3	167740951	167741383	432	216.0	
22206	chr3	167750177	167750943	766	383.0	
22207	chr3	167830106	167830380	274	137.0	
22208	chr3	167843495	167844261	766	383.0	
22209	chr3	167859632	167860031	399	200.0	
22210	chr3	167861628	167862113	485	242.0	
22211	chr3	167866388	167866853	465	232.0	
22212	chr3	167882044	167882470	426	213.0	
22213	chr3	167913531	167913622	91	46.0	
22214	chr3	167941571	167942015	444	222.0	
22215	chr3	168047146	168047651	505	252.0	
22216	chr3	168088352	168088758	406	203.0	
22217	chr3	168094569	168096717	2148	1074.0	
22218	chr3	168156501	168156881	380	190.0	
22219	chr3	168165601	168166045	444	222.0	
22220	chr3	168213956	168214268	312	156.0	
22221	chr3	168249687	168250212	525	262.0	
22222	chr3	168427897	168428465	568	284.0	
22223	chr3	169146354	169147743	1389	694.0	
22224	chr3	169149233	169149827	594	297.0	
22225	chr3	169153620	169154218	598	299.0	
22226	chr3	169227969	169228312	343	172.0	
22227	chr3	169327543	169328418	875	438.0	
22228	chr3	169658491	169658815	324	162.0	
22229	chr3	169660772	169663398	2626	1313.0	
22230	chr3	169663972	169664377	405	202.0	
22231	chr3	169668224	169669508	1284	642.0	
22232	chr3	169676944	169677226	282	141.0	
22233	chr3	169759186	169759744	558	279.0	
22234	chr3	169762822	169765894	3072	1536.0	
22235	chr3	169767468	169770188	2720	1360.0	
22236	chr3	169771510	169774411	2901	1450.0	
22237	chr3	169780818	169780888	70	35.0	
22238	chr3	169811627	169814483	2856	1428.0	
22239	chr3	169836030	169836436	406	203.0	
22240	chr3	169846696	169847057	361	180.0	
22241	chr3	169863311	169864054	743	372.0	
22242	chr3	169865125	169865899	774	387.0	
22243	chr3	169930133	169930607	474	237.0	
22244	chr3	169931956	169932601	645	322.0	
22245	chr3	169940436	169941027	591	296.0	
22246	chr3	169945077	169946001	924	462.0	
22247	chr3	169951954	169952552	598	299.0	
22248	chr3	169953756	169954831	1075	538.0	
22249	chr3	169965644	169967827	2183	1092.0	
22250	chr3	169979947	169980496	549	274.0	
22251	chr3	169998660	169999193	533	266.0	
22252	chr3	170002666	170003295	629	314.0	
22253	chr3	170006881	170007634	753	376.0	
22254	chr3	170021158	170021167	9	4.0	
22255	chr3	170024995	170025821	826	413.0	
22256	chr3	170033316	170034187	871	436.0	
22257	chr3	170037311	170039290	1979	990.0	
22258	chr3	170044194	170045416	1222	611.0	
22259	chr3	170054181	170054585	404	202.0	
22260	chr3	170128495	170129370	875	438.0	
22261	chr3	170154392	170155276	884	442.0	
22262	chr3	170178543	170182144	3601	1800.0	
22263	chr3	170188993	170190253	1260	630.0	
22264	chr3	170221710	170223853	2143	1072.0	
22265	chr3	170258746	170258858	112	56.0	
22266	chr3	170276987	170278329	1342	671.0	
22267	chr3	170301507	170301747	240	120.0	
22268	chr3	170310057	170310613	556	278.0	
22269	chr3	170321263	170321762	499	250.0	
22270	chr3	170331253	170331608	355	178.0	
22271	chr3	170348715	170349012	297	148.0	
22272	chr3	170352827	170353433	606	303.0	
22273	chr3	170355750	170366035	10285	5142.0	
22274	chr3	170367212	170367516	304	152.0	
22275	chr3	170368871	170369313	442	221.0	
22276	chr3	170372448	170372675	227	114.0	
22277	chr3	170414066	170414567	501	250.0	
22278	chr3	170418664	170418831	167	84.0	
22279	chr3	170419577	170419984	407	204.0	
22280	chr3	170768400	170768726	326	163.0	
22281	chr3	170811888	170812414	526	263.0	
22282	chr3	170863981	170864003	22	11.0	
22283	chr3	170864655	170865796	1141	570.0	
22284	chr3	170866823	170867880	1057	528.0	
22285	chr3	170868827	170870981	2154	1077.0	
22286	chr3	170907554	170911001	3447	1724.0	
22287	chr3	171028264	171028689	425	212.0	
22288	chr3	171049858	171050215	357	178.0	
22289	chr3	171163138	171163612	474	237.0	
22290	chr3	171173580	171174343	763	382.0	
22291	chr3	171187676	171188097	421	210.0	
22292	chr3	171247168	171247689	521	260.0	
22293	chr3	171248366	171249442	1076	538.0	
22294	chr3	171251871	171252279	408	204.0	
22295	chr3	171255184	171255981	797	398.0	
22296	chr3	171257237	171257576	339	170.0	
22297	chr3	171269522	171270007	485	242.0	
22298	chr3	171328605	171329152	547	274.0	
22299	chr3	171346817	171348097	1280	640.0	
22300	chr3	171375752	171376671	919	460.0	
22301	chr3	171428483	171428831	348	174.0	
22302	chr3	171453268	171453620	352	176.0	
22303	chr3	171457228	171462622	5394	2697.0	
22304	chr3	171480421	171481046	625	312.0	
22305	chr3	171491075	171491904	829	414.0	
22306	chr3	171494376	171495120	744	372.0	
22307	chr3	171543973	171544096	123	62.0	
22308	chr3	171553039	171553554	515	258.0	
22309	chr3	171564872	171565107	235	118.0	
22310	chr3	171566782	171567224	442	221.0	
22311	chr3	171636702	171637028	326	163.0	
22312	chr3	171646361	171646728	367	184.0	
22313	chr3	171690282	171690681	399	200.0	
22314	chr3	171704038	171704411	373	186.0	
22315	chr3	171755029	171755437	408	204.0	
22316	chr3	171772441	171772836	395	198.0	
22317	chr3	171776782	171777966	1184	592.0	
22318	chr3	171782708	171782942	234	117.0	
22319	chr3	171806162	171806809	647	324.0	
22320	chr3	171809243	171811940	2697	1348.0	
22321	chr3	171813801	171814608	807	404.0	
22322	chr3	171824083	171824447	364	182.0	
22323	chr3	171825390	171825781	391	196.0	
22324	chr3	171827762	171830324	2562	1281.0	
22325	chr3	171834174	171834575	401	200.0	
22326	chr3	171835099	171835549	450	225.0	
22327	chr3	171838289	171838615	326	163.0	
22328	chr3	171935543	171935696	153	76.0	
22329	chr3	171936335	171936995	660	330.0	
22330	chr3	171954630	171955119	489	244.0	
22331	chr3	171961060	171961205	145	72.0	
22332	chr3	171966864	171967811	947	474.0	
22333	chr3	171970699	171970812	113	56.0	
22334	chr3	171975331	171975923	592	296.0	
22335	chr3	171977634	171978431	797	398.0	
22336	chr3	171980434	171981091	657	328.0	
22337	chr3	171984681	171985468	787	394.0	
22338	chr3	171986146	171986677	531	266.0	
22339	chr3	172029634	172030150	516	258.0	
22340	chr3	172033434	172033773	339	170.0	
22341	chr3	172035038	172035687	649	324.0	
22342	chr3	172038225	172043241	5016	2508.0	
22343	chr3	172044603	172046889	2286	1143.0	
22344	chr3	172054168	172055931	1763	882.0	
22345	chr3	172056951	172057471	520	260.0	
22346	chr3	172061562	172062555	993	496.0	
22347	chr3	172066466	172066622	156	78.0	
22348	chr3	172067191	172067204	13	6.0	
22349	chr3	172070167	172070199	32	16.0	
22350	chr3	172073494	172075104	1610	805.0	
22351	chr3	172088212	172088270	58	29.0	
22352	chr3	172092309	172092383	74	37.0	
22353	chr3	172094897	172095664	767	384.0	
22354	chr3	172097066	172097556	490	245.0	
22355	chr3	172102357	172103151	794	397.0	
22356	chr3	172106076	172108938	2862	1431.0	
22357	chr3	172129460	172131021	1561	780.0	
22358	chr3	172131965	172132698	733	366.0	
22359	chr3	172133943	172134805	862	431.0	
22360	chr3	172135622	172136562	940	470.0	
22361	chr3	172137518	172139357	1839	920.0	
22362	chr3	172140359	172141000	641	320.0	
22363	chr3	172142329	172142871	542	271.0	
22364	chr3	172145257	172145601	344	172.0	
22365	chr3	172147082	172147431	349	174.0	
22366	chr3	172148292	172149290	998	499.0	
22367	chr3	172152464	172154027	1563	782.0	
22368	chr3	172159970	172160655	685	342.0	
22369	chr3	172169008	172169732	724	362.0	
22370	chr3	172173839	172174286	447	224.0	
22371	chr3	172176099	172176793	694	347.0	
22372	chr3	172179762	172180224	462	231.0	
22373	chr3	172182141	172182464	323	162.0	
22374	chr3	172201190	172202271	1081	540.0	
22375	chr3	172209039	172209407	368	184.0	
22376	chr3	172218860	172219152	292	146.0	
22377	chr3	172289841	172289916	75	38.0	
22378	chr3	172294070	172294762	692	346.0	
22379	chr3	172317859	172318398	539	270.0	
22380	chr3	172332450	172332967	517	258.0	
22381	chr3	172341402	172341938	536	268.0	
22382	chr3	172358395	172358729	334	167.0	
22383	chr3	172447460	172448497	1037	518.0	
22384	chr3	172449689	172450095	406	203.0	
22385	chr3	172461501	172461967	466	233.0	
22386	chr3	172476434	172477913	1479	740.0	
22387	chr3	172490100	172490745	645	322.0	
22388	chr3	172511876	172513952	2076	1038.0	
22389	chr3	172514954	172515460	506	253.0	
22390	chr3	172516717	172518581	1864	932.0	
22391	chr3	172520383	172520978	595	298.0	
22392	chr3	172521847	172524206	2359	1180.0	
22393	chr3	172530218	172531006	788	394.0	
22394	chr3	172537224	172537229	5	2.0	
22395	chr3	172546532	172547434	902	451.0	
22396	chr3	172550565	172550952	387	194.0	
22397	chr3	172558938	172559469	531	266.0	
22398	chr3	172562138	172563681	1543	772.0	
22399	chr3	172568432	172569501	1069	534.0	
22400	chr3	172578155	172578524	369	184.0	
22401	chr3	172580466	172581194	728	364.0	
22402	chr3	172586555	172586772	217	108.0	
22403	chr3	172591682	172593326	1644	822.0	
22404	chr3	172594538	172594999	461	230.0	
22405	chr3	172595647	172596581	934	467.0	
22406	chr3	172607272	172607583	311	156.0	
22407	chr3	172615916	172616362	446	223.0	
22408	chr3	172623221	172623629	408	204.0	
22409	chr3	172625405	172625757	352	176.0	
22410	chr3	172626676	172627843	1167	584.0	
22411	chr3	172635559	172635903	344	172.0	
22412	chr3	172648757	172649249	492	246.0	
22413	chr3	172666355	172667446	1091	546.0	
22414	chr3	172672940	172673592	652	326.0	
22415	chr3	172675345	172676058	713	356.0	
22416	chr3	172677047	172677392	345	172.0	
22417	chr3	172692690	172693222	532	266.0	
22418	chr3	172694554	172694950	396	198.0	
22419	chr3	172698564	172699110	546	273.0	
22420	chr3	172709804	172711832	2028	1014.0	
22421	chr3	172716373	172716943	570	285.0	
22422	chr3	172717501	172717858	357	178.0	
22423	chr3	172726627	172726741	114	57.0	
22424	chr3	172749987	172751746	1759	880.0	
22425	chr3	173394997	173396102	1105	552.0	
22426	chr3	173397498	173398062	564	282.0	
22427	chr3	174308787	174309120	333	166.0	
22428	chr3	174330934	174332783	1849	924.0	
22429	chr3	174336769	174338033	1264	632.0	
22430	chr3	174417534	174418007	473	236.0	
22431	chr3	174439600	174441817	2217	1108.0	
22432	chr3	174444364	174444824	460	230.0	
22433	chr3	176872699	176873162	463	232.0	
22434	chr3	176939011	176939369	358	179.0	
22435	chr3	176964610	176965087	477	238.0	
22436	chr3	177050706	177051206	500	250.0	
22437	chr3	177057756	177058192	436	218.0	
22438	chr3	177085820	177086137	317	158.0	
22439	chr3	177109648	177110287	639	320.0	
22440	chr3	177110899	177111174	275	138.0	
22441	chr3	177134250	177134353	103	52.0	
22442	chr3	177139236	177139637	401	200.0	
22443	chr3	177141920	177142451	531	266.0	
22444	chr3	177144265	177147285	3020	1510.0	
22445	chr3	177150938	177151608	670	335.0	
22446	chr3	177179782	177179938	156	78.0	
22447	chr3	177184638	177184894	256	128.0	
22448	chr3	177191190	177191861	671	336.0	
22449	chr3	177194570	177199889	5319	2660.0	
22450	chr3	177201180	177202489	1309	654.0	
22451	chr3	177220834	177222193	1359	680.0	
22452	chr3	177251648	177252195	547	274.0	
22453	chr3	177281314	177281755	441	220.0	
22454	chr3	177284242	177284916	674	337.0	
22455	chr3	177289799	177290447	648	324.0	
22456	chr3	177299995	177300522	527	264.0	
22457	chr3	177317804	177318383	579	290.0	
22458	chr3	177322823	177323373	550	275.0	
22459	chr3	177325259	177325599	340	170.0	
22460	chr3	177333531	177334587	1056	528.0	
22461	chr3	177337523	177339461	1938	969.0	
22462	chr3	177345084	177346264	1180	590.0	
22463	chr3	177351630	177352295	665	332.0	
22464	chr3	177357402	177362116	4714	2357.0	
22465	chr3	177378076	177378601	525	262.0	
22466	chr3	177426832	177427988	1156	578.0	
22467	chr3	177441863	177442662	799	400.0	
22468	chr3	177446034	177446706	672	336.0	
22469	chr3	177449015	177450145	1130	565.0	
22470	chr3	177452483	177452889	406	203.0	
22471	chr3	177498284	177498484	200	100.0	
22472	chr3	177538973	177539682	709	354.0	
22473	chr3	177551366	177551903	537	268.0	
22474	chr3	177554971	177555307	336	168.0	
22475	chr3	177570151	177570743	592	296.0	
22476	chr3	177591220	177591929	709	354.0	
22477	chr3	177597217	177598404	1187	594.0	
22478	chr3	177599194	177599921	727	364.0	
22479	chr3	177602492	177603729	1237	618.0	
22480	chr3	177614936	177615546	610	305.0	
22481	chr3	177624604	177625110	506	253.0	
22482	chr3	177642514	177643240	726	363.0	
22483	chr3	177646775	177648272	1497	748.0	
22484	chr3	177652873	177653210	337	168.0	
22485	chr3	177679611	177680133	522	261.0	
22486	chr3	177681868	177682228	360	180.0	
22487	chr3	177683626	177683997	371	186.0	
22488	chr3	177714893	177715427	534	267.0	
22489	chr3	177723911	177724286	375	188.0	
22490	chr3	177725128	177725619	491	246.0	
22491	chr3	177777714	177778171	457	228.0	
22492	chr3	177778677	177778960	283	142.0	
22493	chr3	177820749	177821034	285	142.0	
22494	chr3	177928080	177928674	594	297.0	
22495	chr3	177944006	177944856	850	425.0	
22496	chr3	177977714	177978168	454	227.0	
22497	chr3	178000266	178000771	505	252.0	
22498	chr3	178001608	178002254	646	323.0	
22499	chr3	178003799	178004164	365	182.0	
22500	chr3	178010347	178010747	400	200.0	
22501	chr3	178076717	178077079	362	181.0	
22502	chr3	178084882	178085200	318	159.0	
22503	chr3	178348750	178349538	788	394.0	
22504	chr3	178385351	178385712	361	180.0	
22505	chr3	178969192	178969344	152	76.0	
22506	chr3	179015350	179016142	792	396.0	
22507	chr3	179017283	179017648	365	182.0	
22508	chr3	179027633	179027897	264	132.0	
22509	chr3	179037295	179037939	644	322.0	
22510	chr3	179045993	179046923	930	465.0	
22511	chr3	179069164	179069470	306	153.0	
22512	chr3	179071055	179072590	1535	768.0	
22513	chr3	179074575	179075126	551	276.0	
22514	chr3	179105096	179105461	365	182.0	
22515	chr3	179146849	179149980	3131	1566.0	
22516	chr3	179180445	179180678	233	116.0	
22517	chr3	179181928	179182611	683	342.0	
22518	chr3	179196039	179196478	439	220.0	
22519	chr3	179260818	179261902	1084	542.0	
22520	chr3	179309297	179309875	578	289.0	
22521	chr3	179315708	179316711	1003	502.0	
22522	chr3	179321556	179325155	3599	1800.0	
22523	chr3	179346400	179348892	2492	1246.0	
22524	chr3	179431907	179432550	643	322.0	
22525	chr3	179437424	179437641	217	108.0	
22526	chr3	179438703	179439460	757	378.0	
22527	chr3	179450739	179452225	1486	743.0	
22528	chr3	179464200	179464716	516	258.0	
22529	chr3	179473464	179474104	640	320.0	
22530	chr3	179558713	179559193	480	240.0	
22531	chr3	179562186	179564261	2075	1038.0	
22532	chr3	179603495	179605597	2102	1051.0	
22533	chr3	179606534	179606983	449	224.0	
22534	chr3	179608765	179609727	962	481.0	
22535	chr3	179649336	179650194	858	429.0	
22536	chr3	179652007	179654681	2674	1337.0	
22537	chr3	179695834	179696374	540	270.0	
22538	chr3	179698018	179698105	87	44.0	
22539	chr3	179726290	179726648	358	179.0	
22540	chr3	179743971	179744289	318	159.0	
22541	chr3	179811603	179811956	353	176.0	
22542	chr3	179852153	179852846	693	346.0	
22543	chr3	179942504	179942577	73	36.0	
22544	chr3	180267202	180267599	397	198.0	
22545	chr3	180601394	180603020	1626	813.0	
22546	chr3	180679171	180680340	1169	584.0	
22547	chr3	180911708	180913776	2068	1034.0	
22548	chr3	180988802	180990478	1676	838.0	
22549	chr3	181695398	181695465	67	34.0	
22550	chr3	181700388	181700928	540	270.0	
22551	chr3	181702042	181702417	375	188.0	
22552	chr3	181709528	181709928	400	200.0	
22553	chr3	181711557	181712048	491	246.0	"promoter	protein_binding_site"
22554	chr3	182682140	182684020	1880	940.0	
22555	chr3	182692752	182693033	281	140.0	
22556	chr3	182710566	182711609	1043	522.0	
22557	chr3	182713776	182714481	705	352.0	
22558	chr3	182788366	182788767	401	200.0	
22559	chr3	182789277	182789912	635	318.0	
22560	chr3	182791979	182795995	4016	2008.0	
22561	chr3	182802380	182803475	1095	548.0	
22562	chr3	182837955	182838231	276	138.0	
22563	chr3	182909234	182909634	400	200.0	
22564	chr3	182911201	182911933	732	366.0	
22565	chr3	182913818	182914362	544	272.0	
22566	chr3	182925562	182926006	444	222.0	
22567	chr3	182959785	182960163	378	189.0	
22568	chr3	182967758	182968192	434	217.0	
22569	chr3	182979190	182981699	2509	1254.0	
22570	chr3	183098522	183100224	1702	851.0	
22571	chr3	183107916	183108212	296	148.0	
22572	chr3	183115890	183116688	798	399.0	
22573	chr3	183122275	183122782	507	254.0	
22574	chr3	183128294	183128298	4	2.0	
22575	chr3	183158417	183158947	530	265.0	
22576	chr3	183159666	183159730	64	32.0	
22577	chr3	183161513	183163259	1746	873.0	
22578	chr3	183178720	183180098	1378	689.0	
22579	chr3	183184572	183185024	452	226.0	
22580	chr3	183185694	183185978	284	142.0	
22581	chr3	183188935	183189338	403	202.0	
22582	chr3	183202273	183202741	468	234.0	
22583	chr3	183210307	183211712	1405	702.0	
22584	chr3	183212219	183213053	834	417.0	
22585	chr3	183218776	183219201	425	212.0	
22586	chr3	183224525	183225001	476	238.0	
22587	chr3	183243910	183245511	1601	800.0	
22588	chr3	183252897	183255192	2295	1148.0	
22589	chr3	183259608	183260866	1258	629.0	
22590	chr3	183265086	183265488	402	201.0	
22591	chr3	183275355	183275883	528	264.0	
22592	chr3	183285592	183287891	2299	1150.0	
22593	chr3	183295052	183295674	622	311.0	
22594	chr3	183298682	183299327	645	322.0	
22595	chr3	183303737	183304108	371	186.0	
22596	chr3	183306565	183307626	1061	530.0	
22597	chr3	183313210	183313934	724	362.0	
22598	chr3	183318875	183318895	20	10.0	
22599	chr3	183349421	183350711	1290	645.0	
22600	chr3	183369026	183369643	617	308.0	
22601	chr3	183370730	183371241	511	256.0	
22602	chr3	183375631	183376421	790	395.0	
22603	chr3	183380126	183383005	2879	1440.0	
22604	chr3	183385836	183386433	597	298.0	
22605	chr3	183427487	183429368	1881	940.0	
22606	chr3	183447099	183448397	1298	649.0	
22607	chr3	183469093	183469954	861	430.0	
22608	chr3	183480291	183480759	468	234.0	
22609	chr3	183490709	183491082	373	186.0	
22610	chr3	183506837	183507367	530	265.0	
22611	chr3	183513027	183513876	849	424.0	
22612	chr3	183515898	183516888	990	495.0	
22613	chr3	183527301	183528056	755	378.0	
22614	chr3	183536349	183538040	1691	846.0	
22615	chr3	183539738	183542328	2590	1295.0	
22616	chr3	183544739	183545258	519	260.0	
22617	chr3	183551997	183556399	4402	2201.0	
22618	chr3	183560564	183560937	373	186.0	
22619	chr3	183586491	183587789	1298	649.0	
22620	chr3	183591918	183592618	700	350.0	
22621	chr3	183634732	183637431	2699	1350.0	
22622	chr3	183640082	183640403	321	160.0	
22623	chr3	183697183	183699960	2777	1388.0	
22624	chr3	183766775	183767628	853	426.0	
22625	chr3	183775909	183776577	668	334.0	
22626	chr3	183779939	183780516	577	288.0	
22627	chr3	183783766	183784963	1197	598.0	
22628	chr3	183815033	183815954	921	460.0	
22629	chr3	183824551	183827100	2549	1274.0	
22630	chr3	183868520	183869284	764	382.0	
22631	chr3	183876006	183876016	10	5.0	
22632	chr3	183876624	183877162	538	269.0	
22633	chr3	183877913	183878645	732	366.0	
22634	chr3	183884012	183885593	1581	790.0	
22635	chr3	183895143	183895713	570	285.0	
22636	chr3	183904481	183904572	91	46.0	
22637	chr3	184005856	184007246	1390	695.0	
22638	chr3	184016944	184018629	1685	842.0	
22639	chr3	184022113	184022880	767	384.0	
22640	chr3	184133935	184136568	2633	1316.0	
22641	chr3	184145172	184145637	465	232.0	
22642	chr3	184153591	184157056	3465	1732.0	
22643	chr3	184158431	184158766	335	168.0	
22644	chr3	184174048	184175816	1768	884.0	
22645	chr3	184176344	184177086	742	371.0	
22646	chr3	184185333	184187133	1800	900.0	
22647	chr3	184227305	184227998	693	346.0	
22648	chr3	184228834	184231384	2550	1275.0	
22649	chr3	184248352	184250749	2397	1198.0	
22650	chr3	184259695	184263190	3495	1748.0	
22651	chr3	184284368	184285134	766	383.0	
22652	chr3	184289305	184289997	692	346.0	
22653	chr3	184298266	184300007	1741	870.0	
22654	chr3	184305581	184305966	385	192.0	
22655	chr3	184313872	184317659	3787	1894.0	
22656	chr3	184319266	184320663	1397	698.0	
22657	chr3	184321676	184322022	346	173.0	
22658	chr3	184322550	184323250	700	350.0	
22659	chr3	184333796	184337412	3616	1808.0	
22660	chr3	184338563	184338948	385	192.0	
22661	chr3	184340837	184340867	30	15.0	
22662	chr3	184345604	184346092	488	244.0	
22663	chr3	184353853	184355052	1199	600.0	
22664	chr3	184361035	184364205	3170	1585.0	
22665	chr3	184371465	184371974	509	254.0	
22666	chr3	184380011	184382170	2159	1080.0	
22667	chr3	184407766	184408392	626	313.0	
22668	chr3	184417613	184418331	718	359.0	
22669	chr3	184466603	184466999	396	198.0	
22670	chr3	184472713	184473482	769	384.0	
22671	chr3	184479798	184480167	369	184.0	
22672	chr3	184492077	184492697	620	310.0	
22673	chr3	184493244	184493665	421	210.0	
22674	chr3	184497804	184498205	401	200.0	
22675	chr3	184498968	184499379	411	206.0	
22676	chr3	184513304	184514698	1394	697.0	
22677	chr3	184523709	184524307	598	299.0	
22678	chr3	184524952	184526362	1410	705.0	
22679	chr3	184541031	184541588	557	278.0	
22680	chr3	184543682	184544590	908	454.0	
22681	chr3	184546013	184546806	793	396.0	
22682	chr3	184556554	184557129	575	288.0	
22683	chr3	184560800	184562687	1887	944.0	
22684	chr3	184563497	184564059	562	281.0	
22685	chr3	184568694	184569603	909	454.0	
22686	chr3	184579249	184579944	695	348.0	
22687	chr3	184583433	184584431	998	499.0	
22688	chr3	184586850	184587251	401	200.0	
22689	chr3	184601473	184602881	1408	704.0	
22690	chr3	184603779	184605115	1336	668.0	
22691	chr3	184608030	184608672	642	321.0	
22692	chr3	184617542	184617897	355	178.0	
22693	chr3	184619155	184619812	657	328.0	
22694	chr3	184620760	184620799	39	20.0	
22695	chr3	184637220	184639051	1831	916.0	
22696	chr3	184658609	184658938	329	164.0	
22697	chr3	184676703	184677501	798	399.0	
22698	chr3	184687366	184688157	791	396.0	
22699	chr3	184691233	184691774	541	270.0	
22700	chr3	184697248	184697764	516	258.0	
22701	chr3	184710806	184713570	2764	1382.0	
22702	chr3	184716766	184717186	420	210.0	
22703	chr3	184727343	184727900	557	278.0	
22704	chr3	184748098	184748788	690	345.0	
22705	chr3	184756233	184757587	1354	677.0	
22706	chr3	184765687	184766334	647	324.0	
22707	chr3	184768335	184768722	387	194.0	
22708	chr3	184777513	184778365	852	426.0	
22709	chr3	184785847	184787095	1248	624.0	
22710	chr3	184795476	184795477	1	0.0	
22711	chr3	184803017	184803747	730	365.0	
22712	chr3	184805063	184805952	889	444.0	
22713	chr3	184811657	184813247	1590	795.0	
22714	chr3	184814263	184814591	328	164.0	
22715	chr3	184815192	184815625	433	216.0	
22716	chr3	185059754	185060155	401	200.0	
22717	chr3	185152438	185153564	1126	563.0	
22718	chr3	185175393	185176017	624	312.0	
22719	chr3	185208134	185208174	40	20.0	
22720	chr3	185253710	185254525	815	408.0	
22721	chr3	185280481	185281174	693	346.0	
22722	chr3	185282326	185283660	1334	667.0	
22723	chr3	185299088	185300489	1401	700.0	
22724	chr3	185308038	185308552	514	257.0	
22725	chr3	185316889	185317562	673	336.0	
22726	chr3	185330114	185330769	655	328.0	
22727	chr3	185332241	185332962	721	360.0	
22728	chr3	185342739	185343259	520	260.0	
22729	chr3	185354043	185354634	591	296.0	
22730	chr3	185362787	185363959	1172	586.0	
22731	chr3	185456498	185456549	51	26.0	
22732	chr3	185498033	185499722	1689	844.0	
22733	chr3	185537212	185538038	826	413.0	
22734	chr3	185558754	185559707	953	476.0	
22735	chr3	185561288	185562298	1010	505.0	
22736	chr3	185575171	185575998	827	414.0	
22737	chr3	185582433	185583583	1150	575.0	
22738	chr3	185585380	185587426	2046	1023.0	
22739	chr3	185595375	185596218	843	422.0	
22740	chr3	185646889	185647236	347	174.0	
22741	chr3	185649330	185649683	353	176.0	
22742	chr3	185659990	185660841	851	426.0	
22743	chr3	185662027	185662032	5	2.0	
22744	chr3	185677236	185677594	358	179.0	
22745	chr3	185685514	185685877	363	182.0	
22746	chr3	185688650	185689281	631	316.0	
22747	chr3	185702868	185703026	158	79.0	
22748	chr3	185713006	185713083	77	38.0	
22749	chr3	185729272	185729807	535	268.0	
22750	chr3	185733916	185734360	444	222.0	
22751	chr3	185745132	185745186	54	27.0	
22752	chr3	185766873	185767031	158	79.0	
22753	chr3	185768467	185768920	453	226.0	
22754	chr3	185794633	185795079	446	223.0	
22755	chr3	185813870	185813940	70	35.0	
22756	chr3	185815417	185815833	416	208.0	
22757	chr3	185823153	185826483	3330	1665.0	
22758	chr3	185900226	185900637	411	206.0	
22759	chr3	185904632	185905028	396	198.0	
22760	chr3	185906889	185938842	31953	15976.0	
22761	chr3	185939804	185940033	229	114.0	
22762	chr3	185942995	185944237	1242	621.0	
22763	chr3	185959565	185960603	1038	519.0	
22764	chr3	185977193	185977866	673	336.0	
22765	chr3	185983439	185984096	657	328.0	
22766	chr3	186060435	186060455	20	10.0	
22767	chr3	186067655	186067797	142	71.0	
22768	chr3	186094300	186096444	2144	1072.0	
22769	chr3	186097898	186098200	302	151.0	
22770	chr3	186105548	186105889	341	170.0	
22771	chr3	186107225	186111411	4186	2093.0	
22772	chr3	186150875	186151851	976	488.0	
22773	chr3	186152526	186153514	988	494.0	
22774	chr3	186162152	186162769	617	308.0	
22775	chr3	186180283	186180338	55	28.0	
22776	chr3	186185041	186185944	903	452.0	
22777	chr3	186209964	186210240	276	138.0	
22778	chr3	186241763	186242956	1193	596.0	
22779	chr3	186254488	186256279	1791	896.0	
22780	chr3	186259456	186260098	642	321.0	
22781	chr3	186342162	186342677	515	258.0	
22782	chr3	186360760	186362710	1950	975.0	
22783	chr3	186365062	186365658	596	298.0	
22784	chr3	186368233	186368469	236	118.0	
22785	chr3	186373308	186373401	93	46.0	
22786	chr3	186374273	186374852	579	290.0	
22787	chr3	186413327	186414475	1148	574.0	
22788	chr3	186514509	186515569	1060	530.0	
22789	chr3	186518895	186519872	977	488.0	
22790	chr3	186521466	186521867	401	200.0	
22791	chr3	186526212	186526533	321	160.0	
22792	chr3	186529388	186529422	34	17.0	
22793	chr3	186532606	186533185	579	290.0	
22794	chr3	186533945	186534775	830	415.0	
22795	chr3	186540181	186541123	942	471.0	
22796	chr3	186566409	186568143	1734	867.0	
22797	chr3	186569556	186571799	2243	1122.0	
22798	chr3	186589965	186590313	348	174.0	
22799	chr3	186614412	186615299	887	444.0	
22800	chr3	186616680	186617804	1124	562.0	
22801	chr3	186653004	186653713	709	354.0	
22802	chr3	186686477	186686678	201	100.0	
22803	chr3	186706134	186706592	458	229.0	
22804	chr3	186745912	186746417	505	252.0	
22805	chr3	186772150	186773615	1465	732.0	
22806	chr3	186776406	186776489	83	42.0	
22807	chr3	186782511	186791928	9417	4708.0	
22808	chr3	186805724	186807720	1996	998.0	
22809	chr3	186815499	186815857	358	179.0	
22810	chr3	186821216	186821870	654	327.0	
22811	chr3	186824756	186828169	3413	1706.0	
22812	chr3	186828673	186828683	10	5.0	
22813	chr3	186849280	186849823	543	272.0	"enhancer	protein_binding_site"
22814	chr3	186871403	186871650	247	124.0	
22815	chr3	186908803	186910010	1207	604.0	
22816	chr3	186916013	186916679	666	333.0	
22817	chr3	186929556	186933078	3522	1761.0	
22818	chr3	186933787	186934190	403	202.0	
22819	chr3	186952864	186953612	748	374.0	
22820	chr3	186954337	186954676	339	170.0	
22821	chr3	186985492	186987235	1743	872.0	
22822	chr3	186992189	186992336	147	74.0	
22823	chr3	186996307	186998042	1735	868.0	
22824	chr3	187000533	187001196	663	332.0	
22825	chr3	187005870	187006234	364	182.0	
22826	chr3	187006834	187007361	527	264.0	
22827	chr3	187011905	187013862	1957	978.0	
22828	chr3	187015847	187017800	1953	976.0	
22829	chr3	187020215	187020870	655	328.0	
22830	chr3	187021571	187022129	558	279.0	
22831	chr3	187024574	187026566	1992	996.0	
22832	chr3	187027070	187028408	1338	669.0	
22833	chr3	187029008	187029986	978	489.0	
22834	chr3	187030916	187031671	755	378.0	
22835	chr3	187040380	187040405	25	12.0	
22836	chr3	187041431	187042618	1187	594.0	
22837	chr3	187044212	187044689	477	238.0	
22838	chr3	187051948	187052380	432	216.0	
22839	chr3	187063429	187064580	1151	576.0	
22840	chr3	187065141	187067175	2034	1017.0	
22841	chr3	187072568	187072967	399	200.0	
22842	chr3	187082917	187083300	383	192.0	
22843	chr3	187101372	187102349	977	488.0	
22844	chr3	187112983	187113631	648	324.0	
22845	chr3	187130264	187131532	1268	634.0	
22846	chr3	187133077	187133602	525	262.0	
22847	chr3	187138723	187140351	1628	814.0	
22848	chr3	187150495	187151064	569	284.0	
22849	chr3	187164954	187165529	575	288.0	
22850	chr3	187189075	187189292	217	108.0	
22851	chr3	187220160	187220597	437	218.0	
22852	chr3	187318777	187320157	1380	690.0	
22853	chr3	187367753	187369435	1682	841.0	
22854	chr3	187616289	187616664	375	188.0	
22855	chr3	187678950	187680032	1082	541.0	
22856	chr3	187713334	187715005	1671	836.0	
22857	chr3	187719830	187720627	797	398.0	
22858	chr3	187725049	187725320	271	136.0	
22859	chr3	187729512	187729516	4	2.0	
22860	chr3	187735738	187749351	13613	6806.0	
22861	chr3	187749995	187750560	565	282.0	
22862	chr3	187770051	187770632	581	290.0	
22863	chr3	187773161	187774671	1510	755.0	
22864	chr3	187777011	187778152	1141	570.0	
22865	chr3	187798195	187800418	2223	1112.0	
22866	chr3	187802853	187803323	470	235.0	
22867	chr3	187811597	187812178	581	290.0	
22868	chr3	187822376	187822883	507	254.0	
22869	chr3	187828863	187829599	736	368.0	
22870	chr3	187850206	187851081	875	438.0	
22871	chr3	187856625	187856775	150	75.0	
22872	chr3	187889516	187890054	538	269.0	
22873	chr3	187902020	187902382	362	181.0	
22874	chr3	187914885	187915296	411	206.0	
22875	chr3	187917048	187917663	615	308.0	
22876	chr3	187918603	187920317	1714	857.0	
22877	chr3	187935554	187936384	830	415.0	
22878	chr3	187944749	187945252	503	252.0	
22879	chr3	187951573	187952298	725	362.0	
22880	chr3	187954491	187955819	1328	664.0	
22881	chr3	187958430	187959184	754	377.0	
22882	chr3	187963237	187964170	933	466.0	
22883	chr3	187966209	187966487	278	139.0	
22884	chr3	187968782	187969513	731	366.0	
22885	chr3	187974314	187975820	1506	753.0	
22886	chr3	187978599	187978955	356	178.0	
22887	chr3	187979487	187980061	574	287.0	
22888	chr3	187986376	187987000	624	312.0	
22889	chr3	187987823	187988502	679	340.0	
22890	chr3	187993973	187994747	774	387.0	
22891	chr3	187999687	188000930	1243	622.0	
22892	chr3	188006925	188006926	1	0.0	
22893	chr3	188007814	188008339	525	262.0	
22894	chr3	188049885	188050525	640	320.0	
22895	chr3	188061019	188061751	732	366.0	
22896	chr3	188097703	188098256	553	276.0	
22897	chr3	188108758	188109229	471	236.0	
22898	chr3	188123117	188123836	719	360.0	
22899	chr3	188125086	188125435	349	174.0	
22900	chr3	188137087	188137519	432	216.0	
22901	chr3	188150356	188150725	369	184.0	
22902	chr3	188152750	188155616	2866	1433.0	
22903	chr3	188156303	188156333	30	15.0	
22904	chr3	188164263	188164761	498	249.0	
22905	chr3	188170431	188170867	436	218.0	
22906	chr3	188185803	188186289	486	243.0	
22907	chr3	188186967	188187540	573	286.0	
22908	chr3	188189590	188190018	428	214.0	
22909	chr3	188197413	188197753	340	170.0	
22910	chr3	188200477	188200743	266	133.0	
22911	chr3	188213804	188214878	1074	537.0	
22912	chr3	188242399	188242878	479	240.0	
22913	chr3	188296491	188297451	960	480.0	
22914	chr3	188298547	188299033	486	243.0	
22915	chr3	188309707	188310091	384	192.0	
22916	chr3	188322910	188323711	801	400.0	
22917	chr3	188339360	188340287	927	464.0	
22918	chr3	188348411	188348805	394	197.0	
22919	chr3	188358768	188359868	1100	550.0	
22920	chr3	188361969	188362902	933	466.0	
22921	chr3	188385122	188386367	1245	622.0	
22922	chr3	188389713	188391211	1498	749.0	
22923	chr3	188397100	188397851	751	376.0	
22924	chr3	188400233	188401084	851	426.0	
22925	chr3	188403463	188403799	336	168.0	
22926	chr3	188417183	188418148	965	482.0	
22927	chr3	188421379	188422413	1034	517.0	
22928	chr3	188427442	188427766	324	162.0	
22929	chr3	188431411	188432278	867	434.0	
22930	chr3	188433031	188434159	1128	564.0	
22931	chr3	188438798	188439906	1108	554.0	
22932	chr3	188442415	188442916	501	250.0	
22933	chr3	188446133	188447144	1011	506.0	
22934	chr3	188468725	188469150	425	212.0	
22935	chr3	188489558	188490095	537	268.0	
22936	chr3	188507087	188507836	749	374.0	
22937	chr3	188526068	188526468	400	200.0	
22938	chr3	188553472	188554166	694	347.0	
22939	chr3	188558338	188558689	351	176.0	
22940	chr3	188568678	188569220	542	271.0	
22941	chr3	188573324	188573726	402	201.0	
22942	chr3	188578578	188578922	344	172.0	
22943	chr3	188581809	188582657	848	424.0	
22944	chr3	188583861	188584483	622	311.0	
22945	chr3	188585358	188585633	275	138.0	
22946	chr3	188588991	188589548	557	278.0	
22947	chr3	188646621	188647146	525	262.0	
22948	chr3	188673494	188674040	546	273.0	
22949	chr3	188683241	188683470	229	114.0	
22950	chr3	188686280	188686746	466	233.0	
22951	chr3	188687296	188687957	661	330.0	
22952	chr3	188689024	188689653	629	314.0	
22953	chr3	188701375	188702440	1065	532.0	
22954	chr3	188707339	188707726	387	194.0	
22955	chr3	188712173	188713293	1120	560.0	
22956	chr3	188748959	188749458	499	250.0	
22957	chr3	188753279	188753580	301	150.0	
22958	chr3	188780674	188781264	590	295.0	
22959	chr3	188788295	188789235	940	470.0	
22960	chr3	188792825	188793204	379	190.0	
22961	chr3	188795814	188796729	915	458.0	
22962	chr3	188819811	188820445	634	317.0	
22963	chr3	188821937	188822750	813	406.0	
22964	chr3	188830759	188831446	687	344.0	
22965	chr3	188842596	188843067	471	236.0	
22966	chr3	188905494	188906079	585	292.0	
22967	chr3	188914617	188915366	749	374.0	
22968	chr3	188916623	188917735	1112	556.0	
22969	chr3	188940438	188941558	1120	560.0	
22970	chr3	188943558	188944045	487	244.0	
22971	chr3	188946776	188951374	4598	2299.0	
22972	chr3	188954479	188955056	577	288.0	
22973	chr3	188956812	188957247	435	218.0	
22974	chr3	188974882	188975487	605	302.0	
22975	chr3	189041002	189042063	1061	530.0	
22976	chr3	189049441	189050249	808	404.0	
22977	chr3	189121040	189121615	575	288.0	
22978	chr3	189122791	189123188	397	198.0	
22979	chr3	189132060	189133232	1172	586.0	
22980	chr3	189142445	189142999	554	277.0	
22981	chr3	189144331	189145102	771	386.0	
22982	chr3	189147927	189148479	552	276.0	
22983	chr3	189272840	189273016	176	88.0	
22984	chr3	189276883	189277238	355	178.0	
22985	chr3	189324377	189325497	1120	560.0	
22986	chr3	189330925	189331530	605	302.0	
22987	chr3	189355418	189356326	908	454.0	
22988	chr3	189393568	189394024	456	228.0	
22989	chr3	189630717	189631396	679	340.0	
22990	chr3	189958434	189958874	440	220.0	
22991	chr3	189961503	189961947	444	222.0	
22992	chr3	189967266	189967627	361	180.0	
22993	chr3	190101421	190101822	401	200.0	
22994	chr3	190119638	190121166	1528	764.0	
22995	chr3	190169887	190170249	362	181.0	
22996	chr3	190201758	190202010	252	126.0	
22997	chr3	190205965	190206010	45	22.0	
22998	chr3	190217061	190217508	447	224.0	
22999	chr3	190225151	190225446	295	148.0	
23000	chr3	190227101	190227429	328	164.0	
23001	chr3	190231358	190232466	1108	554.0	
23002	chr3	190301616	190302014	398	199.0	
23003	chr3	190306597	190307101	504	252.0	
23004	chr3	190321920	190323614	1694	847.0	
23005	chr3	190424344	190424890	546	273.0	
23006	chr3	190495830	190496164	334	167.0	
23007	chr3	190512890	190515534	2644	1322.0	
23008	chr3	190517548	190518093	545	272.0	
23009	chr3	190532705	190533851	1146	573.0	
23010	chr3	190565997	190567050	1053	526.0	
23011	chr3	190585676	190587192	1516	758.0	
23012	chr3	190614309	190614802	493	246.0	
23013	chr3	190616622	190617810	1188	594.0	
23014	chr3	190618359	190619117	758	379.0	
23015	chr3	190620904	190621322	418	209.0	
23016	chr3	190621956	190622346	390	195.0	
23017	chr3	190854084	190854468	384	192.0	
23018	chr3	190862522	190863239	717	358.0	
23019	chr3	191239756	191240049	293	146.0	
23020	chr3	191244304	191244621	317	158.0	
23021	chr3	191245835	191246792	957	478.0	
23022	chr3	191253154	191253482	328	164.0	
23023	chr3	191258939	191259372	433	216.0	
23024	chr3	191269443	191269506	63	32.0	
23025	chr3	191290208	191290751	543	272.0	
23026	chr3	191295908	191296456	548	274.0	
23027	chr3	191300959	191301327	368	184.0	
23028	chr3	191328500	191330595	2095	1048.0	
23029	chr3	191416995	191417345	350	175.0	
23030	chr3	192444546	192444836	290	145.0	
23031	chr3	192467264	192467630	366	183.0	
23032	chr3	192494261	192494587	326	163.0	
23033	chr3	192816500	192816597	97	48.0	
23034	chr3	192838064	192838543	479	240.0	
23035	chr3	192851697	192852343	646	323.0	
23036	chr3	192892730	192894290	1560	780.0	
23037	chr3	192898720	192899433	713	356.0	
23038	chr3	192915549	192915690	141	70.0	
23039	chr3	192916349	192918647	2298	1149.0	
23040	chr3	192919865	192920295	430	215.0	
23041	chr3	192929998	192930588	590	295.0	
23042	chr3	192957070	192958350	1280	640.0	
23043	chr3	193016941	193016956	15	8.0	
23044	chr3	193041143	193041380	237	118.0	
23045	chr3	193447142	193447528	386	193.0	
23046	chr3	193461695	193462051	356	178.0	
23047	chr3	193489897	193490367	470	235.0	
23048	chr3	193498341	193498574	233	116.0	
23049	chr3	193499186	193499444	258	129.0	
23050	chr3	193572404	193572785	381	190.0	
23051	chr3	193592529	193594219	1690	845.0	
23052	chr3	193605849	193606320	471	236.0	
23053	chr3	193640321	193640649	328	164.0	
23054	chr3	193693721	193694234	513	256.0	
23055	chr3	193702356	193702604	248	124.0	
23056	chr3	193716146	193716517	371	186.0	
23057	chr3	193780822	193781133	311	156.0	
23058	chr3	193788099	193788506	407	204.0	
23059	chr3	193820938	193821639	701	350.0	
23060	chr3	193832050	193832699	649	324.0	
23061	chr3	193841854	193842867	1013	506.0	
23062	chr3	193894085	193894410	325	162.0	
23063	chr3	193926052	193926494	442	221.0	
23064	chr3	193970186	193970511	325	162.0	
23065	chr3	193971122	193971904	782	391.0	
23066	chr3	193977619	193978042	423	212.0	
23067	chr3	194002931	194004161	1230	615.0	
23068	chr3	194005017	194005616	599	300.0	
23069	chr3	194046905	194047758	853	426.0	
23070	chr3	194051344	194052162	818	409.0	
23071	chr3	194058045	194058608	563	282.0	
23072	chr3	194064576	194064807	231	116.0	
23073	chr3	194067950	194068277	327	164.0	
23074	chr3	194069700	194071562	1862	931.0	
23075	chr3	194088341	194090170	1829	914.0	
23076	chr3	194101123	194101271	148	74.0	
23077	chr3	194103317	194104839	1522	761.0	
23078	chr3	194120788	194121198	410	205.0	
23079	chr3	194130992	194131704	712	356.0	
23080	chr3	194133570	194138397	4827	2414.0	
23081	chr3	194139154	194139920	766	383.0	
23082	chr3	194140485	194142400	1915	958.0	
23083	chr3	194194164	194194612	448	224.0	
23084	chr3	194203475	194204293	818	409.0	
23085	chr3	194255167	194256036	869	434.0	
23086	chr3	194269635	194270159	524	262.0	
23087	chr3	194306033	194307834	1801	900.0	
23088	chr3	194315038	194316315	1277	638.0	
23089	chr3	194323915	194324160	245	122.0	
23090	chr3	194326607	194328614	2007	1004.0	
23091	chr3	194333309	194334226	917	458.0	
23092	chr3	194343861	194344354	493	246.0	
23093	chr3	194395827	194398451	2624	1312.0	
23094	chr3	194404381	194405052	671	336.0	
23095	chr3	194471907	194472926	1019	510.0	
23096	chr3	194485083	194488738	3655	1828.0	
23097	chr3	194489707	194490417	710	355.0	
23098	chr3	194491887	194492529	642	321.0	
23099	chr3	194496473	194496829	356	178.0	
23100	chr3	194497762	194498092	330	165.0	
23101	chr3	194508522	194508869	347	174.0	
23102	chr3	194520146	194520450	304	152.0	
23103	chr3	194526935	194527779	844	422.0	
23104	chr3	194540540	194540941	401	200.0	
23105	chr3	194556278	194556980	702	351.0	
23106	chr3	194572404	194572582	178	89.0	
23107	chr3	194573706	194574219	513	256.0	
23108	chr3	194575647	194576306	659	330.0	
23109	chr3	194578029	194578479	450	225.0	
23110	chr3	194583319	194585339	2020	1010.0	
23111	chr3	194586809	194587853	1044	522.0	
23112	chr3	194592741	194593236	495	248.0	
23113	chr3	194594444	194595148	704	352.0	
23114	chr3	194632699	194634123	1424	712.0	
23115	chr3	194640857	194641258	401	200.0	
23116	chr3	194671324	194673278	1954	977.0	
23117	chr3	194682334	194683501	1167	584.0	
23118	chr3	194685118	194690009	4891	2446.0	
23119	chr3	194691606	194692409	803	402.0	
23120	chr3	194715042	194715917	875	438.0	
23121	chr3	194736311	194737814	1503	752.0	
23122	chr3	194744942	194745900	958	479.0	
23123	chr3	194766765	194767618	853	426.0	
23124	chr3	194768558	194770051	1493	746.0	
23125	chr3	194843468	194843951	483	242.0	
23126	chr3	194854777	194855498	721	360.0	
23127	chr3	194861376	194861813	437	218.0	
23128	chr3	194865615	194866662	1047	524.0	
23129	chr3	194867209	194867702	493	246.0	
23130	chr3	194871433	194872363	930	465.0	
23131	chr3	194879161	194881384	2223	1112.0	
23132	chr3	194910668	194911016	348	174.0	
23133	chr3	194924909	194925395	486	243.0	
23134	chr3	194928965	194929493	528	264.0	
23135	chr3	194930256	194930784	528	264.0	
23136	chr3	194935033	194935397	364	182.0	
23137	chr3	194942589	194943560	971	486.0	
23138	chr3	194954101	194954500	399	200.0	
23139	chr3	194975629	194975926	297	148.0	
23140	chr3	194985030	194985868	838	419.0	
23141	chr3	194986490	194987045	555	278.0	
23142	chr3	195001900	195002321	421	210.0	
23143	chr3	195002904	195003551	647	324.0	
23144	chr3	195009629	195010041	412	206.0	
23145	chr3	195039974	195040505	531	266.0	
23146	chr3	195042706	195043072	366	183.0	
23147	chr3	195065277	195065388	111	56.0	
23148	chr3	195075900	195076394	494	247.0	
23149	chr3	195079674	195080460	786	393.0	
23150	chr3	195093986	195095641	1655	828.0	
23151	chr3	195097734	195098270	536	268.0	
23152	chr3	195100451	195103101	2650	1325.0	
23153	chr3	195106185	195107601	1416	708.0	
23154	chr3	195110751	195111473	722	361.0	
23155	chr3	195128310	195128526	216	108.0	
23156	chr3	195129497	195130038	541	270.0	
23157	chr3	195133511	195133943	432	216.0	
23158	chr3	195144541	195144914	373	186.0	
23159	chr3	195147338	195148936	1598	799.0	
23160	chr3	195150158	195151067	909	454.0	
23161	chr3	195157029	195157604	575	288.0	
23162	chr3	195160984	195161332	348	174.0	
23163	chr3	195162026	195162590	564	282.0	
23164	chr3	195164754	195165328	574	287.0	
23165	chr3	195203693	195204934	1241	620.0	
23166	chr3	195257297	195261309	4012	2006.0	
23167	chr3	195263502	195264197	695	348.0	
23168	chr3	195269658	195272340	2682	1341.0	
23169	chr3	195397145	195397485	340	170.0	
23170	chr3	195408469	195408547	78	39.0	
23171	chr3	195409895	195409969	74	37.0	
23172	chr3	195419282	195419410	128	64.0	
23173	chr3	195425958	195426087	129	64.0	
23174	chr3	195441438	195444043	2605	1302.0	
23175	chr3	195450587	195451363	776	388.0	
23176	chr3	195458116	195458947	831	416.0	
23177	chr3	195508176	195508754	578	289.0	
23178	chr3	195511260	195512236	976	488.0	
23179	chr3	195522067	195523033	966	483.0	
23180	chr3	195524636	195524687	51	26.0	
23181	chr3	195534368	195534867	499	250.0	
23182	chr3	195537824	195538464	640	320.0	
23183	chr3	195539275	195546742	7467	3734.0	
23184	chr3	195548457	195551432	2975	1488.0	
23185	chr3	195556370	195556724	354	177.0	
23186	chr3	195558512	195558949	437	218.0	
23187	chr3	195586587	195587288	701	350.0	
23188	chr3	195609103	195609880	777	388.0	
23189	chr3	195625090	195625534	444	222.0	
23190	chr3	195653653	195654068	415	208.0	
23191	chr3	195657372	195658498	1126	563.0	
23192	chr3	195687303	195687855	552	276.0	
23193	chr3	195709180	195709447	267	134.0	
23194	chr3	195711567	195712763	1196	598.0	
23195	chr3	195737871	195738299	428	214.0	
23196	chr3	195747353	195748669	1316	658.0	
23197	chr3	195756035	195756566	531	266.0	
23198	chr3	195768890	195769201	311	156.0	
23199	chr3	195771644	195772131	487	244.0	
23200	chr3	195790823	195791414	591	296.0	
23201	chr3	195802059	195802636	577	288.0	
23202	chr3	195849724	195850019	295	148.0	
23203	chr3	195850598	195851682	1084	542.0	
23204	chr3	195859030	195859955	925	462.0	
23205	chr3	195862913	195863715	802	401.0	
23206	chr3	195876599	195877027	428	214.0	
23207	chr3	195894325	195897553	3228	1614.0	
23208	chr3	195898268	195898409	141	70.0	
23209	chr3	195900146	195901476	1330	665.0	
23210	chr3	195902337	195902761	424	212.0	
23211	chr3	195903485	195910605	7120	3560.0	
23212	chr3	195914556	195915653	1097	548.0	
23213	chr3	195954098	195955890	1792	896.0	
23214	chr3	195960966	195961843	877	438.0	
23215	chr3	195989576	195991027	1451	726.0	
23216	chr3	195994174	195994797	623	312.0	
23217	chr3	196042905	196042917	12	6.0	
23218	chr3	196044801	196045667	866	433.0	
23219	chr3	196047237	196050129	2892	1446.0	
23220	chr3	196050854	196050857	3	2.0	
23221	chr3	196051633	196052924	1291	646.0	
23222	chr3	196055059	196056655	1596	798.0	
23223	chr3	196057518	196057919	401	200.0	
23224	chr3	196061707	196062341	634	317.0	
23225	chr3	196063579	196064365	786	393.0	
23226	chr3	196067105	196067127	22	11.0	
23227	chr3	196069663	196070047	384	192.0	
23228	chr3	196072988	196074042	1054	527.0	
23229	chr3	196075317	196076106	789	394.0	
23230	chr3	196078719	196083026	4307	2154.0	
23231	chr3	196093207	196093790	583	292.0	
23232	chr3	196096257	196097079	822	411.0	
23233	chr3	196098257	196099000	743	372.0	
23234	chr3	196111847	196112583	736	368.0	
23235	chr3	196115743	196116127	384	192.0	
23236	chr3	196120473	196120865	392	196.0	
23237	chr3	196122080	196122303	223	112.0	
23238	chr3	196122957	196123460	503	252.0	
23239	chr3	196127447	196128036	589	294.0	
23240	chr3	196141426	196141892	466	233.0	
23241	chr3	196144407	196145148	741	370.0	
23242	chr3	196149970	196150379	409	204.0	
23243	chr3	196155061	196155306	245	122.0	
23244	chr3	196159815	196160571	756	378.0	
23245	chr3	196163647	196164319	672	336.0	
23246	chr3	196169806	196171396	1590	795.0	
23247	chr3	196175772	196176094	322	161.0	
23248	chr3	196179217	196180580	1363	682.0	
23249	chr3	196181331	196182424	1093	546.0	
23250	chr3	196183272	196183819	547	274.0	
23251	chr3	196186545	196187532	987	494.0	
23252	chr3	196189020	196189942	922	461.0	
23253	chr3	196191862	196194721	2859	1430.0	
23254	chr3	196195820	196197233	1413	706.0	
23255	chr3	196202370	196202996	626	313.0	
23256	chr3	196203576	196204317	741	370.0	
23257	chr3	196205393	196209676	4283	2142.0	
23258	chr3	196218975	196221307	2332	1166.0	
23259	chr3	196232417	196232951	534	267.0	
23260	chr3	196237262	196237577	315	158.0	
23261	chr3	196247052	196247297	245	122.0	
23262	chr3	196253313	196254041	728	364.0	
23263	chr3	196268789	196269156	367	184.0	
23264	chr3	196273668	196275480	1812	906.0	
23265	chr3	196278313	196279819	1506	753.0	
23266	chr3	196285800	196288562	2762	1381.0	
23267	chr3	196292504	196292623	119	60.0	
23268	chr3	196317387	196318940	1553	776.0	
23269	chr3	196321157	196321651	494	247.0	
23270	chr3	196338099	196338974	875	438.0	
23271	chr3	196339762	196340200	438	219.0	
23272	chr3	196341017	196341595	578	289.0	
23273	chr3	196344517	196345156	639	320.0	
23274	chr3	196357816	196358371	555	278.0	
23275	chr3	196365824	196366064	240	120.0	
23276	chr3	196415997	196416565	568	284.0	
23277	chr3	196418523	196419060	537	268.0	
23278	chr3	196431099	196433358	2259	1130.0	
23279	chr3	196457483	196457979	496	248.0	
23280	chr3	196486322	196486585	263	132.0	
23281	chr3	196500378	196505042	4664	2332.0	
23282	chr3	196519096	196519572	476	238.0	
23283	chr3	196522608	196523070	462	231.0	
23284	chr3	196528396	196529396	1000	500.0	
23285	chr3	196537292	196537745	453	226.0	
23286	chr3	196554167	196554679	512	256.0	
23287	chr3	196563868	196564345	477	238.0	
23288	chr3	196567885	196569778	1893	946.0	
23289	chr3	196574975	196575288	313	156.0	
23290	chr3	196598283	196598767	484	242.0	
23291	chr3	196604475	196605000	525	262.0	
23292	chr3	196609031	196610508	1477	738.0	
23293	chr3	196611994	196612617	623	312.0	
23294	chr3	196617182	196617580	398	199.0	
23295	chr3	196620055	196620713	658	329.0	
23296	chr3	196621591	196622013	422	211.0	
23297	chr3	196623396	196625632	2236	1118.0	
23298	chr3	196629217	196630296	1079	540.0	
23299	chr3	196631184	196635169	3985	1992.0	
23300	chr3	196636410	196636891	481	240.0	
23301	chr3	196637945	196643941	5996	2998.0	
23302	chr3	196645228	196645261	33	16.0	
23303	chr3	196646170	196646840	670	335.0	
23304	chr3	196650799	196651595	796	398.0	
23305	chr3	196670235	196670831	596	298.0	
23306	chr3	196684665	196685533	868	434.0	
23307	chr3	196687998	196688970	972	486.0	
23308	chr3	196689859	196690541	682	341.0	
23309	chr3	196691394	196691757	363	182.0	
23310	chr3	196693285	196695806	2521	1260.0	
23311	chr3	196711274	196713411	2137	1068.0	
23312	chr3	196739212	196741860	2648	1324.0	
23313	chr3	196742801	196743099	298	149.0	
23314	chr3	196749165	196749483	318	159.0	
23315	chr3	196837780	196838318	538	269.0	
23316	chr3	196863147	196863260	113	56.0	
23317	chr3	196867123	196868873	1750	875.0	
23318	chr3	196911290	196911706	416	208.0	
23319	chr3	196920611	196921146	535	268.0	
23320	chr3	196932619	196933050	431	216.0	
23321	chr3	196939661	196939997	336	168.0	
23322	chr3	196940809	196943480	2671	1336.0	
23323	chr3	196968061	196970340	2279	1140.0	
23324	chr3	196978544	196979112	568	284.0	
23325	chr3	197000138	197000534	396	198.0	
23326	chr3	197001869	197004144	2275	1138.0	
23327	chr3	197022671	197024228	1557	778.0	
23328	chr3	197028297	197030334	2037	1018.0	
23329	chr3	197031143	197032182	1039	520.0	
23330	chr3	197088421	197089043	622	311.0	
23331	chr3	197137720	197138232	512	256.0	
23332	chr3	197149535	197149893	358	179.0	
23333	chr3	197181716	197182166	450	225.0	
23334	chr3	197186929	197187408	479	240.0	
23335	chr3	197193880	197194049	169	84.0	
23336	chr3	197200901	197201172	271	136.0	
23337	chr3	197224076	197224313	237	118.0	
23338	chr3	197253521	197253945	424	212.0	
23339	chr3	197256864	197257163	299	150.0	
23340	chr3	197296957	197299787	2830	1415.0	
23341	chr3	197302980	197303365	385	192.0	
23342	chr3	197305832	197306321	489	244.0	
23343	chr3	197394548	197394978	430	215.0	
23344	chr3	197428171	197428528	357	178.0	
23345	chr3	197447778	197448184	406	203.0	
23346	chr3	197454050	197454439	389	194.0	
23347	chr3	197456027	197457101	1074	537.0	
23348	chr3	197458375	197458462	87	44.0	
23349	chr3	197501494	197502393	899	450.0	
23350	chr3	197509851	197510809	958	479.0	
23351	chr3	197516803	197517662	859	430.0	
23352	chr3	197518193	197518269	76	38.0	
23353	chr3	197518775	197520199	1424	712.0	
23354	chr3	197533949	197534285	336	168.0	
23355	chr3	197542653	197543178	525	262.0	
23356	chr3	197545540	197545877	337	168.0	
23357	chr3	197554138	197556476	2338	1169.0	
23358	chr3	197598832	197599774	942	471.0	
23359	chr3	197612989	197613722	733	366.0	
23360	chr3	197627101	197628574	1473	736.0	
23361	chr3	197664733	197665104	371	186.0	
23362	chr3	197674626	197675182	556	278.0	
23363	chr3	197676394	197677035	641	320.0	
23364	chr3	197692549	197693147	598	299.0	
23365	chr3	197706637	197707040	403	202.0	
23366	chr3	197709131	197709565	434	217.0	
23367	chr3	197711919	197713576	1657	828.0	
23368	chr3	197723956	197724342	386	193.0	
23369	chr3	197728544	197728857	313	156.0	
23370	chr3	197734154	197735318	1164	582.0	
23371	chr3	197735832	197737978	2146	1073.0	
23372	chr3	197746836	197747366	530	265.0	
23373	chr3	197748907	197751816	2909	1454.0	
23374	chr3	197790601	197792687	2086	1043.0	
23375	chr3	197793203	197793704	501	250.0	
23376	chr3	197795292	197795413	121	60.0	
23377	chr3	197798957	197799152	195	98.0	
23378	chr3	197801751	197802601	850	425.0	
23379	chr3	197847833	197848566	733	366.0	
23380	chr3	197878373	197878850	477	238.0	
23381	chr3	197882741	197883004	263	132.0	
23382	chr3	197905901	197906992	1091	546.0	
23383	chr3	197942924	197943441	517	258.0	
23384	chr3	197949323	197952116	2793	1396.0	
23385	chr3	197956990	197958196	1206	603.0	
23386	chr3	197959455	197961981	2526	1263.0	
23387	chr3	198030089	198030507	418	209.0	
23388	chr3	198066722	198067340	618	309.0	
23389	chr3	198071912	198072301	389	194.0	
23390	chr3	198079924	198081619	1695	848.0	
23391	chr3	198113469	198114073	604	302.0	
23392	chr3	198149750	198150352	602	301.0	
23393	chr3	198167540	198168132	592	296.0	
23394	chr4	27688	29631	1943	972.0	
23395	chr4	36631	37444	813	406.0	
23396	chr4	40464	41401	937	468.0	
23397	chr4	43006	44239	1233	616.0	
23398	chr4	46132	46199	67	34.0	
23399	chr4	46852	48290	1438	719.0	
23400	chr4	49643	55270	5627	2814.0	
23401	chr4	56009	60186	4177	2088.0	
23402	chr4	64614	66079	1465	732.0	
23403	chr4	67958	68407	449	224.0	
23404	chr4	121090	122065	975	488.0	
23405	chr4	123928	125815	1887	944.0	
23406	chr4	211200	211412	212	106.0	
23407	chr4	212374	212949	575	288.0	
23408	chr4	231034	231457	423	212.0	
23409	chr4	241604	242833	1229	614.0	
23410	chr4	244410	244943	533	266.0	
23411	chr4	306555	306956	401	200.0	
23412	chr4	329765	330522	757	378.0	
23413	chr4	335982	339035	3053	1526.0	
23414	chr4	472900	474839	1939	970.0	
23415	chr4	476577	476731	154	77.0	
23416	chr4	483330	483859	529	264.0	
23417	chr4	498286	500143	1857	928.0	
23418	chr4	602638	603012	374	187.0	
23419	chr4	663061	664642	1581	790.0	
23420	chr4	673540	675625	2085	1042.0	
23421	chr4	676143	677064	921	460.0	
23422	chr4	677946	678272	326	163.0	
23423	chr4	680395	682820	2425	1212.0	
23424	chr4	683489	685259	1770	885.0	
23425	chr4	686933	689972	3039	1520.0	
23426	chr4	699116	700005	889	444.0	
23427	chr4	705046	706531	1485	742.0	
23428	chr4	708234	708553	319	160.0	
23429	chr4	742379	743259	880	440.0	
23430	chr4	765192	765942	750	375.0	
23431	chr4	774088	774359	271	136.0	
23432	chr4	780952	783768	2816	1408.0	
23433	chr4	785518	787371	1853	926.0	
23434	chr4	792040	793236	1196	598.0	
23435	chr4	799067	799333	266	133.0	
23436	chr4	825200	826418	1218	609.0	
23437	chr4	855966	856877	911	456.0	
23438	chr4	878750	880378	1628	814.0	
23439	chr4	914828	916043	1215	608.0	
23440	chr4	920236	920598	362	181.0	
23441	chr4	921770	923303	1533	766.0	
23442	chr4	924066	925172	1106	553.0	
23443	chr4	926244	926626	382	191.0	
23444	chr4	927803	928167	364	182.0	
23445	chr4	930099	933134	3035	1518.0	
23446	chr4	934167	935149	982	491.0	
23447	chr4	936002	936585	583	292.0	
23448	chr4	940348	940392	44	22.0	
23449	chr4	952671	952771	100	50.0	
23450	chr4	967787	968188	401	200.0	
23451	chr4	969971	971310	1339	670.0	
23452	chr4	972084	974741	2657	1328.0	
23453	chr4	978910	979810	900	450.0	
23454	chr4	984920	985578	658	329.0	
23455	chr4	986386	987801	1415	708.0	
23456	chr4	997206	998100	894	447.0	
23457	chr4	1002138	1002777	639	320.0	
23458	chr4	1008591	1012916	4325	2162.0	
23459	chr4	1015250	1015479	229	114.0	
23460	chr4	1016286	1016956	670	335.0	
23461	chr4	1021451	1022127	676	338.0	
23462	chr4	1025930	1027206	1276	638.0	
23463	chr4	1043367	1044195	828	414.0	
23464	chr4	1048557	1049151	594	297.0	
23465	chr4	1055414	1056562	1148	574.0	
23466	chr4	1072776	1073343	567	284.0	
23467	chr4	1081310	1082845	1535	768.0	
23468	chr4	1087227	1087903	676	338.0	
23469	chr4	1113320	1114036	716	358.0	
23470	chr4	1130287	1131217	930	465.0	
23471	chr4	1136073	1136474	401	200.0	
23472	chr4	1137384	1138329	945	472.0	
23473	chr4	1163103	1163849	746	373.0	
23474	chr4	1166677	1169952	3275	1638.0	
23475	chr4	1170629	1173145	2516	1258.0	
23476	chr4	1176721	1178028	1307	654.0	
23477	chr4	1183995	1185000	1005	502.0	
23478	chr4	1186898	1187688	790	395.0	
23479	chr4	1193063	1193341	278	139.0	
23480	chr4	1200163	1204640	4477	2238.0	
23481	chr4	1208114	1208548	434	217.0	
23482	chr4	1216565	1217434	869	434.0	
23483	chr4	1218552	1219618	1066	533.0	
23484	chr4	1221866	1222028	162	81.0	
23485	chr4	1222779	1223350	571	286.0	
23486	chr4	1229688	1230035	347	174.0	
23487	chr4	1231197	1231411	214	107.0	
23488	chr4	1234059	1234189	130	65.0	
23489	chr4	1243178	1244874	1696	848.0	
23490	chr4	1245390	1250462	5072	2536.0	
23491	chr4	1253793	1254245	452	226.0	
23492	chr4	1267257	1268423	1166	583.0	
23493	chr4	1278189	1278301	112	56.0	
23494	chr4	1286112	1286571	459	230.0	
23495	chr4	1289054	1291470	2416	1208.0	
23496	chr4	1292491	1292684	193	96.0	
23497	chr4	1294985	1295455	470	235.0	
23498	chr4	1300536	1301834	1298	649.0	
23499	chr4	1306118	1306373	255	128.0	
23500	chr4	1309123	1310145	1022	511.0	
23501	chr4	1310690	1311755	1065	532.0	
23502	chr4	1318557	1318938	381	190.0	
23503	chr4	1326380	1326479	99	50.0	
23504	chr4	1329198	1331576	2378	1189.0	
23505	chr4	1333119	1334516	1397	698.0	
23506	chr4	1335190	1336876	1686	843.0	
23507	chr4	1345413	1348525	3112	1556.0	
23508	chr4	1351605	1352490	885	442.0	
23509	chr4	1356120	1356616	496	248.0	
23510	chr4	1410402	1410813	411	206.0	
23511	chr4	1511522	1512208	686	343.0	
23512	chr4	1512925	1513604	679	340.0	
23513	chr4	1521196	1521476	280	140.0	
23514	chr4	1548619	1549383	764	382.0	
23515	chr4	1578442	1582452	4010	2005.0	
23516	chr4	1583147	1583302	155	78.0	
23517	chr4	1604679	1605950	1271	636.0	
23518	chr4	1614836	1615291	455	228.0	
23519	chr4	1628924	1629723	799	400.0	
23520	chr4	1676583	1677043	460	230.0	
23521	chr4	1683071	1685182	2111	1056.0	
23522	chr4	1686441	1686799	358	179.0	
23523	chr4	1693119	1694046	927	464.0	
23524	chr4	1701595	1702094	499	250.0	
23525	chr4	1709742	1709758	16	8.0	
23526	chr4	1711020	1713781	2761	1380.0	
23527	chr4	1714551	1715905	1354	677.0	
23528	chr4	1719637	1724231	4594	2297.0	
23529	chr4	1725857	1727843	1986	993.0	
23530	chr4	1729661	1730162	501	250.0	
23531	chr4	1746027	1746722	695	348.0	
23532	chr4	1748201	1749139	938	469.0	
23533	chr4	1752209	1753228	1019	510.0	
23534	chr4	1753868	1753885	17	8.0	
23535	chr4	1763354	1763604	250	125.0	
23536	chr4	1767011	1768237	1226	613.0	
23537	chr4	1792784	1794164	1380	690.0	
23538	chr4	1794682	1795388	706	353.0	
23539	chr4	1809820	1810634	814	407.0	
23540	chr4	1833911	1834425	514	257.0	
23541	chr4	1855144	1857598	2454	1227.0	
23542	chr4	1862002	1863326	1324	662.0	
23543	chr4	1869876	1873437	3561	1780.0	
23544	chr4	1898936	1899838	902	451.0	
23545	chr4	1928289	1929036	747	374.0	
23546	chr4	1949066	1949474	408	204.0	
23547	chr4	2007989	2010591	2602	1301.0	
23548	chr4	2011441	2012088	647	324.0	
23549	chr4	2036910	2037188	278	139.0	
23550	chr4	2040355	2042998	2643	1322.0	
23551	chr4	2058425	2060082	1657	828.0	
23552	chr4	2219794	2220652	858	429.0	
23553	chr4	2240884	2242956	2072	1036.0	
23554	chr4	2243550	2244396	846	423.0	
23555	chr4	2245127	2245764	637	318.0	
23556	chr4	2246307	2248879	2572	1286.0	
23557	chr4	2250456	2251051	595	298.0	
23558	chr4	2256214	2256246	32	16.0	
23559	chr4	2257429	2258684	1255	628.0	
23560	chr4	2259724	2263300	3576	1788.0	
23561	chr4	2264266	2264655	389	194.0	
23562	chr4	2281247	2282808	1561	780.0	
23563	chr4	2285245	2285615	370	185.0	
23564	chr4	2290374	2292187	1813	906.0	
23565	chr4	2295549	2297223	1674	837.0	
23566	chr4	2298308	2298491	183	92.0	
23567	chr4	2306119	2306547	428	214.0	
23568	chr4	2320117	2320578	461	230.0	
23569	chr4	2333516	2333644	128	64.0	
23570	chr4	2354173	2355170	997	498.0	
23571	chr4	2364143	2365487	1344	672.0	
23572	chr4	2383004	2383434	430	215.0	
23573	chr4	2391086	2391394	308	154.0	
23574	chr4	2393485	2394004	519	260.0	
23575	chr4	2401132	2402836	1704	852.0	
23576	chr4	2403748	2404131	383	192.0	
23577	chr4	2411832	2414588	2756	1378.0	
23578	chr4	2416368	2420337	3969	1984.0	
23579	chr4	2441401	2442268	867	434.0	
23580	chr4	2462172	2463364	1192	596.0	
23581	chr4	2467939	2471223	3284	1642.0	
23582	chr4	2481939	2483206	1267	634.0	
23583	chr4	2484088	2486427	2339	1170.0	
23584	chr4	2487574	2488077	503	252.0	
23585	chr4	2497502	2498463	961	480.0	
23586	chr4	2511612	2512314	702	351.0	
23587	chr4	2534950	2538001	3051	1526.0	
23588	chr4	2570484	2571466	982	491.0	
23589	chr4	2574829	2575235	406	203.0	
23590	chr4	2591011	2591527	516	258.0	
23591	chr4	2598585	2599181	596	298.0	
23592	chr4	2667229	2667664	435	218.0	
23593	chr4	2689702	2690368	666	333.0	
23594	chr4	2696397	2697014	617	308.0	
23595	chr4	2713993	2714517	524	262.0	
23596	chr4	2734728	2734946	218	109.0	
23597	chr4	2745710	2747013	1303	652.0	
23598	chr4	2755109	2757969	2860	1430.0	
23599	chr4	2761765	2761866	101	50.0	
23600	chr4	2763645	2764784	1139	570.0	
23601	chr4	2770498	2771525	1027	514.0	
23602	chr4	2785452	2788529	3077	1538.0	
23603	chr4	2790497	2795336	4839	2420.0	
23604	chr4	2797324	2802285	4961	2480.0	
23605	chr4	2803398	2804215	817	408.0	
23606	chr4	2805128	2807078	1950	975.0	
23607	chr4	2809541	2815439	5898	2949.0	enhancer
23608	chr4	2817024	2818963	1939	970.0	
23609	chr4	2832479	2833083	604	302.0	
23610	chr4	2833879	2835855	1976	988.0	
23611	chr4	2836755	2838908	2153	1076.0	
23612	chr4	2842674	2845650	2976	1488.0	
23613	chr4	2847451	2847541	90	45.0	
23614	chr4	2849787	2850054	267	134.0	
23615	chr4	2850931	2853105	2174	1087.0	
23616	chr4	2859556	2859886	330	165.0	
23617	chr4	2860687	2860964	277	138.0	
23618	chr4	2862088	2862895	807	404.0	
23619	chr4	2871730	2872287	557	278.0	
23620	chr4	2906299	2906434	135	68.0	
23621	chr4	2922555	2923658	1103	552.0	
23622	chr4	2928520	2928723	203	102.0	
23623	chr4	2930839	2937691	6852	3426.0	
23624	chr4	2942006	2943257	1251	626.0	
23625	chr4	2948987	2949225	238	119.0	
23626	chr4	2954318	2955307	989	494.0	
23627	chr4	2959648	2960489	841	420.0	
23628	chr4	2961354	2964632	3278	1639.0	
23629	chr4	2978377	2978852	475	238.0	
23630	chr4	3037034	3038615	1581	790.0	
23631	chr4	3040366	3042402	2036	1018.0	
23632	chr4	3044999	3046507	1508	754.0	
23633	chr4	3047306	3048523	1217	608.0	
23634	chr4	3058673	3060472	1799	900.0	
23635	chr4	3060983	3061265	282	141.0	
23636	chr4	3073049	3076035	2986	1493.0	"sequence_feature	repeat_region"
23637	chr4	3077929	3078254	325	162.0	
23638	chr4	3079621	3080080	459	230.0	
23639	chr4	3084967	3085381	414	207.0	
23640	chr4	3106325	3107083	758	379.0	
23641	chr4	3174569	3174716	147	74.0	
23642	chr4	3192110	3193135	1025	512.0	
23643	chr4	3193778	3194258	480	240.0	
23644	chr4	3196642	3197136	494	247.0	
23645	chr4	3201694	3203307	1613	806.0	
23646	chr4	3224007	3224629	622	311.0	
23647	chr4	3225787	3227223	1436	718.0	
23648	chr4	3244031	3244277	246	123.0	
23649	chr4	3246125	3246914	789	394.0	
23650	chr4	3285659	3286653	994	497.0	
23651	chr4	3291618	3294870	3252	1626.0	
23652	chr4	3301715	3303796	2081	1040.0	
23653	chr4	3305527	3305959	432	216.0	
23654	chr4	3330734	3330965	231	116.0	
23655	chr4	3346001	3346578	577	288.0	
23656	chr4	3355229	3355698	469	234.0	
23657	chr4	3358722	3359023	301	150.0	
23658	chr4	3363806	3364190	384	192.0	
23659	chr4	3368764	3370464	1700	850.0	
23660	chr4	3372444	3373619	1175	588.0	
23661	chr4	3384979	3386163	1184	592.0	
23662	chr4	3387444	3389773	2329	1164.0	
23663	chr4	3402416	3403133	717	358.0	
23664	chr4	3414391	3414906	515	258.0	
23665	chr4	3443211	3444047	836	418.0	
23666	chr4	3463175	3463244	69	34.0	
23667	chr4	3480440	3481146	706	353.0	
23668	chr4	3484438	3485757	1319	660.0	
23669	chr4	3489516	3489851	335	168.0	
23670	chr4	3494335	3494428	93	46.0	
23671	chr4	3497549	3498551	1002	501.0	
23672	chr4	3508469	3508998	529	264.0	
23673	chr4	3514528	3515580	1052	526.0	
23674	chr4	3517457	3517830	373	186.0	
23675	chr4	3521388	3521463	75	38.0	
23676	chr4	3528676	3528752	76	38.0	
23677	chr4	3529321	3530123	802	401.0	
23678	chr4	3530649	3533327	2678	1339.0	
23679	chr4	3556520	3557507	987	494.0	
23680	chr4	3575555	3575824	269	134.0	
23681	chr4	3606868	3607168	300	150.0	
23682	chr4	3609068	3609111	43	22.0	
23683	chr4	3620480	3620689	209	104.0	
23684	chr4	3781494	3781498	4	2.0	
23685	chr4	3871298	3871931	633	316.0	
23686	chr4	3879384	3881014	1630	815.0	
23687	chr4	3942398	3942948	550	275.0	
23688	chr4	3949955	3950263	308	154.0	
23689	chr4	3954511	3956859	2348	1174.0	
23690	chr4	4107038	4107906	868	434.0	
23691	chr4	4247466	4249232	1766	883.0	
23692	chr4	4252650	4253187	537	268.0	
23693	chr4	4260081	4260813	732	366.0	
23694	chr4	4268004	4271016	3012	1506.0	
23695	chr4	4289456	4291175	1719	860.0	
23696	chr4	4334972	4335676	704	352.0	
23697	chr4	4344958	4345171	213	106.0	
23698	chr4	4348289	4349103	814	407.0	
23699	chr4	4386195	4388053	1858	929.0	
23700	chr4	4430543	4431004	461	230.0	
23701	chr4	4461661	4462870	1209	604.0	
23702	chr4	4488345	4488998	653	326.0	
23703	chr4	4492461	4492854	393	196.0	
23704	chr4	4502699	4503325	626	313.0	
23705	chr4	4524086	4524893	807	404.0	
23706	chr4	4539622	4539928	306	153.0	
23707	chr4	4540812	4542805	1993	996.0	
23708	chr4	4574706	4576104	1398	699.0	
23709	chr4	4852747	4853630	883	442.0	
23710	chr4	4859330	4860883	1553	776.0	
23711	chr4	4943611	4944524	913	456.0	
23712	chr4	4990873	4991352	479	240.0	
23713	chr4	4995053	4995531	478	239.0	
23714	chr4	5033225	5034033	808	404.0	
23715	chr4	5037394	5038669	1275	638.0	
23716	chr4	5040852	5041187	335	168.0	
23717	chr4	5045003	5045621	618	309.0	
23718	chr4	5050383	5052482	2099	1050.0	
23719	chr4	5553812	5554247	435	218.0	
23720	chr4	5708002	5708657	655	328.0	
23721	chr4	5710847	5711638	791	396.0	
23722	chr4	5731682	5732068	386	193.0	
23723	chr4	5812939	5813299	360	180.0	
23724	chr4	5998547	5998667	120	60.0	
23725	chr4	6134507	6135144	637	318.0	
23726	chr4	6170184	6171199	1015	508.0	
23727	chr4	6172607	6173026	419	210.0	
23728	chr4	6177431	6178440	1009	504.0	
23729	chr4	6179240	6179763	523	262.0	
23730	chr4	6180597	6181763	1166	583.0	
23731	chr4	6182403	6182718	315	158.0	
23732	chr4	6183721	6184167	446	223.0	
23733	chr4	6197694	6202174	4480	2240.0	
23734	chr4	6221669	6222432	763	382.0	
23735	chr4	6250467	6251109	642	321.0	
23736	chr4	6257235	6257731	496	248.0	
23737	chr4	6264184	6264310	126	63.0	
23738	chr4	6267518	6268036	518	259.0	
23739	chr4	6268910	6270924	2014	1007.0	
23740	chr4	6308591	6309584	993	496.0	
23741	chr4	6327163	6327847	684	342.0	
23742	chr4	6332054	6332435	381	190.0	
23743	chr4	6338166	6338516	350	175.0	
23744	chr4	6372877	6373304	427	214.0	
23745	chr4	6546541	6547047	506	253.0	
23746	chr4	6574411	6575930	1519	760.0	
23747	chr4	6583078	6583524	446	223.0	
23748	chr4	6591352	6591653	301	150.0	
23749	chr4	6609202	6609521	319	160.0	
23750	chr4	6633513	6633963	450	225.0	
23751	chr4	6639912	6642363	2451	1226.0	
23752	chr4	6642886	6643150	264	132.0	
23753	chr4	6658459	6659282	823	412.0	
23754	chr4	6663968	6665298	1330	665.0	
23755	chr4	6672879	6675518	2639	1320.0	
23756	chr4	6677499	6677516	17	8.0	
23757	chr4	6688109	6691083	2974	1487.0	
23758	chr4	6692693	6692736	43	22.0	
23759	chr4	6693516	6697067	3551	1776.0	
23760	chr4	6701352	6701813	461	230.0	
23761	chr4	6708818	6711446	2628	1314.0	
23762	chr4	6715566	6717151	1585	792.0	
23763	chr4	6719961	6720892	931	466.0	
23764	chr4	6732613	6733087	474	237.0	
23765	chr4	6751468	6752922	1454	727.0	
23766	chr4	6768426	6768929	503	252.0	
23767	chr4	6773924	6774721	797	398.0	
23768	chr4	6777276	6778321	1045	522.0	
23769	chr4	6781635	6784210	2575	1288.0	
23770	chr4	6788117	6788513	396	198.0	
23771	chr4	6807172	6808057	885	442.0	
23772	chr4	6812847	6812892	45	22.0	
23773	chr4	6825363	6826037	674	337.0	
23774	chr4	6854039	6854694	655	328.0	
23775	chr4	6855605	6856427	822	411.0	
23776	chr4	6870568	6871068	500	250.0	
23777	chr4	6873715	6874528	813	406.0	
23778	chr4	6875219	6876039	820	410.0	
23779	chr4	6885800	6886725	925	462.0	
23780	chr4	6887566	6888484	918	459.0	
23781	chr4	6891361	6894004	2643	1322.0	
23782	chr4	6899017	6900176	1159	580.0	
23783	chr4	6904308	6904752	444	222.0	
23784	chr4	6907784	6911669	3885	1942.0	
23785	chr4	6912553	6912768	215	108.0	
23786	chr4	6916398	6918889	2491	1246.0	
23787	chr4	6925225	6927613	2388	1194.0	
23788	chr4	6929606	6930364	758	379.0	
23789	chr4	6937857	6939308	1451	726.0	
23790	chr4	6940014	6940730	716	358.0	
23791	chr4	6941471	6943467	1996	998.0	
23792	chr4	6951832	6953100	1268	634.0	
23793	chr4	6963936	6964771	835	418.0	
23794	chr4	6974091	6974977	886	443.0	
23795	chr4	6983456	6984177	721	360.0	
23796	chr4	6986204	6988345	2141	1070.0	
23797	chr4	6991423	6992339	916	458.0	
23798	chr4	6999102	6999651	549	274.0	
23799	chr4	7014036	7014362	326	163.0	
23800	chr4	7033726	7034144	418	209.0	
23801	chr4	7037398	7037809	411	206.0	
23802	chr4	7041659	7044732	3073	1536.0	
23803	chr4	7052839	7053767	928	464.0	
23804	chr4	7058361	7061070	2709	1354.0	
23805	chr4	7065382	7065770	388	194.0	
23806	chr4	7066996	7069239	2243	1122.0	
23807	chr4	7070450	7071388	938	469.0	
23808	chr4	7073512	7074026	514	257.0	
23809	chr4	7081959	7082400	441	220.0	
23810	chr4	7101777	7104235	2458	1229.0	
23811	chr4	7192260	7192781	521	260.0	
23812	chr4	7324254	7325197	943	472.0	
23813	chr4	7335748	7336161	413	206.0	
23814	chr4	7435319	7435760	441	220.0	
23815	chr4	7524365	7524845	480	240.0	
23816	chr4	7539484	7540428	944	472.0	
23817	chr4	7596972	7597518	546	273.0	
23818	chr4	7634519	7635848	1329	664.0	
23819	chr4	7638581	7639699	1118	559.0	
23820	chr4	7646360	7651579	5219	2610.0	
23821	chr4	7652463	7653130	667	334.0	
23822	chr4	7653805	7654458	653	326.0	
23823	chr4	7655525	7655842	317	158.0	
23824	chr4	7673071	7673628	557	278.0	
23825	chr4	7719558	7720004	446	223.0	
23826	chr4	7743656	7744527	871	436.0	
23827	chr4	7746947	7747465	518	259.0	
23828	chr4	7749389	7749890	501	250.0	
23829	chr4	7759131	7759934	803	402.0	
23830	chr4	7761611	7762105	494	247.0	
23831	chr4	7801986	7802575	589	294.0	
23832	chr4	7803947	7804481	534	267.0	
23833	chr4	7828037	7829130	1093	546.0	
23834	chr4	7831284	7831849	565	282.0	
23835	chr4	7844174	7844682	508	254.0	
23836	chr4	7854662	7855647	985	492.0	
23837	chr4	7863820	7865956	2136	1068.0	
23838	chr4	7868753	7869410	657	328.0	
23839	chr4	7876359	7876792	433	216.0	
23840	chr4	7937108	7937508	400	200.0	
23841	chr4	7938079	7940544	2465	1232.0	
23842	chr4	7947926	7948366	440	220.0	
23843	chr4	7961029	7961132	103	52.0	
23844	chr4	7964421	7965892	1471	736.0	
23845	chr4	7967391	7968165	774	387.0	
23846	chr4	7969243	7970990	1747	874.0	
23847	chr4	7971717	7972448	731	366.0	
23848	chr4	7973570	7973795	225	112.0	
23849	chr4	7987287	7987823	536	268.0	
23850	chr4	8046934	8047289	355	178.0	
23851	chr4	8117283	8117738	455	228.0	
23852	chr4	8157175	8159917	2742	1371.0	
23853	chr4	8162690	8163049	359	180.0	
23854	chr4	8167276	8168496	1220	610.0	
23855	chr4	8172103	8172701	598	299.0	
23856	chr4	8176566	8177397	831	416.0	
23857	chr4	8190929	8191865	936	468.0	
23858	chr4	8192599	8193245	646	323.0	
23859	chr4	8198201	8203168	4967	2484.0	
23860	chr4	8205245	8206587	1342	671.0	
23861	chr4	8207221	8207785	564	282.0	
23862	chr4	8209115	8209649	534	267.0	
23863	chr4	8221002	8222320	1318	659.0	
23864	chr4	8227201	8229723	2522	1261.0	
23865	chr4	8240597	8240982	385	192.0	
23866	chr4	8241945	8242683	738	369.0	
23867	chr4	8261813	8262492	679	340.0	
23868	chr4	8267133	8267582	449	224.0	
23869	chr4	8269684	8270303	619	310.0	
23870	chr4	8273124	8273351	227	114.0	
23871	chr4	8287809	8288313	504	252.0	
23872	chr4	8303655	8303900	245	122.0	
23873	chr4	8338689	8338716	27	14.0	
23874	chr4	8402650	8403611	961	480.0	
23875	chr4	8408795	8411008	2213	1106.0	
23876	chr4	8414360	8414750	390	195.0	
23877	chr4	8419130	8420095	965	482.0	
23878	chr4	8427653	8429197	1544	772.0	
23879	chr4	8435274	8436387	1113	556.0	
23880	chr4	8439934	8441558	1624	812.0	
23881	chr4	8468690	8469178	488	244.0	
23882	chr4	8857446	8857524	78	39.0	
23883	chr4	8917974	8918386	412	206.0	
23884	chr4	9000485	9001421	936	468.0	
23885	chr4	9123508	9123942	434	217.0	
23886	chr4	9151790	9154129	2339	1170.0	
23887	chr4	9158399	9158836	437	218.0	
23888	chr4	9380955	9381642	687	344.0	
23889	chr4	9495460	9495826	366	183.0	
23890	chr4	9522922	9523254	332	166.0	
23891	chr4	9531969	9533144	1175	588.0	
23892	chr4	9595598	9595808	210	105.0	
23893	chr4	9603851	9605087	1236	618.0	
23894	chr4	9659660	9660023	363	182.0	
23895	chr4	9690982	9693216	2234	1117.0	
23896	chr4	9695967	9696368	401	200.0	
23897	chr4	9703316	9703892	576	288.0	
23898	chr4	9763030	9763506	476	238.0	
23899	chr4	9765130	9765509	379	190.0	
23900	chr4	9769507	9769655	148	74.0	
23901	chr4	9875488	9876044	556	278.0	
23902	chr4	9890264	9890706	442	221.0	
23903	chr4	9894944	9895602	658	329.0	
23904	chr4	9970612	9970932	320	160.0	
23905	chr4	9987917	9988089	172	86.0	
23906	chr4	9990352	9990613	261	130.0	
23907	chr4	10005804	10007544	1740	870.0	
23908	chr4	10013749	10014125	376	188.0	
23909	chr4	10015178	10015547	369	184.0	
23910	chr4	10018448	10020033	1585	792.0	
23911	chr4	10020697	10022020	1323	662.0	
23912	chr4	10022977	10024857	1880	940.0	
23913	chr4	10032369	10033558	1189	594.0	
23914	chr4	10044354	10045211	857	428.0	
23915	chr4	10061041	10061385	344	172.0	
23916	chr4	10063310	10064162	852	426.0	
23917	chr4	10072532	10072547	15	8.0	
23918	chr4	10077702	10078325	623	312.0	
23919	chr4	10080794	10080804	10	5.0	
23920	chr4	10091767	10091802	35	18.0	
23921	chr4	10092915	10097677	4762	2381.0	
23922	chr4	10098707	10101488	2781	1390.0	
23923	chr4	10103942	10104920	978	489.0	
23924	chr4	10105978	10107373	1395	698.0	
23925	chr4	10108939	10109841	902	451.0	
23926	chr4	10110370	10111493	1123	562.0	
23927	chr4	10114829	10120273	5444	2722.0	
23928	chr4	10121138	10121372	234	117.0	
23929	chr4	10122762	10122763	1	0.0	
23930	chr4	10123527	10124752	1225	612.0	
23931	chr4	10151191	10151470	279	140.0	
23932	chr4	10157665	10158181	516	258.0	
23933	chr4	10160305	10160665	360	180.0	
23934	chr4	10161787	10162302	515	258.0	
23935	chr4	10165100	10165112	12	6.0	
23936	chr4	10173365	10173683	318	159.0	
23937	chr4	10180881	10181842	961	480.0	
23938	chr4	10183428	10183849	421	210.0	
23939	chr4	10245762	10246131	369	184.0	
23940	chr4	10403794	10404103	309	154.0	
23941	chr4	10413224	10413438	214	107.0	
23942	chr4	10416513	10416793	280	140.0	
23943	chr4	10456352	10458067	1715	858.0	
23944	chr4	10460802	10462072	1270	635.0	
23945	chr4	10537982	10538398	416	208.0	
23946	chr4	10549681	10550038	357	178.0	
23947	chr4	10554601	10555145	544	272.0	
23948	chr4	10583931	10584554	623	312.0	
23949	chr4	10587665	10588027	362	181.0	
23950	chr4	10640332	10641086	754	377.0	
23951	chr4	10671165	10672069	904	452.0	
23952	chr4	10684676	10685067	391	196.0	
23953	chr4	10722949	10723349	400	200.0	
23954	chr4	10954575	10955336	761	380.0	
23955	chr4	10977580	10977894	314	157.0	
23956	chr4	10983314	10983484	170	85.0	
23957	chr4	11099916	11100569	653	326.0	
23958	chr4	11424040	11424353	313	156.0	
23959	chr4	11428181	11429556	1375	688.0	
23960	chr4	11439840	11440248	408	204.0	
23961	chr4	11470334	11472210	1876	938.0	
23962	chr4	11480523	11481410	887	444.0	
23963	chr4	11483079	11483390	311	156.0	
23964	chr4	11487929	11488182	253	126.0	
23965	chr4	11489171	11489831	660	330.0	
23966	chr4	11490450	11490790	340	170.0	
23967	chr4	11497481	11497821	340	170.0	
23968	chr4	11543611	11544097	486	243.0	
23969	chr4	11566655	11566799	144	72.0	
23970	chr4	11791856	11792191	335	168.0	
23971	chr4	11805832	11806253	421	210.0	
23972	chr4	11824504	11825001	497	248.0	
23973	chr4	11843507	11844298	791	396.0	
23974	chr4	11846973	11847704	731	366.0	
23975	chr4	11861015	11861386	371	186.0	
23976	chr4	12041890	12042241	351	176.0	
23977	chr4	12116193	12116499	306	153.0	
23978	chr4	12118295	12119197	902	451.0	
23979	chr4	12122319	12122721	402	201.0	
23980	chr4	12123593	12124129	536	268.0	
23981	chr4	12126394	12126930	536	268.0	
23982	chr4	12165655	12165915	260	130.0	
23983	chr4	12221062	12221363	301	150.0	
23984	chr4	12633054	12633432	378	189.0	
23985	chr4	13452956	13453324	368	184.0	
23986	chr4	13481628	13481840	212	106.0	
23987	chr4	13483460	13485570	2110	1055.0	
23988	chr4	13491040	13491403	363	182.0	
23989	chr4	13498397	13498881	484	242.0	
23990	chr4	13522562	13522765	203	102.0	
23991	chr4	13527469	13528999	1530	765.0	
23992	chr4	13541766	13545314	3548	1774.0	
23993	chr4	13547005	13548187	1182	591.0	
23994	chr4	13548831	13549555	724	362.0	
23995	chr4	13580033	13580396	363	182.0	
23996	chr4	13600859	13601601	742	371.0	
23997	chr4	13602109	13602217	108	54.0	
23998	chr4	13611307	13611708	401	200.0	
23999	chr4	13615092	13615614	522	261.0	
24000	chr4	13626546	13628563	2017	1008.0	
24001	chr4	13653988	13654974	986	493.0	
24002	chr4	13656388	13657472	1084	542.0	
24003	chr4	13704088	13704406	318	159.0	
24004	chr4	13958375	13958931	556	278.0	
24005	chr4	14008496	14008874	378	189.0	
24006	chr4	14125222	14126011	789	394.0	
24007	chr4	14132232	14132787	555	278.0	
24008	chr4	14165489	14166077	588	294.0	
24009	chr4	14178065	14178820	755	378.0	
24010	chr4	14269716	14270268	552	276.0	
24011	chr4	14305908	14306346	438	219.0	
24012	chr4	14309569	14309597	28	14.0	
24013	chr4	14345208	14345943	735	368.0	
24014	chr4	14400255	14400749	494	247.0	
24015	chr4	14767136	14767517	381	190.0	
24016	chr4	14787912	14788275	363	182.0	
24017	chr4	14848476	14848543	67	34.0	
24018	chr4	14850514	14850829	315	158.0	
24019	chr4	14855944	14856993	1049	524.0	
24020	chr4	14858039	14858148	109	54.0	
24021	chr4	14864356	14864938	582	291.0	
24022	chr4	14872134	14872509	375	188.0	
24023	chr4	14876979	14877997	1018	509.0	
24024	chr4	14920687	14921204	517	258.0	
24025	chr4	14924230	14925378	1148	574.0	
24026	chr4	14994218	14994745	527	264.0	
24027	chr4	15001040	15005581	4541	2270.0	
24028	chr4	15006136	15006860	724	362.0	
24029	chr4	15014095	15014245	150	75.0	
24030	chr4	15020874	15021255	381	190.0	
24031	chr4	15078024	15078343	319	160.0	
24032	chr4	15149795	15150237	442	221.0	
24033	chr4	15188635	15189365	730	365.0	
24034	chr4	15231275	15232031	756	378.0	
24035	chr4	15233099	15234749	1650	825.0	
24036	chr4	15238668	15239162	494	247.0	
24037	chr4	15254253	15254975	722	361.0	
24038	chr4	15375704	15376339	635	318.0	
24039	chr4	15396136	15396640	504	252.0	
24040	chr4	15400650	15401616	966	483.0	
24041	chr4	15403239	15403280	41	20.0	
24042	chr4	15410763	15411244	481	240.0	
24043	chr4	15416236	15416988	752	376.0	
24044	chr4	15450842	15451566	724	362.0	
24045	chr4	15455272	15455398	126	63.0	
24046	chr4	15457110	15458020	910	455.0	
24047	chr4	15469597	15470323	726	363.0	
24048	chr4	15478990	15479269	279	140.0	
24049	chr4	15547341	15547824	483	242.0	
24050	chr4	15586170	15586202	32	16.0	
24051	chr4	15610915	15611193	278	139.0	
24052	chr4	15649688	15650582	894	447.0	
24053	chr4	15651724	15652071	347	174.0	
24054	chr4	15653373	15656484	3111	1556.0	
24055	chr4	15659639	15660635	996	498.0	
24056	chr4	15665682	15666334	652	326.0	
24057	chr4	15673962	15674439	477	238.0	
24058	chr4	15675329	15675746	417	208.0	
24059	chr4	15681089	15683557	2468	1234.0	
24060	chr4	15689478	15690475	997	498.0	
24061	chr4	15691291	15691863	572	286.0	
24062	chr4	15700152	15700560	408	204.0	
24063	chr4	15702624	15703747	1123	562.0	
24064	chr4	15719451	15719942	491	246.0	
24065	chr4	15720814	15721302	488	244.0	
24066	chr4	15725661	15726210	549	274.0	
24067	chr4	15729873	15730535	662	331.0	
24068	chr4	15754039	15754776	737	368.0	
24069	chr4	15755319	15757354	2035	1018.0	
24070	chr4	15765472	15767040	1568	784.0	
24071	chr4	15771288	15771889	601	300.0	
24072	chr4	15774166	15774372	206	103.0	
24073	chr4	15777188	15777222	34	17.0	
24074	chr4	15777777	15780268	2491	1246.0	
24075	chr4	15781532	15782470	938	469.0	
24076	chr4	15783633	15784134	501	250.0	
24077	chr4	15784885	15785385	500	250.0	
24078	chr4	15805565	15806542	977	488.0	
24079	chr4	15808753	15809846	1093	546.0	
24080	chr4	15832746	15833205	459	230.0	
24081	chr4	15861127	15861701	574	287.0	
24082	chr4	15882532	15883101	569	284.0	
24083	chr4	15894857	15895181	324	162.0	
24084	chr4	15901059	15901429	370	185.0	
24085	chr4	15902001	15903263	1262	631.0	
24086	chr4	15905911	15906573	662	331.0	
24087	chr4	15945500	15945887	387	194.0	
24088	chr4	15955949	15956734	785	392.0	
24089	chr4	15961659	15964066	2407	1204.0	
24090	chr4	15971023	15971461	438	219.0	
24091	chr4	15991940	15992316	376	188.0	
24092	chr4	15997021	15997075	54	27.0	
24093	chr4	16001130	16002053	923	462.0	
24094	chr4	16025713	16026581	868	434.0	
24095	chr4	16032414	16032528	114	57.0	
24096	chr4	16056020	16056184	164	82.0	
24097	chr4	16079067	16079552	485	242.0	
24098	chr4	16082482	16084133	1651	826.0	
24099	chr4	16122252	16123078	826	413.0	
24100	chr4	16193145	16193624	479	240.0	
24101	chr4	16196458	16197141	683	342.0	
24102	chr4	16205268	16206026	758	379.0	
24103	chr4	16206832	16207201	369	184.0	
24104	chr4	16212159	16212511	352	176.0	
24105	chr4	16217252	16217817	565	282.0	
24106	chr4	16222946	16223133	187	94.0	
24107	chr4	16224250	16228973	4723	2362.0	
24108	chr4	16237589	16238733	1144	572.0	
24109	chr4	16264817	16265218	401	200.0	
24110	chr4	16270061	16271172	1111	556.0	
24111	chr4	16885057	16885472	415	208.0	
24112	chr4	16890663	16890951	288	144.0	
24113	chr4	16893207	16893288	81	40.0	
24114	chr4	16898716	16899078	362	181.0	
24115	chr4	16916660	16917181	521	260.0	
24116	chr4	17324350	17324751	401	200.0	
24117	chr4	17336301	17337178	877	438.0	
24118	chr4	17385393	17385831	438	219.0	
24119	chr4	17447653	17448115	462	231.0	
24120	chr4	17472327	17472714	387	194.0	
24121	chr4	17476704	17477329	625	312.0	
24122	chr4	17511379	17512745	1366	683.0	
24123	chr4	17544260	17544657	397	198.0	
24124	chr4	17549013	17550062	1049	524.0	
24125	chr4	17576297	17579338	3041	1520.0	
24126	chr4	17580140	17580852	712	356.0	
24127	chr4	17583337	17584396	1059	530.0	
24128	chr4	17586884	17587359	475	238.0	
24129	chr4	17589891	17589897	6	3.0	
24130	chr4	17591772	17591790	18	9.0	
24131	chr4	17595418	17596118	700	350.0	
24132	chr4	17602099	17602260	161	80.0	
24133	chr4	17603418	17603531	113	56.0	
24134	chr4	17605208	17605237	29	14.0	
24135	chr4	17608594	17608915	321	160.0	
24136	chr4	17610258	17610501	243	122.0	
24137	chr4	17613456	17615503	2047	1024.0	
24138	chr4	17636382	17637433	1051	526.0	
24139	chr4	17651694	17652045	351	176.0	
24140	chr4	17664858	17665092	234	117.0	
24141	chr4	17808391	17811777	3386	1693.0	
24142	chr4	17814091	17814653	562	281.0	
24143	chr4	17816983	17817573	590	295.0	
24144	chr4	17827530	17827790	260	130.0	
24145	chr4	18020092	18023220	3128	1564.0	
24146	chr4	18025158	18025869	711	356.0	
24147	chr4	18057300	18057845	545	272.0	
24148	chr4	18075803	18076261	458	229.0	
24149	chr4	18366954	18367387	433	216.0	
24150	chr4	18593468	18593966	498	249.0	
24151	chr4	19992730	19992734	4	2.0	
24152	chr4	20109479	20109750	271	136.0	
24153	chr4	20251906	20251977	71	36.0	
24154	chr4	20395411	20395515	104	52.0	
24155	chr4	20418648	20419341	693	346.0	
24156	chr4	20422402	20422856	454	227.0	
24157	chr4	20623957	20624291	334	167.0	
24158	chr4	20625215	20625976	761	380.0	
24159	chr4	20629205	20629871	666	333.0	
24160	chr4	20642073	20642134	61	30.0	
24161	chr4	20652499	20652809	310	155.0	
24162	chr4	20678470	20678494	24	12.0	
24163	chr4	20685109	20685552	443	222.0	
24164	chr4	20699709	20701238	1529	764.0	
24165	chr4	20773380	20773762	382	191.0	
24166	chr4	20916090	20916540	450	225.0	
24167	chr4	21135041	21135146	105	52.0	
24168	chr4	21765804	21766151	347	174.0	
24169	chr4	22382394	22382650	256	128.0	
24170	chr4	22444463	22444534	71	36.0	
24171	chr4	22483400	22483931	531	266.0	
24172	chr4	22515124	22516454	1330	665.0	
24173	chr4	22607312	22607858	546	273.0	
24174	chr4	22689177	22689418	241	120.0	
24175	chr4	22690731	22691086	355	178.0	
24176	chr4	22782422	22782442	20	10.0	
24177	chr4	22787697	22788508	811	406.0	
24178	chr4	23292009	23292655	646	323.0	
24179	chr4	23305098	23305422	324	162.0	
24180	chr4	23324053	23324449	396	198.0	
24181	chr4	23333522	23334950	1428	714.0	
24182	chr4	23880926	23881327	401	200.0	
24183	chr4	23889865	23890323	458	229.0	
24184	chr4	23944618	23946197	1579	790.0	
24185	chr4	23952308	23952606	298	149.0	
24186	chr4	24470058	24473731	3673	1836.0	
24187	chr4	24476234	24476332	98	49.0	
24188	chr4	24488637	24489100	463	232.0	
24189	chr4	24557693	24558111	418	209.0	
24190	chr4	24570227	24570335	108	54.0	
24191	chr4	24578418	24578814	396	198.0	
24192	chr4	24582539	24585286	2747	1374.0	
24193	chr4	24604615	24605447	832	416.0	
24194	chr4	24611051	24611116	65	32.0	
24195	chr4	24675719	24676093	374	187.0	
24196	chr4	24794015	24794355	340	170.0	
24197	chr4	24912342	24913363	1021	510.0	
24198	chr4	24926957	24927457	500	250.0	
24199	chr4	24928775	24929096	321	160.0	
24200	chr4	24930243	24930534	291	146.0	
24201	chr4	24973614	24975732	2118	1059.0	
24202	chr4	24978600	24980531	1931	966.0	
24203	chr4	24988671	24989072	401	200.0	
24204	chr4	25146409	25146759	350	175.0	
24205	chr4	25159337	25161900	2563	1282.0	
24206	chr4	25163266	25163667	401	200.0	
24207	chr4	25172856	25174047	1191	596.0	
24208	chr4	25180465	25180956	491	246.0	
24209	chr4	25194751	25195087	336	168.0	
24210	chr4	25223980	25223997	17	8.0	
24211	chr4	25232367	25232372	5	2.0	
24212	chr4	25233280	25235810	2530	1265.0	
24213	chr4	25240590	25241472	882	441.0	
24214	chr4	25253041	25253424	383	192.0	
24215	chr4	25310495	25310931	436	218.0	
24216	chr4	25312130	25313558	1428	714.0	
24217	chr4	25320746	25321228	482	241.0	
24218	chr4	25330935	25331916	981	490.0	
24219	chr4	25347008	25347023	15	8.0	
24220	chr4	25374956	25378404	3448	1724.0	
24221	chr4	25439881	25440329	448	224.0	
24222	chr4	25638228	25638546	318	159.0	
24223	chr4	25687673	25688319	646	323.0	
24224	chr4	25753232	25753594	362	181.0	
24225	chr4	25760463	25760986	523	262.0	
24226	chr4	25767877	25768268	391	196.0	
24227	chr4	25814468	25814888	420	210.0	
24228	chr4	25842172	25842817	645	322.0	
24229	chr4	25843740	25844239	499	250.0	
24230	chr4	25844903	25845392	489	244.0	
24231	chr4	25854756	25855402	646	323.0	
24232	chr4	25856700	25857776	1076	538.0	
24233	chr4	25859276	25863832	4556	2278.0	
24234	chr4	25875218	25875624	406	203.0	
24235	chr4	25878619	25879129	510	255.0	
24236	chr4	25880109	25880649	540	270.0	
24237	chr4	25912922	25915136	2214	1107.0	
24238	chr4	25928835	25929456	621	310.0	
24239	chr4	25968405	25968980	575	288.0	
24240	chr4	25970113	25970829	716	358.0	
24241	chr4	25985393	25985581	188	94.0	
24242	chr4	25988058	25988715	657	328.0	
24243	chr4	25993600	25993985	385	192.0	
24244	chr4	26000357	26000581	224	112.0	
24245	chr4	26020080	26020559	479	240.0	
24246	chr4	26028689	26029256	567	284.0	
24247	chr4	26050072	26050691	619	310.0	
24248	chr4	26053151	26053408	257	128.0	
24249	chr4	26061200	26061697	497	248.0	
24250	chr4	26069332	26069509	177	88.0	
24251	chr4	26071769	26071869	100	50.0	
24252	chr4	26074456	26076824	2368	1184.0	
24253	chr4	26081849	26082317	468	234.0	
24254	chr4	26088414	26089079	665	332.0	
24255	chr4	26130999	26132311	1312	656.0	
24256	chr4	26141916	26142348	432	216.0	
24257	chr4	26150802	26151313	511	256.0	
24258	chr4	26175462	26175723	261	130.0	
24259	chr4	26193274	26193394	120	60.0	
24260	chr4	26197142	26198033	891	446.0	
24261	chr4	26204181	26204662	481	240.0	
24262	chr4	26217838	26219385	1547	774.0	
24263	chr4	26257478	26258316	838	419.0	
24264	chr4	26261314	26261865	551	276.0	
24265	chr4	26263221	26263468	247	124.0	
24266	chr4	26268312	26268601	289	144.0	
24267	chr4	26272718	26274030	1312	656.0	
24268	chr4	26287707	26289087	1380	690.0	
24269	chr4	26299233	26299921	688	344.0	
24270	chr4	26302103	26302968	865	432.0	
24271	chr4	26308591	26308918	327	164.0	
24272	chr4	26312244	26312839	595	298.0	
24273	chr4	26318658	26322348	3690	1845.0	
24274	chr4	26325108	26325640	532	266.0	
24275	chr4	26329952	26330796	844	422.0	
24276	chr4	26331489	26331735	246	123.0	
24277	chr4	26345256	26346453	1197	598.0	
24278	chr4	26356012	26356563	551	276.0	
24279	chr4	26372602	26373271	669	334.0	
24280	chr4	26377887	26378380	493	246.0	
24281	chr4	26384449	26384772	323	162.0	
24282	chr4	26410654	26411139	485	242.0	
24283	chr4	26459176	26459635	459	230.0	
24284	chr4	26583289	26584895	1606	803.0	
24285	chr4	26723145	26723658	513	256.0	
24286	chr4	26731656	26731853	197	98.0	
24287	chr4	26746900	26747138	238	119.0	
24288	chr4	26748835	26748977	142	71.0	
24289	chr4	26763670	26763963	293	146.0	
24290	chr4	26766068	26766636	568	284.0	
24291	chr4	26786962	26787251	289	144.0	
24292	chr4	26787880	26788504	624	312.0	
24293	chr4	26807303	26807636	333	166.0	
24294	chr4	26819539	26819782	243	122.0	
24295	chr4	26821781	26823179	1398	699.0	
24296	chr4	26826532	26827457	925	462.0	
24297	chr4	26842940	26843258	318	159.0	
24298	chr4	26856847	26858630	1783	892.0	
24299	chr4	26859825	26862429	2604	1302.0	
24300	chr4	26864853	26865538	685	342.0	
24301	chr4	26866477	26867190	713	356.0	
24302	chr4	26867848	26868225	377	188.0	
24303	chr4	26872979	26874402	1423	712.0	
24304	chr4	26877559	26880334	2775	1388.0	
24305	chr4	26883901	26887656	3755	1878.0	
24306	chr4	26904506	26905622	1116	558.0	
24307	chr4	26907951	26908266	315	158.0	
24308	chr4	26912893	26913201	308	154.0	
24309	chr4	26937170	26937571	401	200.0	
24310	chr4	26985777	26986284	507	254.0	
24311	chr4	26992501	26993346	845	422.0	
24312	chr4	27000850	27001249	399	200.0	
24313	chr4	27003635	27004036	401	200.0	
24314	chr4	27010114	27010801	687	344.0	
24315	chr4	27040344	27040931	587	294.0	
24316	chr4	27048336	27048684	348	174.0	
24317	chr4	27066189	27067152	963	482.0	
24318	chr4	27068475	27068872	397	198.0	
24319	chr4	27082206	27083156	950	475.0	
24320	chr4	27088373	27088913	540	270.0	
24321	chr4	27327958	27328150	192	96.0	
24322	chr4	30717238	30717744	506	253.0	
24323	chr4	31737339	31737935	596	298.0	
24324	chr4	32569790	32570368	578	289.0	
24325	chr4	35649989	35650055	66	33.0	
24326	chr4	36123832	36124223	391	196.0	
24327	chr4	36133696	36133765	69	34.0	
24328	chr4	36142554	36142780	226	113.0	
24329	chr4	36189403	36190398	995	498.0	
24330	chr4	36192887	36193267	380	190.0	
24331	chr4	36208815	36209361	546	273.0	
24332	chr4	36218107	36218474	367	184.0	
24333	chr4	36225319	36225320	1	0.0	
24334	chr4	36235287	36235476	189	94.0	
24335	chr4	36237877	36238415	538	269.0	
24336	chr4	36241341	36245625	4284	2142.0	
24337	chr4	36252014	36252323	309	154.0	
24338	chr4	36253022	36253250	228	114.0	
24339	chr4	36255229	36257005	1776	888.0	
24340	chr4	36267421	36268207	786	393.0	
24341	chr4	36268754	36269806	1052	526.0	
24342	chr4	36278740	36279199	459	230.0	
24343	chr4	36280666	36282064	1398	699.0	
24344	chr4	36284707	36284861	154	77.0	
24345	chr4	36285529	36286958	1429	714.0	
24346	chr4	36289003	36289190	187	94.0	
24347	chr4	36303318	36304164	846	423.0	
24348	chr4	36310524	36311475	951	476.0	
24349	chr4	36313522	36313634	112	56.0	
24350	chr4	36320364	36321022	658	329.0	
24351	chr4	36322699	36324344	1645	822.0	
24352	chr4	36325288	36326323	1035	518.0	
24353	chr4	36328106	36328571	465	232.0	
24354	chr4	36337711	36338096	385	192.0	
24355	chr4	36348373	36349043	670	335.0	
24356	chr4	36351021	36351546	525	262.0	
24357	chr4	36385587	36386734	1147	574.0	
24358	chr4	36394251	36395057	806	403.0	
24359	chr4	36399723	36400203	480	240.0	
24360	chr4	36445539	36445826	287	144.0	
24361	chr4	37367935	37367979	44	22.0	
24362	chr4	37388702	37389047	345	172.0	
24363	chr4	37389925	37390336	411	206.0	
24364	chr4	37392859	37393621	762	381.0	
24365	chr4	37452908	37454191	1283	642.0	
24366	chr4	37471838	37472354	516	258.0	
24367	chr4	37481783	37481885	102	51.0	
24368	chr4	37528274	37528555	281	140.0	
24369	chr4	37566778	37567113	335	168.0	
24370	chr4	37601359	37601944	585	292.0	
24371	chr4	37602940	37603605	665	332.0	
24372	chr4	37629090	37629320	230	115.0	
24373	chr4	37648071	37648545	474	237.0	
24374	chr4	37666568	37667106	538	269.0	
24375	chr4	37675750	37676343	593	296.0	
24376	chr4	37682730	37683562	832	416.0	
24377	chr4	37684901	37687766	2865	1432.0	
24378	chr4	37735560	37736000	440	220.0	
24379	chr4	37749477	37750026	549	274.0	
24380	chr4	37754209	37755137	928	464.0	
24381	chr4	37757697	37758778	1081	540.0	
24382	chr4	37762367	37763271	904	452.0	
24383	chr4	37767610	37767727	117	58.0	
24384	chr4	37780390	37781412	1022	511.0	
24385	chr4	37793550	37793988	438	219.0	
24386	chr4	37797385	37797785	400	200.0	
24387	chr4	37803347	37803799	452	226.0	
24388	chr4	37815680	37816516	836	418.0	
24389	chr4	37825672	37827685	2013	1006.0	
24390	chr4	37837352	37837776	424	212.0	
24391	chr4	37850738	37851289	551	276.0	
24392	chr4	37864689	37866404	1715	858.0	
24393	chr4	37879323	37879796	473	236.0	
24394	chr4	37885562	37885827	265	132.0	
24395	chr4	37890129	37893324	3195	1598.0	
24396	chr4	37946445	37946908	463	232.0	
24397	chr4	37951440	37951866	426	213.0	
24398	chr4	37954545	37954992	447	224.0	
24399	chr4	37970601	37971251	650	325.0	
24400	chr4	37975213	37975280	67	34.0	
24401	chr4	37976395	37978616	2221	1110.0	
24402	chr4	37989541	37990359	818	409.0	
24403	chr4	37994558	37994832	274	137.0	
24404	chr4	38003032	38003562	530	265.0	
24405	chr4	38023528	38024222	694	347.0	
24406	chr4	38035214	38035697	483	242.0	
24407	chr4	38061916	38062613	697	348.0	
24408	chr4	38067464	38067865	401	200.0	
24409	chr4	38069222	38069581	359	180.0	
24410	chr4	38071832	38072996	1164	582.0	
24411	chr4	38075118	38076484	1366	683.0	
24412	chr4	38078291	38079429	1138	569.0	
24413	chr4	38082076	38083236	1160	580.0	
24414	chr4	38117764	38117782	18	9.0	
24415	chr4	38128350	38129844	1494	747.0	
24416	chr4	38131009	38132835	1826	913.0	
24417	chr4	38154350	38155916	1566	783.0	
24418	chr4	38160221	38161604	1383	692.0	
24419	chr4	38165993	38166646	653	326.0	
24420	chr4	38174597	38175301	704	352.0	
24421	chr4	38176848	38178263	1415	708.0	
24422	chr4	38179568	38180251	683	342.0	
24423	chr4	38191364	38191729	365	182.0	
24424	chr4	38211161	38211473	312	156.0	
24425	chr4	38213317	38213842	525	262.0	
24426	chr4	38233980	38234544	564	282.0	
24427	chr4	38306355	38307011	656	328.0	
24428	chr4	38310242	38311334	1092	546.0	
24429	chr4	38318401	38320610	2209	1104.0	
24430	chr4	38328643	38329639	996	498.0	
24431	chr4	38330491	38330962	471	236.0	
24432	chr4	38333279	38333517	238	119.0	
24433	chr4	38368671	38369018	347	174.0	
24434	chr4	38490073	38490453	380	190.0	
24435	chr4	38504145	38504504	359	180.0	
24436	chr4	38509226	38510360	1134	567.0	
24437	chr4	38519639	38520040	401	200.0	
24438	chr4	38523010	38524617	1607	804.0	
24439	chr4	38528955	38530279	1324	662.0	
24440	chr4	38562606	38563224	618	309.0	
24441	chr4	38574368	38574927	559	280.0	
24442	chr4	38582457	38583522	1065	532.0	
24443	chr4	38600562	38601704	1142	571.0	
24444	chr4	38620862	38621562	700	350.0	
24445	chr4	38654048	38655890	1842	921.0	
24446	chr4	38661654	38667919	6265	3132.0	
24447	chr4	38669215	38676194	6979	3490.0	
24448	chr4	38677384	38678357	973	486.0	
24449	chr4	38684227	38684822	595	298.0	
24450	chr4	38687549	38688166	617	308.0	
24451	chr4	38695900	38696114	214	107.0	
24452	chr4	38730697	38731598	901	450.0	
24453	chr4	38743773	38744474	701	350.0	
24454	chr4	38752215	38752719	504	252.0	
24455	chr4	38757282	38757669	387	194.0	
24456	chr4	38759454	38759954	500	250.0	
24457	chr4	38761002	38762110	1108	554.0	
24458	chr4	38764302	38764657	355	178.0	
24459	chr4	38769008	38770168	1160	580.0	
24460	chr4	38782467	38783282	815	408.0	
24461	chr4	38785367	38786649	1282	641.0	
24462	chr4	38790950	38791675	725	362.0	
24463	chr4	38803955	38806329	2374	1187.0	
24464	chr4	38815872	38816933	1061	530.0	
24465	chr4	38837804	38838259	455	228.0	
24466	chr4	38855909	38858419	2510	1255.0	
24467	chr4	38860772	38861296	524	262.0	
24468	chr4	38867225	38868304	1079	540.0	
24469	chr4	38893645	38894000	355	178.0	
24470	chr4	38902653	38903098	445	222.0	
24471	chr4	38949290	38950056	766	383.0	
24472	chr4	38985447	38985726	279	140.0	
24473	chr4	38988387	38988729	342	171.0	
24474	chr4	39025812	39025861	49	24.0	
24475	chr4	39027233	39028050	817	408.0	
24476	chr4	39030096	39030830	734	367.0	
24477	chr4	39031630	39033087	1457	728.0	
24478	chr4	39033675	39033970	295	148.0	
24479	chr4	39043452	39046724	3272	1636.0	
24480	chr4	39048219	39048899	680	340.0	
24481	chr4	39096889	39097173	284	142.0	
24482	chr4	39118176	39118580	404	202.0	
24483	chr4	39125208	39125596	388	194.0	
24484	chr4	39135178	39135761	583	292.0	
24485	chr4	39151008	39151524	516	258.0	
24486	chr4	39166071	39167039	968	484.0	
24487	chr4	39180162	39180363	201	100.0	
24488	chr4	39181628	39183694	2066	1033.0	
24489	chr4	39353066	39355536	2470	1235.0	
24490	chr4	39356974	39357481	507	254.0	
24491	chr4	39365373	39366952	1579	790.0	
24492	chr4	39446542	39447694	1152	576.0	
24493	chr4	39451587	39452100	513	256.0	
24494	chr4	39453088	39453420	332	166.0	
24495	chr4	39455307	39456382	1075	538.0	
24496	chr4	39457315	39460413	3098	1549.0	
24497	chr4	39469174	39470098	924	462.0	
24498	chr4	39480766	39481460	694	347.0	
24499	chr4	39484714	39485128	414	207.0	
24500	chr4	39486264	39486639	375	188.0	
24501	chr4	39526461	39528657	2196	1098.0	
24502	chr4	39568994	39569079	85	42.0	
24503	chr4	39609354	39610009	655	328.0	
24504	chr4	39624175	39624576	401	200.0	
24505	chr4	39626213	39626729	516	258.0	
24506	chr4	39632016	39632018	2	1.0	
24507	chr4	39636534	39640196	3662	1831.0	
24508	chr4	39657484	39657896	412	206.0	
24509	chr4	39681775	39682588	813	406.0	
24510	chr4	39695430	39696319	889	444.0	
24511	chr4	39697052	39699136	2084	1042.0	
24512	chr4	39699641	39700441	800	400.0	
24513	chr4	39711759	39712438	679	340.0	
24514	chr4	39713719	39714509	790	395.0	
24515	chr4	39718855	39719265	410	205.0	
24516	chr4	39811891	39812903	1012	506.0	
24517	chr4	39814105	39816236	2131	1066.0	
24518	chr4	39931276	39932050	774	387.0	
24519	chr4	39932698	39934163	1465	732.0	
24520	chr4	39937925	39938251	326	163.0	
24521	chr4	39946073	39947082	1009	504.0	
24522	chr4	39970647	39971114	467	234.0	
24523	chr4	39976164	39978628	2464	1232.0	
24524	chr4	40003916	40004319	403	202.0	
24525	chr4	40054330	40058632	4302	2151.0	
24526	chr4	40066941	40067096	155	78.0	
24527	chr4	40099021	40099374	353	176.0	
24528	chr4	40121396	40122018	622	311.0	
24529	chr4	40124626	40125361	735	368.0	
24530	chr4	40149627	40150495	868	434.0	
24531	chr4	40152606	40153015	409	204.0	
24532	chr4	40173471	40173973	502	251.0	
24533	chr4	40180258	40180846	588	294.0	
24534	chr4	40184000	40184404	404	202.0	
24535	chr4	40185694	40186536	842	421.0	
24536	chr4	40190735	40191705	970	485.0	
24537	chr4	40192629	40208043	15414	7707.0	
24538	chr4	40209337	40209739	402	201.0	
24539	chr4	40211381	40211847	466	233.0	
24540	chr4	40212603	40214753	2150	1075.0	
24541	chr4	40221766	40222480	714	357.0	
24542	chr4	40224859	40227770	2911	1456.0	
24543	chr4	40228416	40229603	1187	594.0	
24544	chr4	40230269	40232916	2647	1324.0	
24545	chr4	40235768	40236317	549	274.0	
24546	chr4	40237309	40239598	2289	1144.0	
24547	chr4	40240228	40240357	129	64.0	
24548	chr4	40241666	40243997	2331	1166.0	
24549	chr4	40244621	40245049	428	214.0	
24550	chr4	40245594	40247904	2310	1155.0	
24551	chr4	40254880	40255457	577	288.0	
24552	chr4	40256960	40257157	197	98.0	
24553	chr4	40258411	40259078	667	334.0	
24554	chr4	40264945	40266193	1248	624.0	
24555	chr4	40276647	40276802	155	78.0	
24556	chr4	40283462	40284702	1240	620.0	
24557	chr4	40288612	40288942	330	165.0	
24558	chr4	40289492	40290426	934	467.0	
24559	chr4	40292269	40292909	640	320.0	
24560	chr4	40297084	40297687	603	302.0	
24561	chr4	40298692	40298851	159	80.0	
24562	chr4	40301033	40302397	1364	682.0	
24563	chr4	40304969	40310168	5199	2600.0	
24564	chr4	40311651	40312558	907	454.0	
24565	chr4	40314880	40315388	508	254.0	
24566	chr4	40316111	40317793	1682	841.0	
24567	chr4	40325307	40326055	748	374.0	
24568	chr4	40327163	40327989	826	413.0	
24569	chr4	40377894	40378118	224	112.0	
24570	chr4	40427226	40427469	243	122.0	
24571	chr4	40433365	40433999	634	317.0	
24572	chr4	40454928	40455681	753	376.0	
24573	chr4	40486463	40487195	732	366.0	
24574	chr4	40491761	40492248	487	244.0	
24575	chr4	40492773	40493031	258	129.0	
24576	chr4	40502168	40503425	1257	628.0	
24577	chr4	40515299	40516187	888	444.0	
24578	chr4	40534781	40535175	394	197.0	
24579	chr4	40546966	40547600	634	317.0	
24580	chr4	40550811	40552053	1242	621.0	
24581	chr4	40553927	40555558	1631	816.0	
24582	chr4	40561755	40562721	966	483.0	
24583	chr4	40563425	40564535	1110	555.0	
24584	chr4	40572153	40572541	388	194.0	
24585	chr4	40573814	40574398	584	292.0	
24586	chr4	40575840	40578031	2191	1096.0	
24587	chr4	40586172	40588258	2086	1043.0	
24588	chr4	40600749	40602135	1386	693.0	
24589	chr4	40604518	40605521	1003	502.0	
24590	chr4	40621511	40622545	1034	517.0	
24591	chr4	40629330	40631209	1879	940.0	
24592	chr4	40648585	40649337	752	376.0	
24593	chr4	40653396	40654059	663	332.0	
24594	chr4	40656207	40656818	611	306.0	
24595	chr4	40672414	40673592	1178	589.0	
24596	chr4	40682756	40684244	1488	744.0	
24597	chr4	40697519	40697921	402	201.0	
24598	chr4	40709954	40711376	1422	711.0	
24599	chr4	40720851	40723247	2396	1198.0	
24600	chr4	40723752	40724109	357	178.0	
24601	chr4	40730086	40730671	585	292.0	
24602	chr4	40731294	40732416	1122	561.0	
24603	chr4	40736931	40737241	310	155.0	
24604	chr4	40749586	40750683	1097	548.0	
24605	chr4	40763278	40763684	406	203.0	
24606	chr4	40807037	40807927	890	445.0	
24607	chr4	40811782	40812922	1140	570.0	
24608	chr4	40829628	40830040	412	206.0	
24609	chr4	40840283	40841431	1148	574.0	
24610	chr4	40843751	40844137	386	193.0	
24611	chr4	40855522	40857478	1956	978.0	
24612	chr4	40858146	40858197	51	26.0	
24613	chr4	40887848	40887953	105	52.0	
24614	chr4	40897515	40898038	523	262.0	
24615	chr4	40908592	40909252	660	330.0	
24616	chr4	40912478	40912754	276	138.0	
24617	chr4	40916966	40917237	271	136.0	
24618	chr4	40924425	40924943	518	259.0	
24619	chr4	40927554	40928063	509	254.0	
24620	chr4	40952074	40952762	688	344.0	
24621	chr4	40990452	40991177	725	362.0	
24622	chr4	40992628	40993321	693	346.0	
24623	chr4	40998597	40999121	524	262.0	
24624	chr4	41000515	41000703	188	94.0	
24625	chr4	41212632	41212965	333	166.0	
24626	chr4	41213940	41215034	1094	547.0	
24627	chr4	41216229	41217003	774	387.0	
24628	chr4	41257156	41257747	591	296.0	
24629	chr4	41281027	41281419	392	196.0	
24630	chr4	41361814	41362124	310	155.0	
24631	chr4	41512072	41512967	895	448.0	
24632	chr4	41514700	41515405	705	352.0	
24633	chr4	41647498	41647769	271	136.0	
24634	chr4	41651144	41651535	391	196.0	
24635	chr4	41863672	41863957	285	142.0	
24636	chr4	41882758	41883219	461	230.0	
24637	chr4	41920486	41920839	353	176.0	
24638	chr4	41933834	41936082	2248	1124.0	
24639	chr4	41938953	41939447	494	247.0	
24640	chr4	41957693	41958031	338	169.0	
24641	chr4	41969694	41970032	338	169.0	
24642	chr4	41977736	41978091	355	178.0	
24643	chr4	41989688	41991437	1749	874.0	
24644	chr4	41994663	41995016	353	176.0	
24645	chr4	42150714	42152902	2188	1094.0	
24646	chr4	42282016	42282358	342	171.0	
24647	chr4	42397187	42397942	755	378.0	
24648	chr4	42519763	42520218	455	228.0	
24649	chr4	42568576	42569069	493	246.0	
24650	chr4	42570486	42570526	40	20.0	
24651	chr4	42627636	42628991	1355	678.0	
24652	chr4	42632921	42632982	61	30.0	
24653	chr4	42635884	42636648	764	382.0	
24654	chr4	42637901	42637981	80	40.0	
24655	chr4	42638889	42639375	486	243.0	
24656	chr4	42642128	42642547	419	210.0	
24657	chr4	42643618	42644152	534	267.0	
24658	chr4	42646213	42646401	188	94.0	
24659	chr4	42646926	42647424	498	249.0	
24660	chr4	42654380	42658394	4014	2007.0	
24661	chr4	42670967	42673432	2465	1232.0	
24662	chr4	42750061	42750497	436	218.0	
24663	chr4	42865581	42866017	436	218.0	
24664	chr4	43453082	43453398	316	158.0	
24665	chr4	44448800	44449224	424	212.0	
24666	chr4	44629221	44629653	432	216.0	
24667	chr4	44662638	44663010	372	186.0	
24668	chr4	44677542	44679573	2031	1016.0	
24669	chr4	44725542	44727415	1873	936.0	
24670	chr4	44760134	44760592	458	229.0	
24671	chr4	46839183	46839515	332	166.0	
24672	chr4	46844333	46844700	367	184.0	
24673	chr4	46887553	46887855	302	151.0	
24674	chr4	46931979	46932346	367	184.0	
24675	chr4	46975793	46976595	802	401.0	
24676	chr4	46993467	46993576	109	54.0	
24677	chr4	47010607	47011594	987	494.0	
24678	chr4	47031704	47033071	1367	684.0	
24679	chr4	47122453	47123125	672	336.0	
24680	chr4	47173711	47174500	789	394.0	
24681	chr4	47442950	47443512	562	281.0	
24682	chr4	47462546	47464233	1687	844.0	
24683	chr4	47465016	47465418	402	201.0	
24684	chr4	47481910	47482865	955	478.0	
24685	chr4	47484074	47484287	213	106.0	
24686	chr4	47484801	47486297	1496	748.0	
24687	chr4	47490498	47490972	474	237.0	
24688	chr4	47499727	47499991	264	132.0	
24689	chr4	47510055	47510999	944	472.0	
24690	chr4	47519508	47519939	431	216.0	
24691	chr4	47531245	47532380	1135	568.0	
24692	chr4	47564358	47564766	408	204.0	
24693	chr4	47668856	47669215	359	180.0	
24694	chr4	47686253	47686758	505	252.0	
24695	chr4	47704765	47704983	218	109.0	
24696	chr4	47741257	47741506	249	124.0	
24697	chr4	47819221	47819608	387	194.0	
24698	chr4	47835569	47835779	210	105.0	
24699	chr4	47836481	47838209	1728	864.0	
24700	chr4	47839231	47839739	508	254.0	
24701	chr4	47913370	47915543	2173	1086.0	
24702	chr4	47922944	47923693	749	374.0	
24703	chr4	47926509	47927255	746	373.0	
24704	chr4	47929879	47930016	137	68.0	
24705	chr4	47933759	47934299	540	270.0	
24706	chr4	47972186	47972587	401	200.0	
24707	chr4	48003582	48003976	394	197.0	
24708	chr4	48016131	48017724	1593	796.0	
24709	chr4	48033746	48034426	680	340.0	
24710	chr4	48036505	48037232	727	364.0	
24711	chr4	48047022	48048568	1546	773.0	
24712	chr4	48087087	48087551	464	232.0	
24713	chr4	48109592	48110082	490	245.0	
24714	chr4	48112253	48112662	409	204.0	
24715	chr4	48114266	48114720	454	227.0	
24716	chr4	48127516	48128713	1197	598.0	
24717	chr4	48129289	48130212	923	462.0	
24718	chr4	48133744	48134764	1020	510.0	
24719	chr4	48137605	48139768	2163	1082.0	
24720	chr4	48140956	48141423	467	234.0	
24721	chr4	48173680	48173763	83	42.0	
24722	chr4	48180281	48180643	362	181.0	
24723	chr4	48187932	48188148	216	108.0	
24724	chr4	48193518	48193858	340	170.0	
24725	chr4	48195278	48195717	439	220.0	
24726	chr4	48196820	48196822	2	1.0	
24727	chr4	48212117	48212661	544	272.0	
24728	chr4	48226231	48226597	366	183.0	
24729	chr4	48227521	48228036	515	258.0	
24730	chr4	48247106	48247475	369	184.0	
24731	chr4	48262851	48263422	571	286.0	
24732	chr4	48266808	48266987	179	90.0	
24733	chr4	48268880	48271351	2471	1236.0	
24734	chr4	48275221	48275686	465	232.0	
24735	chr4	48290381	48290768	387	194.0	
24736	chr4	48296310	48296692	382	191.0	
24737	chr4	48315971	48316439	468	234.0	
24738	chr4	48331576	48332049	473	236.0	
24739	chr4	48340282	48343306	3024	1512.0	
24740	chr4	48380715	48381146	431	216.0	
24741	chr4	48483094	48484560	1466	733.0	
24742	chr4	48490032	48491605	1573	786.0	
24743	chr4	48578116	48578994	878	439.0	
24744	chr4	48635678	48635731	53	26.0	
24745	chr4	48674877	48675276	399	200.0	
24746	chr4	48681867	48682199	332	166.0	
24747	chr4	48684217	48684673	456	228.0	
24748	chr4	48698264	48698646	382	191.0	
24749	chr4	48699938	48700308	370	185.0	
24750	chr4	48728778	48729777	999	500.0	
24751	chr4	48746585	48746948	363	182.0	
24752	chr4	48752477	48752847	370	185.0	
24753	chr4	48773334	48774024	690	345.0	
24754	chr4	48778475	48782217	3742	1871.0	
24755	chr4	48830354	48832040	1686	843.0	
24756	chr4	48899152	48899549	397	198.0	
24757	chr4	48906023	48907440	1417	708.0	
24758	chr4	48944734	48945259	525	262.0	
24759	chr4	48962981	48963501	520	260.0	
24760	chr4	49092696	49092980	284	142.0	
24761	chr4	49098656	49099200	544	272.0	
24762	chr4	49100056	49100313	257	128.0	
24763	chr4	49102444	49102550	106	53.0	
24764	chr4	49103175	49103622	447	224.0	
24765	chr4	49105152	49105950	798	399.0	
24766	chr4	49107288	49108823	1535	768.0	
24767	chr4	49110676	49110840	164	82.0	
24768	chr4	49118711	49121340	2629	1314.0	
24769	chr4	49148979	49150972	1993	996.0	
24770	chr4	49153278	49153680	402	201.0	
24771	chr4	49154331	49154759	428	214.0	
24772	chr4	49219593	49219671	78	39.0	
24773	chr4	49632513	49632739	226	113.0	
24774	chr4	49637145	49637511	366	183.0	
24775	chr4	49638204	49638355	151	76.0	
24776	chr4	49641964	49641965	1	0.0	
24777	chr4	49657277	49657914	637	318.0	
24778	chr4	51831091	51831568	477	238.0	
24779	chr4	51836552	51836902	350	175.0	
24780	chr4	51841996	51845427	3431	1716.0	
24781	chr4	51851582	51851613	31	16.0	
24782	chr4	51885385	51885742	357	178.0	
24783	chr4	51895742	51896247	505	252.0	
24784	chr4	51900746	51901440	694	347.0	
24785	chr4	51905846	51906984	1138	569.0	
24786	chr4	52014884	52015353	469	234.0	
24787	chr4	52025782	52026499	717	358.0	
24788	chr4	52037631	52038872	1241	620.0	
24789	chr4	52051051	52052848	1797	898.0	
24790	chr4	52057226	52057574	348	174.0	
24791	chr4	52059495	52059614	119	60.0	
24792	chr4	52545407	52545836	429	214.0	
24793	chr4	52588404	52589309	905	452.0	
24794	chr4	52638695	52639123	428	214.0	
24795	chr4	52657837	52660448	2611	1306.0	
24796	chr4	52665625	52665980	355	178.0	
24797	chr4	52711037	52713825	2788	1394.0	
24798	chr4	52721697	52722974	1277	638.0	
24799	chr4	52750944	52751546	602	301.0	
24800	chr4	52843798	52844476	678	339.0	
24801	chr4	52861468	52862916	1448	724.0	
24802	chr4	52911663	52912085	422	211.0	
24803	chr4	52983600	52983944	344	172.0	
24804	chr4	53012887	53013156	269	134.0	
24805	chr4	53039844	53039976	132	66.0	
24806	chr4	53197192	53197578	386	193.0	enhancer
24807	chr4	53364899	53366771	1872	936.0	
24808	chr4	53376924	53378502	1578	789.0	
24809	chr4	53474600	53474912	312	156.0	
24810	chr4	53558605	53558839	234	117.0	
24811	chr4	53676342	53676838	496	248.0	
24812	chr4	53702520	53703168	648	324.0	
24813	chr4	53734980	53735363	383	192.0	
24814	chr4	53748216	53748798	582	291.0	
24815	chr4	53855185	53855931	746	373.0	
24816	chr4	53906076	53906325	249	124.0	
24817	chr4	53908572	53909149	577	288.0	
24818	chr4	53914110	53915113	1003	502.0	
24819	chr4	53919433	53920495	1062	531.0	
24820	chr4	53928861	53929140	279	140.0	
24821	chr4	53929879	53930431	552	276.0	
24822	chr4	53994329	53994816	487	244.0	
24823	chr4	54005517	54005855	338	169.0	
24824	chr4	54032516	54033010	494	247.0	
24825	chr4	54041112	54041458	346	173.0	
24826	chr4	54056387	54057350	963	482.0	
24827	chr4	54058088	54058663	575	288.0	
24828	chr4	54060254	54060559	305	152.0	
24829	chr4	54061525	54061885	360	180.0	
24830	chr4	54062570	54066276	3706	1853.0	
24831	chr4	54091097	54092585	1488	744.0	
24832	chr4	54093847	54094168	321	160.0	
24833	chr4	54098809	54101459	2650	1325.0	
24834	chr4	54103106	54104200	1094	547.0	
24835	chr4	54108320	54108472	152	76.0	
24836	chr4	54217572	54218248	676	338.0	
24837	chr4	54226030	54228487	2457	1228.0	
24838	chr4	54232754	54234882	2128	1064.0	
24839	chr4	54315519	54316012	493	246.0	
24840	chr4	54318856	54319427	571	286.0	
24841	chr4	54322803	54323243	440	220.0	
24842	chr4	54439692	54440423	731	366.0	
24843	chr4	54657308	54659542	2234	1117.0	
24844	chr4	54663110	54663635	525	262.0	
24845	chr4	54683581	54684421	840	420.0	
24846	chr4	54687868	54688789	921	460.0	
24847	chr4	54708926	54710139	1213	606.0	
24848	chr4	54742652	54743056	404	202.0	
24849	chr4	54941062	54943250	2188	1094.0	
24850	chr4	54945850	54946251	401	200.0	
24851	chr4	54958155	54958566	411	206.0	
24852	chr4	54961405	54961769	364	182.0	
24853	chr4	54971399	54971732	333	166.0	
24854	chr4	55311789	55312911	1122	561.0	
24855	chr4	55321761	55322040	279	140.0	
24856	chr4	55330128	55330817	689	344.0	
24857	chr4	55345652	55347289	1637	818.0	
24858	chr4	55358655	55359137	482	241.0	
24859	chr4	55362019	55362241	222	111.0	
24860	chr4	55386055	55386440	385	192.0	
24861	chr4	55395099	55399617	4518	2259.0	
24862	chr4	55409411	55409967	556	278.0	
24863	chr4	55435049	55435619	570	285.0	
24864	chr4	55447144	55447443	299	150.0	
24865	chr4	55539156	55539375	219	110.0	
24866	chr4	55543825	55547723	3898	1949.0	
24867	chr4	55551883	55552352	469	234.0	
24868	chr4	55553297	55554846	1549	774.0	
24869	chr4	55561902	55562330	428	214.0	
24870	chr4	55578382	55578756	374	187.0	
24871	chr4	55636011	55636472	461	230.0	
24872	chr4	55851818	55852345	527	264.0	
24873	chr4	55852987	55854563	1576	788.0	
24874	chr4	55866302	55867434	1132	566.0	
24875	chr4	55946972	55950212	3240	1620.0	
24876	chr4	56048654	56049783	1129	564.0	
24877	chr4	56301427	56301889	462	231.0	
24878	chr4	56386685	56388678	1993	996.0	
24879	chr4	56424860	56425327	467	234.0	
24880	chr4	56434666	56438050	3384	1692.0	
24881	chr4	56466190	56468627	2437	1218.0	
24882	chr4	56505047	56506536	1489	744.0	
24883	chr4	56529903	56531636	1733	866.0	
24884	chr4	56544290	56545242	952	476.0	
24885	chr4	56575878	56576222	344	172.0	
24886	chr4	56648266	56648728	462	231.0	
24887	chr4	56649909	56650447	538	269.0	
24888	chr4	56653401	56656991	3590	1795.0	
24889	chr4	56681215	56681838	623	312.0	
24890	chr4	56723444	56723679	235	118.0	
24891	chr4	56728627	56728943	316	158.0	
24892	chr4	56731839	56732324	485	242.0	
24893	chr4	56757305	56758819	1514	757.0	
24894	chr4	56764140	56764621	481	240.0	
24895	chr4	56782849	56783155	306	153.0	
24896	chr4	56799639	56800599	960	480.0	
24897	chr4	56803380	56803941	561	280.0	
24898	chr4	56806677	56807064	387	194.0	
24899	chr4	56817726	56818305	579	290.0	
24900	chr4	56821173	56822324	1151	576.0	
24901	chr4	56836404	56837077	673	336.0	
24902	chr4	56871594	56871787	193	96.0	
24903	chr4	56906434	56910017	3583	1792.0	
24904	chr4	56958026	56958737	711	356.0	
24905	chr4	56960255	56960651	396	198.0	
24906	chr4	56976167	56980130	3963	1982.0	
24907	chr4	57038050	57038359	309	154.0	
24908	chr4	57050925	57051874	949	474.0	
24909	chr4	57071298	57071706	408	204.0	
24910	chr4	57090162	57090448	286	143.0	
24911	chr4	57109420	57111527	2107	1054.0	
24912	chr4	57112360	57112901	541	270.0	
24913	chr4	57163442	57164484	1042	521.0	
24914	chr4	59704723	59704962	239	120.0	
24915	chr4	59818920	59818933	13	6.0	
24916	chr4	66943105	66943547	442	221.0	
24917	chr4	66949342	66949886	544	272.0	
24918	chr4	67327259	67327650	391	196.0	
24919	chr4	67398369	67401251	2882	1441.0	
24920	chr4	67437947	67438253	306	153.0	
24921	chr4	67520391	67520484	93	46.0	
24922	chr4	67521621	67521880	259	130.0	
24923	chr4	67523164	67523703	539	270.0	
24924	chr4	67524217	67524622	405	202.0	
24925	chr4	67527364	67527737	373	186.0	
24926	chr4	67541858	67543214	1356	678.0	
24927	chr4	67543997	67546379	2382	1191.0	
24928	chr4	67549113	67549574	461	230.0	
24929	chr4	67558358	67559045	687	344.0	
24930	chr4	67575225	67575910	685	342.0	
24931	chr4	67581206	67581923	717	358.0	
24932	chr4	67632470	67632871	401	200.0	
24933	chr4	67699785	67701939	2154	1077.0	
24934	chr4	67746719	67747126	407	204.0	
24935	chr4	67871966	67871986	20	10.0	
24936	chr4	67886341	67886439	98	49.0	
24937	chr4	68271763	68272409	646	323.0	
24938	chr4	68319048	68319357	309	154.0	
24939	chr4	68341655	68342379	724	362.0	
24940	chr4	68344164	68344952	788	394.0	
24941	chr4	68346034	68347572	1538	769.0	
24942	chr4	68348578	68350770	2192	1096.0	
24943	chr4	68359359	68359882	523	262.0	
24944	chr4	68373425	68374067	642	321.0	
24945	chr4	68375735	68376636	901	450.0	
24946	chr4	68439369	68439740	371	186.0	
24947	chr4	68498370	68498830	460	230.0	
24948	chr4	68504926	68505232	306	153.0	
24949	chr4	69661079	69661554	475	238.0	
24950	chr4	69689525	69689925	400	200.0	
24951	chr4	69713497	69714112	615	308.0	
24952	chr4	69718417	69718785	368	184.0	
24953	chr4	69749804	69750078	274	137.0	
24954	chr4	69751086	69751584	498	249.0	
24955	chr4	69758024	69758367	343	172.0	
24956	chr4	69759360	69759552	192	96.0	
24957	chr4	69760269	69761147	878	439.0	
24958	chr4	69823297	69823978	681	340.0	
24959	chr4	69831450	69832891	1441	720.0	
24960	chr4	69881130	69881581	451	226.0	
24961	chr4	70505149	70505533	384	192.0	
24962	chr4	70559250	70559590	340	170.0	
24963	chr4	70601341	70601875	534	267.0	
24964	chr4	70614394	70614559	165	82.0	
24965	chr4	70617934	70618138	204	102.0	
24966	chr4	70618976	70619964	988	494.0	
24967	chr4	70623413	70624638	1225	612.0	
24968	chr4	70652069	70652566	497	248.0	
24969	chr4	70687344	70689621	2277	1138.0	
24970	chr4	70691295	70692129	834	417.0	
24971	chr4	70703602	70706714	3112	1556.0	
24972	chr4	70713031	70714419	1388	694.0	
24973	chr4	70715037	70716050	1013	506.0	
24974	chr4	70722378	70722725	347	174.0	
24975	chr4	70734116	70736336	2220	1110.0	
24976	chr4	70736998	70737747	749	374.0	
24977	chr4	70739482	70739922	440	220.0	
24978	chr4	70754464	70754904	440	220.0	
24979	chr4	70759630	70759908	278	139.0	
24980	chr4	70773138	70773306	168	84.0	
24981	chr4	70838415	70841239	2824	1412.0	
24982	chr4	70841980	70842231	251	126.0	
24983	chr4	70844190	70844469	279	140.0	
24984	chr4	70846471	70846994	523	262.0	
24985	chr4	70849316	70849677	361	180.0	
24986	chr4	70874811	70875164	353	176.0	
24987	chr4	70891977	70892893	916	458.0	
24988	chr4	70895875	70895924	49	24.0	
24989	chr4	70901639	70903597	1958	979.0	
24990	chr4	70926249	70926310	61	30.0	
24991	chr4	70927384	70928091	707	354.0	
24992	chr4	70943020	70943526	506	253.0	
24993	chr4	70944817	70945522	705	352.0	
24994	chr4	70946661	70947430	769	384.0	
24995	chr4	70948565	70949226	661	330.0	
24996	chr4	70954334	70954735	401	200.0	
24997	chr4	70979626	70980064	438	219.0	
24998	chr4	70984616	70984984	368	184.0	
24999	chr4	70992531	70997877	5346	2673.0	
25000	chr4	71004043	71005411	1368	684.0	
25001	chr4	71006019	71006901	882	441.0	
25002	chr4	71009588	71010425	837	418.0	
25003	chr4	71095533	71096003	470	235.0	
25004	chr4	71107567	71108257	690	345.0	
25005	chr4	71111123	71111514	391	196.0	
25006	chr4	71184098	71184651	553	276.0	
25007	chr4	71186162	71188697	2535	1268.0	
25008	chr4	71198964	71199373	409	204.0	
25009	chr4	71243091	71243448	357	178.0	
25010	chr4	71259902	71260503	601	300.0	
25011	chr4	71270871	71271251	380	190.0	
25012	chr4	71275570	71275956	386	193.0	
25013	chr4	71338895	71339296	401	200.0	
25014	chr4	71713675	71713954	279	140.0	
25015	chr4	71978169	71978674	505	252.0	
25016	chr4	72303065	72303495	430	215.0	
25017	chr4	72569132	72569391	259	130.0	
25018	chr4	72702287	72702349	62	31.0	
25019	chr4	73038869	73039174	305	152.0	
25020	chr4	73066893	73070490	3597	1798.0	
25021	chr4	73086115	73086865	750	375.0	
25022	chr4	73127859	73128221	362	181.0	
25023	chr4	73181166	73181621	455	228.0	
25024	chr4	73193193	73193572	379	190.0	
25025	chr4	73222470	73223422	952	476.0	
25026	chr4	73224966	73225231	265	132.0	
25027	chr4	73251443	73251560	117	58.0	
25028	chr4	73256890	73260293	3403	1702.0	
25029	chr4	73315148	73315460	312	156.0	
25030	chr4	73446392	73446395	3	2.0	
25031	chr4	73620355	73620645	290	145.0	
25032	chr4	73653596	73654040	444	222.0	
25033	chr4	73662664	73663104	440	220.0	
25034	chr4	73704403	73705226	823	412.0	
25035	chr4	73707907	73708298	391	196.0	
25036	chr4	73709360	73709919	559	280.0	
25037	chr4	73718518	73719260	742	371.0	
25038	chr4	73721548	73721796	248	124.0	
25039	chr4	73729528	73729965	437	218.0	
25040	chr4	73730813	73732684	1871	936.0	
25041	chr4	73735091	73735732	641	320.0	
25042	chr4	73740231	73741341	1110	555.0	
25043	chr4	73760629	73761075	446	223.0	
25044	chr4	73762346	73762868	522	261.0	
25045	chr4	73815121	73815475	354	177.0	
25046	chr4	73823109	73823427	318	159.0	
25047	chr4	73836370	73837367	997	498.0	
25048	chr4	73844351	73845032	681	340.0	
25049	chr4	73847489	73847898	409	204.0	
25050	chr4	73865583	73865793	210	105.0	
25051	chr4	73868973	73870692	1719	860.0	
25052	chr4	73872704	73873344	640	320.0	
25053	chr4	73874300	73874918	618	309.0	
25054	chr4	74018736	74019279	543	272.0	
25055	chr4	74033896	74034041	145	72.0	
25056	chr4	74038354	74039457	1103	552.0	
25057	chr4	74043801	74044439	638	319.0	
25058	chr4	74056452	74057288	836	418.0	
25059	chr4	74078962	74079465	503	252.0	
25060	chr4	74083324	74083913	589	294.0	
25061	chr4	74085087	74085281	194	97.0	
25062	chr4	74097740	74099979	2239	1120.0	
25063	chr4	74108776	74109863	1087	544.0	
25064	chr4	74134180	74134646	466	233.0	
25065	chr4	74157290	74159098	1808	904.0	
25066	chr4	74166489	74166498	9	4.0	
25067	chr4	74189228	74189725	497	248.0	
25068	chr4	74206213	74207010	797	398.0	
25069	chr4	74223736	74224254	518	259.0	
25070	chr4	74228644	74229131	487	244.0	
25071	chr4	74230723	74231600	877	438.0	
25072	chr4	74235337	74235440	103	52.0	
25073	chr4	74311729	74312052	323	162.0	
25074	chr4	74320383	74321077	694	347.0	
25075	chr4	74335582	74336075	493	246.0	
25076	chr4	74338760	74339379	619	310.0	
25077	chr4	74364300	74365926	1626	813.0	
25078	chr4	74366532	74367134	602	301.0	
25079	chr4	74369880	74370199	319	160.0	
25080	chr4	74370791	74371269	478	239.0	
25081	chr4	74374291	74375011	720	360.0	
25082	chr4	74376847	74377318	471	236.0	
25083	chr4	74397740	74399353	1613	806.0	
25084	chr4	74403083	74403405	322	161.0	
25085	chr4	74531861	74532276	415	208.0	
25086	chr4	74543060	74543743	683	342.0	
25087	chr4	74546054	74546416	362	181.0	
25088	chr4	74444743	74444901	158	79.0	
25089	chr4	74623054	74623456	402	201.0	
25090	chr4	74624690	74625221	531	266.0	
25091	chr4	74628728	74629300	572	286.0	
25092	chr4	74632566	74633066	500	250.0	
25093	chr4	74659670	74660216	546	273.0	
25094	chr4	74671069	74671517	448	224.0	
25095	chr4	74675674	74676080	406	203.0	
25096	chr4	74873635	74873830	195	98.0	
25097	chr4	74874741	74875167	426	213.0	
25098	chr4	74930198	74930566	368	184.0	
25099	chr4	74932733	74934246	1513	756.0	
25100	chr4	75030553	75031173	620	310.0	
25101	chr4	75035986	75036514	528	264.0	
25102	chr4	75099407	75099668	261	130.0	
25103	chr4	75494478	75495822	1344	672.0	
25104	chr4	75511732	75515725	3993	1996.0	
25105	chr4	75573285	75574089	804	402.0	
25106	chr4	75598473	75598664	191	96.0	
25107	chr4	75629830	75631283	1453	726.0	
25108	chr4	75633830	75634283	453	226.0	
25109	chr4	75638944	75639677	733	366.0	
25110	chr4	75641145	75641188	43	22.0	
25111	chr4	75644658	75644664	6	3.0	
25112	chr4	75652374	75652684	310	155.0	
25113	chr4	75653835	75656229	2394	1197.0	
25114	chr4	75657821	75658138	317	158.0	
25115	chr4	75664513	75665372	859	430.0	
25116	chr4	75666899	75670172	3273	1636.0	
25117	chr4	75670957	75674332	3375	1688.0	
25118	chr4	75682869	75683358	489	244.0	
25119	chr4	75686187	75686896	709	354.0	
25120	chr4	75695758	75696596	838	419.0	
25121	chr4	75698049	75699451	1402	701.0	
25122	chr4	75708144	75708798	654	327.0	
25123	chr4	75723338	75725696	2358	1179.0	
25124	chr4	75727083	75727314	231	116.0	
25125	chr4	75745187	75745590	403	202.0	
25126	chr4	75832021	75832381	360	180.0	
25127	chr4	75848180	75848746	566	283.0	
25128	chr4	75895664	75896163	499	250.0	
25129	chr4	75901194	75902074	880	440.0	
25130	chr4	75907918	75908947	1029	514.0	
25131	chr4	75915933	75916393	460	230.0	
25132	chr4	75939469	75941577	2108	1054.0	
25133	chr4	75942816	75943314	498	249.0	
25134	chr4	75977849	75978173	324	162.0	
25135	chr4	75989883	75991503	1620	810.0	
25136	chr4	75995556	75996209	653	326.0	
25137	chr4	76001773	76002600	827	414.0	
25138	chr4	76011713	76012528	815	408.0	
25139	chr4	76023311	76023927	616	308.0	
25140	chr4	76028183	76028948	765	382.0	
25141	chr4	76035099	76035511	412	206.0	
25142	chr4	76055081	76055290	209	104.0	
25143	chr4	76059705	76060909	1204	602.0	
25144	chr4	76061913	76062424	511	256.0	
25145	chr4	76067600	76068111	511	256.0	
25146	chr4	76087209	76087500	291	146.0	
25147	chr4	76090029	76090797	768	384.0	
25148	chr4	76147529	76149249	1720	860.0	
25149	chr4	76179737	76180359	622	311.0	
25150	chr4	76194358	76194862	504	252.0	
25151	chr4	76197896	76201103	3207	1604.0	
25152	chr4	76208314	76208921	607	304.0	
25153	chr4	76209658	76210985	1327	664.0	
25154	chr4	76212172	76214848	2676	1338.0	
25155	chr4	76216530	76216914	384	192.0	
25156	chr4	76219054	76219727	673	336.0	
25157	chr4	76251315	76252115	800	400.0	
25158	chr4	76276905	76277093	188	94.0	
25159	chr4	76299949	76300392	443	222.0	
25160	chr4	76301356	76301794	438	219.0	
25161	chr4	76302984	76303121	137	68.0	
25162	chr4	76304828	76307495	2667	1334.0	
25163	chr4	76354507	76354943	436	218.0	
25164	chr4	76377978	76378423	445	222.0	
25165	chr4	76381973	76382639	666	333.0	
25166	chr4	76386831	76387332	501	250.0	
25167	chr4	76420953	76421389	436	218.0	
25168	chr4	76449361	76449580	219	110.0	
25169	chr4	76516021	76516869	848	424.0	
25170	chr4	76704637	76704857	220	110.0	
25171	chr4	76897021	76898555	1534	767.0	
25172	chr4	76948407	76951406	2999	1500.0	
25173	chr4	76982430	76983223	793	396.0	
25174	chr4	76984143	76984715	572	286.0	
25175	chr4	76989217	76990505	1288	644.0	
25176	chr4	76993933	76994726	793	396.0	
25177	chr4	77002003	77002157	154	77.0	
25178	chr4	77007197	77008189	992	496.0	
25179	chr4	77014425	77014531	106	53.0	
25180	chr4	77031565	77031971	406	203.0	
25181	chr4	77040837	77041585	748	374.0	
25182	chr4	77044479	77044960	481	240.0	
25183	chr4	77052224	77052716	492	246.0	
25184	chr4	77067558	77067756	198	99.0	
25185	chr4	77069478	77070368	890	445.0	
25186	chr4	77072150	77077705	5555	2778.0	
25187	chr4	77080727	77081257	530	265.0	
25188	chr4	77092856	77093369	513	256.0	
25189	chr4	77095104	77095866	762	381.0	
25190	chr4	77126687	77127611	924	462.0	
25191	chr4	77137386	77137855	469	234.0	
25192	chr4	77142317	77142610	293	146.0	
25193	chr4	77145776	77146829	1053	526.0	
25194	chr4	77148120	77148445	325	162.0	
25195	chr4	77152912	77153420	508	254.0	
25196	chr4	77155066	77155382	316	158.0	
25197	chr4	77156262	77159041	2779	1390.0	
25198	chr4	77193255	77194373	1118	559.0	
25199	chr4	77196767	77197255	488	244.0	
25200	chr4	77203384	77204077	693	346.0	
25201	chr4	77240593	77240850	257	128.0	
25202	chr4	77385371	77385757	386	193.0	
25203	chr4	77433340	77433739	399	200.0	
25204	chr4	77586735	77587497	762	381.0	
25205	chr4	77618587	77619055	468	234.0	
25206	chr4	77711514	77711618	104	52.0	
25207	chr4	77734830	77735556	726	363.0	
25208	chr4	77765013	77765089	76	38.0	
25209	chr4	77777090	77777462	372	186.0	
25210	chr4	77782499	77782893	394	197.0	
25211	chr4	77785855	77786430	575	288.0	
25212	chr4	77793094	77793764	670	335.0	
25213	chr4	77795409	77795771	362	181.0	
25214	chr4	77798702	77799807	1105	552.0	
25215	chr4	77800773	77801706	933	466.0	
25216	chr4	77804782	77805183	401	200.0	
25217	chr4	77805811	77806349	538	269.0	
25218	chr4	77807266	77807780	514	257.0	
25219	chr4	77808292	77808384	92	46.0	
25220	chr4	77811827	77812246	419	210.0	
25221	chr4	77815229	77816009	780	390.0	
25222	chr4	77817419	77823018	5599	2800.0	
25223	chr4	77827204	77827958	754	377.0	
25224	chr4	77852694	77855338	2644	1322.0	
25225	chr4	77856863	77857211	348	174.0	
25226	chr4	77861358	77864065	2707	1354.0	
25227	chr4	77911983	77912476	493	246.0	
25228	chr4	78056471	78058265	1794	897.0	
25229	chr4	78058930	78059918	988	494.0	
25230	chr4	78551725	78551839	114	57.0	
25231	chr4	78581560	78582015	455	228.0	
25232	chr4	78612355	78612830	475	238.0	
25233	chr4	78624124	78624403	279	140.0	
25234	chr4	78629259	78631008	1749	874.0	
25235	chr4	78638678	78639030	352	176.0	
25236	chr4	78643104	78643410	306	153.0	
25237	chr4	78644655	78646473	1818	909.0	
25238	chr4	78650150	78650642	492	246.0	
25239	chr4	78654835	78655024	189	94.0	
25240	chr4	78656825	78658890	2065	1032.0	
25241	chr4	78661751	78662610	859	430.0	
25242	chr4	78666723	78667413	690	345.0	
25243	chr4	78673543	78673600	57	28.0	
25244	chr4	78692049	78692285	236	118.0	
25245	chr4	78721026	78721757	731	366.0	
25246	chr4	78749483	78750770	1287	644.0	
25247	chr4	78766835	78766884	49	24.0	
25248	chr4	78774396	78777911	3515	1758.0	
25249	chr4	78781993	78782394	401	200.0	
25250	chr4	78845356	78845981	625	312.0	
25251	chr4	78864380	78864825	445	222.0	
25252	chr4	78891053	78891435	382	191.0	
25253	chr4	78938083	78940142	2059	1030.0	
25254	chr4	78942337	78943175	838	419.0	
25255	chr4	78951840	78952301	461	230.0	
25256	chr4	79578621	79578958	337	168.0	
25257	chr4	79603733	79604054	321	160.0	
25258	chr4	79907042	79907189	147	74.0	
25259	chr4	79917142	79917576	434	217.0	
25260	chr4	79923341	79923623	282	141.0	
25261	chr4	80005970	80006268	298	149.0	
25262	chr4	80006811	80007399	588	294.0	
25263	chr4	80017118	80017962	844	422.0	
25264	chr4	80035310	80035726	416	208.0	
25265	chr4	80036854	80037334	480	240.0	
25266	chr4	80058132	80059999	1867	934.0	
25267	chr4	80070118	80070511	393	196.0	
25268	chr4	80071449	80074065	2616	1308.0	
25269	chr4	80076350	80077006	656	328.0	
25270	chr4	80077644	80078049	405	202.0	
25271	chr4	80079254	80079950	696	348.0	
25272	chr4	80103806	80103965	159	80.0	
25273	chr4	80125190	80126431	1241	620.0	
25274	chr4	80127239	80127829	590	295.0	
25275	chr4	80138885	80140592	1707	854.0	
25276	chr4	80142293	80142826	533	266.0	
25277	chr4	80144705	80145060	355	178.0	
25278	chr4	80171996	80174165	2169	1084.0	
25279	chr4	80181289	80186310	5021	2510.0	
25280	chr4	80195741	80198355	2614	1307.0	
25281	chr4	80201568	80203922	2354	1177.0	
25282	chr4	80207901	80208191	290	145.0	
25283	chr4	80215414	80215898	484	242.0	
25284	chr4	80216458	80216814	356	178.0	
25285	chr4	80266352	80267134	782	391.0	
25286	chr4	80335363	80336407	1044	522.0	
25287	chr4	80360087	80360347	260	130.0	
25288	chr4	80362602	80362990	388	194.0	
25289	chr4	80365868	80366352	484	242.0	
25290	chr4	80422913	80423439	526	263.0	
25291	chr4	80439624	80440172	548	274.0	
25292	chr4	80462572	80463185	613	306.0	
25293	chr4	80492605	80493417	812	406.0	
25294	chr4	80500473	80501151	678	339.0	
25295	chr4	80875556	80876023	467	234.0	
25296	chr4	80989884	80990363	479	240.0	
25297	chr4	81003607	81003915	308	154.0	
25298	chr4	81040034	81040427	393	196.0	
25299	chr4	81052241	81052850	609	304.0	
25300	chr4	81069670	81070164	494	247.0	
25301	chr4	81153759	81154302	543	272.0	
25302	chr4	81351665	81352047	382	191.0	
25303	chr4	81389182	81389223	41	20.0	
25304	chr4	81393648	81393705	57	28.0	
25305	chr4	81405730	81406454	724	362.0	
25306	chr4	81413358	81413418	60	30.0	
25307	chr4	81421175	81422166	991	496.0	
25308	chr4	81438422	81438940	518	259.0	
25309	chr4	81445941	81451286	5345	2672.0	
25310	chr4	81451837	81457484	5647	2824.0	
25311	chr4	81457990	81458317	327	164.0	
25312	chr4	81458945	81468080	9135	4568.0	
25313	chr4	81468700	81473710	5010	2505.0	
25314	chr4	81482021	81482782	761	380.0	
25315	chr4	81489225	81489322	97	48.0	
25316	chr4	81490411	81492763	2352	1176.0	
25317	chr4	81493700	81494664	964	482.0	
25318	chr4	81495750	81495808	58	29.0	
25319	chr4	81504352	81507016	2664	1332.0	
25320	chr4	81508721	81510223	1502	751.0	
25321	chr4	81512846	81513675	829	414.0	
25322	chr4	81561843	81562831	988	494.0	
25323	chr4	81565467	81565635	168	84.0	
25324	chr4	81605228	81605732	504	252.0	
25325	chr4	81606651	81607501	850	425.0	
25326	chr4	81631931	81631996	65	32.0	
25327	chr4	81635616	81636165	549	274.0	
25328	chr4	81648836	81649397	561	280.0	
25329	chr4	81725000	81725473	473	236.0	
25330	chr4	81740467	81740974	507	254.0	
25331	chr4	81747142	81747743	601	300.0	
25332	chr4	81796843	81797259	416	208.0	
25333	chr4	81814949	81815363	414	207.0	
25334	chr4	81844619	81845323	704	352.0	
25335	chr4	81913334	81913777	443	222.0	
25336	chr4	82038959	82039352	393	196.0	
25337	chr4	82044076	82045058	982	491.0	
25338	chr4	82136476	82136746	270	135.0	
25339	chr4	82201975	82202440	465	232.0	
25340	chr4	82213414	82213958	544	272.0	
25341	chr4	82216163	82216692	529	264.0	
25342	chr4	82223646	82224248	602	301.0	
25343	chr4	82230015	82230750	735	368.0	
25344	chr4	82267879	82269021	1142	571.0	
25345	chr4	82275825	82276108	283	142.0	
25346	chr4	82284170	82285948	1778	889.0	
25347	chr4	82293271	82293759	488	244.0	
25348	chr4	82358873	82359548	675	338.0	
25349	chr4	82360463	82361207	744	372.0	
25350	chr4	82362539	82362882	343	172.0	
25351	chr4	82365612	82365789	177	88.0	
25352	chr4	82367416	82368083	667	334.0	
25353	chr4	82371356	82375541	4185	2092.0	
25354	chr4	82376188	82376517	329	164.0	
25355	chr4	82416052	82416528	476	238.0	
25356	chr4	82421795	82422382	587	294.0	
25357	chr4	82426682	82427233	551	276.0	
25358	chr4	82427740	82431778	4038	2019.0	
25359	chr4	82462303	82462876	573	286.0	
25360	chr4	82652027	82652427	400	200.0	
25361	chr4	82739251	82739776	525	262.0	
25362	chr4	82797566	82799934	2368	1184.0	
25363	chr4	82802950	82803285	335	168.0	
25364	chr4	82852225	82852659	434	217.0	
25365	chr4	82865521	82866088	567	284.0	
25366	chr4	82889762	82893340	3578	1789.0	
25367	chr4	82894043	82894168	125	62.0	
25368	chr4	82898215	82901812	3597	1798.0	
25369	chr4	82903698	82904223	525	262.0	
25370	chr4	82905182	82905767	585	292.0	
25371	chr4	82989313	82990326	1013	506.0	
25372	chr4	82992794	82993258	464	232.0	
25373	chr4	83007589	83007833	244	122.0	
25374	chr4	83009703	83014180	4477	2238.0	
25375	chr4	83022747	83023460	713	356.0	
25376	chr4	83033643	83036014	2371	1186.0	
25377	chr4	83055000	83055324	324	162.0	
25378	chr4	83073743	83074715	972	486.0	
25379	chr4	83075795	83075866	71	36.0	
25380	chr4	83082748	83084679	1931	966.0	
25381	chr4	83107537	83113820	6283	3142.0	
25382	chr4	83114451	83115433	982	491.0	
25383	chr4	83123991	83124776	785	392.0	
25384	chr4	83125537	83126409	872	436.0	
25385	chr4	83128227	83129025	798	399.0	
25386	chr4	83138914	83139477	563	282.0	
25387	chr4	83145733	83146196	463	232.0	
25388	chr4	83150151	83150944	793	396.0	
25389	chr4	83171686	83171780	94	47.0	
25390	chr4	83172440	83172750	310	155.0	
25391	chr4	83174772	83175544	772	386.0	
25392	chr4	83180207	83180816	609	304.0	
25393	chr4	83194484	83194895	411	206.0	
25394	chr4	83197541	83198749	1208	604.0	
25395	chr4	83211919	83213352	1433	716.0	
25396	chr4	83216680	83220154	3474	1737.0	
25397	chr4	83222072	83222226	154	77.0	
25398	chr4	83230903	83232207	1304	652.0	
25399	chr4	83235317	83236207	890	445.0	
25400	chr4	83240270	83241020	750	375.0	
25401	chr4	83252395	83253279	884	442.0	
25402	chr4	83256336	83257019	683	342.0	
25403	chr4	83260295	83261171	876	438.0	
25404	chr4	83272841	83273288	447	224.0	
25405	chr4	83276424	83276712	288	144.0	
25406	chr4	83281277	83282491	1214	607.0	
25407	chr4	83283862	83285694	1832	916.0	
25408	chr4	83316359	83317232	873	436.0	
25409	chr4	83320249	83321157	908	454.0	
25410	chr4	83322214	83322957	743	372.0	
25411	chr4	83326535	83327017	482	241.0	
25412	chr4	83328469	83329076	607	304.0	
25413	chr4	83329780	83330181	401	200.0	
25414	chr4	83334010	83336288	2278	1139.0	
25415	chr4	83340833	83341433	600	300.0	
25416	chr4	83349969	83350644	675	338.0	
25417	chr4	83362507	83362866	359	180.0	
25418	chr4	83369764	83370886	1122	561.0	
25419	chr4	83382801	83383263	462	231.0	
25420	chr4	83388224	83388675	451	226.0	
25421	chr4	83454313	83456692	2379	1190.0	
25422	chr4	83484260	83485879	1619	810.0	
25423	chr4	83490847	83491290	443	222.0	
25424	chr4	83503976	83504372	396	198.0	
25425	chr4	83505068	83505104	36	18.0	
25426	chr4	83508847	83509669	822	411.0	
25427	chr4	83535259	83537093	1834	917.0	
25428	chr4	83546882	83547063	181	90.0	
25429	chr4	83548239	83548931	692	346.0	
25430	chr4	83552917	83553334	417	208.0	
25431	chr4	83556222	83556932	710	355.0	
25432	chr4	83558594	83559100	506	253.0	
25433	chr4	83561315	83561833	518	259.0	
25434	chr4	83568166	83568425	259	130.0	
25435	chr4	83569690	83570721	1031	516.0	
25436	chr4	83581627	83582656	1029	514.0	
25437	chr4	83599118	83599635	517	258.0	
25438	chr4	83604263	83604781	518	259.0	
25439	chr4	83618906	83619583	677	338.0	
25440	chr4	83629969	83630776	807	404.0	
25441	chr4	83639840	83640338	498	249.0	
25442	chr4	83644628	83645105	477	238.0	
25443	chr4	83716914	83717272	358	179.0	
25444	chr4	84482871	84483254	383	192.0	
25445	chr4	84493267	84493953	686	343.0	
25446	chr4	84496503	84499788	3285	1642.0	
25447	chr4	84503823	84504238	415	208.0	
25448	chr4	84573336	84574697	1361	680.0	
25449	chr4	84582081	84584474	2393	1196.0	
25450	chr4	84681895	84682334	439	220.0	
25451	chr4	84691348	84691754	406	203.0	
25452	chr4	84750308	84750609	301	150.0	
25453	chr4	84753245	84753938	693	346.0	
25454	chr4	84878565	84879015	450	225.0	
25455	chr4	84907148	84907613	465	232.0	
25456	chr4	84915092	84915361	269	134.0	
25457	chr4	84965643	84967714	2071	1036.0	
25458	chr4	84971371	84971735	364	182.0	
25459	chr4	84977598	84977745	147	74.0	
25460	chr4	85147515	85147874	359	180.0	
25461	chr4	85370449	85370640	191	96.0	
25462	chr4	85418120	85418504	384	192.0	
25463	chr4	85474650	85475828	1178	589.0	
25464	chr4	85481999	85482422	423	212.0	
25465	chr4	85498164	85498861	697	348.0	
25466	chr4	85514171	85514456	285	142.0	
25467	chr4	85557144	85557720	576	288.0	
25468	chr4	85603954	85604265	311	156.0	
25469	chr4	85607517	85608129	612	306.0	
25470	chr4	85657208	85657577	369	184.0	
25471	chr4	85659630	85660036	406	203.0	
25472	chr4	85669150	85669684	534	267.0	
25473	chr4	85681042	85681783	741	370.0	
25474	chr4	85697892	85698032	140	70.0	
25475	chr4	85701740	85702472	732	366.0	
25476	chr4	85707626	85708046	420	210.0	
25477	chr4	85725462	85726347	885	442.0	
25478	chr4	85733746	85734164	418	209.0	
25479	chr4	85736531	85737001	470	235.0	
25480	chr4	85743251	85743832	581	290.0	
25481	chr4	85747838	85748291	453	226.0	
25482	chr4	85761753	85762269	516	258.0	
25483	chr4	85778208	85778775	567	284.0	
25484	chr4	85796895	85797225	330	165.0	
25485	chr4	85798313	85798722	409	204.0	
25486	chr4	85842443	85842993	550	275.0	
25487	chr4	85928787	85929309	522	261.0	
25488	chr4	86359754	86360664	910	455.0	
25489	chr4	86498531	86498960	429	214.0	
25490	chr4	86523310	86523787	477	238.0	
25491	chr4	86544634	86544986	352	176.0	
25492	chr4	86554685	86555084	399	200.0	
25493	chr4	86557042	86557183	141	70.0	
25494	chr4	86586095	86587001	906	453.0	
25495	chr4	86593690	86595424	1734	867.0	
25496	chr4	86891763	86892783	1020	510.0	
25497	chr4	86894597	86894618	21	10.0	
25498	chr4	86895689	86896146	457	228.0	
25499	chr4	86904006	86904545	539	270.0	
25500	chr4	86907840	86908859	1019	510.0	
25501	chr4	86909791	86910937	1146	573.0	
25502	chr4	86918509	86918975	466	233.0	
25503	chr4	86922298	86923012	714	357.0	
25504	chr4	86927681	86928462	781	390.0	
25505	chr4	86934042	86936895	2853	1426.0	
25506	chr4	86937997	86938256	259	130.0	
25507	chr4	86938891	86940343	1452	726.0	
25508	chr4	86945181	86945474	293	146.0	
25509	chr4	86947478	86947918	440	220.0	
25510	chr4	86957104	86957664	560	280.0	
25511	chr4	86959415	86959636	221	110.0	
25512	chr4	86961099	86962087	988	494.0	
25513	chr4	86965277	86965689	412	206.0	
25514	chr4	86967066	86968178	1112	556.0	
25515	chr4	86973110	86973207	97	48.0	
25516	chr4	86981621	86982377	756	378.0	
25517	chr4	86997980	86998513	533	266.0	
25518	chr4	86999279	86999566	287	144.0	
25519	chr4	87005328	87008464	3136	1568.0	
25520	chr4	87009023	87009745	722	361.0	
25521	chr4	87011614	87011997	383	192.0	
25522	chr4	87014342	87014715	373	186.0	
25523	chr4	87018860	87019171	311	156.0	
25524	chr4	87027008	87027615	607	304.0	
25525	chr4	87043115	87043465	350	175.0	
25526	chr4	87044927	87045342	415	208.0	
25527	chr4	87046025	87046484	459	230.0	
25528	chr4	87050886	87051227	341	170.0	
25529	chr4	87053257	87053791	534	267.0	
25530	chr4	87058445	87058515	70	35.0	
25531	chr4	87073293	87074463	1170	585.0	
25532	chr4	87087288	87087755	467	234.0	
25533	chr4	87092755	87094171	1416	708.0	
25534	chr4	87103584	87104148	564	282.0	
25535	chr4	87118879	87119182	303	152.0	
25536	chr4	87141446	87141801	355	178.0	
25537	chr4	87150687	87151277	590	295.0	
25538	chr4	87209400	87210349	949	474.0	
25539	chr4	87218837	87221436	2599	1300.0	
25540	chr4	87235485	87236608	1123	562.0	
25541	chr4	87375657	87376232	575	288.0	
25542	chr4	87385896	87386482	586	293.0	
25543	chr4	87388607	87389324	717	358.0	
25544	chr4	87389826	87391988	2162	1081.0	
25545	chr4	87395189	87395390	201	100.0	
25546	chr4	87406444	87406970	526	263.0	
25547	chr4	87421878	87423303	1425	712.0	
25548	chr4	87465701	87466139	438	219.0	
25549	chr4	87559347	87559942	595	298.0	
25550	chr4	87679512	87679830	318	159.0	
25551	chr4	87732204	87732829	625	312.0	
25552	chr4	87807471	87807781	310	155.0	
25553	chr4	87839347	87839714	367	184.0	
25554	chr4	87843776	87844434	658	329.0	
25555	chr4	87848839	87850086	1247	624.0	
25556	chr4	87851144	87851949	805	402.0	
25557	chr4	87852984	87853382	398	199.0	
25558	chr4	87890744	87891121	377	188.0	
25559	chr4	87896031	87896802	771	386.0	
25560	chr4	87973505	87974018	513	256.0	promoter
25561	chr4	87975420	87975839	419	210.0	"promoter	promoter	region	protein_binding_site	protein_binding_site	protein_binding_site	protein_binding_site	protein_binding_site	promoter	protein_binding_site	protein_binding_site	enhancer	protein_binding_site	protein_binding_site	region	protein_binding_site	region	protein_binding_site"
25562	chr4	87985561	87986002	441	220.0	
25563	chr4	88006956	88008965	2009	1004.0	
25564	chr4	88012539	88013030	491	246.0	
25565	chr4	88033251	88033708	457	228.0	
25566	chr4	88045065	88045396	331	166.0	
25567	chr4	88063719	88063951	232	116.0	
25568	chr4	88101139	88101662	523	262.0	
25569	chr4	88130766	88130862	96	48.0	
25570	chr4	88158447	88159259	812	406.0	
25571	chr4	88177957	88178783	826	413.0	
25572	chr4	88211902	88212550	648	324.0	
25573	chr4	88218992	88219471	479	240.0	
25574	chr4	88223547	88223768	221	110.0	
25575	chr4	88230693	88230694	1	0.0	
25576	chr4	88231601	88232002	401	200.0	
25577	chr4	88240138	88240609	471	236.0	
25578	chr4	88244645	88245559	914	457.0	
25579	chr4	88251969	88252264	295	148.0	
25580	chr4	88275498	88275966	468	234.0	
25581	chr4	88282418	88285831	3413	1706.0	
25582	chr4	88320355	88321523	1168	584.0	
25583	chr4	88369212	88369628	416	208.0	
25584	chr4	88375082	88375399	317	158.0	
25585	chr4	88378416	88379736	1320	660.0	
25586	chr4	88381493	88383222	1729	864.0	
25587	chr4	88398360	88398841	481	240.0	
25588	chr4	88456171	88458759	2588	1294.0	
25589	chr4	88482206	88482487	281	140.0	
25590	chr4	88515433	88516428	995	498.0	
25591	chr4	88522648	88524465	1817	908.0	
25592	chr4	88526189	88526688	499	250.0	
25593	chr4	88539239	88539934	695	348.0	
25594	chr4	88591498	88593807	2309	1154.0	
25595	chr4	88599717	88600550	833	416.0	
25596	chr4	88605932	88606065	133	66.0	
25597	chr4	88609450	88609765	315	158.0	
25598	chr4	88612006	88614070	2064	1032.0	
25599	chr4	88659325	88659745	420	210.0	
25600	chr4	88672919	88673319	400	200.0	
25601	chr4	88697052	88698513	1461	730.0	
25602	chr4	88734619	88734783	164	82.0	
25603	chr4	88737353	88738104	751	376.0	
25604	chr4	88792480	88792852	372	186.0	
25605	chr4	88803513	88803994	481	240.0	
25606	chr4	88818551	88819504	953	476.0	
25607	chr4	88820293	88820932	639	320.0	
25608	chr4	88822689	88824078	1389	694.0	
25609	chr4	88826749	88827137	388	194.0	
25610	chr4	88858530	88859830	1300	650.0	
25611	chr4	88940498	88940886	388	194.0	
25612	chr4	88953361	88953858	497	248.0	
25613	chr4	88957575	88958039	464	232.0	
25614	chr4	88960589	88960862	273	136.0	
25615	chr4	88963979	88964026	47	24.0	
25616	chr4	89000842	89001228	386	193.0	
25617	chr4	89023979	89024511	532	266.0	
25618	chr4	89029757	89029804	47	24.0	
25619	chr4	89057010	89057180	170	85.0	
25620	chr4	89101551	89101986	435	218.0	
25621	chr4	89110408	89112637	2229	1114.0	
25622	chr4	89158861	89159302	441	220.0	
25623	chr4	89226878	89227416	538	269.0	
25624	chr4	89243380	89244080	700	350.0	
25625	chr4	89254723	89255536	813	406.0	
25626	chr4	89256531	89256691	160	80.0	
25627	chr4	89269042	89269224	182	91.0	
25628	chr4	89270746	89271196	450	225.0	
25629	chr4	89281054	89281193	139	70.0	
25630	chr4	89283170	89285836	2666	1333.0	
25631	chr4	89288774	89291406	2632	1316.0	
25632	chr4	89293299	89295653	2354	1177.0	
25633	chr4	89296840	89297372	532	266.0	
25634	chr4	89297954	89300592	2638	1319.0	
25635	chr4	89302997	89304244	1247	624.0	
25636	chr4	89305649	89308752	3103	1552.0	
25637	chr4	89316231	89317569	1338	669.0	
25638	chr4	89318462	89318713	251	126.0	
25639	chr4	89324336	89325204	868	434.0	
25640	chr4	89331379	89332420	1041	520.0	
25641	chr4	89434301	89434799	498	249.0	
25642	chr4	89438016	89438815	799	400.0	
25643	chr4	89469747	89470509	762	381.0	
25644	chr4	89487426	89488018	592	296.0	
25645	chr4	89489457	89489786	329	164.0	
25646	chr4	89509552	89510072	520	260.0	
25647	chr4	89528576	89528972	396	198.0	
25648	chr4	89819986	89820442	456	228.0	
25649	chr4	89829298	89830211	913	456.0	
25650	chr4	89836093	89838375	2282	1141.0	
25651	chr4	89889256	89889709	453	226.0	
25652	chr4	89894572	89895501	929	464.0	
25653	chr4	89898468	89898728	260	130.0	
25654	chr4	89901797	89902265	468	234.0	
25655	chr4	89929514	89930120	606	303.0	
25656	chr4	90027501	90027948	447	224.0	
25657	chr4	90071623	90072333	710	355.0	
25658	chr4	90078584	90078865	281	140.0	
25659	chr4	90099731	90100352	621	310.0	
25660	chr4	90118550	90118951	401	200.0	
25661	chr4	90126850	90129559	2709	1354.0	
25662	chr4	90315044	90315487	443	222.0	
25663	chr4	92101845	92102288	443	222.0	
25664	chr4	94207283	94208694	1411	706.0	
25665	chr4	94333235	94333322	87	44.0	
25666	chr4	94339674	94340144	470	235.0	
25667	chr4	94342963	94343055	92	46.0	
25668	chr4	94345258	94346248	990	495.0	
25669	chr4	94354563	94354848	285	142.0	
25670	chr4	94406659	94407099	440	220.0	
25671	chr4	94451117	94453754	2637	1318.0	
25672	chr4	94485429	94486031	602	301.0	
25673	chr4	94518928	94519432	504	252.0	
25674	chr4	94520167	94520734	567	284.0	
25675	chr4	94534710	94535492	782	391.0	
25676	chr4	94548620	94548915	295	148.0	
25677	chr4	94567942	94568069	127	64.0	
25678	chr4	94584246	94584250	4	2.0	
25679	chr4	94595923	94596236	313	156.0	
25680	chr4	95156024	95156565	541	270.0	
25681	chr4	95165912	95166381	469	234.0	
25682	chr4	95199010	95199181	171	86.0	
25683	chr4	95216041	95216866	825	412.0	
25684	chr4	98142682	98144138	1456	728.0	
25685	chr4	98151298	98151926	628	314.0	
25686	chr4	98203421	98204269	848	424.0	
25687	chr4	98232145	98232631	486	243.0	
25688	chr4	98259971	98263044	3073	1536.0	
25689	chr4	98263657	98264053	396	198.0	
25690	chr4	98446163	98448045	1882	941.0	
25691	chr4	98448946	98449282	336	168.0	
25692	chr4	98467432	98468208	776	388.0	
25693	chr4	98470993	98471008	15	8.0	
25694	chr4	98603963	98604038	75	38.0	
25695	chr4	98639253	98640013	760	380.0	
25696	chr4	98643105	98643285	180	90.0	
25697	chr4	98657192	98659467	2275	1138.0	
25698	chr4	98659990	98660380	390	195.0	
25699	chr4	98662678	98664149	1471	736.0	
25700	chr4	98688964	98689330	366	183.0	
25701	chr4	98706011	98706956	945	472.0	
25702	chr4	98829086	98829087	1	0.0	
25703	chr4	98927414	98930836	3422	1711.0	
25704	chr4	98932479	98933025	546	273.0	
25705	chr4	98939776	98940224	448	224.0	
25706	chr4	98994606	98996932	2326	1163.0	
25707	chr4	99043280	99044197	917	458.0	
25708	chr4	99055776	99056515	739	370.0	
25709	chr4	99087739	99089882	2143	1072.0	
25710	chr4	99108984	99109117	133	66.0	
25711	chr4	99405465	99405943	478	239.0	
25712	chr4	99462832	99463265	433	216.0	
25713	chr4	99507835	99508154	319	160.0	
25714	chr4	99518634	99519351	717	358.0	
25715	chr4	99560897	99561727	830	415.0	
25716	chr4	99562724	99564497	1773	886.0	
25717	chr4	99808212	99808732	520	260.0	
25718	chr4	99811708	99812343	635	318.0	
25719	chr4	99815420	99815514	94	47.0	
25720	chr4	99816127	99818005	1878	939.0	
25721	chr4	99821780	99822576	796	398.0	
25722	chr4	99827398	99827913	515	258.0	
25723	chr4	99845651	99846327	676	338.0	
25724	chr4	99847065	99848057	992	496.0	
25725	chr4	99851043	99851769	726	363.0	
25726	chr4	99855263	99857729	2466	1233.0	
25727	chr4	99861644	99861726	82	41.0	
25728	chr4	99885040	99885472	432	216.0	
25729	chr4	99893640	99895154	1514	757.0	
25730	chr4	99944058	99944686	628	314.0	
25731	chr4	99945726	99947844	2118	1059.0	
25732	chr4	99948678	99951506	2828	1414.0	
25733	chr4	99965761	99965992	231	116.0	
25734	chr4	100079210	100079628	418	209.0	
25735	chr4	100093130	100094112	982	491.0	
25736	chr4	100095918	100096470	552	276.0	
25737	chr4	100101038	100101469	431	216.0	
25738	chr4	100106733	100107465	732	366.0	
25739	chr4	100189945	100190992	1047	524.0	
25740	chr4	100257534	100257964	430	215.0	
25741	chr4	100340740	100341052	312	156.0	
25742	chr4	100348523	100348850	327	164.0	
25743	chr4	100594186	100594225	39	20.0	
25744	chr4	100651843	100652145	302	151.0	
25745	chr4	100826796	100827215	419	210.0	
25746	chr4	100895491	100896251	760	380.0	
25747	chr4	100981455	100982206	751	376.0	
25748	chr4	101018756	101021790	3034	1517.0	
25749	chr4	101037811	101038526	715	358.0	
25750	chr4	101039190	101039804	614	307.0	
25751	chr4	101075563	101075938	375	188.0	
25752	chr4	101084412	101085042	630	315.0	
25753	chr4	101103493	101104153	660	330.0	
25754	chr4	101135634	101135934	300	150.0	
25755	chr4	101169144	101169682	538	269.0	
25756	chr4	101200472	101201104	632	316.0	
25757	chr4	101205814	101206364	550	275.0	
25758	chr4	101236070	101236486	416	208.0	
25759	chr4	101258814	101259174	360	180.0	
25760	chr4	101275053	101275305	252	126.0	
25761	chr4	101279434	101280147	713	356.0	
25762	chr4	101282312	101283806	1494	747.0	
25763	chr4	101284528	101284831	303	152.0	
25764	chr4	101288703	101289061	358	179.0	
25765	chr4	101306208	101306538	330	165.0	
25766	chr4	101327879	101328911	1032	516.0	
25767	chr4	101334889	101335614	725	362.0	
25768	chr4	101337722	101338027	305	152.0	
25769	chr4	101345144	101349435	4291	2146.0	
25770	chr4	101417971	101418864	893	446.0	
25771	chr4	101458949	101459385	436	218.0	
25772	chr4	101526954	101527889	935	468.0	
25773	chr4	101596761	101597580	819	410.0	
25774	chr4	101730441	101730929	488	244.0	
25775	chr4	101790338	101791458	1120	560.0	
25776	chr4	101792359	101792497	138	69.0	
25777	chr4	101801903	101802396	493	246.0	
25778	chr4	101806869	101807626	757	378.0	
25779	chr4	101813602	101813991	389	194.0	
25780	chr4	101833442	101833951	509	254.0	
25781	chr4	101835465	101835920	455	228.0	
25782	chr4	102037729	102037869	140	70.0	
25783	chr4	102263080	102263381	301	150.0	
25784	chr4	102299650	102300029	379	190.0	
25785	chr4	102343749	102346552	2803	1402.0	
25786	chr4	102390230	102391030	800	400.0	
25787	chr4	102397130	102397451	321	160.0	
25788	chr4	102398951	102399505	554	277.0	
25789	chr4	102403067	102403660	593	296.0	
25790	chr4	102430557	102431864	1307	654.0	
25791	chr4	102447438	102447721	283	142.0	
25792	chr4	102449697	102450214	517	258.0	
25793	chr4	102500088	102504819	4731	2366.0	
25794	chr4	102506316	102506674	358	179.0	
25795	chr4	102508789	102510320	1531	766.0	
25796	chr4	102511349	102512647	1298	649.0	
25797	chr4	102514224	102514943	719	360.0	
25798	chr4	102517147	102517196	49	24.0	
25799	chr4	102517883	102520498	2615	1308.0	
25800	chr4	102521482	102522580	1098	549.0	
25801	chr4	102523210	102524008	798	399.0	
25802	chr4	102524648	102525908	1260	630.0	
25803	chr4	102527075	102529586	2511	1256.0	
25804	chr4	102533945	102535981	2036	1018.0	
25805	chr4	102541653	102542097	444	222.0	
25806	chr4	102552683	102553279	596	298.0	
25807	chr4	102560285	102561079	794	397.0	
25808	chr4	102564273	102564787	514	257.0	
25809	chr4	102574251	102574895	644	322.0	
25810	chr4	102578900	102579255	355	178.0	
25811	chr4	102586011	102587181	1170	585.0	
25812	chr4	102590013	102590102	89	44.0	
25813	chr4	102593159	102593487	328	164.0	
25814	chr4	102598117	102599087	970	485.0	
25815	chr4	102611794	102615359	3565	1782.0	
25816	chr4	102620607	102620998	391	196.0	
25817	chr4	102625069	102626018	949	474.0	
25818	chr4	102630481	102631183	702	351.0	
25819	chr4	102637420	102637807	387	194.0	
25820	chr4	102687304	102688297	993	496.0	
25821	chr4	102692742	102693722	980	490.0	
25822	chr4	102734425	102735134	709	354.0	
25823	chr4	102735714	102736115	401	200.0	
25824	chr4	102743069	102744089	1020	510.0	
25825	chr4	102751924	102752405	481	240.0	
25826	chr4	102757495	102761903	4408	2204.0	
25827	chr4	102780470	102780931	461	230.0	
25828	chr4	102787596	102787751	155	78.0	
25829	chr4	102789411	102789699	288	144.0	
25830	chr4	102791533	102793174	1641	820.0	
25831	chr4	102793861	102794097	236	118.0	
25832	chr4	102794791	102795108	317	158.0	
25833	chr4	102798038	102798044	6	3.0	
25834	chr4	102803382	102804258	876	438.0	
25835	chr4	102805349	102805386	37	18.0	
25836	chr4	102809129	102809689	560	280.0	
25837	chr4	102810311	102810358	47	24.0	
25838	chr4	102811114	102812090	976	488.0	
25839	chr4	102813303	102814827	1524	762.0	
25840	chr4	102815984	102820741	4757	2378.0	
25841	chr4	102821259	102829605	8346	4173.0	
25842	chr4	102861968	102863140	1172	586.0	
25843	chr4	102867793	102870269	2476	1238.0	
25844	chr4	102871691	102872110	419	210.0	
25845	chr4	102878202	102878841	639	320.0	
25846	chr4	103008887	103009566	679	340.0	
25847	chr4	103018125	103020414	2289	1144.0	
25848	chr4	103032732	103032805	73	36.0	
25849	chr4	103046423	103047117	694	347.0	
25850	chr4	103074579	103077370	2791	1396.0	
25851	chr4	103091513	103092092	579	290.0	
25852	chr4	103092621	103092705	84	42.0	
25853	chr4	103099285	103100505	1220	610.0	
25854	chr4	103156072	103156504	432	216.0	
25855	chr4	103197241	103199273	2032	1016.0	
25856	chr4	104490373	104491950	1577	788.0	
25857	chr4	104494582	104495562	980	490.0	
25858	chr4	104860477	104860931	454	227.0	
25859	chr4	104896903	104897333	430	215.0	
25860	chr4	104930655	104931517	862	431.0	
25861	chr4	104938633	104939017	384	192.0	
25862	chr4	104943370	104943785	415	208.0	
25863	chr4	104964551	104964764	213	106.0	
25864	chr4	104966368	104967455	1087	544.0	
25865	chr4	105014205	105015056	851	426.0	
25866	chr4	105022780	105023348	568	284.0	
25867	chr4	105057268	105058454	1186	593.0	
25868	chr4	105059220	105059878	658	329.0	
25869	chr4	105060438	105062105	1667	834.0	
25870	chr4	105107075	105107583	508	254.0	
25871	chr4	105113700	105114342	642	321.0	
25872	chr4	105120630	105121026	396	198.0	
25873	chr4	105129298	105129606	308	154.0	
25874	chr4	105131064	105131984	920	460.0	
25875	chr4	105135693	105136401	708	354.0	
25876	chr4	105137114	105137921	807	404.0	
25877	chr4	105140547	105141476	929	464.0	
25878	chr4	105144601	105148309	3708	1854.0	
25879	chr4	105149661	105150297	636	318.0	
25880	chr4	105158747	105159229	482	241.0	
25881	chr4	105170713	105171137	424	212.0	
25882	chr4	105191580	105192221	641	320.0	
25883	chr4	105196227	105197187	960	480.0	
25884	chr4	105236788	105237059	271	136.0	
25885	chr4	105293490	105293596	106	53.0	
25886	chr4	105296644	105297056	412	206.0	
25887	chr4	105304837	105305415	578	289.0	
25888	chr4	105306208	105306833	625	312.0	
25889	chr4	105350924	105351199	275	138.0	
25890	chr4	105443672	105443818	146	73.0	
25891	chr4	105461223	105461829	606	303.0	
25892	chr4	105469793	105470096	303	152.0	
25893	chr4	105470804	105474705	3901	1950.0	
25894	chr4	105509357	105509730	373	186.0	
25895	chr4	105520849	105521183	334	167.0	
25896	chr4	105707753	105709622	1869	934.0	
25897	chr4	105714204	105714635	431	216.0	
25898	chr4	105715683	105716067	384	192.0	
25899	chr4	106238878	106239208	330	165.0	
25900	chr4	106315298	106317581	2283	1142.0	
25901	chr4	106329038	106329418	380	190.0	
25902	chr4	106369472	106369733	261	130.0	
25903	chr4	106659194	106659849	655	328.0	
25904	chr4	106676212	106677006	794	397.0	
25905	chr4	106679026	106679479	453	226.0	
25906	chr4	106690471	106690933	462	231.0	
25907	chr4	106694194	106694595	401	200.0	
25908	chr4	106707710	106709017	1307	654.0	
25909	chr4	106746520	106747029	509	254.0	
25910	chr4	106809100	106809479	379	190.0	
25911	chr4	107034232	107034643	411	206.0	
25912	chr4	107035266	107036539	1273	636.0	
25913	chr4	107094350	107094824	474	237.0	
25914	chr4	107183183	107183557	374	187.0	
25915	chr4	107692994	107693601	607	304.0	
25916	chr4	107709777	107710460	683	342.0	
25917	chr4	107718627	107721940	3313	1656.0	
25918	chr4	107734165	107734513	348	174.0	
25919	chr4	107736910	107737426	516	258.0	
25920	chr4	107756022	107756306	284	142.0	
25921	chr4	107757292	107758246	954	477.0	
25922	chr4	107799975	107801115	1140	570.0	
25923	chr4	107804978	107805326	348	174.0	
25924	chr4	107818210	107818904	694	347.0	
25925	chr4	107824106	107825875	1769	884.0	
25926	chr4	107837241	107839540	2299	1150.0	
25927	chr4	107843579	107843637	58	29.0	
25928	chr4	107853428	107853760	332	166.0	
25929	chr4	107913212	107913720	508	254.0	
25930	chr4	107930670	107932525	1855	928.0	
25931	chr4	107936992	107937628	636	318.0	
25932	chr4	107987847	107988160	313	156.0	
25933	chr4	107989051	107991169	2118	1059.0	
25934	chr4	107992418	107992819	401	200.0	
25935	chr4	107993995	107994359	364	182.0	
25936	chr4	108004291	108004309	18	9.0	
25937	chr4	108018351	108019043	692	346.0	
25938	chr4	108029101	108030807	1706	853.0	
25939	chr4	108036133	108036889	756	378.0	
25940	chr4	108043226	108044031	805	402.0	
25941	chr4	108045413	108046416	1003	502.0	
25942	chr4	108049063	108051822	2759	1380.0	
25943	chr4	108053400	108054350	950	475.0	
25944	chr4	108056821	108057080	259	130.0	
25945	chr4	108070803	108073038	2235	1118.0	
25946	chr4	108080666	108081668	1002	501.0	
25947	chr4	108094938	108095330	392	196.0	
25948	chr4	108106965	108108486	1521	760.0	
25949	chr4	108112706	108113992	1286	643.0	
25950	chr4	108114548	108114751	203	102.0	
25951	chr4	108115710	108117699	1989	994.0	
25952	chr4	108118488	108118889	401	200.0	
25953	chr4	108140254	108140721	467	234.0	
25954	chr4	108141457	108141788	331	166.0	
25955	chr4	108144487	108144909	422	211.0	
25956	chr4	108155398	108155808	410	205.0	
25957	chr4	108159892	108160293	401	200.0	
25958	chr4	108160940	108161479	539	270.0	
25959	chr4	108165496	108170091	4595	2298.0	
25960	chr4	108170608	108173848	3240	1620.0	
25961	chr4	108342523	108343050	527	264.0	
25962	chr4	108355292	108356306	1014	507.0	
25963	chr4	108359282	108360136	854	427.0	
25964	chr4	108370276	108370740	464	232.0	
25965	chr4	108372809	108373097	288	144.0	
25966	chr4	108433531	108434335	804	402.0	
25967	chr4	108466292	108466373	81	40.0	
25968	chr4	108467172	108467817	645	322.0	
25969	chr4	108483124	108483416	292	146.0	
25970	chr4	108513146	108513447	301	150.0	
25971	chr4	108527615	108528141	526	263.0	
25972	chr4	108572122	108573121	999	500.0	
25973	chr4	108619180	108621863	2683	1342.0	
25974	chr4	108649586	108651782	2196	1098.0	
25975	chr4	108762537	108762943	406	203.0	
25976	chr4	109040353	109040897	544	272.0	
25977	chr4	109072540	109073011	471	236.0	
25978	chr4	109278538	109278873	335	168.0	
25979	chr4	109294017	109294405	388	194.0	
25980	chr4	109302310	109303383	1073	536.0	
25981	chr4	109359042	109359486	444	222.0	
25982	chr4	109406286	109406730	444	222.0	
25983	chr4	109422321	109423005	684	342.0	
25984	chr4	109427557	109427873	316	158.0	
25985	chr4	109432724	109435027	2303	1152.0	
25986	chr4	109435794	109436130	336	168.0	
25987	chr4	109436646	109436677	31	16.0	
25988	chr4	109437378	109437717	339	170.0	
25989	chr4	109439170	109439571	401	200.0	
25990	chr4	109443952	109444706	754	377.0	
25991	chr4	109448776	109449106	330	165.0	
25992	chr4	109548273	109549254	981	490.0	
25993	chr4	109558107	109558449	342	171.0	
25994	chr4	109559465	109561860	2395	1198.0	
25995	chr4	109574289	109575086	797	398.0	
25996	chr4	109591280	109591299	19	10.0	
25997	chr4	109611296	109611442	146	73.0	
25998	chr4	109631746	109631758	12	6.0	
25999	chr4	109645659	109646040	381	190.0	
26000	chr4	109648148	109649588	1440	720.0	
26001	chr4	109690669	109691672	1003	502.0	
26002	chr4	109701873	109704477	2604	1302.0	
26003	chr4	109729197	109730894	1697	848.0	
26004	chr4	109754513	109754528	15	8.0	
26005	chr4	109804162	109804567	405	202.0	
26006	chr4	109813296	109813793	497	248.0	
26007	chr4	109814842	109816670	1828	914.0	
26008	chr4	109826711	109827112	401	200.0	
26009	chr4	109945109	109945442	333	166.0	
26010	chr4	109969909	109970389	480	240.0	
26011	chr4	109979031	109979434	403	202.0	
26012	chr4	109983924	109984320	396	198.0	
26013	chr4	109990164	109991304	1140	570.0	
26014	chr4	109994325	109994964	639	320.0	
26015	chr4	109996489	109996976	487	244.0	
26016	chr4	109998712	109999253	541	270.0	
26017	chr4	110005443	110005941	498	249.0	
26018	chr4	110032470	110033117	647	324.0	
26019	chr4	110033894	110034405	511	256.0	
26020	chr4	110049897	110050412	515	258.0	
26021	chr4	110055470	110055810	340	170.0	
26022	chr4	110059523	110060343	820	410.0	
26023	chr4	110085132	110085477	345	172.0	
26024	chr4	110088775	110088975	200	100.0	
26025	chr4	110106216	110106776	560	280.0	
26026	chr4	110107943	110108831	888	444.0	
26027	chr4	110164834	110166009	1175	588.0	
26028	chr4	110193579	110194420	841	420.0	
26029	chr4	110195646	110199400	3754	1877.0	
26030	chr4	110211232	110211687	455	228.0	
26031	chr4	110310677	110311257	580	290.0	
26032	chr4	110315465	110315838	373	186.0	
26033	chr4	110483902	110484525	623	312.0	
26034	chr4	110487958	110488153	195	98.0	
26035	chr4	110489871	110490338	467	234.0	
26036	chr4	110492340	110493053	713	356.0	
26037	chr4	110503471	110504069	598	299.0	
26038	chr4	110510924	110511390	466	233.0	
26039	chr4	110514934	110516854	1920	960.0	
26040	chr4	110518904	110519280	376	188.0	
26041	chr4	110621078	110621133	55	28.0	
26042	chr4	110622871	110623385	514	257.0	
26043	chr4	110631781	110632264	483	242.0	
26044	chr4	110704731	110705116	385	192.0	
26045	chr4	111991646	111992177	531	266.0	
26046	chr4	112075086	112075601	515	258.0	
26047	chr4	112084710	112085791	1081	540.0	
26048	chr4	112099604	112100079	475	238.0	
26049	chr4	112109436	112110211	775	388.0	
26050	chr4	112113004	112113510	506	253.0	
26051	chr4	112119303	112119635	332	166.0	
26052	chr4	112144568	112146963	2395	1198.0	
26053	chr4	112152564	112153014	450	225.0	
26054	chr4	112167723	112168188	465	232.0	
26055	chr4	112170425	112170774	349	174.0	
26056	chr4	112183437	112183646	209	104.0	
26057	chr4	112186094	112186569	475	238.0	
26058	chr4	112213159	112215090	1931	966.0	
26059	chr4	112230733	112232898	2165	1082.0	
26060	chr4	112234893	112235450	557	278.0	
26061	chr4	112253373	112253766	393	196.0	
26062	chr4	112273326	112274208	882	441.0	
26063	chr4	112279281	112280363	1082	541.0	
26064	chr4	112281708	112283464	1756	878.0	
26065	chr4	112284064	112289075	5011	2506.0	
26066	chr4	112296827	112297864	1037	518.0	
26067	chr4	112302267	112303004	737	368.0	
26068	chr4	112309134	112309588	454	227.0	
26069	chr4	112312262	112313264	1002	501.0	
26070	chr4	112315418	112316789	1371	686.0	
26071	chr4	112318816	112318991	175	88.0	
26072	chr4	112321727	112322286	559	280.0	
26073	chr4	112327843	112328411	568	284.0	
26074	chr4	112329989	112330417	428	214.0	
26075	chr4	112509381	112511674	2293	1146.0	
26076	chr4	112514378	112517492	3114	1557.0	
26077	chr4	112517995	112518259	264	132.0	
26078	chr4	112521000	112521726	726	363.0	enhancer
26079	chr4	112522614	112524667	2053	1026.0	
26080	chr4	112545481	112545719	238	119.0	
26081	chr4	112560032	112560530	498	249.0	
26082	chr4	112604533	112604958	425	212.0	
26083	chr4	112633352	112633870	518	259.0	
26084	chr4	112636339	112638099	1760	880.0	
26085	chr4	112643261	112643674	413	206.0	
26086	chr4	112705524	112706897	1373	686.0	
26087	chr4	112762722	112762919	197	98.0	
26088	chr4	112765602	112765822	220	110.0	
26089	chr4	112817879	112818347	468	234.0	
26090	chr4	113316958	113317242	284	142.0	
26091	chr4	113355440	113356427	987	494.0	
26092	chr4	113394648	113395145	497	248.0	
26093	chr4	113547266	113548324	1058	529.0	
26094	chr4	113556059	113556193	134	67.0	
26095	chr4	113564270	113565672	1402	701.0	
26096	chr4	113589123	113589198	75	38.0	
26097	chr4	113636382	113637405	1023	512.0	
26098	chr4	113640983	113641315	332	166.0	
26099	chr4	113673442	113673862	420	210.0	
26100	chr4	113677067	113677819	752	376.0	
26101	chr4	113682989	113683807	818	409.0	
26102	chr4	113692826	113693273	447	224.0	
26103	chr4	113739275	113739530	255	128.0	
26104	chr4	113759902	113763442	3540	1770.0	
26105	chr4	113772913	113773392	479	240.0	
26106	chr4	113781692	113781813	121	60.0	
26107	chr4	113784571	113785273	702	351.0	
26108	chr4	113785991	113786043	52	26.0	
26109	chr4	113790373	113791023	650	325.0	
26110	chr4	113809202	113809779	577	288.0	
26111	chr4	113811182	113811874	692	346.0	
26112	chr4	113815730	113816376	646	323.0	
26113	chr4	113823199	113823622	423	212.0	
26114	chr4	113825157	113825632	475	238.0	
26115	chr4	113837360	113837934	574	287.0	
26116	chr4	113899266	113900230	964	482.0	
26117	chr4	113901862	113902787	925	462.0	
26118	chr4	113908901	113909232	331	166.0	
26119	chr4	113952431	113952863	432	216.0	
26120	chr4	113979341	113979981	640	320.0	
26121	chr4	114004469	114004970	501	250.0	
26122	chr4	114005727	114006336	609	304.0	
26123	chr4	114040572	114040895	323	162.0	
26124	chr4	114070905	114071434	529	264.0	
26125	chr4	114147461	114148063	602	301.0	
26126	chr4	114180649	114180672	23	12.0	
26127	chr4	114598127	114599692	1565	782.0	
26128	chr4	114601764	114602091	327	164.0	
26129	chr4	114603439	114603935	496	248.0	
26130	chr4	114807762	114808199	437	218.0	
26131	chr4	115234459	115234833	374	187.0	
26132	chr4	115274579	115274890	311	156.0	
26133	chr4	115781824	115781928	104	52.0	
26134	chr4	116358541	116358998	457	228.0	
26135	chr4	117987665	117987826	161	80.0	
26136	chr4	118033451	118033478	27	14.0	
26137	chr4	118224241	118224583	342	171.0	
26138	chr4	118265340	118266093	753	376.0	
26139	chr4	118270418	118270879	461	230.0	
26140	chr4	118275328	118275724	396	198.0	
26141	chr4	118277304	118283258	5954	2977.0	
26142	chr4	118284084	118284584	500	250.0	
26143	chr4	118352230	118353470	1240	620.0	
26144	chr4	118424096	118424427	331	166.0	
26145	chr4	118589677	118590128	451	226.0	
26146	chr4	118591056	118592403	1347	674.0	
26147	chr4	118595971	118596257	286	143.0	
26148	chr4	118669205	118669565	360	180.0	
26149	chr4	118682948	118683335	387	194.0	
26150	chr4	118684755	118686091	1336	668.0	
26151	chr4	118729914	118730108	194	97.0	
26152	chr4	118760418	118760890	472	236.0	
26153	chr4	118772048	118772681	633	316.0	
26154	chr4	118810968	118810998	30	15.0	
26155	chr4	118827064	118827347	283	142.0	
26156	chr4	118832234	118832531	297	148.0	
26157	chr4	118834828	118837186	2358	1179.0	
26158	chr4	118850098	118851144	1046	523.0	
26159	chr4	118865099	118865514	415	208.0	
26160	chr4	118888635	118889155	520	260.0	
26161	chr4	118890104	118890480	376	188.0	
26162	chr4	118967915	118968645	730	365.0	
26163	chr4	118981710	118982257	547	274.0	
26164	chr4	118983844	118984116	272	136.0	
26165	chr4	118991661	118992073	412	206.0	
26166	chr4	119002928	119003548	620	310.0	
26167	chr4	119010164	119010681	517	258.0	
26168	chr4	119025414	119026504	1090	545.0	
26169	chr4	119037976	119038833	857	428.0	
26170	chr4	119041865	119042380	515	258.0	
26171	chr4	119100647	119101154	507	254.0	
26172	chr4	119103171	119103771	600	300.0	
26173	chr4	119113178	119113698	520	260.0	
26174	chr4	119139759	119140201	442	221.0	
26175	chr4	119209033	119209537	504	252.0	
26176	chr4	119211727	119213726	1999	1000.0	
26177	chr4	119233907	119234113	206	103.0	
26178	chr4	119244838	119245117	279	140.0	
26179	chr4	119284832	119285416	584	292.0	
26180	chr4	119286390	119286739	349	174.0	
26181	chr4	119299170	119301337	2167	1084.0	
26182	chr4	119314289	119314791	502	251.0	
26183	chr4	119336967	119337373	406	203.0	
26184	chr4	119370262	119370940	678	339.0	
26185	chr4	119453953	119455460	1507	754.0	
26186	chr4	119462695	119463137	442	221.0	
26187	chr4	119488466	119488472	6	3.0	
26188	chr4	119626871	119629538	2667	1334.0	
26189	chr4	120049520	120050330	810	405.0	
26190	chr4	120052812	120053292	480	240.0	
26191	chr4	120053965	120054289	324	162.0	
26192	chr4	120066041	120068375	2334	1167.0	
26193	chr4	120071105	120071809	704	352.0	
26194	chr4	120156111	120156496	385	192.0	
26195	chr4	120718990	120719331	341	170.0	
26196	chr4	120921899	120923284	1385	692.0	
26197	chr4	121009589	121009966	377	188.0	
26198	chr4	121070757	121073179	2422	1211.0	
26199	chr4	121093322	121093532	210	105.0	
26200	chr4	121139517	121140060	543	272.0	
26201	chr4	121153750	121154692	942	471.0	
26202	chr4	121155936	121157545	1609	804.0	
26203	chr4	121164233	121164637	404	202.0	
26204	chr4	121168682	121169430	748	374.0	
26205	chr4	121176338	121177736	1398	699.0	
26206	chr4	121180553	121183706	3153	1576.0	
26207	chr4	121189593	121190537	944	472.0	
26208	chr4	121191372	121191686	314	157.0	
26209	chr4	121192332	121193037	705	352.0	
26210	chr4	121199738	121201232	1494	747.0	
26211	chr4	121205817	121205998	181	90.0	
26212	chr4	121221705	121221983	278	139.0	
26213	chr4	121227240	121227947	707	354.0	
26214	chr4	121243373	121244024	651	326.0	
26215	chr4	121252176	121252662	486	243.0	
26216	chr4	121253598	121255066	1468	734.0	
26217	chr4	121256291	121257177	886	443.0	
26218	chr4	121307562	121308219	657	328.0	
26219	chr4	121462657	121463068	411	206.0	
26220	chr4	121484570	121484943	373	186.0	
26221	chr4	121690705	121691186	481	240.0	
26222	chr4	121695776	121698572	2796	1398.0	
26223	chr4	121706387	121707274	887	444.0	
26224	chr4	121711481	121712128	647	324.0	
26225	chr4	121726584	121727114	530	265.0	
26226	chr4	121795618	121795637	19	10.0	
26227	chr4	121799395	121799530	135	68.0	
26228	chr4	121800446	121801952	1506	753.0	
26229	chr4	121822690	121824550	1860	930.0	
26230	chr4	121869409	121871264	1855	928.0	
26231	chr4	121881505	121881513	8	4.0	
26232	chr4	121900135	121900815	680	340.0	
26233	chr4	121938639	121939120	481	240.0	
26234	chr4	121950065	121952319	2254	1127.0	
26235	chr4	121977790	121978243	453	226.0	
26236	chr4	122003318	122003783	465	232.0	
26237	chr4	122117769	122118119	350	175.0	
26238	chr4	122131702	122132176	474	237.0	
26239	chr4	122150735	122153523	2788	1394.0	
26240	chr4	122156889	122157024	135	68.0	
26241	chr4	122163746	122164139	393	196.0	
26242	chr4	122167609	122167837	228	114.0	
26243	chr4	122212848	122213300	452	226.0	
26244	chr4	122221317	122221718	401	200.0	
26245	chr4	122321964	122322309	345	172.0	
26246	chr4	122365069	122365275	206	103.0	
26247	chr4	122456515	122456916	401	200.0	
26248	chr4	122458472	122459060	588	294.0	
26249	chr4	122540086	122540457	371	186.0	
26250	chr4	122576785	122579227	2442	1221.0	
26251	chr4	122584026	122584862	836	418.0	
26252	chr4	122588810	122589111	301	150.0	
26253	chr4	122652394	122652685	291	146.0	
26254	chr4	122716800	122717270	470	235.0	
26255	chr4	122731956	122733696	1740	870.0	
26256	chr4	122739428	122739587	159	80.0	
26257	chr4	122744099	122744704	605	302.0	
26258	chr4	122746352	122746941	589	294.0	
26259	chr4	122757895	122758396	501	250.0	
26260	chr4	122762458	122762995	537	268.0	
26261	chr4	122826726	122828499	1773	886.0	"promoter	promoter	protein_binding_site"
26262	chr4	122914292	122914737	445	222.0	
26263	chr4	122921879	122923695	1816	908.0	
26264	chr4	122945139	122945530	391	196.0	
26265	chr4	123088524	123088927	403	202.0	
26266	chr4	123102912	123103306	394	197.0	
26267	chr4	123232390	123232869	479	240.0	
26268	chr4	123233411	123233918	507	254.0	
26269	chr4	123240313	123240635	322	161.0	
26270	chr4	123244246	123244628	382	191.0	
26271	chr4	123288685	123288975	290	145.0	
26272	chr4	123325234	123325607	373	186.0	
26273	chr4	123340166	123340744	578	289.0	
26274	chr4	123352135	123352526	391	196.0	
26275	chr4	123363824	123364026	202	101.0	
26276	chr4	123376789	123377237	448	224.0	
26277	chr4	123385131	123385723	592	296.0	
26278	chr4	123390863	123391225	362	181.0	
26279	chr4	123396287	123400225	3938	1969.0	
26280	chr4	123415638	123416477	839	420.0	
26281	chr4	123418459	123418921	462	231.0	
26282	chr4	123421535	123422495	960	480.0	
26283	chr4	123443323	123444676	1353	676.0	
26284	chr4	123449676	123450192	516	258.0	
26285	chr4	123452511	123453056	545	272.0	
26286	chr4	123455884	123456220	336	168.0	
26287	chr4	123477691	123478322	631	316.0	
26288	chr4	123488840	123489427	587	294.0	
26289	chr4	123495606	123495836	230	115.0	
26290	chr4	123505331	123506149	818	409.0	
26291	chr4	123553299	123553675	376	188.0	
26292	chr4	123554934	123555260	326	163.0	
26293	chr4	123564693	123565235	542	271.0	
26294	chr4	123588934	123589500	566	283.0	
26295	chr4	123598502	123598537	35	18.0	
26296	chr4	123599418	123600579	1161	580.0	
26297	chr4	123606960	123607530	570	285.0	
26298	chr4	123616745	123617838	1093	546.0	
26299	chr4	123618628	123619108	480	240.0	
26300	chr4	123625061	123625299	238	119.0	
26301	chr4	123649340	123649626	286	143.0	
26302	chr4	123672993	123673382	389	194.0	
26303	chr4	123772830	123773231	401	200.0	
26304	chr4	123811600	123812125	525	262.0	
26305	chr4	123817337	123817645	308	154.0	
26306	chr4	124018742	124019205	463	232.0	
26307	chr4	124060684	124060785	101	50.0	
26308	chr4	124262265	124262601	336	168.0	
26309	chr4	124641988	124642399	411	206.0	
26310	chr4	124682471	124682498	27	14.0	
26311	chr4	124703104	124703603	499	250.0	
26312	chr4	124710261	124713744	3483	1742.0	
26313	chr4	125313415	125313852	437	218.0	
26314	chr4	125314563	125316740	2177	1088.0	
26315	chr4	125317558	125317871	313	156.0	
26316	chr4	127162835	127163001	166	83.0	
26317	chr4	127622665	127623443	778	389.0	
26318	chr4	127632481	127633278	797	398.0	
26319	chr4	127698835	127699114	279	140.0	
26320	chr4	127779340	127779752	412	206.0	
26321	chr4	127781565	127783394	1829	914.0	
26322	chr4	127832591	127832978	387	194.0	
26323	chr4	127880245	127881868	1623	812.0	
26324	chr4	127963439	127966434	2995	1498.0	
26325	chr4	127993186	127993332	146	73.0	
26326	chr4	127997476	127998199	723	362.0	
26327	chr4	128060218	128062760	2542	1271.0	
26328	chr4	128191231	128191830	599	300.0	
26329	chr4	128286176	128289328	3152	1576.0	
26330	chr4	128298873	128299204	331	166.0	
26331	chr4	128454208	128454749	541	270.0	
26332	chr4	128514095	128514257	162	81.0	
26333	chr4	128517657	128518081	424	212.0	
26334	chr4	128552761	128553749	988	494.0	
26335	chr4	128561150	128561517	367	184.0	
26336	chr4	128565613	128565871	258	129.0	
26337	chr4	128570273	128570843	570	285.0	
26338	chr4	128574636	128575033	397	198.0	
26339	chr4	128782300	128782753	453	226.0	
26340	chr4	128794084	128794364	280	140.0	
26341	chr4	128803635	128804247	612	306.0	
26342	chr4	128809089	128813662	4573	2286.0	
26343	chr4	128814943	128815362	419	210.0	
26344	chr4	128827342	128827396	54	27.0	
26345	chr4	128830997	128831350	353	176.0	
26346	chr4	128840716	128841057	341	170.0	
26347	chr4	128847070	128847615	545	272.0	
26348	chr4	128853948	128854873	925	462.0	
26349	chr4	128861803	128863916	2113	1056.0	
26350	chr4	128908701	128909137	436	218.0	
26351	chr4	128913059	128913656	597	298.0	
26352	chr4	128916491	128918275	1784	892.0	
26353	chr4	128958070	128958666	596	298.0	
26354	chr4	129089676	129089902	226	113.0	
26355	chr4	129090643	129094649	4006	2003.0	
26356	chr4	129095834	129096737	903	452.0	
26357	chr4	129326760	129328634	1874	937.0	
26358	chr4	129342694	129343329	635	318.0	
26359	chr4	129343990	129344352	362	181.0	
26360	chr4	129345549	129346467	918	459.0	
26361	chr4	129362676	129363080	404	202.0	
26362	chr4	129532685	129533106	421	210.0	
26363	chr4	129641243	129641589	346	173.0	
26364	chr4	131724925	131725279	354	177.0	
26365	chr4	131974971	131975036	65	32.0	
26366	chr4	131975557	131976439	882	441.0	
26367	chr4	136650907	136651256	349	174.0	
26368	chr4	137532330	137532792	462	231.0	
26369	chr4	138035611	138036126	515	258.0	
26370	chr4	138090489	138090796	307	154.0	
26371	chr4	138114425	138114828	403	202.0	
26372	chr4	138190278	138190818	540	270.0	
26373	chr4	138223379	138223493	114	57.0	
26374	chr4	138235444	138236098	654	327.0	
26375	chr4	138241817	138242912	1095	548.0	
26376	chr4	138298539	138299285	746	373.0	
26377	chr4	138305106	138305512	406	203.0	
26378	chr4	138307225	138307816	591	296.0	
26379	chr4	138328187	138328341	154	77.0	
26380	chr4	138392532	138393343	811	406.0	
26381	chr4	138405357	138407166	1809	904.0	
26382	chr4	138680956	138681395	439	220.0	
26383	chr4	138775803	138776330	527	264.0	
26384	chr4	138871031	138871438	407	204.0	
26385	chr4	138894733	138895116	383	192.0	
26386	chr4	138919117	138919501	384	192.0	
26387	chr4	138953852	138954463	611	306.0	
26388	chr4	138958506	138959773	1267	634.0	
26389	chr4	138963548	138963684	136	68.0	
26390	chr4	138967197	138967851	654	327.0	
26391	chr4	138973208	138973615	407	204.0	
26392	chr4	138977373	138977993	620	310.0	
26393	chr4	138981807	138982316	509	254.0	
26394	chr4	138983320	138983321	1	0.0	
26395	chr4	138999706	139000102	396	198.0	
26396	chr4	139001366	139001878	512	256.0	
26397	chr4	139013845	139017054	3209	1604.0	
26398	chr4	139017787	139022186	4399	2200.0	
26399	chr4	139022886	139023270	384	192.0	
26400	chr4	139024503	139025218	715	358.0	
26401	chr4	139028296	139028615	319	160.0	
26402	chr4	139030050	139031871	1821	910.0	
26403	chr4	139033260	139033852	592	296.0	
26404	chr4	139034654	139035280	626	313.0	
26405	chr4	139038663	139038952	289	144.0	
26406	chr4	139041993	139042033	40	20.0	
26407	chr4	139042968	139043321	353	176.0	
26408	chr4	139044478	139045239	761	380.0	
26409	chr4	139082351	139085748	3397	1698.0	
26410	chr4	139099310	139099862	552	276.0	
26411	chr4	139137798	139138044	246	123.0	
26412	chr4	139144297	139145027	730	365.0	
26413	chr4	139163733	139163759	26	13.0	
26414	chr4	139167595	139168452	857	428.0	
26415	chr4	139174500	139175041	541	270.0	
26416	chr4	139175560	139179197	3637	1818.0	
26417	chr4	139188660	139189773	1113	556.0	
26418	chr4	139207195	139209808	2613	1306.0	
26419	chr4	139213914	139214762	848	424.0	
26420	chr4	139227736	139228208	472	236.0	
26421	chr4	139229403	139229858	455	228.0	
26422	chr4	139237891	139238335	444	222.0	
26423	chr4	139261187	139261233	46	23.0	
26424	chr4	139266362	139267353	991	496.0	
26425	chr4	139279006	139280530	1524	762.0	
26426	chr4	139294783	139296489	1706	853.0	
26427	chr4	139300465	139303003	2538	1269.0	
26428	chr4	139312933	139313413	480	240.0	
26429	chr4	139314130	139314452	322	161.0	
26430	chr4	139315262	139315586	324	162.0	
26431	chr4	139414893	139414983	90	45.0	
26432	chr4	139416030	139416526	496	248.0	
26433	chr4	139419156	139419902	746	373.0	
26434	chr4	139452637	139456542	3905	1952.0	
26435	chr4	139484723	139485196	473	236.0	
26436	chr4	139497897	139498130	233	116.0	
26437	chr4	139521943	139522658	715	358.0	
26438	chr4	139525416	139525769	353	176.0	
26439	chr4	139528392	139529136	744	372.0	
26440	chr4	139530763	139531306	543	272.0	
26441	chr4	139552435	139553025	590	295.0	
26442	chr4	139554138	139554160	22	11.0	
26443	chr4	139554690	139558153	3463	1732.0	
26444	chr4	139559631	139561436	1805	902.0	
26445	chr4	139564524	139564861	337	168.0	
26446	chr4	139598430	139598742	312	156.0	
26447	chr4	139603565	139604015	450	225.0	
26448	chr4	139606517	139607117	600	300.0	
26449	chr4	139619688	139619957	269	134.0	
26450	chr4	139651259	139652036	777	388.0	
26451	chr4	139655064	139655425	361	180.0	
26452	chr4	139656952	139658666	1714	857.0	
26453	chr4	139660436	139661000	564	282.0	
26454	chr4	139665449	139667440	1991	996.0	
26455	chr4	139674824	139676099	1275	638.0	
26456	chr4	139683362	139683394	32	16.0	
26457	chr4	139692312	139693023	711	356.0	
26458	chr4	139734060	139736996	2936	1468.0	
26459	chr4	139737990	139738391	401	200.0	
26460	chr4	139740160	139741411	1251	626.0	
26461	chr4	139742441	139742679	238	119.0	
26462	chr4	139767178	139767711	533	266.0	
26463	chr4	139786991	139787330	339	170.0	
26464	chr4	139789307	139789442	135	68.0	
26465	chr4	139798473	139798672	199	100.0	
26466	chr4	139808419	139808638	219	110.0	
26467	chr4	139814126	139814548	422	211.0	
26468	chr4	139815886	139816398	512	256.0	
26469	chr4	139829215	139829898	683	342.0	
26470	chr4	139841509	139841962	453	226.0	
26471	chr4	139843621	139844300	679	340.0	
26472	chr4	139863557	139863989	432	216.0	
26473	chr4	139872117	139872860	743	372.0	
26474	chr4	139890762	139891281	519	260.0	
26475	chr4	139898226	139898658	432	216.0	
26476	chr4	139903776	139904286	510	255.0	
26477	chr4	139946717	139947549	832	416.0	
26478	chr4	139950466	139951516	1050	525.0	
26479	chr4	139967329	139967962	633	316.0	
26480	chr4	139975690	139976409	719	360.0	
26481	chr4	139978517	139979234	717	358.0	
26482	chr4	140012536	140013065	529	264.0	
26483	chr4	140027120	140027533	413	206.0	
26484	chr4	140048826	140050053	1227	614.0	
26485	chr4	140052127	140052462	335	168.0	
26486	chr4	140053722	140054519	797	398.0	
26487	chr4	140057717	140058045	328	164.0	
26488	chr4	140069075	140069501	426	213.0	
26489	chr4	140070272	140071159	887	444.0	
26490	chr4	140071725	140072340	615	308.0	
26491	chr4	140088357	140088755	398	199.0	
26492	chr4	140090861	140091710	849	424.0	
26493	chr4	140092384	140093412	1028	514.0	
26494	chr4	140094379	140096775	2396	1198.0	
26495	chr4	140098376	140098909	533	266.0	
26496	chr4	140099900	140100477	577	288.0	
26497	chr4	140102489	140102716	227	114.0	
26498	chr4	140103533	140104245	712	356.0	
26499	chr4	140116478	140116936	458	229.0	
26500	chr4	140130671	140131072	401	200.0	
26501	chr4	140136468	140136952	484	242.0	
26502	chr4	140149876	140154936	5060	2530.0	
26503	chr4	140155793	140157296	1503	752.0	
26504	chr4	140162861	140163316	455	228.0	
26505	chr4	140172990	140173319	329	164.0	
26506	chr4	140174510	140175008	498	249.0	
26507	chr4	140237376	140238768	1392	696.0	
26508	chr4	140242817	140243803	986	493.0	
26509	chr4	140250937	140251500	563	282.0	
26510	chr4	140252163	140253744	1581	790.0	
26511	chr4	140331236	140331702	466	233.0	
26512	chr4	140359587	140360521	934	467.0	
26513	chr4	140372542	140374532	1990	995.0	
26514	chr4	140426986	140428071	1085	542.0	
26515	chr4	140497994	140498485	491	246.0	
26516	chr4	140523353	140524988	1635	818.0	
26517	chr4	140556662	140557165	503	252.0	
26518	chr4	140568679	140569153	474	237.0	
26519	chr4	140610051	140610410	359	180.0	
26520	chr4	140637852	140638235	383	192.0	
26521	chr4	140697979	140698327	348	174.0	
26522	chr4	140718086	140719825	1739	870.0	
26523	chr4	140720527	140721491	964	482.0	
26524	chr4	140727912	140728356	444	222.0	
26525	chr4	140742310	140743881	1571	786.0	
26526	chr4	140753377	140753644	267	134.0	
26527	chr4	140755583	140757572	1989	994.0	
26528	chr4	140789575	140791418	1843	922.0	
26529	chr4	140800642	140801148	506	253.0	
26530	chr4	140806060	140806531	471	236.0	
26531	chr4	140807737	140808391	654	327.0	
26532	chr4	140809668	140810126	458	229.0	
26533	chr4	140829747	140830266	519	260.0	
26534	chr4	140837747	140838080	333	166.0	
26535	chr4	140850981	140851433	452	226.0	
26536	chr4	140861340	140861755	415	208.0	
26537	chr4	140863196	140863624	428	214.0	
26538	chr4	140884451	140884820	369	184.0	
26539	chr4	141133009	141133796	787	394.0	
26540	chr4	141220278	141221811	1533	766.0	
26541	chr4	141294342	141294716	374	187.0	
26542	chr4	141307096	141307831	735	368.0	
26543	chr4	141311761	141312309	548	274.0	
26544	chr4	141325083	141325185	102	51.0	
26545	chr4	141328791	141329632	841	420.0	
26546	chr4	141333395	141334153	758	379.0	
26547	chr4	141346177	141346516	339	170.0	
26548	chr4	141347637	141349039	1402	701.0	
26549	chr4	141352404	141353688	1284	642.0	
26550	chr4	141484295	141484714	419	210.0	
26551	chr4	141604894	141604919	25	12.0	
26552	chr4	141631107	141631193	86	43.0	
26553	chr4	141635709	141637483	1774	887.0	
26554	chr4	141640620	141641166	546	273.0	
26555	chr4	141642098	141642666	568	284.0	
26556	chr4	141648128	141648234	106	53.0	
26557	chr4	141705996	141706359	363	182.0	
26558	chr4	142126863	142127301	438	219.0	
26559	chr4	142282856	142283257	401	200.0	
26560	chr4	142285317	142285671	354	177.0	
26561	chr4	142353059	142353745	686	343.0	
26562	chr4	142354759	142355848	1089	544.0	
26563	chr4	142356409	142357198	789	394.0	
26564	chr4	142377349	142377669	320	160.0	
26565	chr4	142401875	142402266	391	196.0	
26566	chr4	142403046	142403233	187	94.0	
26567	chr4	142404195	142407667	3472	1736.0	
26568	chr4	142416558	142417416	858	429.0	
26569	chr4	142434500	142434871	371	186.0	
26570	chr4	142485362	142486188	826	413.0	
26571	chr4	142565558	142568441	2883	1442.0	
26572	chr4	142696556	142696966	410	205.0	
26573	chr4	142704032	142704058	26	13.0	
26574	chr4	142720146	142720532	386	193.0	
26575	chr4	142845406	142847712	2306	1153.0	
26576	chr4	142961313	142962369	1056	528.0	
26577	chr4	143021335	143021776	441	220.0	
26578	chr4	143023516	143023870	354	177.0	
26579	chr4	143025051	143025697	646	323.0	
26580	chr4	143183782	143187122	3340	1670.0	
26581	chr4	143187723	143189824	2101	1050.0	
26582	chr4	143230624	143231156	532	266.0	
26583	chr4	143289474	143289608	134	67.0	
26584	chr4	143335534	143338058	2524	1262.0	
26585	chr4	143347717	143348010	293	146.0	
26586	chr4	143357406	143357771	365	182.0	
26587	chr4	143358750	143359795	1045	522.0	
26588	chr4	143375674	143376051	377	188.0	
26589	chr4	143377586	143378015	429	214.0	
26590	chr4	143399342	143399755	413	206.0	
26591	chr4	143403406	143403758	352	176.0	
26592	chr4	143404579	143405563	984	492.0	
26593	chr4	143512601	143515427	2826	1413.0	
26594	chr4	143517676	143517911	235	118.0	
26595	chr4	143521084	143521514	430	215.0	
26596	chr4	143531437	143531745	308	154.0	
26597	chr4	143539036	143539270	234	117.0	
26598	chr4	143558328	143560268	1940	970.0	
26599	chr4	143773948	143774399	451	226.0	
26600	chr4	143907834	143907973	139	70.0	
26601	chr4	143911989	143912470	481	240.0	
26602	chr4	143921181	143921575	394	197.0	
26603	chr4	144142950	144143288	338	169.0	
26604	chr4	144174365	144174850	485	242.0	
26605	chr4	144356324	144356671	347	174.0	enhancer
26606	chr4	144645650	144647312	1662	831.0	
26607	chr4	145012816	145013243	427	214.0	
26608	chr4	145019362	145019731	369	184.0	
26609	chr4	145061320	145061738	418	209.0	
26610	chr4	145097268	145100023	2755	1378.0	
26611	chr4	145103438	145103958	520	260.0	
26612	chr4	145125804	145126628	824	412.0	
26613	chr4	145132423	145132957	534	267.0	
26614	chr4	145136117	145136631	514	257.0	
26615	chr4	145154564	145154987	423	212.0	
26616	chr4	145177102	145181399	4297	2148.0	
26617	chr4	145186633	145187194	561	280.0	
26618	chr4	145195138	145195508	370	185.0	
26619	chr4	145234060	145234548	488	244.0	
26620	chr4	145480255	145480725	470	235.0	
26621	chr4	145481417	145483239	1822	911.0	
26622	chr4	145487577	145488105	528	264.0	
26623	chr4	145557638	145558065	427	214.0	
26624	chr4	145609748	145610268	520	260.0	
26625	chr4	145613517	145614050	533	266.0	
26626	chr4	145616863	145617322	459	230.0	
26627	chr4	145618155	145620138	1983	992.0	
26628	chr4	145620755	145621002	247	124.0	
26629	chr4	145623855	145624480	625	312.0	
26630	chr4	145626293	145626664	371	186.0	
26631	chr4	145732657	145733953	1296	648.0	
26632	chr4	145734711	145735072	361	180.0	
26633	chr4	145769572	145770124	552	276.0	
26634	chr4	145785390	145785864	474	237.0	
26635	chr4	145795527	145796738	1211	606.0	
26636	chr4	145808304	145808698	394	197.0	
26637	chr4	145820365	145820824	459	230.0	
26638	chr4	145822685	145822751	66	33.0	
26639	chr4	145830938	145830976	38	19.0	
26640	chr4	145840132	145840572	440	220.0	
26641	chr4	145909285	145909816	531	266.0	
26642	chr4	145934344	145934919	575	288.0	
26643	chr4	145935545	145939706	4161	2080.0	
26644	chr4	145956281	145956724	443	222.0	
26645	chr4	145957297	145957517	220	110.0	
26646	chr4	146029896	146030331	435	218.0	
26647	chr4	146049582	146050204	622	311.0	
26648	chr4	146059031	146060409	1378	689.0	
26649	chr4	146062405	146062422	17	8.0	
26650	chr4	146072406	146072682	276	138.0	
26651	chr4	146095309	146095451	142	71.0	
26652	chr4	146105072	146106443	1371	686.0	
26653	chr4	146108749	146109122	373	186.0	
26654	chr4	146110781	146111287	506	253.0	
26655	chr4	146143731	146144351	620	310.0	
26656	chr4	146175138	146177328	2190	1095.0	
26657	chr4	146232565	146232629	64	32.0	
26658	chr4	146235506	146236140	634	317.0	
26659	chr4	146241545	146242362	817	408.0	
26660	chr4	146243208	146243915	707	354.0	
26661	chr4	146288161	146288626	465	232.0	
26662	chr4	146333462	146333974	512	256.0	
26663	chr4	146450674	146450778	104	52.0	
26664	chr4	146458436	146458883	447	224.0	
26665	chr4	146511319	146511801	482	241.0	
26666	chr4	146520771	146523255	2484	1242.0	
26667	chr4	146916535	146916845	310	155.0	
26668	chr4	146945244	146946403	1159	580.0	
26669	chr4	147059360	147059662	302	151.0	
26670	chr4	147097022	147097366	344	172.0	
26671	chr4	147518896	147519201	305	152.0	
26672	chr4	147616752	147618464	1712	856.0	
26673	chr4	147679194	147679345	151	76.0	
26674	chr4	147683018	147685019	2001	1000.0	
26675	chr4	147689285	147689446	161	80.0	
26676	chr4	147707932	147708623	691	346.0	
26677	chr4	147730815	147733442	2627	1314.0	
26678	chr4	147741717	147742343	626	313.0	
26679	chr4	147768023	147768497	474	237.0	
26680	chr4	147779437	147780947	1510	755.0	
26681	chr4	147782340	147782608	268	134.0	
26682	chr4	147786001	147786374	373	186.0	
26683	chr4	147792614	147793152	538	269.0	
26684	chr4	147799789	147800691	902	451.0	
26685	chr4	147808995	147809543	548	274.0	
26686	chr4	147815811	147815954	143	72.0	
26687	chr4	147825980	147826502	522	261.0	
26688	chr4	147828355	147828837	482	241.0	
26689	chr4	147831668	147832960	1292	646.0	
26690	chr4	147833816	147834024	208	104.0	
26691	chr4	147846330	147846753	423	212.0	
26692	chr4	147866691	147867442	751	376.0	
26693	chr4	147933432	147933698	266	133.0	
26694	chr4	147942757	147943738	981	490.0	
26695	chr4	147944307	147944917	610	305.0	
26696	chr4	147983982	147984373	391	196.0	
26697	chr4	148007241	148008274	1033	516.0	
26698	chr4	148044989	148045369	380	190.0	
26699	chr4	148052373	148053081	708	354.0	enhancer
26700	chr4	148054273	148054907	634	317.0	enhancer
26701	chr4	148056686	148057729	1043	522.0	
26702	chr4	148060433	148061424	991	496.0	
26703	chr4	148216671	148217631	960	480.0	
26704	chr4	148355436	148355799	363	182.0	
26705	chr4	148375913	148376576	663	332.0	
26706	chr4	148441510	148448198	6688	3344.0	
26707	chr4	149980859	149981245	386	193.0	
26708	chr4	150038591	150039099	508	254.0	
26709	chr4	150039784	150040218	434	217.0	
26710	chr4	150078013	150079642	1629	814.0	
26711	chr4	150126120	150127144	1024	512.0	
26712	chr4	150135638	150135731	93	46.0	
26713	chr4	150242857	150243224	367	184.0	
26714	chr4	150298083	150298236	153	76.0	
26715	chr4	150827201	150828809	1608	804.0	
26716	chr4	150851955	150852638	683	342.0	
26717	chr4	150866995	150867495	500	250.0	
26718	chr4	150885140	150885793	653	326.0	
26719	chr4	150909300	150909480	180	90.0	
26720	chr4	150960826	150961229	403	202.0	
26721	chr4	151012806	151013265	459	230.0	
26722	chr4	151014270	151016872	2602	1301.0	
26723	chr4	151031988	151032128	140	70.0	
26724	chr4	151098090	151100837	2747	1374.0	
26725	chr4	151105744	151105940	196	98.0	
26726	chr4	151117310	151117818	508	254.0	
26727	chr4	151362624	151363189	565	282.0	
26728	chr4	151403561	151404095	534	267.0	
26729	chr4	151407559	151410322	2763	1382.0	
26730	chr4	151419348	151419502	154	77.0	
26731	chr4	151420453	151420599	146	73.0	
26732	chr4	151760311	151761771	1460	730.0	
26733	chr4	151801547	151801999	452	226.0	
26734	chr4	151852950	151853425	475	238.0	
26735	chr4	151854402	151854428	26	13.0	
26736	chr4	151865208	151866961	1753	876.0	
26737	chr4	151887434	151887944	510	255.0	
26738	chr4	151905205	151905554	349	174.0	
26739	chr4	151991064	151991409	345	172.0	
26740	chr4	152010716	152011168	452	226.0	
26741	chr4	152014171	152014736	565	282.0	
26742	chr4	152063775	152064250	475	238.0	
26743	chr4	152079559	152080343	784	392.0	
26744	chr4	152098800	152101778	2978	1489.0	
26745	chr4	152102306	152102618	312	156.0	
26746	chr4	152106091	152106620	529	264.0	
26747	chr4	152112842	152113290	448	224.0	
26748	chr4	152115333	152116480	1147	574.0	
26749	chr4	152183494	152184071	577	288.0	
26750	chr4	152246767	152246893	126	63.0	
26751	chr4	152255358	152255895	537	268.0	
26752	chr4	152352797	152352934	137	68.0	
26753	chr4	152357347	152357564	217	108.0	
26754	chr4	152359622	152360069	447	224.0	
26755	chr4	152394849	152395129	280	140.0	
26756	chr4	152399188	152399732	544	272.0	
26757	chr4	152408491	152409019	528	264.0	
26758	chr4	152424744	152425488	744	372.0	
26759	chr4	152434058	152434361	303	152.0	
26760	chr4	152454383	152454784	401	200.0	
26761	chr4	152458607	152459650	1043	522.0	
26762	chr4	152460451	152460923	472	236.0	
26763	chr4	152461972	152462393	421	210.0	
26764	chr4	152464355	152464820	465	232.0	
26765	chr4	152467098	152467527	429	214.0	
26766	chr4	152468386	152468797	411	206.0	
26767	chr4	152476659	152477303	644	322.0	
26768	chr4	152485547	152486343	796	398.0	
26769	chr4	152500582	152501650	1068	534.0	
26770	chr4	152505604	152505913	309	154.0	
26771	chr4	152509616	152511188	1572	786.0	
26772	chr4	152512523	152512926	403	202.0	
26773	chr4	152522519	152522688	169	84.0	
26774	chr4	152524266	152524892	626	313.0	
26775	chr4	152530627	152531010	383	192.0	
26776	chr4	152532459	152533202	743	372.0	
26777	chr4	152534222	152538193	3971	1986.0	
26778	chr4	152540347	152540676	329	164.0	
26779	chr4	152552063	152552655	592	296.0	
26780	chr4	152554057	152554935	878	439.0	
26781	chr4	152556342	152556743	401	200.0	
26782	chr4	152572690	152573151	461	230.0	
26783	chr4	152577679	152578292	613	306.0	
26784	chr4	152584975	152585354	379	190.0	
26785	chr4	152586697	152586927	230	115.0	
26786	chr4	152621157	152621280	123	62.0	
26787	chr4	152635714	152636548	834	417.0	
26788	chr4	152638354	152638528	174	87.0	
26789	chr4	152640085	152640750	665	332.0	
26790	chr4	152643058	152644227	1169	584.0	
26791	chr4	152662678	152664298	1620	810.0	
26792	chr4	152676036	152676360	324	162.0	
26793	chr4	152678687	152680585	1898	949.0	
26794	chr4	152684031	152684399	368	184.0	
26795	chr4	152689796	152690173	377	188.0	
26796	chr4	152696639	152697605	966	483.0	
26797	chr4	152734339	152735721	1382	691.0	
26798	chr4	152778117	152780867	2750	1375.0	
26799	chr4	152786112	152786629	517	258.0	
26800	chr4	152820461	152820754	293	146.0	
26801	chr4	152839971	152840063	92	46.0	
26802	chr4	152846661	152847287	626	313.0	
26803	chr4	152850203	152850868	665	332.0	
26804	chr4	152935774	152938138	2364	1182.0	
26805	chr4	152957551	152957781	230	115.0	
26806	chr4	153008535	153009000	465	232.0	
26807	chr4	153045290	153045702	412	206.0	
26808	chr4	153080041	153080313	272	136.0	
26809	chr4	153082255	153082656	401	200.0	
26810	chr4	153083203	153083883	680	340.0	
26811	chr4	153084930	153085814	884	442.0	
26812	chr4	153112073	153112450	377	188.0	
26813	chr4	153113351	153116709	3358	1679.0	
26814	chr4	153127682	153128342	660	330.0	
26815	chr4	153129291	153129709	418	209.0	
26816	chr4	153134127	153135255	1128	564.0	
26817	chr4	153138705	153139227	522	261.0	
26818	chr4	153142903	153143515	612	306.0	
26819	chr4	153151368	153154444	3076	1538.0	
26820	chr4	153156270	153156719	449	224.0	
26821	chr4	153159153	153159354	201	100.0	
26822	chr4	153205003	153205777	774	387.0	
26823	chr4	153222054	153223636	1582	791.0	
26824	chr4	153248608	153250006	1398	699.0	
26825	chr4	153318750	153319087	337	168.0	
26826	chr4	153341641	153342241	600	300.0	
26827	chr4	153344100	153346000	1900	950.0	
26828	chr4	153364997	153365353	356	178.0	
26829	chr4	153419713	153420026	313	156.0	
26830	chr4	153426195	153426969	774	387.0	
26831	chr4	153429194	153429548	354	177.0	
26832	chr4	153432699	153434203	1504	752.0	
26833	chr4	153438737	153440734	1997	998.0	
26834	chr4	153449852	153450909	1057	528.0	
26835	chr4	153451751	153452256	505	252.0	
26836	chr4	153453398	153453889	491	246.0	
26837	chr4	153464893	153469800	4907	2454.0	
26838	chr4	153470736	153473384	2648	1324.0	
26839	chr4	153480238	153481148	910	455.0	
26840	chr4	153483410	153484078	668	334.0	
26841	chr4	153486332	153490122	3790	1895.0	
26842	chr4	153490842	153491243	401	200.0	
26843	chr4	153493038	153494114	1076	538.0	
26844	chr4	153496494	153498879	2385	1192.0	
26845	chr4	153514706	153515296	590	295.0	
26846	chr4	153518379	153520143	1764	882.0	
26847	chr4	153520714	153524415	3701	1850.0	
26848	chr4	153525076	153525734	658	329.0	
26849	chr4	153526530	153527008	478	239.0	
26850	chr4	153527570	153528079	509	254.0	
26851	chr4	153528691	153531205	2514	1257.0	
26852	chr4	153536121	153536514	393	196.0	
26853	chr4	153560984	153561125	141	70.0	
26854	chr4	153573761	153574911	1150	575.0	
26855	chr4	153576141	153576529	388	194.0	
26856	chr4	153579993	153580165	172	86.0	
26857	chr4	153609062	153609463	401	200.0	
26858	chr4	153622941	153623579	638	319.0	
26859	chr4	153634698	153635189	491	246.0	
26860	chr4	153635818	153636261	443	222.0	
26861	chr4	153643153	153644386	1233	616.0	
26862	chr4	153645497	153645501	4	2.0	
26863	chr4	153648258	153648395	137	68.0	
26864	chr4	153649696	153649868	172	86.0	
26865	chr4	153651018	153653022	2004	1002.0	
26866	chr4	153654835	153656872	2037	1018.0	
26867	chr4	153661180	153661937	757	378.0	
26868	chr4	153676856	153677471	615	308.0	
26869	chr4	153679484	153680008	524	262.0	
26870	chr4	153683732	153685337	1605	802.0	
26871	chr4	153705994	153706561	567	284.0	
26872	chr4	153728520	153729102	582	291.0	
26873	chr4	153741502	153741996	494	247.0	
26874	chr4	153747354	153747923	569	284.0	
26875	chr4	153749998	153750651	653	326.0	
26876	chr4	153757700	153757750	50	25.0	
26877	chr4	153759721	153760381	660	330.0	
26878	chr4	153790880	153791407	527	264.0	
26879	chr4	153792296	153792847	551	276.0	
26880	chr4	153809221	153809766	545	272.0	
26881	chr4	153950138	153950460	322	161.0	
26882	chr4	154332847	154333575	728	364.0	
26883	chr4	154416448	154417283	835	418.0	
26884	chr4	154491668	154492029	361	180.0	
26885	chr4	154549537	154550975	1438	719.0	
26886	chr4	154552031	154552536	505	252.0	
26887	chr4	154559382	154559790	408	204.0	
26888	chr4	154616741	154617083	342	171.0	
26889	chr4	154618686	154619110	424	212.0	
26890	chr4	154622604	154623053	449	224.0	
26891	chr4	154626736	154627180	444	222.0	
26892	chr4	154743730	154744235	505	252.0	
26893	chr4	155353952	155354328	376	188.0	
26894	chr4	155371462	155371894	432	216.0	
26895	chr4	155376128	155377584	1456	728.0	
26896	chr4	155378295	155378628	333	166.0	
26897	chr4	155442249	155442679	430	215.0	
26898	chr4	155639678	155640338	660	330.0	
26899	chr4	155666743	155668461	1718	859.0	
26900	chr4	155675760	155676592	832	416.0	
26901	chr4	155679395	155679721	326	163.0	
26902	chr4	155685180	155685251	71	36.0	
26903	chr4	155758507	155760312	1805	902.0	
26904	chr4	155768975	155769494	519	260.0	
26905	chr4	155787067	155787561	494	247.0	
26906	chr4	155809767	155810229	462	231.0	
26907	chr4	155953006	155954533	1527	764.0	
26908	chr4	156329752	156330951	1199	600.0	
26909	chr4	156515529	156515628	99	50.0	
26910	chr4	156775824	156776199	375	188.0	
26911	chr4	156829127	156829670	543	272.0	
26912	chr4	156898283	156898821	538	269.0	
26913	chr4	156915315	156915601	286	143.0	
26914	chr4	156939767	156940168	401	200.0	
26915	chr4	156946604	156946785	181	90.0	
26916	chr4	156954553	156954954	401	200.0	
26917	chr4	156956929	156957320	391	196.0	
26918	chr4	156966777	156967198	421	210.0	
26919	chr4	156968427	156969212	785	392.0	
26920	chr4	156970375	156972667	2292	1146.0	
26921	chr4	157045549	157045885	336	168.0	
26922	chr4	157978702	157979174	472	236.0	
26923	chr4	157983295	157983691	396	198.0	
26924	chr4	157986470	157986861	391	196.0	
26925	chr4	157988743	157989088	345	172.0	
26926	chr4	157992021	157992832	811	406.0	
26927	chr4	158006840	158007452	612	306.0	
26928	chr4	158033327	158033741	414	207.0	
26929	chr4	158121124	158121591	467	234.0	
26930	chr4	158159071	158159463	392	196.0	
26931	chr4	158161301	158162135	834	417.0	
26932	chr4	158167475	158167814	339	170.0	
26933	chr4	158169818	158171574	1756	878.0	
26934	chr4	158172477	158173206	729	364.0	
26935	chr4	158193227	158193498	271	136.0	
26936	chr4	158208893	158210793	1900	950.0	
26937	chr4	158235701	158235975	274	137.0	
26938	chr4	158250312	158250764	452	226.0	
26939	chr4	158253353	158253789	436	218.0	
26940	chr4	158255744	158256101	357	178.0	
26941	chr4	158513202	158513607	405	202.0	
26942	chr4	158535233	158535767	534	267.0	
26943	chr4	158538891	158539310	419	210.0	
26944	chr4	158542320	158542967	647	324.0	
26945	chr4	158599164	158599476	312	156.0	
26946	chr4	158609180	158609345	165	82.0	
26947	chr4	158610700	158611285	585	292.0	
26948	chr4	158624874	158625312	438	219.0	
26949	chr4	158663159	158664407	1248	624.0	
26950	chr4	158667561	158668144	583	292.0	
26951	chr4	158670792	158673177	2385	1192.0	
26952	chr4	158714989	158715081	92	46.0	
26953	chr4	158722193	158724324	2131	1066.0	
26954	chr4	158729727	158730411	684	342.0	
26955	chr4	158766324	158767510	1186	593.0	
26956	chr4	158768196	158770223	2027	1014.0	
26957	chr4	158777853	158778559	706	353.0	
26958	chr4	158783805	158784314	509	254.0	
26959	chr4	158787693	158788818	1125	562.0	
26960	chr4	158796769	158797120	351	176.0	
26961	chr4	158805496	158806309	813	406.0	
26962	chr4	158807580	158808691	1111	556.0	
26963	chr4	158809427	158812373	2946	1473.0	
26964	chr4	158817033	158818568	1535	768.0	
26965	chr4	158821311	158821605	294	147.0	
26966	chr4	158850585	158851218	633	316.0	
26967	chr4	158856822	158857296	474	237.0	
26968	chr4	158870553	158871118	565	282.0	
26969	chr4	158873943	158874495	552	276.0	
26970	chr4	158895809	158897089	1280	640.0	
26971	chr4	158902520	158903046	526	263.0	
26972	chr4	158906016	158906449	433	216.0	
26973	chr4	158929853	158930640	787	394.0	
26974	chr4	158935967	158936717	750	375.0	
26975	chr4	158940288	158940654	366	183.0	
26976	chr4	158941499	158941501	2	1.0	
26977	chr4	158949049	158949712	663	332.0	
26978	chr4	158993884	158994036	152	76.0	
26979	chr4	159017978	159018462	484	242.0	
26980	chr4	159077589	159078131	542	271.0	
26981	chr4	159101101	159106329	5228	2614.0	
26982	chr4	159117896	159118411	515	258.0	
26983	chr4	159174126	159174161	35	18.0	
26984	chr4	159175217	159176159	942	471.0	
26985	chr4	159177524	159179910	2386	1193.0	
26986	chr4	159190505	159190826	321	160.0	
26987	chr4	159202736	159203405	669	334.0	
26988	chr4	159205600	159205639	39	20.0	
26989	chr4	159206383	159206825	442	221.0	
26990	chr4	159239842	159241215	1373	686.0	
26991	chr4	159267443	159267667	224	112.0	
26992	chr4	159271767	159272228	461	230.0	
26993	chr4	159274712	159275177	465	232.0	
26994	chr4	159278264	159278939	675	338.0	
26995	chr4	159400963	159401724	761	380.0	
26996	chr4	159446428	159446957	529	264.0	
26997	chr4	159487313	159487590	277	138.0	
26998	chr4	161419780	161420166	386	193.0	
26999	chr4	161519905	161519959	54	27.0	
27000	chr4	161572936	161573351	415	208.0	
27001	chr4	161581135	161581768	633	316.0	
27002	chr4	161604622	161605003	381	190.0	
27003	chr4	161650745	161651417	672	336.0	
27004	chr4	162274388	162274746	358	179.0	
27005	chr4	162497571	162497973	402	201.0	
27006	chr4	163148516	163149115	599	300.0	
27007	chr4	163152773	163153281	508	254.0	
27008	chr4	163161639	163162293	654	327.0	
27009	chr4	163164493	163167712	3219	1610.0	
27010	chr4	163481991	163482823	832	416.0	
27011	chr4	163484773	163485274	501	250.0	
27012	chr4	163493252	163496382	3130	1565.0	
27013	chr4	163544122	163545239	1117	558.0	
27014	chr4	163548439	163549258	819	410.0	
27015	chr4	163549950	163550929	979	490.0	
27016	chr4	163554855	163555285	430	215.0	
27017	chr4	163556264	163556341	77	38.0	
27018	chr4	163556920	163557399	479	240.0	
27019	chr4	163558374	163559155	781	390.0	
27020	chr4	163568894	163569219	325	162.0	
27021	chr4	163587737	163588246	509	254.0	
27022	chr4	163590567	163592604	2037	1018.0	
27023	chr4	163595544	163596035	491	246.0	
27024	chr4	163600625	163601192	567	284.0	
27025	chr4	163606770	163607780	1010	505.0	
27026	chr4	163610668	163611614	946	473.0	
27027	chr4	163613306	163613857	551	276.0	
27028	chr4	163621779	163622972	1193	596.0	
27029	chr4	163663492	163664257	765	382.0	
27030	chr4	163665422	163666971	1549	774.0	
27031	chr4	163674213	163674728	515	258.0	
27032	chr4	163681163	163681837	674	337.0	
27033	chr4	163754924	163755491	567	284.0	
27034	chr4	163895262	163895975	713	356.0	
27035	chr4	164012639	164013016	377	188.0	
27036	chr4	164731847	164732241	394	197.0	
27037	chr4	164956625	164957397	772	386.0	
27038	chr4	164977409	164977958	549	274.0	
27039	chr4	165111857	165113654	1797	898.0	
27040	chr4	165131152	165131874	722	361.0	
27041	chr4	165133096	165133862	766	383.0	
27042	chr4	165203913	165205086	1173	586.0	
27043	chr4	165206514	165209296	2782	1391.0	
27044	chr4	165222385	165223057	672	336.0	
27045	chr4	165248020	165248648	628	314.0	
27046	chr4	165255257	165256503	1246	623.0	
27047	chr4	165286939	165287356	417	208.0	
27048	chr4	165294547	165295502	955	478.0	
27049	chr4	165299277	165299812	535	268.0	
27050	chr4	165301771	165302322	551	276.0	
27051	chr4	165308121	165308538	417	208.0	
27052	chr4	165321237	165321268	31	16.0	
27053	chr4	165325576	165328513	2937	1468.0	
27054	chr4	165343735	165344057	322	161.0	
27055	chr4	165359511	165359891	380	190.0	
27056	chr4	165378763	165379650	887	444.0	
27057	chr4	165464755	165465204	449	224.0	
27058	chr4	165493289	165493690	401	200.0	
27059	chr4	165610841	165611085	244	122.0	
27060	chr4	165612939	165613363	424	212.0	
27061	chr4	166045428	166045913	485	242.0	
27062	chr4	166165855	166166199	344	172.0	
27063	chr4	167021538	167021938	400	200.0	
27064	chr4	167042298	167042317	19	10.0	
27065	chr4	167221971	167222556	585	292.0	
27066	chr4	167233808	167234714	906	453.0	
27067	chr4	168153882	168154236	354	177.0	
27068	chr4	168257899	168257997	98	49.0	
27069	chr4	168317378	168319238	1860	930.0	
27070	chr4	168450203	168450377	174	87.0	
27071	chr4	168451282	168452099	817	408.0	
27072	chr4	168479666	168482134	2468	1234.0	
27073	chr4	168486904	168487417	513	256.0	
27074	chr4	168503733	168504539	806	403.0	
27075	chr4	168506006	168506471	465	232.0	
27076	chr4	168509606	168510348	742	371.0	
27077	chr4	168511697	168512351	654	327.0	
27078	chr4	168552042	168552406	364	182.0	
27079	chr4	168585543	168585870	327	164.0	
27080	chr4	168710366	168712029	1663	832.0	
27081	chr4	168722955	168723807	852	426.0	
27082	chr4	168741676	168742233	557	278.0	
27083	chr4	168759597	168760404	807	404.0	
27084	chr4	168789599	168790425	826	413.0	
27085	chr4	168797071	168798140	1069	534.0	
27086	chr4	168802984	168803566	582	291.0	
27087	chr4	168806362	168806613	251	126.0	
27088	chr4	168816437	168817214	777	388.0	
27089	chr4	168831082	168833275	2193	1096.0	
27090	chr4	168847754	168848478	724	362.0	
27091	chr4	168853789	168854074	285	142.0	
27092	chr4	168877487	168879807	2320	1160.0	
27093	chr4	168880956	168882198	1242	621.0	
27094	chr4	168907252	168907783	531	266.0	
27095	chr4	168923663	168924156	493	246.0	
27096	chr4	169005719	169006068	349	174.0	
27097	chr4	169009219	169011148	1929	964.0	
27098	chr4	169015685	169016871	1186	593.0	
27099	chr4	169024756	169025199	443	222.0	
27100	chr4	169068442	169068771	329	164.0	
27101	chr4	169079779	169080899	1120	560.0	
27102	chr4	169098458	169099147	689	344.0	
27103	chr4	169210535	169211644	1109	554.0	
27104	chr4	169225495	169225839	344	172.0	
27105	chr4	169245094	169245452	358	179.0	
27106	chr4	169270050	169271742	1692	846.0	
27107	chr4	169272273	169272788	515	258.0	
27108	chr4	169286792	169287289	497	248.0	
27109	chr4	169288011	169288305	294	147.0	
27110	chr4	169293078	169294189	1111	556.0	
27111	chr4	169295746	169296192	446	223.0	
27112	chr4	169311628	169312036	408	204.0	
27113	chr4	169410749	169411242	493	246.0	
27114	chr4	169486185	169486477	292	146.0	
27115	chr4	169492721	169493318	597	298.0	
27116	chr4	169566303	169566689	386	193.0	
27117	chr4	169573936	169574223	287	144.0	
27118	chr4	169611710	169613815	2105	1052.0	
27119	chr4	169618278	169618794	516	258.0	
27120	chr4	169619357	169622947	3590	1795.0	
27121	chr4	169657545	169657885	340	170.0	
27122	chr4	169659604	169660777	1173	586.0	
27123	chr4	169682466	169682710	244	122.0	
27124	chr4	169756700	169758844	2144	1072.0	
27125	chr4	169774722	169775143	421	210.0	
27126	chr4	169791828	169791830	2	1.0	
27127	chr4	169810335	169810721	386	193.0	
27128	chr4	169818400	169818442	42	21.0	
27129	chr4	169823703	169823863	160	80.0	
27130	chr4	169952825	169952843	18	9.0	
27131	chr4	170011978	170012066	88	44.0	
27132	chr4	170025550	170027947	2397	1198.0	
27133	chr4	170047812	170048163	351	176.0	
27134	chr4	170090087	170090233	146	73.0	
27135	chr4	170138620	170138953	333	166.0	
27136	chr4	171644650	171645019	369	184.0	
27137	chr4	172573795	172574342	547	274.0	
27138	chr4	172664766	172664997	231	116.0	
27139	chr4	172758680	172759365	685	342.0	
27140	chr4	172778815	172778941	126	63.0	
27141	chr4	172780623	172780906	283	142.0	
27142	chr4	172786001	172787627	1626	813.0	
27143	chr4	173002759	173003478	719	360.0	
27144	chr4	173013361	173013888	527	264.0	
27145	chr4	173025016	173025625	609	304.0	
27146	chr4	173074569	173074821	252	126.0	
27147	chr4	173088030	173088570	540	270.0	
27148	chr4	173167784	173170506	2722	1361.0	
27149	chr4	173171087	173172316	1229	614.0	
27150	chr4	173174595	173175031	436	218.0	
27151	chr4	173180154	173180591	437	218.0	
27152	chr4	173186130	173186581	451	226.0	
27153	chr4	173231987	173232050	63	32.0	
27154	chr4	173257697	173258176	479	240.0	
27155	chr4	173264612	173265076	464	232.0	
27156	chr4	173281390	173282310	920	460.0	
27157	chr4	173288265	173288723	458	229.0	
27158	chr4	173301378	173302022	644	322.0	
27159	chr4	173317017	173317386	369	184.0	
27160	chr4	173318776	173320071	1295	648.0	
27161	chr4	173331946	173335787	3841	1920.0	
27162	chr4	173365806	173365988	182	91.0	
27163	chr4	173369203	173373235	4032	2016.0	
27164	chr4	173410878	173411494	616	308.0	
27165	chr4	173413050	173413166	116	58.0	
27166	chr4	173415066	173417618	2552	1276.0	
27167	chr4	173418517	173419184	667	334.0	
27168	chr4	173420319	173420726	407	204.0	
27169	chr4	173434206	173434653	447	224.0	
27170	chr4	173490307	173490611	304	152.0	
27171	chr4	173494073	173494832	759	380.0	
27172	chr4	173498001	173498450	449	224.0	
27173	chr4	173500756	173501418	662	331.0	
27174	chr4	173505829	173507129	1300	650.0	
27175	chr4	173508797	173510077	1280	640.0	
27176	chr4	173537811	173539218	1407	704.0	
27177	chr4	173547841	173548299	458	229.0	
27178	chr4	173909225	173909696	471	236.0	
27179	chr4	173910875	173911307	432	216.0	
27180	chr4	174107857	174108100	243	122.0	
27181	chr4	174120483	174120834	351	176.0	
27182	chr4	174213976	174214462	486	243.0	
27183	chr4	174216749	174218196	1447	724.0	
27184	chr4	174222247	174222687	440	220.0	
27185	chr4	174282755	174284898	2143	1072.0	
27186	chr4	174365040	174365397	357	178.0	
27187	chr4	174427747	174427928	181	90.0	
27188	chr4	174520785	174520789	4	2.0	
27189	chr4	174521627	174523396	1769	884.0	
27190	chr4	174528285	174528573	288	144.0	
27191	chr4	174591190	174592059	869	434.0	
27192	chr4	174592937	174593374	437	218.0	
27193	chr4	174613941	174614560	619	310.0	
27194	chr4	174616710	174616985	275	138.0	
27195	chr4	174632163	174632539	376	188.0	
27196	chr4	174928205	174928611	406	203.0	
27197	chr4	175946489	175947144	655	328.0	
27198	chr4	176001440	176002719	1279	640.0	
27199	chr4	176013414	176013889	475	238.0	
27200	chr4	176052634	176053103	469	234.0	
27201	chr4	176065341	176066426	1085	542.0	
27202	chr4	176089981	176090632	651	326.0	
27203	chr4	176123706	176124383	677	338.0	
27204	chr4	176188689	176189052	363	182.0	
27205	chr4	176194189	176194226	37	18.0	
27206	chr4	176195001	176196130	1129	564.0	
27207	chr4	176319132	176321456	2324	1162.0	
27208	chr4	176324875	176325228	353	176.0	
27209	chr4	176340830	176341392	562	281.0	
27210	chr4	176903081	176903279	198	99.0	
27211	chr4	176979469	176979870	401	200.0	
27212	chr4	176981431	176982046	615	308.0	
27213	chr4	177047352	177047725	373	186.0	
27214	chr4	177249954	177250549	595	298.0	
27215	chr4	177259446	177259829	383	192.0	
27216	chr4	177287213	177287547	334	167.0	
27217	chr4	177293661	177293812	151	76.0	
27218	chr4	177307982	177310724	2742	1371.0	
27219	chr4	177315755	177316857	1102	551.0	
27220	chr4	177320195	177320756	561	280.0	
27221	chr4	177339659	177340287	628	314.0	
27222	chr4	177393165	177393667	502	251.0	
27223	chr4	177401773	177402277	504	252.0	
27224	chr4	177440691	177443359	2668	1334.0	
27225	chr4	179990039	179990419	380	190.0	
27226	chr4	180664788	180665148	360	180.0	
27227	chr4	180788720	180789127	407	204.0	
27228	chr4	180794337	180794802	465	232.0	
27229	chr4	181143318	181143565	247	124.0	
27230	chr4	182448666	182449251	585	292.0	
27231	chr4	182806293	182806998	705	352.0	
27232	chr4	182808826	182810096	1270	635.0	
27233	chr4	182916430	182919614	3184	1592.0	
27234	chr4	182925114	182925783	669	334.0	
27235	chr4	182938023	182938537	514	257.0	
27236	chr4	183073512	183073967	455	228.0	
27237	chr4	183097283	183100192	2909	1454.0	
27238	chr4	183183312	183183738	426	213.0	
27239	chr4	183194091	183194116	25	12.0	
27240	chr4	183256762	183257149	387	194.0	
27241	chr4	183261845	183262903	1058	529.0	
27242	chr4	183321066	183321529	463	232.0	
27243	chr4	183342876	183343192	316	158.0	
27244	chr4	183349120	183349123	3	2.0	
27245	chr4	183392223	183392826	603	302.0	
27246	chr4	183396168	183396829	661	330.0	
27247	chr4	183397878	183399989	2111	1056.0	
27248	chr4	183406900	183407779	879	440.0	
27249	chr4	183430624	183431154	530	265.0	
27250	chr4	183443583	183445686	2103	1052.0	
27251	chr4	183447599	183447982	383	192.0	
27252	chr4	183465969	183466226	257	128.0	
27253	chr4	183469344	183469672	328	164.0	
27254	chr4	183472007	183472696	689	344.0	
27255	chr4	183503408	183506853	3445	1722.0	
27256	chr4	183621680	183622361	681	340.0	
27257	chr4	183657582	183660873	3291	1646.0	
27258	chr4	183674120	183674554	434	217.0	
27259	chr4	183721283	183723653	2370	1185.0	
27260	chr4	183797167	183798336	1169	584.0	
27261	chr4	183830579	183830929	350	175.0	
27262	chr4	183840231	183840643	412	206.0	
27263	chr4	183905216	183905602	386	193.0	
27264	chr4	183967320	183967606	286	143.0	
27265	chr4	183987953	183988523	570	285.0	
27266	chr4	183989422	183990061	639	320.0	
27267	chr4	183995593	183995780	187	94.0	
27268	chr4	184028452	184029064	612	306.0	
27269	chr4	184097205	184097688	483	242.0	
27270	chr4	184100297	184100642	345	172.0	
27271	chr4	184168354	184168867	513	256.0	
27272	chr4	184229823	184230756	933	466.0	
27273	chr4	184237648	184237884	236	118.0	
27274	chr4	184250582	184251417	835	418.0	
27275	chr4	184263830	184264774	944	472.0	
27276	chr4	184265623	184265949	326	163.0	
27277	chr4	184267240	184268852	1612	806.0	
27278	chr4	184280160	184281098	938	469.0	
27279	chr4	184282137	184282849	712	356.0	
27280	chr4	184283354	184283430	76	38.0	
27281	chr4	184288355	184288829	474	237.0	
27282	chr4	184292835	184294002	1167	584.0	
27283	chr4	184310089	184310723	634	317.0	
27284	chr4	184313908	184314758	850	425.0	
27285	chr4	184315884	184316403	519	260.0	
27286	chr4	184319394	184319777	383	192.0	
27287	chr4	184328071	184328869	798	399.0	
27288	chr4	184329747	184330585	838	419.0	
27289	chr4	184331468	184332226	758	379.0	
27290	chr4	184333398	184333853	455	228.0	
27291	chr4	184339274	184339964	690	345.0	
27292	chr4	184343397	184348101	4704	2352.0	
27293	chr4	184349239	184349933	694	347.0	
27294	chr4	184354913	184355772	859	430.0	
27295	chr4	184364437	184364655	218	109.0	
27296	chr4	184375624	184375987	363	182.0	
27297	chr4	184382522	184382620	98	49.0	
27298	chr4	184383549	184384958	1409	704.0	
27299	chr4	184385726	184387471	1745	872.0	
27300	chr4	184392704	184393737	1033	516.0	
27301	chr4	184395893	184396356	463	232.0	
27302	chr4	184407006	184407460	454	227.0	
27303	chr4	184409770	184410425	655	328.0	
27304	chr4	184413641	184413947	306	153.0	
27305	chr4	184416930	184418484	1554	777.0	
27306	chr4	184420232	184421778	1546	773.0	
27307	chr4	184437760	184438765	1005	502.0	
27308	chr4	184444839	184445360	521	260.0	
27309	chr4	184448547	184449497	950	475.0	
27310	chr4	184451741	184452050	309	154.0	
27311	chr4	184453292	184454046	754	377.0	
27312	chr4	184457808	184457853	45	22.0	
27313	chr4	184460854	184461333	479	240.0	
27314	chr4	184472122	184477249	5127	2564.0	
27315	chr4	184479476	184480027	551	276.0	
27316	chr4	184503793	184504490	697	348.0	
27317	chr4	184506561	184507151	590	295.0	
27318	chr4	184510214	184510890	676	338.0	
27319	chr4	184514035	184514959	924	462.0	
27320	chr4	184534312	184535900	1588	794.0	
27321	chr4	184536518	184538674	2156	1078.0	
27322	chr4	184583792	184584171	379	190.0	
27323	chr4	184617338	184617963	625	312.0	
27324	chr4	184620478	184620626	148	74.0	
27325	chr4	184625109	184625510	401	200.0	
27326	chr4	184626198	184626730	532	266.0	
27327	chr4	184646972	184650627	3655	1828.0	
27328	chr4	184664428	184664867	439	220.0	
27329	chr4	184668106	184668993	887	444.0	
27330	chr4	184684688	184685231	543	272.0	
27331	chr4	184705727	184705960	233	116.0	
27332	chr4	184733005	184734903	1898	949.0	
27333	chr4	184739455	184740134	679	340.0	
27334	chr4	184745676	184747242	1566	783.0	
27335	chr4	184748381	184748453	72	36.0	
27336	chr4	184761881	184762863	982	491.0	
27337	chr4	184782533	184783451	918	459.0	
27338	chr4	184792701	184793707	1006	503.0	
27339	chr4	184805381	184806302	921	460.0	
27340	chr4	184807441	184808762	1321	660.0	
27341	chr4	184810525	184811202	677	338.0	
27342	chr4	184811712	184812492	780	390.0	
27343	chr4	184813116	184814105	989	494.0	
27344	chr4	184814656	184815891	1235	618.0	
27345	chr4	184816940	184818954	2014	1007.0	
27346	chr4	184819512	184821647	2135	1068.0	
27347	chr4	184822453	184827417	4964	2482.0	
27348	chr4	184833275	184833942	667	334.0	
27349	chr4	184848196	184849035	839	420.0	
27350	chr4	184850365	184851748	1383	692.0	
27351	chr4	184853435	184853880	445	222.0	
27352	chr4	184854540	184856942	2402	1201.0	
27353	chr4	184857477	184858019	542	271.0	
27354	chr4	184859834	184861533	1699	850.0	
27355	chr4	184866485	184866748	263	132.0	
27356	chr4	184889596	184890155	559	280.0	
27357	chr4	184895104	184895700	596	298.0	
27358	chr4	184896644	184898348	1704	852.0	
27359	chr4	184907524	184907589	65	32.0	
27360	chr4	184958892	184959217	325	162.0	
27361	chr4	184963141	184965345	2204	1102.0	
27362	chr4	184967861	184969470	1609	804.0	
27363	chr4	184983690	184984426	736	368.0	
27364	chr4	185004960	185005676	716	358.0	
27365	chr4	185039694	185040241	547	274.0	
27366	chr4	185082735	185082825	90	45.0	
27367	chr4	185127528	185129123	1595	798.0	
27368	chr4	185134380	185134879	499	250.0	
27369	chr4	185142569	185144027	1458	729.0	
27370	chr4	185165518	185165965	447	224.0	
27371	chr4	185183537	185184059	522	261.0	
27372	chr4	185192111	185192392	281	140.0	
27373	chr4	185201855	185204970	3115	1558.0	
27374	chr4	185206014	185206365	351	176.0	
27375	chr4	185208697	185211246	2549	1274.0	
27376	chr4	185213773	185214340	567	284.0	
27377	chr4	185219666	185219945	279	140.0	
27378	chr4	185251315	185251791	476	238.0	
27379	chr4	185254243	185254989	746	373.0	
27380	chr4	185255552	185256710	1158	579.0	
27381	chr4	185258793	185259120	327	164.0	
27382	chr4	185266041	185266370	329	164.0	
27383	chr4	185304912	185305386	474	237.0	
27384	chr4	185394452	185397404	2952	1476.0	
27385	chr4	185398837	185398858	21	10.0	
27386	chr4	185405267	185405680	413	206.0	
27387	chr4	185424845	185426779	1934	967.0	
27388	chr4	185468446	185472235	3789	1894.0	
27389	chr4	185513488	185513878	390	195.0	
27390	chr4	185587241	185588120	879	440.0	
27391	chr4	185597543	185597990	447	224.0	
27392	chr4	185730376	185730787	411	206.0	
27393	chr4	185733954	185734880	926	463.0	
27394	chr4	185735984	185736343	359	180.0	
27395	chr4	185740581	185740742	161	80.0	
27396	chr4	185743872	185744463	591	296.0	
27397	chr4	185887062	185887472	410	205.0	
27398	chr4	186038136	186038590	454	227.0	
27399	chr4	186058663	186059050	387	194.0	
27400	chr4	186068022	186069391	1369	684.0	
27401	chr4	186074304	186074499	195	98.0	
27402	chr4	186104444	186105506	1062	531.0	
27403	chr4	186134335	186134657	322	161.0	
27404	chr4	186149971	186150310	339	170.0	
27405	chr4	186190286	186192708	2422	1211.0	
27406	chr4	186201570	186202308	738	369.0	
27407	chr4	186204282	186204581	299	150.0	
27408	chr4	189279561	189279976	415	208.0	
27409	chr4	189566321	189567579	1258	629.0	
27410	chr4	189622754	189622774	20	10.0	
27411	chr4	189631143	189631931	788	394.0	
27412	chr4	189637204	189637229	25	12.0	
27413	chr4	189647636	189647759	123	62.0	
27414	chr4	189653956	189654159	203	102.0	
27415	chr4	189656336	189657091	755	378.0	
27416	chr4	189658174	189659823	1649	824.0	
27417	chr4	189667442	189667746	304	152.0	
27418	chr4	189668872	189669383	511	256.0	
27419	chr4	189669917	189670430	513	256.0	
27420	chr4	189671094	189671834	740	370.0	
27421	chr4	189674378	189674691	313	156.0	
27422	chr4	189675394	189675435	41	20.0	
27423	chr4	189676354	189676544	190	95.0	
27424	chr4	189689549	189689997	448	224.0	
27425	chr4	189697051	189697068	17	8.0	
27426	chr4	189705319	189705493	174	87.0	
27427	chr4	189707329	189707720	391	196.0	
27428	chr4	189716689	189716739	50	25.0	
27429	chr4	189721623	189721765	142	71.0	
27430	chr4	189725165	189725365	200	100.0	
27431	chr4	189730782	189731028	246	123.0	
27432	chr4	189738981	189739282	301	150.0	
27433	chr4	189792998	189793417	419	210.0	
27434	chr4	189904440	189904799	359	180.0	
27435	chr4	189940007	189941561	1554	777.0	
27436	chr4	189942416	189942987	571	286.0	
27437	chr4	190108420	190108787	367	184.0	
27438	chr4	190109710	190110109	399	200.0	
27439	chr4	190110979	190111892	913	456.0	
27440	chr4	190112476	190112584	108	54.0	
27441	chr4	190122744	190123112	368	184.0	
27442	chr5	12891	13421	530	265.0	
27443	chr5	53875	53886	11	6.0	
27444	chr5	188130	189232	1102	551.0	
27445	chr5	191498	191899	401	200.0	
27446	chr5	217444	221000	3556	1778.0	
27447	chr5	243965	244255	290	145.0	
27448	chr5	270602	272302	1700	850.0	
27449	chr5	297082	297487	405	202.0	
27450	chr5	317095	317544	449	224.0	
27451	chr5	321392	322801	1409	704.0	
27452	chr5	343858	344530	672	336.0	
27453	chr5	360302	361067	765	382.0	
27454	chr5	368579	369418	839	420.0	
27455	chr5	373591	374255	664	332.0	
27456	chr5	392350	393025	675	338.0	
27457	chr5	399643	400416	773	386.0	
27458	chr5	402721	403389	668	334.0	
27459	chr5	424649	425003	354	177.0	
27460	chr5	430938	431344	406	203.0	
27461	chr5	440485	441081	596	298.0	
27462	chr5	442247	443955	1708	854.0	
27463	chr5	446725	447253	528	264.0	
27464	chr5	448084	448932	848	424.0	
27465	chr5	463803	464783	980	490.0	
27466	chr5	471605	475491	3886	1943.0	
27467	chr5	483567	483928	361	180.0	
27468	chr5	485914	486588	674	337.0	
27469	chr5	528295	529256	961	480.0	
27470	chr5	529855	530537	682	341.0	
27471	chr5	543439	544730	1291	646.0	
27472	chr5	548113	548688	575	288.0	
27473	chr5	594090	594668	578	289.0	
27474	chr5	607347	607878	531	266.0	
27475	chr5	611061	613008	1947	974.0	
27476	chr5	669020	669836	816	408.0	
27477	chr5	671351	673502	2151	1076.0	
27478	chr5	692221	694467	2246	1123.0	
27479	chr5	757005	757353	348	174.0	
27480	chr5	757973	759643	1670	835.0	
27481	chr5	783140	785813	2673	1336.0	
27482	chr5	856034	857165	1131	566.0	
27483	chr5	891579	893562	1983	992.0	
27484	chr5	903042	903501	459	230.0	
27485	chr5	912101	913247	1146	573.0	
27486	chr5	923315	923866	551	276.0	
27487	chr5	926870	927303	433	216.0	
27488	chr5	957233	957860	627	314.0	
27489	chr5	960684	960933	249	124.0	
27490	chr5	963514	964326	812	406.0	
27491	chr5	990306	990497	191	96.0	
27492	chr5	997195	997242	47	24.0	
27493	chr5	1004023	1005256	1233	616.0	
27494	chr5	1008312	1009597	1285	642.0	
27495	chr5	1011148	1011489	341	170.0	
27496	chr5	1049314	1049822	508	254.0	
27497	chr5	1057062	1057334	272	136.0	
27498	chr5	1057947	1058561	614	307.0	
27499	chr5	1102273	1113505	11232	5616.0	
27500	chr5	1134379	1135011	632	316.0	
27501	chr5	1137791	1138612	821	410.0	
27502	chr5	1140037	1140948	911	456.0	
27503	chr5	1152048	1152704	656	328.0	
27504	chr5	1153277	1153912	635	318.0	
27505	chr5	1155276	1156351	1075	538.0	
27506	chr5	1167635	1168723	1088	544.0	
27507	chr5	1172845	1173478	633	316.0	
27508	chr5	1174332	1174806	474	237.0	
27509	chr5	1254884	1255410	526	263.0	
27510	chr5	1294524	1295631	1107	554.0	
27511	chr5	1304068	1304471	403	202.0	
27512	chr5	1311942	1313953	2011	1006.0	
27513	chr5	1315316	1317024	1708	854.0	
27514	chr5	1336074	1336409	335	168.0	
27515	chr5	1344241	1345891	1650	825.0	
27516	chr5	1366488	1366872	384	192.0	
27517	chr5	1371545	1372053	508	254.0	
27518	chr5	1373883	1374672	789	394.0	
27519	chr5	1379946	1381023	1077	538.0	
27520	chr5	1385303	1387593	2290	1145.0	
27521	chr5	1409466	1409591	125	62.0	
27522	chr5	1445259	1445743	484	242.0	
27523	chr5	1447801	1449178	1377	688.0	
27524	chr5	1467664	1469302	1638	819.0	
27525	chr5	1469823	1470493	670	335.0	
27526	chr5	1472874	1473398	524	262.0	
27527	chr5	1474654	1475485	831	416.0	
27528	chr5	1476500	1482266	5766	2883.0	
27529	chr5	1484758	1485954	1196	598.0	
27530	chr5	1488614	1491065	2451	1226.0	
27531	chr5	1492815	1493226	411	206.0	
27532	chr5	1494398	1496110	1712	856.0	
27533	chr5	1497120	1499500	2380	1190.0	
27534	chr5	1501149	1504881	3732	1866.0	
27535	chr5	1506023	1506051	28	14.0	
27536	chr5	1511728	1512073	345	172.0	
27537	chr5	1513470	1514162	692	346.0	
27538	chr5	1515271	1519447	4176	2088.0	
27539	chr5	1521815	1525695	3880	1940.0	
27540	chr5	1535702	1537484	1782	891.0	
27541	chr5	1540154	1540572	418	209.0	
27542	chr5	1563744	1564742	998	499.0	
27543	chr5	1583143	1583165	22	11.0	
27544	chr5	1593539	1595093	1554	777.0	
27545	chr5	1608202	1608590	388	194.0	
27546	chr5	1633383	1634607	1224	612.0	
27547	chr5	1641337	1642037	700	350.0	
27548	chr5	1644797	1645515	718	359.0	
27549	chr5	1652906	1654713	1807	904.0	
27550	chr5	1667141	1667625	484	242.0	
27551	chr5	1710071	1710467	396	198.0	
27552	chr5	1724979	1725566	587	294.0	
27553	chr5	1737816	1738217	401	200.0	
27554	chr5	1789407	1789685	278	139.0	
27555	chr5	1792329	1793850	1521	760.0	
27556	chr5	1798911	1802171	3260	1630.0	
27557	chr5	1827874	1828238	364	182.0	
27558	chr5	2038285	2039077	792	396.0	
27559	chr5	2105188	2105615	427	214.0	
27560	chr5	2753019	2753396	377	188.0	
27561	chr5	4189513	4189524	11	6.0	
27562	chr5	5141751	5142001	250	125.0	
27563	chr5	5419346	5419682	336	168.0	
27564	chr5	5420989	5423883	2894	1447.0	
27565	chr5	5480726	5481633	907	454.0	
27566	chr5	5486147	5486518	371	186.0	
27567	chr5	5492289	5492820	531	266.0	
27568	chr5	5494310	5495439	1129	564.0	
27569	chr5	5496118	5496450	332	166.0	
27570	chr5	5497129	5497587	458	229.0	
27571	chr5	5523042	5523900	858	429.0	
27572	chr5	5752926	5753150	224	112.0	
27573	chr5	5886931	5887232	301	150.0	
27574	chr5	6359911	6360312	401	200.0	
27575	chr5	6377445	6379304	1859	930.0	
27576	chr5	6393587	6393987	400	200.0	
27577	chr5	6448959	6449012	53	26.0	
27578	chr5	6583001	6583442	441	220.0	
27579	chr5	6631966	6634738	2772	1386.0	
27580	chr5	6645314	6646074	760	380.0	
27581	chr5	6649544	6649862	318	159.0	
27582	chr5	6660130	6661109	979	490.0	
27583	chr5	6687022	6687423	401	200.0	
27584	chr5	6711665	6717311	5646	2823.0	
27585	chr5	6720010	6720438	428	214.0	
27586	chr5	6721637	6722546	909	454.0	
27587	chr5	6723323	6723492	169	84.0	
27588	chr5	6727961	6728433	472	236.0	
27589	chr5	6729226	6730315	1089	544.0	
27590	chr5	6732957	6733412	455	228.0	
27591	chr5	6735454	6735725	271	136.0	
27592	chr5	6736824	6737904	1080	540.0	
27593	chr5	6745396	6746097	701	350.0	
27594	chr5	6760605	6761121	516	258.0	
27595	chr5	6765571	6767291	1720	860.0	
27596	chr5	6774423	6775408	985	492.0	
27597	chr5	6780761	6781185	424	212.0	
27598	chr5	6786825	6787457	632	316.0	
27599	chr5	6820844	6821263	419	210.0	
27600	chr5	6827734	6828321	587	294.0	
27601	chr5	6829363	6829487	124	62.0	
27602	chr5	6837529	6837911	382	191.0	
27603	chr5	7250634	7251578	944	472.0	
27604	chr5	7746147	7746457	310	155.0	
27605	chr5	7755011	7755395	384	192.0	
27606	chr5	7756347	7756913	566	283.0	
27607	chr5	7779372	7779380	8	4.0	
27608	chr5	7802735	7803410	675	338.0	
27609	chr5	7815800	7816727	927	464.0	
27610	chr5	7849701	7851415	1714	857.0	
27611	chr5	7856870	7857226	356	178.0	
27612	chr5	7868269	7870166	1897	948.0	
27613	chr5	7871575	7872153	578	289.0	
27614	chr5	7872876	7873673	797	398.0	
27615	chr5	7878355	7879462	1107	554.0	
27616	chr5	7887031	7887514	483	242.0	
27617	chr5	8456896	8458489	1593	796.0	
27618	chr5	9437648	9438049	401	200.0	
27619	chr5	9544474	9544811	337	168.0	
27620	chr5	9545968	9546443	475	238.0	
27621	chr5	10249008	10251777	2769	1384.0	
27622	chr5	10264749	10264967	218	109.0	
27623	chr5	10266127	10266473	346	173.0	
27624	chr5	10267454	10268098	644	322.0	
27625	chr5	10283899	10284618	719	360.0	
27626	chr5	10307344	10308122	778	389.0	
27627	chr5	10332975	10334073	1098	549.0	
27628	chr5	10334836	10335233	397	198.0	
27629	chr5	10352457	10355588	3131	1566.0	
27630	chr5	10357591	10358343	752	376.0	
27631	chr5	10360606	10361082	476	238.0	
27632	chr5	10364247	10364707	460	230.0	
27633	chr5	10368832	10369190	358	179.0	
27634	chr5	10421669	10422511	842	421.0	
27635	chr5	10423033	10423358	325	162.0	
27636	chr5	10424092	10424539	447	224.0	
27637	chr5	10440911	10442976	2065	1032.0	
27638	chr5	10445272	10446016	744	372.0	
27639	chr5	10448802	10449431	629	314.0	
27640	chr5	10451150	10451889	739	370.0	
27641	chr5	10452660	10453300	640	320.0	
27642	chr5	10456647	10457282	635	318.0	
27643	chr5	10485217	10485343	126	63.0	
27644	chr5	10489729	10490323	594	297.0	
27645	chr5	10505445	10506229	784	392.0	
27646	chr5	10508968	10508981	13	6.0	
27647	chr5	10525851	10526376	525	262.0	
27648	chr5	10536752	10537994	1242	621.0	
27649	chr5	10543638	10543888	250	125.0	
27650	chr5	10552765	10553274	509	254.0	
27651	chr5	10556639	10556680	41	20.0	
27652	chr5	10562154	10566679	4525	2262.0	
27653	chr5	10573496	10573876	380	190.0	
27654	chr5	10576542	10578127	1585	792.0	
27655	chr5	10578824	10579346	522	261.0	
27656	chr5	10584786	10585155	369	184.0	
27657	chr5	10595698	10596223	525	262.0	
27658	chr5	10606963	10608453	1490	745.0	
27659	chr5	10621680	10622335	655	328.0	
27660	chr5	10626342	10628496	2154	1077.0	
27661	chr5	10630721	10631143	422	211.0	
27662	chr5	10631659	10634517	2858	1429.0	
27663	chr5	10635201	10636074	873	436.0	
27664	chr5	10643604	10644001	397	198.0	
27665	chr5	10662581	10662957	376	188.0	
27666	chr5	10671030	10671411	381	190.0	
27667	chr5	10681935	10682221	286	143.0	
27668	chr5	10695058	10696186	1128	564.0	
27669	chr5	10699886	10700474	588	294.0	
27670	chr5	10701456	10701877	421	210.0	
27671	chr5	10704761	10705753	992	496.0	
27672	chr5	10720055	10720435	380	190.0	
27673	chr5	10726833	10727528	695	348.0	
27674	chr5	10729791	10730128	337	168.0	
27675	chr5	10731816	10733563	1747	874.0	
27676	chr5	10735782	10736350	568	284.0	
27677	chr5	10746599	10747220	621	310.0	
27678	chr5	10759944	10763282	3338	1669.0	
27679	chr5	10854469	10854901	432	216.0	
27680	chr5	10856996	10857397	401	200.0	
27681	chr5	10863745	10864185	440	220.0	
27682	chr5	10876303	10876754	451	226.0	
27683	chr5	10913858	10914240	382	191.0	
27684	chr5	10962025	10962741	716	358.0	
27685	chr5	10987882	10988332	450	225.0	
27686	chr5	11234536	11235086	550	275.0	
27687	chr5	11267367	11267406	39	20.0	
27688	chr5	11300624	11301232	608	304.0	
27689	chr5	11302381	11303239	858	429.0	
27690	chr5	11321861	11322666	805	402.0	
27691	chr5	11323802	11324135	333	166.0	
27692	chr5	11361506	11361921	415	208.0	
27693	chr5	11384940	11385273	333	166.0	
27694	chr5	11642481	11642758	277	138.0	
27695	chr5	11672716	11673027	311	156.0	
27696	chr5	12870811	12871295	484	242.0	
27697	chr5	13988076	13988167	91	46.0	
27698	chr5	14011167	14012069	902	451.0	
27699	chr5	14108430	14110099	1669	834.0	
27700	chr5	14142329	14145749	3420	1710.0	
27701	chr5	14154302	14155491	1189	594.0	
27702	chr5	14156617	14156966	349	174.0	
27703	chr5	14168386	14168843	457	228.0	
27704	chr5	14171691	14172619	928	464.0	
27705	chr5	14174058	14174702	644	322.0	
27706	chr5	14202420	14202955	535	268.0	
27707	chr5	14204698	14205391	693	346.0	
27708	chr5	14208110	14208801	691	346.0	
27709	chr5	14212245	14212593	348	174.0	
27710	chr5	14250024	14251292	1268	634.0	
27711	chr5	14258168	14258258	90	45.0	
27712	chr5	14264515	14265117	602	301.0	
27713	chr5	14268050	14268641	591	296.0	
27714	chr5	14270174	14270603	429	214.0	
27715	chr5	14286974	14287486	512	256.0	
27716	chr5	14326305	14326650	345	172.0	
27717	chr5	14331252	14331951	699	350.0	
27718	chr5	14341750	14342749	999	500.0	
27719	chr5	14343297	14343789	492	246.0	
27720	chr5	14351143	14352533	1390	695.0	
27721	chr5	14362432	14362903	471	236.0	
27722	chr5	14364081	14364686	605	302.0	
27723	chr5	14365914	14366489	575	288.0	
27724	chr5	14380042	14380376	334	167.0	
27725	chr5	14399039	14399443	404	202.0	
27726	chr5	14413224	14415236	2012	1006.0	
27727	chr5	14445580	14445902	322	161.0	
27728	chr5	14463542	14464292	750	375.0	
27729	chr5	14465060	14465200	140	70.0	
27730	chr5	14489567	14490621	1054	527.0	
27731	chr5	14491433	14492818	1385	692.0	
27732	chr5	14545128	14546312	1184	592.0	
27733	chr5	14549729	14549747	18	9.0	
27734	chr5	14551980	14552456	476	238.0	
27735	chr5	14559411	14560748	1337	668.0	
27736	chr5	14572344	14573225	881	440.0	
27737	chr5	14574113	14575543	1430	715.0	
27738	chr5	14578037	14578319	282	141.0	
27739	chr5	14580976	14583168	2192	1096.0	
27740	chr5	14584044	14584288	244	122.0	
27741	chr5	14586837	14589437	2600	1300.0	
27742	chr5	14593325	14596467	3142	1571.0	
27743	chr5	14597836	14598649	813	406.0	
27744	chr5	14607126	14607503	377	188.0	
27745	chr5	14608231	14608590	359	180.0	
27746	chr5	14628349	14628718	369	184.0	
27747	chr5	14648474	14648996	522	261.0	
27748	chr5	14663606	14668835	5229	2614.0	
27749	chr5	14671181	14672640	1459	730.0	
27750	chr5	14675601	14676828	1227	614.0	
27751	chr5	14685434	14686261	827	414.0	
27752	chr5	14700953	14701518	565	282.0	
27753	chr5	14706350	14707344	994	497.0	
27754	chr5	14714054	14714061	7	4.0	
27755	chr5	14723541	14723935	394	197.0	
27756	chr5	14724627	14725108	481	240.0	
27757	chr5	14727284	14727952	668	334.0	
27758	chr5	14745616	14746254	638	319.0	
27759	chr5	14757781	14758497	716	358.0	
27760	chr5	14767939	14768284	345	172.0	
27761	chr5	14770009	14770121	112	56.0	
27762	chr5	14809321	14810563	1242	621.0	
27763	chr5	14868720	14873186	4466	2233.0	
27764	chr5	14925969	14926329	360	180.0	
27765	chr5	14937159	14937654	495	248.0	
27766	chr5	14946786	14947266	480	240.0	
27767	chr5	14957391	14957807	416	208.0	
27768	chr5	14984008	14984434	426	213.0	
27769	chr5	14992406	14993978	1572	786.0	
27770	chr5	14996896	14997688	792	396.0	
27771	chr5	14998414	14999043	629	314.0	
27772	chr5	15001540	15001843	303	152.0	
27773	chr5	15003363	15004071	708	354.0	
27774	chr5	15013861	15014290	429	214.0	
27775	chr5	15103157	15103508	351	176.0	
27776	chr5	15105903	15106143	240	120.0	
27777	chr5	15886979	15887315	336	168.0	
27778	chr5	16455669	16457591	1922	961.0	
27779	chr5	16464328	16467936	3608	1804.0	
27780	chr5	16489284	16489628	344	172.0	
27781	chr5	16508808	16509613	805	402.0	
27782	chr5	16550339	16550712	373	186.0	
27783	chr5	16552715	16553095	380	190.0	
27784	chr5	16556011	16556414	403	202.0	
27785	chr5	16585589	16585647	58	29.0	
27786	chr5	16600425	16600842	417	208.0	
27787	chr5	16615829	16618594	2765	1382.0	
27788	chr5	16624962	16625559	597	298.0	
27789	chr5	16626790	16627354	564	282.0	
27790	chr5	16629022	16630254	1232	616.0	
27791	chr5	16666780	16667237	457	228.0	
27792	chr5	16673394	16673625	231	116.0	
27793	chr5	16728338	16728363	25	12.0	
27794	chr5	16791067	16791643	576	288.0	
27795	chr5	16934028	16934410	382	191.0	
27796	chr5	16935327	16937048	1721	860.0	
27797	chr5	17109338	17109886	548	274.0	
27798	chr5	17118292	17119474	1182	591.0	
27799	chr5	17123710	17124038	328	164.0	
27800	chr5	17130299	17130701	402	201.0	
27801	chr5	17154641	17154920	279	140.0	
27802	chr5	17189450	17189767	317	158.0	
27803	chr5	17190456	17190896	440	220.0	
27804	chr5	17203297	17203764	467	234.0	
27805	chr5	17216048	17219379	3331	1666.0	
27806	chr5	17229281	17229599	318	159.0	
27807	chr5	17234273	17235401	1128	564.0	
27808	chr5	17252634	17252797	163	82.0	
27809	chr5	17255267	17256323	1056	528.0	
27810	chr5	17257723	17258155	432	216.0	
27811	chr5	17282294	17283275	981	490.0	
27812	chr5	17302260	17303158	898	449.0	"enhancer	sequence_feature"
27813	chr5	17304296	17304657	361	180.0	
27814	chr5	17315965	17316114	149	74.0	
27815	chr5	17316739	17317894	1155	578.0	
27816	chr5	17318503	17318951	448	224.0	
27817	chr5	17343787	17344020	233	116.0	
27818	chr5	17355638	17356070	432	216.0	
27819	chr5	17359685	17359894	209	104.0	
27820	chr5	17381758	17382451	693	346.0	
27821	chr5	17398880	17398994	114	57.0	
27822	chr5	17399726	17400314	588	294.0	
27823	chr5	17400933	17401409	476	238.0	
27824	chr5	17413212	17413718	506	253.0	
27825	chr5	17436254	17437356	1102	551.0	
27826	chr5	17443705	17444209	504	252.0	
27827	chr5	17735750	17736155	405	202.0	
27828	chr5	17748163	17748621	458	229.0	
27829	chr5	17794949	17795165	216	108.0	
27830	chr5	17910297	17910784	487	244.0	
27831	chr5	17928721	17929083	362	181.0	
27832	chr5	18114658	18114719	61	30.0	
27833	chr5	18159279	18159652	373	186.0	
27834	chr5	18281953	18282246	293	146.0	
27835	chr5	18295690	18296084	394	197.0	
27836	chr5	18299144	18299535	391	196.0	
27837	chr5	18305309	18305692	383	192.0	
27838	chr5	18307607	18307957	350	175.0	
27839	chr5	18311308	18311679	371	186.0	
27840	chr5	18394190	18394555	365	182.0	
27841	chr5	18466326	18466427	101	50.0	
27842	chr5	18697557	18698984	1427	714.0	
27843	chr5	18744142	18747534	3392	1696.0	
27844	chr5	18749896	18750181	285	142.0	
27845	chr5	18761772	18762097	325	162.0	
27846	chr5	21458971	21459950	979	490.0	
27847	chr5	21806919	21807339	420	210.0	
27848	chr5	21807969	21808370	401	200.0	
27849	chr5	21831341	21831478	137	68.0	
27850	chr5	23507408	23507515	107	54.0	
27851	chr5	24272811	24273129	318	159.0	
27852	chr5	25569028	25569418	390	195.0	
27853	chr5	27982635	27983052	417	208.0	
27854	chr5	28217154	28217208	54	27.0	
27855	chr5	30413677	30413717	40	20.0	
27856	chr5	30436720	30437138	418	209.0	
27857	chr5	30725060	30725461	401	200.0	
27858	chr5	31116385	31116900	515	258.0	
27859	chr5	31119788	31120507	719	360.0	
27860	chr5	31131402	31132084	682	341.0	
27861	chr5	31133369	31133944	575	288.0	
27862	chr5	31144423	31144779	356	178.0	
27863	chr5	31153403	31154049	646	323.0	
27864	chr5	31531336	31533443	2107	1054.0	
27865	chr5	31566286	31566823	537	268.0	
27866	chr5	31581755	31581791	36	18.0	
27867	chr5	31589168	31589475	307	154.0	
27868	chr5	31638559	31639832	1273	636.0	
27869	chr5	31825489	31825966	477	238.0	
27870	chr5	31854384	31854494	110	55.0	
27871	chr5	31855280	31855601	321	160.0	
27872	chr5	31867181	31867563	382	191.0	
27873	chr5	31939281	31939567	286	143.0	
27874	chr5	32018125	32018728	603	302.0	
27875	chr5	32020126	32020877	751	376.0	
27876	chr5	32027995	32028413	418	209.0	
27877	chr5	32042427	32043008	581	290.0	
27878	chr5	32076732	32077089	357	178.0	
27879	chr5	32093138	32093639	501	250.0	
27880	chr5	32147211	32147712	501	250.0	
27881	chr5	32158333	32158552	219	110.0	
27882	chr5	32165371	32165714	343	172.0	
27883	chr5	32170689	32170845	156	78.0	
27884	chr5	32171902	32175552	3650	1825.0	
27885	chr5	32176143	32176781	638	319.0	
27886	chr5	32182755	32183079	324	162.0	
27887	chr5	32193439	32194094	655	328.0	
27888	chr5	32203272	32203880	608	304.0	
27889	chr5	32207111	32207699	588	294.0	
27890	chr5	32211046	32211572	526	263.0	
27891	chr5	32230343	32233214	2871	1436.0	
27892	chr5	32233984	32234441	457	228.0	
27893	chr5	32240993	32241869	876	438.0	
27894	chr5	32261325	32261388	63	32.0	
27895	chr5	32276269	32277138	869	434.0	
27896	chr5	32278381	32278754	373	186.0	
27897	chr5	32280518	32281214	696	348.0	
27898	chr5	32283644	32284153	509	254.0	
27899	chr5	32290820	32291393	573	286.0	
27900	chr5	32298042	32298390	348	174.0	
27901	chr5	32299586	32299587	1	0.0	
27902	chr5	32304670	32305001	331	166.0	
27903	chr5	32308942	32310528	1586	793.0	
27904	chr5	32311510	32313929	2419	1210.0	
27905	chr5	32321894	32322004	110	55.0	
27906	chr5	32329207	32329961	754	377.0	
27907	chr5	32388447	32388865	418	209.0	
27908	chr5	32390692	32391670	978	489.0	
27909	chr5	32443015	32445706	2691	1346.0	
27910	chr5	32446589	32447120	531	266.0	
27911	chr5	32489609	32490188	579	290.0	
27912	chr5	32505241	32505667	426	213.0	
27913	chr5	32509021	32509614	593	296.0	
27914	chr5	32511758	32512169	411	206.0	
27915	chr5	32520405	32520804	399	200.0	
27916	chr5	32522349	32523323	974	487.0	
27917	chr5	32526654	32527086	432	216.0	
27918	chr5	32531344	32532768	1424	712.0	
27919	chr5	32537383	32538486	1103	552.0	
27920	chr5	32540126	32540984	858	429.0	
27921	chr5	32542538	32542997	459	230.0	
27922	chr5	32554259	32554937	678	339.0	
27923	chr5	32573110	32573393	283	142.0	
27924	chr5	32578446	32578657	211	106.0	
27925	chr5	32581303	32581917	614	307.0	
27926	chr5	32582418	32586690	4272	2136.0	
27927	chr5	32588086	32588505	419	210.0	
27928	chr5	32589006	32590919	1913	956.0	
27929	chr5	32592964	32592977	13	6.0	
27930	chr5	32595133	32595773	640	320.0	
27931	chr5	32596863	32597635	772	386.0	
27932	chr5	32598203	32598688	485	242.0	
27933	chr5	32604853	32606148	1295	648.0	
27934	chr5	32612827	32613513	686	343.0	
27935	chr5	32709661	32710741	1080	540.0	
27936	chr5	33235872	33236227	355	178.0	
27937	chr5	33241857	33242225	368	184.0	
27938	chr5	33299448	33300638	1190	595.0	
27939	chr5	33379834	33380174	340	170.0	
27940	chr5	33435609	33436464	855	428.0	
27941	chr5	33439788	33442292	2504	1252.0	
27942	chr5	33471170	33471443	273	136.0	
27943	chr5	33475805	33475810	5	2.0	
27944	chr5	33850051	33850452	401	200.0	
27945	chr5	33859131	33859671	540	270.0	
27946	chr5	33934655	33935113	458	229.0	
27947	chr5	33935976	33936277	301	150.0	
27948	chr5	33969850	33970234	384	192.0	
27949	chr5	33997275	33997810	535	268.0	
27950	chr5	34007091	34009110	2019	1010.0	
27951	chr5	34022349	34022472	123	62.0	
27952	chr5	34042385	34042702	317	158.0	
27953	chr5	34043330	34043854	524	262.0	
27954	chr5	34044804	34045388	584	292.0	
27955	chr5	34047862	34048116	254	127.0	
27956	chr5	34184316	34184509	193	96.0	
27957	chr5	34185573	34185882	309	154.0	
27958	chr5	34188031	34188668	637	318.0	
27959	chr5	34189898	34190566	668	334.0	
27960	chr5	34191252	34192995	1743	872.0	
27961	chr5	34205347	34205749	402	201.0	
27962	chr5	34244181	34245167	986	493.0	
27963	chr5	34465258	34465697	439	220.0	
27964	chr5	34474457	34474926	469	234.0	
27965	chr5	34486133	34486628	495	248.0	
27966	chr5	34494059	34494508	449	224.0	
27967	chr5	34498487	34499726	1239	620.0	
27968	chr5	34500478	34501391	913	456.0	
27969	chr5	34523076	34523560	484	242.0	
27970	chr5	34538083	34538364	281	140.0	
27971	chr5	34583204	34583547	343	172.0	
27972	chr5	34586117	34586467	350	175.0	
27973	chr5	34587676	34588053	377	188.0	
27974	chr5	34655287	34657146	1859	930.0	
27975	chr5	34695669	34696036	367	184.0	
27976	chr5	34742778	34743327	549	274.0	
27977	chr5	34838507	34839853	1346	673.0	
27978	chr5	34898215	34898695	480	240.0	
27979	chr5	34914627	34916477	1850	925.0	
27980	chr5	34919125	34919381	256	128.0	
27981	chr5	34928402	34930806	2404	1202.0	
27982	chr5	35003349	35003752	403	202.0	
27983	chr5	35066300	35066652	352	176.0	
27984	chr5	35089679	35090095	416	208.0	
27985	chr5	35130148	35130543	395	198.0	
27986	chr5	35153551	35153656	105	52.0	
27987	chr5	35183224	35183439	215	108.0	
27988	chr5	35194262	35195464	1202	601.0	
27989	chr5	35202339	35202712	373	186.0	
27990	chr5	35212036	35212918	882	441.0	
27991	chr5	35229357	35230750	1393	696.0	
27992	chr5	35319318	35320185	867	434.0	
27993	chr5	35383086	35383304	218	109.0	
27994	chr5	35393846	35394310	464	232.0	
27995	chr5	35430894	35431192	298	149.0	
27996	chr5	35475986	35476452	466	233.0	
27997	chr5	35478877	35479788	911	456.0	
27998	chr5	35483872	35484210	338	169.0	
27999	chr5	35518052	35518575	523	262.0	
28000	chr5	35543555	35543642	87	44.0	
28001	chr5	35617194	35618720	1526	763.0	
28002	chr5	35651121	35651610	489	244.0	
28003	chr5	35665136	35665418	282	141.0	
28004	chr5	35671471	35671949	478	239.0	
28005	chr5	35672936	35673431	495	248.0	
28006	chr5	35698074	35698510	436	218.0	
28007	chr5	35777585	35778249	664	332.0	
28008	chr5	35780158	35780796	638	319.0	
28009	chr5	35785886	35785964	78	39.0	
28010	chr5	35790396	35790533	137	68.0	
28011	chr5	35796805	35797736	931	466.0	
28012	chr5	35802893	35803556	663	332.0	
28013	chr5	35807858	35807946	88	44.0	
28014	chr5	35810454	35811918	1464	732.0	
28015	chr5	35815559	35816010	451	226.0	
28016	chr5	35816776	35817720	944	472.0	
28017	chr5	35819666	35820095	429	214.0	
28018	chr5	35822090	35823086	996	498.0	
28019	chr5	35823699	35823722	23	12.0	
28020	chr5	35826536	35826863	327	164.0	
28021	chr5	35830364	35831419	1055	528.0	
28022	chr5	35833237	35833596	359	180.0	
28023	chr5	35852133	35855531	3398	1699.0	
28024	chr5	35856130	35858231	2101	1050.0	
28025	chr5	35858902	35859797	895	448.0	
28026	chr5	35863228	35863576	348	174.0	
28027	chr5	35876940	35877341	401	200.0	
28028	chr5	35879700	35879701	1	0.0	
28029	chr5	35880206	35880874	668	334.0	
28030	chr5	35881882	35881920	38	19.0	
28031	chr5	35883989	35884895	906	453.0	
28032	chr5	35924390	35926896	2506	1253.0	
28033	chr5	35979836	35980059	223	112.0	
28034	chr5	36071230	36071507	277	138.0	
28035	chr5	36073587	36073945	358	179.0	
28036	chr5	36079156	36079585	429	214.0	
28037	chr5	36150714	36152888	2174	1087.0	
28038	chr5	36236781	36236989	208	104.0	
28039	chr5	36239699	36243121	3422	1711.0	
28040	chr5	36265391	36265890	499	250.0	
28041	chr5	36273783	36274456	673	336.0	
28042	chr5	36373355	36374207	852	426.0	
28043	chr5	36389268	36389678	410	205.0	
28044	chr5	36403937	36404466	529	264.0	
28045	chr5	36419525	36419942	417	208.0	
28046	chr5	36507338	36507739	401	200.0	
28047	chr5	36529200	36529498	298	149.0	
28048	chr5	36593826	36594277	451	226.0	
28049	chr5	36602731	36603088	357	178.0	
28050	chr5	36606103	36607453	1350	675.0	
28051	chr5	36654939	36655642	703	352.0	
28052	chr5	36657359	36658274	915	458.0	
28053	chr5	36680249	36680342	93	46.0	
28054	chr5	36683861	36684259	398	199.0	
28055	chr5	36685376	36686348	972	486.0	
28056	chr5	36689013	36691002	1989	994.0	
28057	chr5	36692614	36693731	1117	558.0	
28058	chr5	36696036	36696482	446	223.0	
28059	chr5	36701141	36701735	594	297.0	
28060	chr5	36703520	36703531	11	6.0	
28061	chr5	36712759	36713030	271	136.0	
28062	chr5	36720888	36720944	56	28.0	
28063	chr5	36722886	36725527	2641	1320.0	
28064	chr5	36728907	36729383	476	238.0	
28065	chr5	36739420	36740260	840	420.0	
28066	chr5	36744332	36746095	1763	882.0	
28067	chr5	36820906	36821254	348	174.0	
28068	chr5	36836874	36837236	362	181.0	
28069	chr5	36839376	36840155	779	390.0	
28070	chr5	36842092	36842460	368	184.0	
28071	chr5	36870217	36870920	703	352.0	
28072	chr5	36874559	36879164	4605	2302.0	
28073	chr5	36882239	36882715	476	238.0	
28074	chr5	36885765	36885907	142	71.0	
28075	chr5	36944607	36945008	401	200.0	
28076	chr5	36951833	36952037	204	102.0	
28077	chr5	37111672	37112459	787	394.0	
28078	chr5	37121339	37121347	8	4.0	
28079	chr5	37184961	37185035	74	37.0	
28080	chr5	37197339	37198383	1044	522.0	
28081	chr5	37209056	37209484	428	214.0	
28082	chr5	37214632	37214812	180	90.0	
28083	chr5	37248642	37250044	1402	701.0	
28084	chr5	37370067	37372411	2344	1172.0	
28085	chr5	37378603	37379857	1254	627.0	
28086	chr5	37391523	37391986	463	232.0	
28087	chr5	37412962	37413404	442	221.0	
28088	chr5	37463429	37463815	386	193.0	
28089	chr5	37672047	37672615	568	284.0	
28090	chr5	37721529	37721930	401	200.0	
28091	chr5	37722804	37723320	516	258.0	
28092	chr5	37738109	37738502	393	196.0	
28093	chr5	38193099	38193477	378	189.0	
28094	chr5	38376464	38376712	248	124.0	
28095	chr5	38382813	38383214	401	200.0	
28096	chr5	38441476	38442184	708	354.0	
28097	chr5	38453183	38454154	971	486.0	
28098	chr5	38455905	38456001	96	48.0	
28099	chr5	38556320	38557068	748	374.0	
28100	chr5	38809823	38810161	338	169.0	
28101	chr5	38922109	38922515	406	203.0	
28102	chr5	38994283	38994712	429	214.0	
28103	chr5	39005591	39005999	408	204.0	
28104	chr5	39058118	39058599	481	240.0	
28105	chr5	39072860	39075554	2694	1347.0	
28106	chr5	39076635	39077403	768	384.0	
28107	chr5	39080509	39081071	562	281.0	
28108	chr5	39099180	39102080	2900	1450.0	
28109	chr5	39102819	39102916	97	48.0	
28110	chr5	39148592	39149732	1140	570.0	
28111	chr5	39151649	39152254	605	302.0	
28112	chr5	39156140	39156508	368	184.0	
28113	chr5	39158013	39158549	536	268.0	
28114	chr5	39160799	39161215	416	208.0	
28115	chr5	39163971	39165361	1390	695.0	
28116	chr5	39167010	39167607	597	298.0	
28117	chr5	39174975	39175271	296	148.0	
28118	chr5	39176616	39179980	3364	1682.0	
28119	chr5	39185772	39191779	6007	3004.0	
28120	chr5	39192480	39193965	1485	742.0	
28121	chr5	39194653	39195637	984	492.0	
28122	chr5	39196567	39196959	392	196.0	
28123	chr5	39197473	39198010	537	268.0	
28124	chr5	39199847	39204415	4568	2284.0	
28125	chr5	39205519	39205739	220	110.0	
28126	chr5	39207674	39212705	5031	2516.0	
28127	chr5	39213346	39214478	1132	566.0	
28128	chr5	39215279	39216091	812	406.0	
28129	chr5	39216595	39218439	1844	922.0	
28130	chr5	39218986	39220054	1068	534.0	
28131	chr5	39224134	39224926	792	396.0	
28132	chr5	39231666	39232040	374	187.0	
28133	chr5	39256357	39257051	694	347.0	
28134	chr5	39262940	39263470	530	265.0	
28135	chr5	39264393	39265001	608	304.0	
28136	chr5	39266441	39266796	355	178.0	
28137	chr5	39269589	39270911	1322	661.0	
28138	chr5	39272079	39275464	3385	1692.0	
28139	chr5	39283049	39283934	885	442.0	
28140	chr5	39301649	39301729	80	40.0	
28141	chr5	39302546	39302958	412	206.0	
28142	chr5	39376206	39376659	453	226.0	
28143	chr5	39398918	39400407	1489	744.0	
28144	chr5	39411037	39411473	436	218.0	
28145	chr5	39420653	39421054	401	200.0	
28146	chr5	39424362	39425539	1177	588.0	
28147	chr5	39460888	39461654	766	383.0	
28148	chr5	39466760	39467253	493	246.0	
28149	chr5	39469225	39470357	1132	566.0	
28150	chr5	39503198	39503533	335	168.0	
28151	chr5	39526705	39527342	637	318.0	
28152	chr5	39543485	39543618	133	66.0	
28153	chr5	39547519	39547994	475	238.0	
28154	chr5	39555870	39556271	401	200.0	
28155	chr5	39570418	39570766	348	174.0	
28156	chr5	39581146	39581547	401	200.0	
28157	chr5	39714076	39714450	374	187.0	
28158	chr5	39716492	39716829	337	168.0	
28159	chr5	39946358	39947029	671	336.0	
28160	chr5	39948835	39949379	544	272.0	
28161	chr5	40017066	40017597	531	266.0	
28162	chr5	40025643	40025968	325	162.0	
28163	chr5	40033233	40033868	635	318.0	enhancer
28164	chr5	40258055	40258733	678	339.0	
28165	chr5	40276759	40277845	1086	543.0	
28166	chr5	40338353	40338888	535	268.0	
28167	chr5	40355853	40356749	896	448.0	
28168	chr5	40361324	40361836	512	256.0	
28169	chr5	40365545	40366068	523	262.0	
28170	chr5	40367232	40367671	439	220.0	
28171	chr5	40378189	40379218	1029	514.0	
28172	chr5	40383762	40386819	3057	1528.0	
28173	chr5	40388031	40388746	715	358.0	
28174	chr5	40390205	40390765	560	280.0	
28175	chr5	40391537	40392111	574	287.0	
28176	chr5	40397090	40397499	409	204.0	
28177	chr5	40401999	40402354	355	178.0	
28178	chr5	40404256	40407661	3405	1702.0	
28179	chr5	40409469	40411681	2212	1106.0	
28180	chr5	40428094	40428553	459	230.0	
28181	chr5	40429534	40430234	700	350.0	
28182	chr5	40435699	40438327	2628	1314.0	
28183	chr5	40439101	40439501	400	200.0	
28184	chr5	40441365	40442663	1298	649.0	
28185	chr5	40480331	40480812	481	240.0	
28186	chr5	40484412	40487429	3017	1508.0	
28187	chr5	40490295	40490895	600	300.0	
28188	chr5	40492054	40492349	295	148.0	
28189	chr5	40495169	40495540	371	186.0	
28190	chr5	40502636	40503160	524	262.0	
28191	chr5	40507094	40507459	365	182.0	
28192	chr5	40514895	40515537	642	321.0	
28193	chr5	40521928	40522299	371	186.0	
28194	chr5	40569596	40570790	1194	597.0	
28195	chr5	40572032	40572100	68	34.0	
28196	chr5	40578728	40579382	654	327.0	
28197	chr5	40591699	40592226	527	264.0	
28198	chr5	40605526	40606480	954	477.0	
28199	chr5	40615425	40617256	1831	916.0	
28200	chr5	40621964	40622051	87	44.0	
28201	chr5	40623409	40623921	512	256.0	
28202	chr5	40628292	40628892	600	300.0	
28203	chr5	40641300	40641776	476	238.0	
28204	chr5	40649264	40650241	977	488.0	
28205	chr5	40652208	40654398	2190	1095.0	
28206	chr5	40655098	40655429	331	166.0	
28207	chr5	40669397	40670573	1176	588.0	
28208	chr5	40672153	40673066	913	456.0	
28209	chr5	40675311	40677008	1697	848.0	
28210	chr5	40677963	40684007	6044	3022.0	
28211	chr5	40684586	40689886	5300	2650.0	
28212	chr5	40691888	40692756	868	434.0	
28213	chr5	40694380	40694610	230	115.0	
28214	chr5	40736114	40736725	611	306.0	
28215	chr5	40754124	40756618	2494	1247.0	
28216	chr5	40796368	40799220	2852	1426.0	
28217	chr5	40831909	40832165	256	128.0	
28218	chr5	40833831	40836349	2518	1259.0	
28219	chr5	40838143	40838554	411	206.0	
28220	chr5	40841013	40841848	835	418.0	
28221	chr5	40849202	40849598	396	198.0	
28222	chr5	40879339	40879774	435	218.0	
28223	chr5	40904887	40905077	190	95.0	
28224	chr5	41843456	41843903	447	224.0	
28225	chr5	41856393	41857662	1269	634.0	
28226	chr5	41863851	41864238	387	194.0	
28227	chr5	41864792	41865143	351	176.0	
28228	chr5	41866621	41866813	192	96.0	
28229	chr5	41867412	41868088	676	338.0	
28230	chr5	41868783	41871208	2425	1212.0	
28231	chr5	41903325	41905128	1803	902.0	
28232	chr5	41924401	41926485	2084	1042.0	
28233	chr5	42057206	42057707	501	250.0	
28234	chr5	42423273	42423647	374	187.0	"promoter	promoter	protein_binding_site	promoter	protein_binding_site	region"
28235	chr5	42583255	42583660	405	202.0	
28236	chr5	42590836	42591486	650	325.0	
28237	chr5	42593373	42594083	710	355.0	
28238	chr5	42621241	42622002	761	380.0	
28239	chr5	42718617	42719161	544	272.0	
28240	chr5	42720262	42721171	909	454.0	
28241	chr5	42749160	42749455	295	148.0	
28242	chr5	42756539	42757647	1108	554.0	
28243	chr5	42767539	42767857	318	159.0	
28244	chr5	42889267	42889761	494	247.0	
28245	chr5	42908094	42909630	1536	768.0	
28246	chr5	42912161	42912697	536	268.0	
28247	chr5	42948859	42953405	4546	2273.0	
28248	chr5	42954373	42954400	27	14.0	
28249	chr5	42961061	42961103	42	21.0	
28250	chr5	42961888	42962734	846	423.0	
28251	chr5	42965952	42966354	402	201.0	
28252	chr5	42989078	42996776	7698	3849.0	
28253	chr5	43000246	43000899	653	326.0	
28254	chr5	43007063	43011410	4347	2174.0	
28255	chr5	43015382	43015763	381	190.0	
28256	chr5	43016980	43021618	4638	2319.0	
28257	chr5	43030805	43031489	684	342.0	
28258	chr5	43034666	43035008	342	171.0	
28259	chr5	43036407	43043746	7339	3670.0	
28260	chr5	43044283	43045721	1438	719.0	
28261	chr5	43046570	43046876	306	153.0	
28262	chr5	43063680	43068124	4444	2222.0	
28263	chr5	43071382	43071542	160	80.0	
28264	chr5	43073606	43074492	886	443.0	
28265	chr5	43104059	43106379	2320	1160.0	
28266	chr5	43109596	43109876	280	140.0	
28267	chr5	43110423	43111272	849	424.0	
28268	chr5	43120318	43122846	2528	1264.0	
28269	chr5	43123848	43124354	506	253.0	
28270	chr5	43138198	43138580	382	191.0	
28271	chr5	43140103	43140756	653	326.0	
28272	chr5	43161283	43161608	325	162.0	
28273	chr5	43191558	43194247	2689	1344.0	
28274	chr5	43215114	43215440	326	163.0	
28275	chr5	43284608	43284623	15	8.0	
28276	chr5	43286017	43286110	93	46.0	
28277	chr5	43286929	43286931	2	1.0	
28278	chr5	43303325	43303475	150	75.0	
28279	chr5	43304511	43305295	784	392.0	
28280	chr5	43305893	43307301	1408	704.0	
28281	chr5	43309313	43309466	153	76.0	
28282	chr5	43310074	43310087	13	6.0	
28283	chr5	43310946	43311149	203	102.0	
28284	chr5	43311979	43314453	2474	1237.0	
28285	chr5	43338821	43339392	571	286.0	
28286	chr5	43389523	43390248	725	362.0	
28287	chr5	43396372	43397482	1110	555.0	
28288	chr5	43483042	43485880	2838	1419.0	
28289	chr5	43514362	43515870	1508	754.0	
28290	chr5	43555720	43558047	2327	1164.0	
28291	chr5	43601827	43604501	2674	1337.0	
28292	chr5	43609787	43610159	372	186.0	
28293	chr5	43627008	43627418	410	205.0	
28294	chr5	43631113	43631751	638	319.0	
28295	chr5	44808328	44810143	1815	908.0	
28296	chr5	50154619	50154959	340	170.0	
28297	chr5	50328241	50328632	391	196.0	
28298	chr5	50407037	50407217	180	90.0	
28299	chr5	50415842	50416994	1152	576.0	
28300	chr5	50420461	50420715	254	127.0	
28301	chr5	50428399	50429143	744	372.0	
28302	chr5	50429730	50430489	759	380.0	
28303	chr5	50431242	50431571	329	164.0	
28304	chr5	50435193	50435791	598	299.0	
28305	chr5	50436573	50436845	272	136.0	
28306	chr5	50438067	50438490	423	212.0	
28307	chr5	50439446	50442071	2625	1312.0	
28308	chr5	50442591	50442951	360	180.0	
28309	chr5	50445014	50446144	1130	565.0	
28310	chr5	50458298	50458784	486	243.0	
28311	chr5	50501417	50502249	832	416.0	
28312	chr5	50553608	50553791	183	92.0	
28313	chr5	50559976	50560345	369	184.0	
28314	chr5	50564117	50564528	411	206.0	
28315	chr5	50576854	50577196	342	171.0	
28316	chr5	50590491	50591760	1269	634.0	
28317	chr5	50593530	50594490	960	480.0	
28318	chr5	50613033	50613422	389	194.0	
28319	chr5	50634605	50635365	760	380.0	
28320	chr5	50637587	50637939	352	176.0	
28321	chr5	50647653	50648375	722	361.0	
28322	chr5	50653872	50654448	576	288.0	
28323	chr5	50658215	50658699	484	242.0	
28324	chr5	50662897	50664057	1160	580.0	
28325	chr5	50665014	50668988	3974	1987.0	
28326	chr5	50671992	50673064	1072	536.0	
28327	chr5	50674178	50674589	411	206.0	
28328	chr5	50679783	50680642	859	430.0	
28329	chr5	50691615	50691906	291	146.0	
28330	chr5	50693986	50695248	1262	631.0	
28331	chr5	50702570	50703244	674	337.0	
28332	chr5	50707809	50707887	78	39.0	
28333	chr5	50709664	50709862	198	99.0	
28334	chr5	50710742	50712011	1269	634.0	
28335	chr5	50717486	50718180	694	347.0	
28336	chr5	50726925	50727517	592	296.0	
28337	chr5	50733784	50734176	392	196.0	
28338	chr5	50744212	50745691	1479	740.0	
28339	chr5	50750100	50750182	82	41.0	
28340	chr5	50750786	50751651	865	432.0	
28341	chr5	50848267	50849375	1108	554.0	
28342	chr5	50852832	50853704	872	436.0	
28343	chr5	50856529	50857201	672	336.0	
28344	chr5	50874318	50875130	812	406.0	
28345	chr5	50962853	50964399	1546	773.0	
28346	chr5	50967609	50968082	473	236.0	
28347	chr5	52469397	52469994	597	298.0	
28348	chr5	52657171	52657529	358	179.0	
28349	chr5	52693297	52693667	370	185.0	
28350	chr5	52725074	52726146	1072	536.0	
28351	chr5	52743733	52744344	611	306.0	
28352	chr5	52758669	52758923	254	127.0	
28353	chr5	52771559	52772097	538	269.0	
28354	chr5	52775746	52776628	882	441.0	
28355	chr5	52784707	52785057	350	175.0	
28356	chr5	52786759	52788758	1999	1000.0	
28357	chr5	52789963	52790050	87	44.0	
28358	chr5	52798812	52801760	2948	1474.0	
28359	chr5	52805045	52805328	283	142.0	
28360	chr5	52809868	52810269	401	200.0	
28361	chr5	52810970	52811537	567	284.0	
28362	chr5	52825798	52826281	483	242.0	
28363	chr5	52914952	52915850	898	449.0	
28364	chr5	52922324	52922742	418	209.0	
28365	chr5	52943395	52943644	249	124.0	
28366	chr5	52948273	52949028	755	378.0	
28367	chr5	52988716	52990217	1501	750.0	
28368	chr5	53023942	53024388	446	223.0	
28369	chr5	53031763	53031968	205	102.0	
28370	chr5	53041327	53041552	225	112.0	
28371	chr5	53089497	53089886	389	194.0	
28372	chr5	53095888	53096384	496	248.0	
28373	chr5	53108901	53110489	1588	794.0	
28374	chr5	53470188	53470195	7	4.0	
28375	chr5	53478269	53481041	2772	1386.0	
28376	chr5	53481685	53483405	1720	860.0	
28377	chr5	53560242	53561285	1043	522.0	
28378	chr5	54013456	54013971	515	258.0	
28379	chr5	54080800	54081202	402	201.0	
28380	chr5	54159110	54159600	490	245.0	
28381	chr5	54218181	54218231	50	25.0	
28382	chr5	54229120	54229623	503	252.0	
28383	chr5	54243478	54243884	406	203.0	
28384	chr5	54249304	54250097	793	396.0	
28385	chr5	54295606	54296146	540	270.0	
28386	chr5	54301266	54301530	264	132.0	
28387	chr5	54302070	54302661	591	296.0	
28388	chr5	54303794	54304524	730	365.0	
28389	chr5	54309287	54312440	3153	1576.0	
28390	chr5	54313211	54313764	553	276.0	
28391	chr5	54419673	54419829	156	78.0	
28392	chr5	54440442	54440913	471	236.0	
28393	chr5	54489127	54489783	656	328.0	
28394	chr5	54516921	54521055	4134	2067.0	
28395	chr5	54522139	54522283	144	72.0	
28396	chr5	54523582	54525008	1426	713.0	
28397	chr5	54574074	54574468	394	197.0	
28398	chr5	54577522	54577992	470	235.0	
28399	chr5	54590585	54591266	681	340.0	
28400	chr5	54601483	54602243	760	380.0	
28401	chr5	54608403	54609040	637	318.0	
28402	chr5	54609980	54612005	2025	1012.0	
28403	chr5	54615990	54616500	510	255.0	
28404	chr5	54620138	54620760	622	311.0	
28405	chr5	54638089	54638466	377	188.0	
28406	chr5	54646051	54647258	1207	604.0	
28407	chr5	54653921	54654640	719	360.0	
28408	chr5	54663989	54664023	34	17.0	
28409	chr5	54670961	54671954	993	496.0	
28410	chr5	54672791	54674539	1748	874.0	
28411	chr5	54676580	54676801	221	110.0	
28412	chr5	54691647	54692095	448	224.0	
28413	chr5	54706353	54706600	247	124.0	
28414	chr5	54728205	54728570	365	182.0	
28415	chr5	54738043	54738522	479	240.0	
28416	chr5	54743909	54745168	1259	630.0	
28417	chr5	54752990	54753510	520	260.0	
28418	chr5	54756396	54756809	413	206.0	
28419	chr5	54764389	54764680	291	146.0	
28420	chr5	54772507	54773218	711	356.0	
28421	chr5	54774719	54775243	524	262.0	
28422	chr5	54785871	54786824	953	476.0	
28423	chr5	54799678	54799851	173	86.0	
28424	chr5	54832799	54833441	642	321.0	
28425	chr5	54837029	54837374	345	172.0	
28426	chr5	54844935	54845770	835	418.0	
28427	chr5	54867075	54867802	727	364.0	
28428	chr5	54874653	54874994	341	170.0	
28429	chr5	54881313	54881749	436	218.0	
28430	chr5	54883418	54884357	939	470.0	
28431	chr5	54901302	54901781	479	240.0	
28432	chr5	54902612	54903265	653	326.0	
28433	chr5	54905932	54906397	465	232.0	
28434	chr5	54944205	54944667	462	231.0	
28435	chr5	54989106	54989122	16	8.0	
28436	chr5	55002271	55002467	196	98.0	
28437	chr5	55022403	55022851	448	224.0	
28438	chr5	55023887	55024417	530	265.0	
28439	chr5	55027531	55028063	532	266.0	
28440	chr5	55037019	55038160	1141	570.0	
28441	chr5	55061698	55062890	1192	596.0	
28442	chr5	55072602	55073235	633	316.0	
28443	chr5	55096042	55097454	1412	706.0	
28444	chr5	55101353	55103090	1737	868.0	
28445	chr5	55104043	55105531	1488	744.0	
28446	chr5	55146424	55147026	602	301.0	
28447	chr5	55159610	55160215	605	302.0	
28448	chr5	55171773	55174221	2448	1224.0	
28449	chr5	55176094	55177477	1383	692.0	
28450	chr5	55220344	55221268	924	462.0	
28451	chr5	55222176	55222535	359	180.0	
28452	chr5	55223053	55223832	779	390.0	
28453	chr5	55226264	55228089	1825	912.0	
28454	chr5	55230522	55234433	3911	1956.0	
28455	chr5	55303233	55303742	509	254.0	
28456	chr5	55305503	55305603	100	50.0	
28457	chr5	55306867	55308866	1999	1000.0	
28458	chr5	55324764	55325231	467	234.0	
28459	chr5	55338873	55339058	185	92.0	
28460	chr5	55344346	55344793	447	224.0	
28461	chr5	55533711	55535869	2158	1079.0	
28462	chr5	55538599	55539029	430	215.0	
28463	chr5	55541291	55541410	119	60.0	
28464	chr5	55600631	55601043	412	206.0	
28465	chr5	55641839	55642179	340	170.0	
28466	chr5	55691748	55692228	480	240.0	
28467	chr5	55702649	55702956	307	154.0	
28468	chr5	55711390	55713196	1806	903.0	
28469	chr5	55821842	55822252	410	205.0	
28470	chr5	55853010	55853636	626	313.0	
28471	chr5	55856378	55857057	679	340.0	
28472	chr5	55860237	55860836	599	300.0	
28473	chr5	55864775	55865468	693	346.0	
28474	chr5	55868986	55869092	106	53.0	
28475	chr5	55897305	55897658	353	176.0	
28476	chr5	55902951	55904594	1643	822.0	
28477	chr5	55923048	55924130	1082	541.0	
28478	chr5	55936024	55936583	559	280.0	
28479	chr5	55977693	55978753	1060	530.0	
28480	chr5	55982837	55983493	656	328.0	
28481	chr5	55988865	55990851	1986	993.0	
28482	chr5	55991591	55996039	4448	2224.0	
28483	chr5	55997767	55998080	313	156.0	
28484	chr5	56006260	56006482	222	111.0	
28485	chr5	56011847	56013058	1211	606.0	
28486	chr5	56026788	56027408	620	310.0	
28487	chr5	56040055	56040419	364	182.0	
28488	chr5	56050695	56051393	698	349.0	
28489	chr5	56055951	56056196	245	122.0	
28490	chr5	56058261	56059418	1157	578.0	
28491	chr5	56060753	56061071	318	159.0	
28492	chr5	56071031	56071829	798	399.0	
28493	chr5	56080935	56081330	395	198.0	
28494	chr5	56094641	56095020	379	190.0	
28495	chr5	56100387	56101011	624	312.0	
28496	chr5	56102177	56102654	477	238.0	
28497	chr5	56142656	56143059	403	202.0	
28498	chr5	56145394	56145818	424	212.0	
28499	chr5	56147628	56149046	1418	709.0	
28500	chr5	56152461	56152796	335	168.0	
28501	chr5	56154933	56157579	2646	1323.0	
28502	chr5	56159138	56162480	3342	1671.0	
28503	chr5	56165774	56166215	441	220.0	
28504	chr5	56167056	56167084	28	14.0	
28505	chr5	56167716	56168603	887	444.0	
28506	chr5	56174914	56175826	912	456.0	
28507	chr5	56183516	56183861	345	172.0	
28508	chr5	56190516	56190937	421	210.0	
28509	chr5	56191656	56192148	492	246.0	
28510	chr5	56200886	56201572	686	343.0	
28511	chr5	56259210	56259603	393	196.0	
28512	chr5	56264359	56264816	457	228.0	
28513	chr5	56269506	56271424	1918	959.0	
28514	chr5	56302837	56303240	403	202.0	
28515	chr5	56327515	56328214	699	350.0	
28516	chr5	56328858	56329448	590	295.0	
28517	chr5	56347134	56347482	348	174.0	
28518	chr5	56412782	56413490	708	354.0	
28519	chr5	56414007	56415962	1955	978.0	
28520	chr5	56441438	56441804	366	183.0	
28521	chr5	56454326	56454650	324	162.0	
28522	chr5	56464883	56465762	879	440.0	
28523	chr5	56466447	56466448	1	0.0	
28524	chr5	56477370	56478129	759	380.0	
28525	chr5	56479125	56482963	3838	1919.0	
28526	chr5	56494289	56494669	380	190.0	
28527	chr5	56496625	56497013	388	194.0	
28528	chr5	56512655	56512781	126	63.0	
28529	chr5	56516701	56517331	630	315.0	
28530	chr5	56523015	56523256	241	120.0	
28531	chr5	56529686	56530524	838	419.0	
28532	chr5	56544904	56545464	560	280.0	
28533	chr5	56550226	56550581	355	178.0	
28534	chr5	56564870	56566179	1309	654.0	
28535	chr5	56569686	56569848	162	81.0	
28536	chr5	56585421	56585765	344	172.0	
28537	chr5	56587433	56589621	2188	1094.0	
28538	chr5	56593064	56593139	75	38.0	
28539	chr5	56608061	56608692	631	316.0	
28540	chr5	56610277	56610467	190	95.0	
28541	chr5	56612711	56613187	476	238.0	
28542	chr5	56640690	56641249	559	280.0	
28543	chr5	56660892	56661252	360	180.0	
28544	chr5	56666861	56667323	462	231.0	
28545	chr5	56669453	56670642	1189	594.0	
28546	chr5	56671625	56671980	355	178.0	
28547	chr5	56673078	56673660	582	291.0	
28548	chr5	56674481	56674583	102	51.0	
28549	chr5	56685512	56687103	1591	796.0	
28550	chr5	56692407	56692975	568	284.0	
28551	chr5	56698946	56699115	169	84.0	
28552	chr5	56725702	56726159	457	228.0	
28553	chr5	56729392	56729976	584	292.0	
28554	chr5	56736002	56737518	1516	758.0	
28555	chr5	56761388	56761765	377	188.0	
28556	chr5	56763594	56764541	947	474.0	
28557	chr5	56812158	56812481	323	162.0	
28558	chr5	56813100	56817731	4631	2316.0	
28559	chr5	56818575	56819803	1228	614.0	
28560	chr5	56822839	56823649	810	405.0	
28561	chr5	56824301	56824602	301	150.0	
28562	chr5	56825565	56825877	312	156.0	
28563	chr5	56826738	56827559	821	410.0	
28564	chr5	56829017	56829889	872	436.0	
28565	chr5	56832180	56832514	334	167.0	
28566	chr5	56837191	56839075	1884	942.0	
28567	chr5	56840613	56840951	338	169.0	
28568	chr5	56845285	56845683	398	199.0	
28569	chr5	56849107	56850208	1101	550.0	
28570	chr5	56851475	56852761	1286	643.0	
28571	chr5	56853594	56854150	556	278.0	
28572	chr5	56856784	56856907	123	62.0	
28573	chr5	56860885	56861314	429	214.0	
28574	chr5	56862908	56863247	339	170.0	
28575	chr5	56876467	56876524	57	28.0	
28576	chr5	56900388	56901436	1048	524.0	
28577	chr5	56908249	56911041	2792	1396.0	
28578	chr5	56949790	56949827	37	18.0	
28579	chr5	56950481	56952949	2468	1234.0	
28580	chr5	56963259	56963380	121	60.0	
28581	chr5	56986317	56986763	446	223.0	
28582	chr5	56996235	56996671	436	218.0	
28583	chr5	57007310	57007692	382	191.0	
28584	chr5	57030094	57030733	639	320.0	
28585	chr5	57117478	57118115	637	318.0	
28586	chr5	57137792	57138577	785	392.0	
28587	chr5	57166186	57166783	597	298.0	
28588	chr5	57171719	57176996	5277	2638.0	
28589	chr5	57177637	57178508	871	436.0	
28590	chr5	57179144	57181818	2674	1337.0	
28591	chr5	57184292	57184766	474	237.0	
28592	chr5	57186259	57186519	260	130.0	
28593	chr5	57187790	57188598	808	404.0	
28594	chr5	57193733	57194201	468	234.0	
28595	chr5	57199766	57200421	655	328.0	
28596	chr5	57205328	57205627	299	150.0	
28597	chr5	57209330	57209726	396	198.0	
28598	chr5	57210946	57210952	6	3.0	
28599	chr5	57219369	57219808	439	220.0	
28600	chr5	57220520	57221414	894	447.0	
28601	chr5	57243266	57243780	514	257.0	
28602	chr5	57246402	57246857	455	228.0	
28603	chr5	57298126	57299567	1441	720.0	
28604	chr5	57300075	57300392	317	158.0	
28605	chr5	57302262	57302544	282	141.0	
28606	chr5	57451659	57451686	27	14.0	
28607	chr5	57499331	57499794	463	232.0	
28608	chr5	57650257	57650660	403	202.0	
28609	chr5	57779619	57779714	95	48.0	
28610	chr5	58235187	58235805	618	309.0	
28611	chr5	58238815	58239092	277	138.0	
28612	chr5	58294523	58295390	867	434.0	
28613	chr5	58410438	58410902	464	232.0	
28614	chr5	58446163	58446253	90	45.0	
28615	chr5	58450828	58450991	163	82.0	
28616	chr5	58458686	58461389	2703	1352.0	
28617	chr5	58462253	58463098	845	422.0	
28618	chr5	58466879	58467356	477	238.0	
28619	chr5	58469841	58470326	485	242.0	
28620	chr5	58484518	58484802	284	142.0	
28621	chr5	58486213	58486745	532	266.0	
28622	chr5	58490421	58491880	1459	730.0	
28623	chr5	58499938	58500306	368	184.0	
28624	chr5	58505984	58506682	698	349.0	
28625	chr5	58543777	58544737	960	480.0	
28626	chr5	58545886	58546412	526	263.0	
28627	chr5	58582099	58583561	1462	731.0	
28628	chr5	58759724	58760572	848	424.0	
28629	chr5	58775883	58776059	176	88.0	
28630	chr5	58786778	58786896	118	59.0	
28631	chr5	58850336	58850652	316	158.0	
28632	chr5	58886547	58887389	842	421.0	
28633	chr5	58891650	58892132	482	241.0	
28634	chr5	58934315	58934767	452	226.0	
28635	chr5	58966141	58966153	12	6.0	
28636	chr5	59000088	59000167	79	40.0	
28637	chr5	59007737	59007796	59	30.0	
28638	chr5	59034356	59035202	846	423.0	
28639	chr5	59036227	59036815	588	294.0	
28640	chr5	59037955	59041776	3821	1910.0	
28641	chr5	59042435	59042808	373	186.0	
28642	chr5	59098775	59100131	1356	678.0	
28643	chr5	59123410	59124638	1228	614.0	
28644	chr5	59125323	59126463	1140	570.0	
28645	chr5	59126967	59128460	1493	746.0	
28646	chr5	59132150	59132544	394	197.0	
28647	chr5	59161702	59162071	369	184.0	
28648	chr5	59173828	59174674	846	423.0	
28649	chr5	59188400	59189043	643	322.0	
28650	chr5	59275693	59275806	113	56.0	
28651	chr5	59337283	59337580	297	148.0	
28652	chr5	59356901	59357196	295	148.0	
28653	chr5	59358539	59358861	322	161.0	
28654	chr5	59360137	59360519	382	191.0	
28655	chr5	59367799	59368161	362	181.0	
28656	chr5	59380350	59380854	504	252.0	
28657	chr5	59562682	59563431	749	374.0	
28658	chr5	59598649	59598721	72	36.0	
28659	chr5	59673480	59673789	309	154.0	
28660	chr5	59751613	59751619	6	3.0	
28661	chr5	59760817	59761424	607	304.0	
28662	chr5	59768523	59768918	395	198.0	
28663	chr5	59790386	59790887	501	250.0	
28664	chr5	59798999	59800516	1517	758.0	
28665	chr5	59809904	59810422	518	259.0	
28666	chr5	59813623	59814654	1031	516.0	
28667	chr5	59893893	59894245	352	176.0	
28668	chr5	60196296	60196821	525	262.0	
28669	chr5	60202825	60203296	471	236.0	
28670	chr5	60206954	60207533	579	290.0	
28671	chr5	60232314	60232869	555	278.0	
28672	chr5	60248838	60249460	622	311.0	
28673	chr5	60257836	60258304	468	234.0	
28674	chr5	60259661	60260206	545	272.0	
28675	chr5	60269930	60270209	279	140.0	
28676	chr5	60287119	60287619	500	250.0	
28677	chr5	60416411	60416457	46	23.0	
28678	chr5	60521357	60522809	1452	726.0	
28679	chr5	60538440	60539997	1557	778.0	
28680	chr5	60540933	60542447	1514	757.0	
28681	chr5	60597696	60598002	306	153.0	
28682	chr5	60651891	60652724	833	416.0	
28683	chr5	60677482	60678145	663	332.0	
28684	chr5	60685817	60686144	327	164.0	
28685	chr5	60688249	60688650	401	200.0	
28686	chr5	60699228	60701746	2518	1259.0	
28687	chr5	60820683	60821011	328	164.0	
28688	chr5	60843879	60844606	727	364.0	
28689	chr5	60943463	60946426	2963	1482.0	
28690	chr5	60960652	60960963	311	156.0	
28691	chr5	61055428	61055829	401	200.0	
28692	chr5	61161674	61163599	1925	962.0	
28693	chr5	61177758	61177914	156	78.0	
28694	chr5	61182433	61182851	418	209.0	
28695	chr5	61263821	61264346	525	262.0	
28696	chr5	61268925	61269199	274	137.0	
28697	chr5	61273574	61273912	338	169.0	
28698	chr5	61275340	61276526	1186	593.0	
28699	chr5	61277162	61277851	689	344.0	
28700	chr5	61280197	61281321	1124	562.0	
28701	chr5	61289813	61290350	537	268.0	
28702	chr5	61305038	61305369	331	166.0	
28703	chr5	61306688	61307247	559	280.0	
28704	chr5	61313947	61314509	562	281.0	
28705	chr5	61319155	61321350	2195	1098.0	
28706	chr5	61322927	61323507	580	290.0	
28707	chr5	61327645	61328823	1178	589.0	
28708	chr5	61329616	61337669	8053	4026.0	
28709	chr5	61338932	61339582	650	325.0	
28710	chr5	61340259	61342752	2493	1246.0	
28711	chr5	61343424	61349581	6157	3078.0	
28712	chr5	61350082	61350741	659	330.0	
28713	chr5	61351779	61355385	3606	1803.0	
28714	chr5	61357089	61358117	1028	514.0	
28715	chr5	61358783	61361730	2947	1474.0	
28716	chr5	61362597	61363819	1222	611.0	
28717	chr5	61364652	61365131	479	240.0	
28718	chr5	61365928	61368096	2168	1084.0	
28719	chr5	61368628	61369909	1281	640.0	
28720	chr5	61371651	61372676	1025	512.0	
28721	chr5	61401751	61402156	405	202.0	
28722	chr5	61407710	61409464	1754	877.0	
28723	chr5	61625585	61627323	1738	869.0	
28724	chr5	61658495	61658961	466	233.0	
28725	chr5	61666199	61666642	443	222.0	
28726	chr5	62223323	62225397	2074	1037.0	
28727	chr5	62256144	62257187	1043	522.0	
28728	chr5	62285008	62285976	968	484.0	
28729	chr5	62287126	62287355	229	114.0	
28730	chr5	62291559	62292460	901	450.0	
28731	chr5	62297049	62297351	302	151.0	
28732	chr5	62299324	62300249	925	462.0	
28733	chr5	62305150	62308622	3472	1736.0	
28734	chr5	62310731	62310734	3	2.0	
28735	chr5	62314542	62314614	72	36.0	
28736	chr5	62315357	62315747	390	195.0	
28737	chr5	62333518	62333694	176	88.0	
28738	chr5	62340358	62340781	423	212.0	
28739	chr5	62341697	62342580	883	442.0	
28740	chr5	62354023	62354499	476	238.0	
28741	chr5	62403063	62404818	1755	878.0	
28742	chr5	62411972	62413460	1488	744.0	
28743	chr5	62431779	62432662	883	442.0	
28744	chr5	62443749	62444130	381	190.0	
28745	chr5	62460493	62460857	364	182.0	
28746	chr5	62521333	62521732	399	200.0	
28747	chr5	62538601	62538958	357	178.0	
28748	chr5	62547868	62548696	828	414.0	
28749	chr5	62572796	62573044	248	124.0	
28750	chr5	62578456	62579044	588	294.0	
28751	chr5	62585827	62585873	46	23.0	
28752	chr5	62592504	62593008	504	252.0	
28753	chr5	62640450	62640899	449	224.0	
28754	chr5	62643972	62644233	261	130.0	
28755	chr5	62653578	62654026	448	224.0	
28756	chr5	62689776	62690604	828	414.0	
28757	chr5	62701011	62701320	309	154.0	
28758	chr5	62707688	62707748	60	30.0	
28759	chr5	62730972	62731378	406	203.0	
28760	chr5	62732484	62733235	751	376.0	
28761	chr5	62778296	62779339	1043	522.0	
28762	chr5	64612086	64612426	340	170.0	
28763	chr5	64634854	64635470	616	308.0	
28764	chr5	64766945	64769563	2618	1309.0	
28765	chr5	64775206	64775768	562	281.0	
28766	chr5	64784360	64784861	501	250.0	
28767	chr5	64811025	64811430	405	202.0	
28768	chr5	64822336	64822642	306	153.0	
28769	chr5	65021540	65022250	710	355.0	
28770	chr5	65034502	65036747	2245	1122.0	
28771	chr5	65037594	65038292	698	349.0	
28772	chr5	65041645	65041895	250	125.0	
28773	chr5	65061536	65061853	317	158.0	
28774	chr5	65066426	65066615	189	94.0	
28775	chr5	65076291	65076791	500	250.0	
28776	chr5	65101007	65101479	472	236.0	
28777	chr5	65102497	65104083	1586	793.0	
28778	chr5	65480108	65484201	4093	2046.0	
28779	chr5	65562495	65564109	1614	807.0	
28780	chr5	65623531	65625655	2124	1062.0	
28781	chr5	65675989	65676565	576	288.0	
28782	chr5	65719198	65723513	4315	2158.0	
28783	chr5	65724033	65724657	624	312.0	
28784	chr5	65731826	65732542	716	358.0	
28785	chr5	65734903	65735416	513	256.0	
28786	chr5	65742522	65742938	416	208.0	
28787	chr5	65760864	65761328	464	232.0	
28788	chr5	65779663	65780060	397	198.0	
28789	chr5	65790227	65790874	647	324.0	
28790	chr5	65796927	65797272	345	172.0	
28791	chr5	65825837	65826426	589	294.0	
28792	chr5	65845180	65845985	805	402.0	
28793	chr5	65857917	65858337	420	210.0	
28794	chr5	65924448	65928648	4200	2100.0	
28795	chr5	66010393	66010769	376	188.0	
28796	chr5	66142739	66142856	117	58.0	
28797	chr5	66143504	66145470	1966	983.0	
28798	chr5	66171272	66171796	524	262.0	
28799	chr5	66255789	66256077	288	144.0	
28800	chr5	66279738	66280414	676	338.0	
28801	chr5	66306305	66306762	457	228.0	
28802	chr5	66307648	66308088	440	220.0	
28803	chr5	66351772	66352173	401	200.0	
28804	chr5	66515226	66515625	399	200.0	
28805	chr5	66554098	66554707	609	304.0	
28806	chr5	66558626	66558918	292	146.0	
28807	chr5	66595986	66597061	1075	538.0	
28808	chr5	66718504	66719054	550	275.0	
28809	chr5	66722729	66723125	396	198.0	
28810	chr5	66724410	66724527	117	58.0	
28811	chr5	66810721	66811182	461	230.0	
28812	chr5	66814403	66814784	381	190.0	
28813	chr5	66828339	66829450	1111	556.0	
28814	chr5	66840604	66841170	566	283.0	
28815	chr5	66850548	66851169	621	310.0	
28816	chr5	66854403	66854885	482	241.0	
28817	chr5	66875241	66875712	471	236.0	
28818	chr5	66880661	66880781	120	60.0	
28819	chr5	66987935	66988430	495	248.0	
28820	chr5	66992539	66992923	384	192.0	
28821	chr5	67002520	67002901	381	190.0	
28822	chr5	67003578	67006366	2788	1394.0	
28823	chr5	67015419	67015875	456	228.0	
28824	chr5	67033142	67033645	503	252.0	
28825	chr5	67081412	67081478	66	33.0	
28826	chr5	67146608	67146991	383	192.0	
28827	chr5	67156731	67157610	879	440.0	
28828	chr5	67165153	67167877	2724	1362.0	
28829	chr5	67170723	67171292	569	284.0	
28830	chr5	67176896	67177326	430	215.0	
28831	chr5	67177967	67178470	503	252.0	
28832	chr5	67181524	67182744	1220	610.0	
28833	chr5	67187221	67187842	621	310.0	
28834	chr5	67188953	67189350	397	198.0	
28835	chr5	67192779	67194658	1879	940.0	
28836	chr5	67195629	67197372	1743	872.0	
28837	chr5	67202752	67203381	629	314.0	
28838	chr5	67204025	67204509	484	242.0	
28839	chr5	67206138	67207943	1805	902.0	
28840	chr5	67208999	67209828	829	414.0	
28841	chr5	67215382	67216682	1300	650.0	
28842	chr5	67221392	67223607	2215	1108.0	
28843	chr5	67245829	67246477	648	324.0	
28844	chr5	67288596	67289258	662	331.0	
28845	chr5	67299034	67299580	546	273.0	
28846	chr5	67301208	67301747	539	270.0	
28847	chr5	67315393	67316108	715	358.0	
28848	chr5	67350240	67351095	855	428.0	
28849	chr5	67354028	67354310	282	141.0	
28850	chr5	67360104	67360396	292	146.0	
28851	chr5	67514779	67516266	1487	744.0	
28852	chr5	67537477	67537849	372	186.0	
28853	chr5	67542538	67542678	140	70.0	
28854	chr5	67544982	67545364	382	191.0	
28855	chr5	67998759	67999394	635	318.0	
28856	chr5	68002782	68003193	411	206.0	
28857	chr5	68041264	68042612	1348	674.0	
28858	chr5	68046380	68046865	485	242.0	
28859	chr5	68141481	68141940	459	230.0	
28860	chr5	68189232	68189480	248	124.0	
28861	chr5	68193346	68193983	637	318.0	
28862	chr5	68196631	68197401	770	385.0	
28863	chr5	68214499	68217992	3493	1746.0	
28864	chr5	68224815	68225587	772	386.0	
28865	chr5	68239296	68240818	1522	761.0	
28866	chr5	68241536	68241808	272	136.0	
28867	chr5	68243649	68244114	465	232.0	
28868	chr5	68246839	68247207	368	184.0	
28869	chr5	68251311	68253087	1776	888.0	
28870	chr5	68255154	68256898	1744	872.0	
28871	chr5	68261625	68262173	548	274.0	
28872	chr5	68264960	68267294	2334	1167.0	
28873	chr5	68268180	68269068	888	444.0	
28874	chr5	68272295	68272693	398	199.0	
28875	chr5	68274987	68276054	1067	534.0	
28876	chr5	68279658	68280938	1280	640.0	
28877	chr5	68281534	68282111	577	288.0	
28878	chr5	68285363	68289114	3751	1876.0	
28879	chr5	68303444	68303689	245	122.0	
28880	chr5	68315543	68316243	700	350.0	
28881	chr5	68329517	68330033	516	258.0	
28882	chr5	68331054	68332856	1802	901.0	
28883	chr5	68344408	68345362	954	477.0	
28884	chr5	68347494	68348023	529	264.0	
28885	chr5	68369098	68370141	1043	522.0	
28886	chr5	68372058	68372628	570	285.0	
28887	chr5	68378222	68378613	391	196.0	
28888	chr5	68381948	68382356	408	204.0	
28889	chr5	68406723	68407255	532	266.0	
28890	chr5	68415592	68415677	85	42.0	
28891	chr5	68424959	68425763	804	402.0	
28892	chr5	68432740	68436091	3351	1676.0	
28893	chr5	68441210	68441730	520	260.0	
28894	chr5	68458739	68458781	42	21.0	
28895	chr5	68460076	68460579	503	252.0	
28896	chr5	68464371	68464856	485	242.0	
28897	chr5	68519112	68519561	449	224.0	
28898	chr5	68565553	68565788	235	118.0	
28899	chr5	68711249	68712096	847	424.0	
28900	chr5	68875416	68875711	295	148.0	
28901	chr5	68884186	68884391	205	102.0	
28902	chr5	69007724	69008211	487	244.0	
28903	chr5	69042515	69043680	1165	582.0	
28904	chr5	69093311	69094990	1679	840.0	
28905	chr5	69106016	69106718	702	351.0	
28906	chr5	69136448	69136567	119	60.0	
28907	chr5	69152796	69153095	299	150.0	
28908	chr5	69166336	69167925	1589	794.0	
28909	chr5	69188813	69190684	1871	936.0	
28910	chr5	69199433	69199436	3	2.0	
28911	chr5	69212009	69212411	402	201.0	
28912	chr5	69216951	69218779	1828	914.0	
28913	chr5	69234151	69235505	1354	677.0	
28914	chr5	69317363	69317832	469	234.0	
28915	chr5	69331587	69333297	1710	855.0	
28916	chr5	69334559	69335355	796	398.0	
28917	chr5	69364412	69364827	415	208.0	
28918	chr5	69368631	69370793	2162	1081.0	
28919	chr5	69414798	69415572	774	387.0	
28920	chr5	69492539	69492876	337	168.0	
28921	chr5	69493446	69493904	458	229.0	
28922	chr5	69559787	69560506	719	360.0	
28923	chr5	69606858	69607261	403	202.0	
28924	chr5	70400932	70401741	809	404.0	
28925	chr5	71447179	71447596	417	208.0	
28926	chr5	71454945	71456547	1602	801.0	
28927	chr5	71468924	71469574	650	325.0	
28928	chr5	71475740	71476194	454	227.0	
28929	chr5	71533218	71534083	865	432.0	
28930	chr5	71586414	71588197	1783	892.0	
28931	chr5	71600920	71602105	1185	592.0	
28932	chr5	71757842	71758296	454	227.0	
28933	chr5	71782733	71783247	514	257.0	
28934	chr5	71887574	71888163	589	294.0	
28935	chr5	72018173	72018555	382	191.0	
28936	chr5	72137791	72138205	414	207.0	
28937	chr5	72139113	72139203	90	45.0	
28938	chr5	72194766	72195264	498	249.0	
28939	chr5	72232226	72233002	776	388.0	
28940	chr5	72234090	72234937	847	424.0	
28941	chr5	72244973	72245078	105	52.0	
28942	chr5	72269131	72269524	393	196.0	
28943	chr5	72284677	72285398	721	360.0	
28944	chr5	72307555	72309218	1663	832.0	
28945	chr5	72318656	72320990	2334	1167.0	
28946	chr5	72347976	72348061	85	42.0	
28947	chr5	72352736	72352956	220	110.0	
28948	chr5	72366290	72366761	471	236.0	
28949	chr5	72372359	72372694	335	168.0	
28950	chr5	72378665	72379153	488	244.0	
28951	chr5	72380610	72381235	625	312.0	
28952	chr5	72386516	72387048	532	266.0	
28953	chr5	72452172	72452573	401	200.0	
28954	chr5	72465585	72466206	621	310.0	
28955	chr5	72467913	72468459	546	273.0	
28956	chr5	72472453	72473273	820	410.0	
28957	chr5	72505564	72505897	333	166.0	
28958	chr5	72507179	72508688	1509	754.0	
28959	chr5	72517867	72518396	529	264.0	
28960	chr5	72523981	72524348	367	184.0	
28961	chr5	72525810	72526148	338	169.0	
28962	chr5	72556424	72557277	853	426.0	
28963	chr5	72587889	72588257	368	184.0	
28964	chr5	72598247	72599264	1017	508.0	
28965	chr5	72600331	72600581	250	125.0	
28966	chr5	72611109	72611560	451	226.0	
28967	chr5	72812444	72812993	549	274.0	
28968	chr5	72815721	72818052	2331	1166.0	
28969	chr5	72818851	72819465	614	307.0	
28970	chr5	72822591	72822594	3	2.0	
28971	chr5	72842792	72843276	484	242.0	
28972	chr5	72847803	72849529	1726	863.0	
28973	chr5	72920711	72921089	378	189.0	
28974	chr5	72937745	72938568	823	412.0	
28975	chr5	72940139	72940448	309	154.0	
28976	chr5	72952005	72952566	561	280.0	
28977	chr5	72955169	72957122	1953	976.0	
28978	chr5	73095630	73096573	943	472.0	
28979	chr5	73119365	73120931	1566	783.0	
28980	chr5	73160065	73160731	666	333.0	
28981	chr5	73170627	73170645	18	9.0	
28982	chr5	73201673	73202384	711	356.0	
28983	chr5	73215596	73216645	1049	524.0	
28984	chr5	73219423	73219534	111	56.0	
28985	chr5	73232487	73232721	234	117.0	
28986	chr5	73233659	73233868	209	104.0	
28987	chr5	73312527	73312790	263	132.0	
28988	chr5	73381311	73382072	761	380.0	
28989	chr5	73387036	73388451	1415	708.0	
28990	chr5	73436423	73437753	1330	665.0	
28991	chr5	73446825	73449908	3083	1542.0	
28992	chr5	73450901	73451902	1001	500.0	
28993	chr5	73454350	73454866	516	258.0	
28994	chr5	73497718	73499539	1821	910.0	
28995	chr5	73519357	73520284	927	464.0	
28996	chr5	73536576	73537418	842	421.0	
28997	chr5	73564179	73566542	2363	1182.0	
28998	chr5	73591068	73591565	497	248.0	
28999	chr5	73596765	73597047	282	141.0	
29000	chr5	73625606	73626627	1021	510.0	
29001	chr5	73694006	73694536	530	265.0	
29002	chr5	73792703	73793180	477	238.0	
29003	chr5	73796310	73796859	549	274.0	
29004	chr5	73859607	73860224	617	308.0	
29005	chr5	73861578	73861925	347	174.0	
29006	chr5	73902544	73903170	626	313.0	
29007	chr5	73918934	73918950	16	8.0	
29008	chr5	74035498	74035879	381	190.0	
29009	chr5	74149403	74149863	460	230.0	
29010	chr5	74239092	74239717	625	312.0	
29011	chr5	74241363	74241702	339	170.0	
29012	chr5	74250923	74251554	631	316.0	
29013	chr5	74257688	74258156	468	234.0	
29014	chr5	74275510	74276322	812	406.0	
29015	chr5	74294187	74294853	666	333.0	
29016	chr5	74326813	74327460	647	324.0	
29017	chr5	74394564	74395168	604	302.0	
29018	chr5	74421407	74421829	422	211.0	
29019	chr5	74430637	74431027	390	195.0	
29020	chr5	74432254	74432699	445	222.0	
29021	chr5	74433299	74435000	1701	850.0	
29022	chr5	74452724	74453556	832	416.0	
29023	chr5	74490769	74491253	484	242.0	
29024	chr5	74537785	74538967	1182	591.0	
29025	chr5	74576787	74577471	684	342.0	
29026	chr5	74578890	74579716	826	413.0	
29027	chr5	74613164	74613779	615	308.0	
29028	chr5	74628412	74628652	240	120.0	
29029	chr5	74630251	74633367	3116	1558.0	
29030	chr5	74638155	74643782	5627	2814.0	
29031	chr5	74644995	74645000	5	2.0	
29032	chr5	74648693	74649416	723	362.0	
29033	chr5	74672943	74673342	399	200.0	
29034	chr5	74684618	74686812	2194	1097.0	
29035	chr5	74766068	74768021	1953	976.0	
29036	chr5	74851936	74852301	365	182.0	
29037	chr5	74865486	74867046	1560	780.0	
29038	chr5	74889709	74889841	132	66.0	
29039	chr5	74903428	74903644	216	108.0	
29040	chr5	74919477	74919954	477	238.0	
29041	chr5	74934922	74935826	904	452.0	
29042	chr5	74974473	74975231	758	379.0	
29043	chr5	75023706	75024307	601	300.0	
29044	chr5	75028069	75028459	390	195.0	
29045	chr5	75034224	75034822	598	299.0	
29046	chr5	75044417	75044659	242	121.0	
29047	chr5	75048379	75048901	522	261.0	
29048	chr5	75049731	75054643	4912	2456.0	
29049	chr5	75057554	75057986	432	216.0	
29050	chr5	75059440	75060470	1030	515.0	
29051	chr5	75078074	75078393	319	160.0	
29052	chr5	75095364	75095760	396	198.0	
29053	chr5	75236048	75237551	1503	752.0	
29054	chr5	75265589	75266092	503	252.0	
29055	chr5	75319031	75321338	2307	1154.0	
29056	chr5	75336008	75338176	2168	1084.0	
29057	chr5	75461748	75462047	299	150.0	
29058	chr5	75509522	75512676	3154	1577.0	
29059	chr5	75523867	75524469	602	301.0	
29060	chr5	75526012	75526465	453	226.0	
29061	chr5	75558832	75559532	700	350.0	
29062	chr5	75566568	75567308	740	370.0	
29063	chr5	75607250	75607641	391	196.0	
29064	chr5	75611521	75611876	355	178.0	
29065	chr5	75660090	75661160	1070	535.0	
29066	chr5	75668676	75669715	1039	520.0	
29067	chr5	75678309	75678318	9	4.0	
29068	chr5	75681171	75681674	503	252.0	
29069	chr5	75710609	75711054	445	222.0	
29070	chr5	75716649	75718104	1455	728.0	
29071	chr5	75720909	75721315	406	203.0	
29072	chr5	75847503	75847953	450	225.0	
29073	chr5	76037853	76038072	219	110.0	
29074	chr5	76074534	76074863	329	164.0	
29075	chr5	76083176	76083369	193	96.0	
29076	chr5	76084471	76084872	401	200.0	
29077	chr5	76099197	76099633	436	218.0	
29078	chr5	76175013	76176535	1522	761.0	
29079	chr5	76180611	76181781	1170	585.0	
29080	chr5	76202212	76202595	383	192.0	
29081	chr5	76256017	76256710	693	346.0	
29082	chr5	76270268	76270408	140	70.0	
29083	chr5	76292612	76293364	752	376.0	
29084	chr5	76294552	76295063	511	256.0	
29085	chr5	76303818	76304402	584	292.0	
29086	chr5	76305229	76305738	509	254.0	
29087	chr5	76309061	76309462	401	200.0	
29088	chr5	76325438	76326827	1389	694.0	
29089	chr5	76331091	76331719	628	314.0	
29090	chr5	76337818	76338515	697	348.0	
29091	chr5	76341813	76342438	625	312.0	
29092	chr5	76351507	76351966	459	230.0	
29093	chr5	76367874	76368430	556	278.0	
29094	chr5	76372565	76372782	217	108.0	
29095	chr5	76384315	76385103	788	394.0	
29096	chr5	76390961	76391428	467	234.0	
29097	chr5	76393031	76393487	456	228.0	
29098	chr5	76401450	76409149	7699	3850.0	
29099	chr5	76413855	76414069	214	107.0	
29100	chr5	76425314	76425367	53	26.0	
29101	chr5	76450996	76451505	509	254.0	
29102	chr5	76457914	76458374	460	230.0	
29103	chr5	76468551	76469659	1108	554.0	
29104	chr5	76472503	76472515	12	6.0	
29105	chr5	76473413	76474183	770	385.0	
29106	chr5	76479834	76480200	366	183.0	
29107	chr5	76495922	76496276	354	177.0	
29108	chr5	76521078	76521781	703	352.0	
29109	chr5	76527807	76528036	229	114.0	
29110	chr5	76541937	76544762	2825	1412.0	
29111	chr5	76546280	76549281	3001	1500.0	
29112	chr5	76556708	76557292	584	292.0	
29113	chr5	76564902	76565502	600	300.0	
29114	chr5	76571708	76571822	114	57.0	
29115	chr5	76582090	76582841	751	376.0	
29116	chr5	76590140	76590408	268	134.0	
29117	chr5	76601382	76601947	565	282.0	
29118	chr5	76607496	76607732	236	118.0	
29119	chr5	76608756	76609321	565	282.0	
29120	chr5	76623208	76623428	220	110.0	
29121	chr5	76625185	76625672	487	244.0	
29122	chr5	76626668	76627269	601	300.0	
29123	chr5	76638425	76639031	606	303.0	
29124	chr5	76641282	76641961	679	340.0	
29125	chr5	76705533	76705933	400	200.0	
29126	chr5	76714616	76717101	2485	1242.0	
29127	chr5	76720985	76721618	633	316.0	
29128	chr5	76732350	76733625	1275	638.0	
29129	chr5	76736971	76737544	573	286.0	
29130	chr5	76738407	76739799	1392	696.0	
29131	chr5	76741483	76741872	389	194.0	
29132	chr5	76763101	76763611	510	255.0	
29133	chr5	76774418	76775203	785	392.0	
29134	chr5	76778789	76779324	535	268.0	
29135	chr5	76791881	76792292	411	206.0	
29136	chr5	76794756	76795157	401	200.0	
29137	chr5	76818130	76820298	2168	1084.0	
29138	chr5	76849601	76850589	988	494.0	
29139	chr5	76851363	76852304	941	470.0	
29140	chr5	76853785	76854229	444	222.0	
29141	chr5	76855754	76856560	806	403.0	
29142	chr5	76859568	76859875	307	154.0	
29143	chr5	76868019	76868511	492	246.0	
29144	chr5	76873986	76874429	443	222.0	
29145	chr5	76875294	76875690	396	198.0	
29146	chr5	76959319	76959713	394	197.0	
29147	chr5	76999473	76999868	395	198.0	
29148	chr5	77029580	77031374	1794	897.0	
29149	chr5	77065319	77067485	2166	1083.0	
29150	chr5	77076914	77078201	1287	644.0	
29151	chr5	77086489	77088303	1814	907.0	
29152	chr5	77144496	77144951	455	228.0	
29153	chr5	77146874	77147246	372	186.0	
29154	chr5	77155136	77155971	835	418.0	
29155	chr5	77210219	77210951	732	366.0	
29156	chr5	77231101	77231910	809	404.0	
29157	chr5	77232880	77233475	595	298.0	
29158	chr5	77294171	77294507	336	168.0	
29159	chr5	77379635	77380070	435	218.0	
29160	chr5	77483727	77484046	319	160.0	
29161	chr5	77490923	77493053	2130	1065.0	
29162	chr5	77499489	77499736	247	124.0	
29163	chr5	77590369	77590808	439	220.0	
29164	chr5	77629360	77631549	2189	1094.0	
29165	chr5	77645173	77645972	799	400.0	enhancer
29166	chr5	77774997	77777122	2125	1062.0	
29167	chr5	77798435	77798862	427	214.0	
29168	chr5	77806406	77806813	407	204.0	
29169	chr5	77844262	77845118	856	428.0	
29170	chr5	77851637	77853311	1674	837.0	
29171	chr5	77864835	77865761	926	463.0	
29172	chr5	77867386	77867487	101	50.0	
29173	chr5	77876394	77877280	886	443.0	
29174	chr5	77935974	77936433	459	230.0	
29175	chr5	77937045	77937448	403	202.0	
29176	chr5	77972369	77973119	750	375.0	
29177	chr5	78109790	78110241	451	226.0	
29178	chr5	78113668	78114093	425	212.0	
29179	chr5	78221836	78222560	724	362.0	
29180	chr5	78268257	78269564	1307	654.0	
29181	chr5	78286278	78286636	358	179.0	
29182	chr5	78287888	78288210	322	161.0	
29183	chr5	78289972	78290285	313	156.0	
29184	chr5	78293802	78296214	2412	1206.0	
29185	chr5	78300445	78300923	478	239.0	
29186	chr5	78359634	78362150	2516	1258.0	
29187	chr5	78424745	78424869	124	62.0	
29188	chr5	78483493	78484460	967	484.0	
29189	chr5	78500875	78501804	929	464.0	
29190	chr5	78509401	78512093	2692	1346.0	
29191	chr5	78526906	78527841	935	468.0	
29192	chr5	78529317	78530731	1414	707.0	
29193	chr5	78534280	78534790	510	255.0	
29194	chr5	78537799	78538235	436	218.0	
29195	chr5	78540105	78541503	1398	699.0	
29196	chr5	78548881	78549649	768	384.0	
29197	chr5	78553053	78553335	282	141.0	
29198	chr5	78574074	78574392	318	159.0	
29199	chr5	78586287	78586678	391	196.0	
29200	chr5	78592262	78593075	813	406.0	
29201	chr5	78593996	78594432	436	218.0	
29202	chr5	78647300	78649413	2113	1056.0	
29203	chr5	78699897	78700011	114	57.0	
29204	chr5	78727692	78728539	847	424.0	
29205	chr5	78758455	78758867	412	206.0	
29206	chr5	78760256	78760935	679	340.0	
29207	chr5	78771562	78772203	641	320.0	
29208	chr5	78787801	78788143	342	171.0	
29209	chr5	78792476	78792772	296	148.0	
29210	chr5	78886843	78886927	84	42.0	
29211	chr5	78887599	78888095	496	248.0	
29212	chr5	78905655	78906007	352	176.0	
29213	chr5	78907547	78907621	74	37.0	
29214	chr5	78973097	78973464	367	184.0	
29215	chr5	78979917	78980289	372	186.0	
29216	chr5	78981278	78981728	450	225.0	
29217	chr5	78983291	78986352	3061	1530.0	
29218	chr5	79021004	79021457	453	226.0	
29219	chr5	79024968	79025576	608	304.0	
29220	chr5	79107025	79107519	494	247.0	
29221	chr5	79109879	79110251	372	186.0	
29222	chr5	79122989	79123349	360	180.0	
29223	chr5	79133029	79134121	1092	546.0	
29224	chr5	79229616	79230000	384	192.0	
29225	chr5	79230956	79231357	401	200.0	
29226	chr5	79235168	79238138	2970	1485.0	
29227	chr5	79240322	79240950	628	314.0	
29228	chr5	79242427	79243548	1121	560.0	
29229	chr5	79244074	79244680	606	303.0	
29230	chr5	79246415	79246472	57	28.0	
29231	chr5	79249053	79250004	951	476.0	
29232	chr5	79253716	79253948	232	116.0	
29233	chr5	79255709	79256498	789	394.0	
29234	chr5	79258578	79260572	1994	997.0	
29235	chr5	79261685	79262094	409	204.0	
29236	chr5	79263127	79264198	1071	536.0	
29237	chr5	79269985	79270019	34	17.0	
29238	chr5	79276356	79276361	5	2.0	
29239	chr5	79278287	79278393	106	53.0	
29240	chr5	79416505	79416911	406	203.0	
29241	chr5	79464755	79465091	336	168.0	
29242	chr5	79500873	79500962	89	44.0	
29243	chr5	79507870	79509038	1168	584.0	
29244	chr5	79510438	79511117	679	340.0	
29245	chr5	79511993	79515285	3292	1646.0	
29246	chr5	79529088	79529551	463	232.0	
29247	chr5	79556120	79556741	621	310.0	
29248	chr5	79561094	79561794	700	350.0	
29249	chr5	79590364	79590830	466	233.0	
29250	chr5	79611626	79613633	2007	1004.0	
29251	chr5	79630158	79630997	839	420.0	
29252	chr5	79697734	79698222	488	244.0	
29253	chr5	79699405	79699759	354	177.0	
29254	chr5	79702529	79703297	768	384.0	
29255	chr5	79736466	79737049	583	292.0	
29256	chr5	79801204	79801264	60	30.0	
29257	chr5	79857906	79858543	637	318.0	
29258	chr5	79981054	79981332	278	139.0	
29259	chr5	79990128	79991844	1716	858.0	
29260	chr5	80069969	80070766	797	398.0	
29261	chr5	80082714	80083974	1260	630.0	
29262	chr5	80091607	80092513	906	453.0	
29263	chr5	80122343	80123086	743	372.0	
29264	chr5	80124140	80124490	350	175.0	
29265	chr5	80125219	80127596	2377	1188.0	
29266	chr5	80134896	80138240	3344	1672.0	
29267	chr5	80139474	80140064	590	295.0	
29268	chr5	80141038	80141841	803	402.0	
29269	chr5	80142430	80142826	396	198.0	
29270	chr5	80145074	80146632	1558	779.0	
29271	chr5	80151941	80152014	73	36.0	
29272	chr5	80152671	80153990	1319	660.0	
29273	chr5	80180899	80182473	1574	787.0	
29274	chr5	80183114	80184084	970	485.0	
29275	chr5	80186542	80187099	557	278.0	
29276	chr5	80189259	80190049	790	395.0	
29277	chr5	80190874	80193215	2341	1170.0	
29278	chr5	80204932	80205429	497	248.0	
29279	chr5	80213364	80213881	517	258.0	
29280	chr5	80216193	80216361	168	84.0	
29281	chr5	80218511	80219009	498	249.0	
29282	chr5	80220699	80220782	83	42.0	
29283	chr5	80234315	80234679	364	182.0	
29284	chr5	80238022	80238494	472	236.0	
29285	chr5	80239026	80239841	815	408.0	
29286	chr5	80246328	80246337	9	4.0	
29287	chr5	80246987	80248682	1695	848.0	
29288	chr5	80253549	80258174	4625	2312.0	
29289	chr5	80264341	80264784	443	222.0	
29290	chr5	80268917	80269160	243	122.0	
29291	chr5	80270016	80270691	675	338.0	
29292	chr5	80275351	80275790	439	220.0	
29293	chr5	80284787	80285104	317	158.0	
29294	chr5	80307428	80307939	511	256.0	
29295	chr5	80346057	80346414	357	178.0	
29296	chr5	80389214	80389832	618	309.0	
29297	chr5	80399351	80400747	1396	698.0	
29298	chr5	80406814	80408941	2127	1064.0	
29299	chr5	80414100	80414533	433	216.0	
29300	chr5	80466598	80466920	322	161.0	
29301	chr5	80481214	80481711	497	248.0	
29302	chr5	80487641	80488795	1154	577.0	
29303	chr5	80502794	80504268	1474	737.0	
29304	chr5	80569865	80570465	600	300.0	
29305	chr5	80608673	80609230	557	278.0	
29306	chr5	80620210	80620601	391	196.0	
29307	chr5	80621694	80622084	390	195.0	
29308	chr5	80629655	80630535	880	440.0	
29309	chr5	80653952	80655770	1818	909.0	
29310	chr5	80672110	80672601	491	246.0	
29311	chr5	80754921	80756547	1626	813.0	
29312	chr5	80777673	80778152	479	240.0	
29313	chr5	80837659	80838115	456	228.0	
29314	chr5	80846423	80846825	402	201.0	
29315	chr5	80866362	80866742	380	190.0	
29316	chr5	80904608	80904636	28	14.0	
29317	chr5	80957798	80958611	813	406.0	
29318	chr5	80959882	80962307	2425	1212.0	
29319	chr5	80973050	80973368	318	159.0	
29320	chr5	81006433	81008595	2162	1081.0	
29321	chr5	81108381	81108841	460	230.0	
29322	chr5	81165500	81165907	407	204.0	
29323	chr5	81194775	81195481	706	353.0	
29324	chr5	81299276	81302640	3364	1682.0	
29325	chr5	81334621	81334631	10	5.0	
29326	chr5	81363485	81363882	397	198.0	
29327	chr5	81400609	81400737	128	64.0	
29328	chr5	81425476	81425987	511	256.0	
29329	chr5	81506792	81507391	599	300.0	
29330	chr5	81514039	81514319	280	140.0	
29331	chr5	81525633	81526012	379	190.0	
29332	chr5	81538088	81538594	506	253.0	
29333	chr5	81579569	81579861	292	146.0	
29334	chr5	81631092	81631508	416	208.0	
29335	chr5	81749187	81752382	3195	1598.0	
29336	chr5	81759218	81759999	781	390.0	
29337	chr5	81778463	81780237	1774	887.0	
29338	chr5	81788016	81788023	7	4.0	
29339	chr5	81805155	81805444	289	144.0	
29340	chr5	81817937	81818425	488	244.0	
29341	chr5	81820930	81821210	280	140.0	
29342	chr5	81823342	81823485	143	72.0	
29343	chr5	81838495	81838991	496	248.0	
29344	chr5	81848394	81848751	357	178.0	
29345	chr5	81850754	81853180	2426	1213.0	
29346	chr5	81856856	81857258	402	201.0	
29347	chr5	81878413	81878469	56	28.0	
29348	chr5	81894044	81894201	157	78.0	
29349	chr5	81895239	81895849	610	305.0	
29350	chr5	81898353	81899036	683	342.0	
29351	chr5	81970885	81972877	1992	996.0	
29352	chr5	81974456	81974867	411	206.0	
29353	chr5	82018568	82018886	318	159.0	
29354	chr5	82043811	82044458	647	324.0	
29355	chr5	82068709	82069142	433	216.0	
29356	chr5	82100635	82101064	429	214.0	
29357	chr5	82165799	82166325	526	263.0	
29358	chr5	82174001	82175019	1018	509.0	
29359	chr5	82225478	82226003	525	262.0	
29360	chr5	82273570	82273712	142	71.0	
29361	chr5	82277584	82279086	1502	751.0	
29362	chr5	82351726	82352410	684	342.0	
29363	chr5	82356733	82358005	1272	636.0	
29364	chr5	82389135	82389169	34	17.0	
29365	chr5	82417955	82418151	196	98.0	
29366	chr5	82641323	82641793	470	235.0	
29367	chr5	83011857	83012465	608	304.0	
29368	chr5	83027312	83027675	363	182.0	
29369	chr5	83076547	83078301	1754	877.0	
29370	chr5	83157002	83157343	341	170.0	
29371	chr5	83306430	83307261	831	416.0	
29372	chr5	83312397	83313190	793	396.0	
29373	chr5	83320843	83321512	669	334.0	
29374	chr5	83323843	83323960	117	58.0	
29375	chr5	83340404	83340879	475	238.0	
29376	chr5	83368094	83369590	1496	748.0	
29377	chr5	83377056	83377611	555	278.0	
29378	chr5	83378905	83379379	474	237.0	
29379	chr5	83401043	83401973	930	465.0	
29380	chr5	83406951	83407259	308	154.0	
29381	chr5	83410270	83410770	500	250.0	
29382	chr5	83430369	83430840	471	236.0	
29383	chr5	83470959	83474937	3978	1989.0	
29384	chr5	83527328	83527521	193	96.0	
29385	chr5	83538950	83539505	555	278.0	
29386	chr5	83564111	83564512	401	200.0	
29387	chr5	83750796	83751229	433	216.0	
29388	chr5	84197586	84197829	243	122.0	
29389	chr5	84292781	84293288	507	254.0	
29390	chr5	84605220	84605622	402	201.0	
29391	chr5	84751792	84752069	277	138.0	
29392	chr5	84790864	84791587	723	362.0	
29393	chr5	86617217	86619083	1866	933.0	
29394	chr5	86623817	86624246	429	214.0	
29395	chr5	86666186	86666263	77	38.0	
29396	chr5	86880759	86881274	515	258.0	
29397	chr5	86968492	86968616	124	62.0	
29398	chr5	86970503	86971779	1276	638.0	
29399	chr5	86977259	86977521	262	131.0	
29400	chr5	86979599	86980589	990	495.0	
29401	chr5	87013023	87013464	441	220.0	
29402	chr5	87015908	87016369	461	230.0	
29403	chr5	87019910	87020607	697	348.0	
29404	chr5	87075065	87075633	568	284.0	
29405	chr5	87081223	87082135	912	456.0	
29406	chr5	87120470	87122181	1711	856.0	
29407	chr5	87243145	87243951	806	403.0	
29408	chr5	87266003	87266087	84	42.0	
29409	chr5	87267008	87269259	2251	1126.0	
29410	chr5	87282333	87282772	439	220.0	
29411	chr5	87297740	87299104	1364	682.0	
29412	chr5	87334646	87335029	383	192.0	
29413	chr5	87340429	87341197	768	384.0	
29414	chr5	87389573	87391090	1517	758.0	
29415	chr5	87392175	87392178	3	2.0	
29416	chr5	87396678	87397334	656	328.0	
29417	chr5	87398974	87401191	2217	1108.0	
29418	chr5	87403289	87404117	828	414.0	
29419	chr5	87404665	87410086	5421	2710.0	
29420	chr5	87410643	87413727	3084	1542.0	
29421	chr5	87424914	87425288	374	187.0	
29422	chr5	87781068	87781582	514	257.0	
29423	chr5	88140597	88142777	2180	1090.0	
29424	chr5	88143431	88144482	1051	526.0	
29425	chr5	88145532	88146085	553	276.0	
29426	chr5	88203877	88204937	1060	530.0	
29427	chr5	88268114	88269889	1775	888.0	
29428	chr5	88502129	88503000	871	436.0	
29429	chr5	88660520	88661414	894	447.0	
29430	chr5	88665980	88665997	17	8.0	
29431	chr5	88666632	88667474	842	421.0	
29432	chr5	88674351	88676268	1917	958.0	
29433	chr5	88680149	88681082	933	466.0	
29434	chr5	88683525	88683964	439	220.0	
29435	chr5	88690336	88691423	1087	544.0	
29436	chr5	88729317	88730028	711	356.0	
29437	chr5	88732044	88732879	835	418.0	
29438	chr5	88734044	88734708	664	332.0	
29439	chr5	88736565	88736918	353	176.0	
29440	chr5	88761211	88761975	764	382.0	
29441	chr5	88784819	88785544	725	362.0	
29442	chr5	88813243	88813590	347	174.0	
29443	chr5	88824996	88825623	627	314.0	
29444	chr5	88826745	88827908	1163	582.0	
29445	chr5	88828966	88830093	1127	564.0	
29446	chr5	88833306	88833748	442	221.0	
29447	chr5	88845401	88845667	266	133.0	
29448	chr5	88875705	88875740	35	18.0	
29449	chr5	88879893	88880121	228	114.0	
29450	chr5	88881548	88884860	3312	1656.0	
29451	chr5	88886786	88887094	308	154.0	
29452	chr5	88888812	88890187	1375	688.0	
29453	chr5	88940687	88941122	435	218.0	
29454	chr5	88945257	88945622	365	182.0	
29455	chr5	89106529	89106853	324	162.0	
29456	chr5	89120617	89121200	583	292.0	
29457	chr5	89256105	89256403	298	149.0	
29458	chr5	89268060	89268922	862	431.0	
29459	chr5	89271405	89272222	817	408.0	
29460	chr5	89279515	89279802	287	144.0	
29461	chr5	89293563	89294372	809	404.0	
29462	chr5	89300466	89300610	144	72.0	
29463	chr5	89302869	89303565	696	348.0	
29464	chr5	89313805	89314616	811	406.0	
29465	chr5	89343703	89344104	401	200.0	
29466	chr5	89396375	89397563	1188	594.0	
29467	chr5	89417970	89419045	1075	538.0	
29468	chr5	89420958	89421359	401	200.0	
29469	chr5	89444261	89444411	150	75.0	
29470	chr5	89457987	89458364	377	188.0	
29471	chr5	90015450	90015931	481	240.0	
29472	chr5	90021072	90021641	569	284.0	
29473	chr5	90131798	90132162	364	182.0	
29474	chr5	90135194	90135208	14	7.0	
29475	chr5	90161555	90161629	74	37.0	
29476	chr5	90265218	90265633	415	208.0	
29477	chr5	90408685	90410771	2086	1043.0	
29478	chr5	90434103	90434518	415	208.0	
29479	chr5	90439652	90440310	658	329.0	
29480	chr5	90473153	90475440	2287	1144.0	
29481	chr5	90528428	90530709	2281	1140.0	
29482	chr5	90558537	90559182	645	322.0	
29483	chr5	90690299	90690837	538	269.0	
29484	chr5	90696074	90696677	603	302.0	
29485	chr5	90783656	90784135	479	240.0	
29486	chr5	90854243	90854451	208	104.0	
29487	chr5	90866282	90866681	399	200.0	
29488	chr5	90873104	90873505	401	200.0	
29489	chr5	90932076	90932495	419	210.0	
29490	chr5	90940550	90941017	467	234.0	
29491	chr5	91052906	91053720	814	407.0	
29492	chr5	91058490	91058845	355	178.0	
29493	chr5	91062056	91062269	213	106.0	
29494	chr5	91101680	91102252	572	286.0	
29495	chr5	91103798	91103939	141	70.0	
29496	chr5	91111879	91112207	328	164.0	
29497	chr5	91132493	91132888	395	198.0	
29498	chr5	91146264	91147356	1092	546.0	
29499	chr5	91162136	91163500	1364	682.0	
29500	chr5	91170084	91170886	802	401.0	
29501	chr5	91182447	91183170	723	362.0	
29502	chr5	91183915	91184039	124	62.0	
29503	chr5	91187475	91187746	271	136.0	
29504	chr5	91189708	91190419	711	356.0	
29505	chr5	91212227	91212808	581	290.0	
29506	chr5	91218913	91220143	1230	615.0	
29507	chr5	91226018	91226558	540	270.0	
29508	chr5	91231032	91231647	615	308.0	
29509	chr5	91266350	91266631	281	140.0	
29510	chr5	91279422	91281469	2047	1024.0	
29511	chr5	91283887	91284288	401	200.0	
29512	chr5	91301188	91302002	814	407.0	
29513	chr5	91311122	91312598	1476	738.0	
29514	chr5	91313817	91316205	2388	1194.0	
29515	chr5	91318784	91319066	282	141.0	
29516	chr5	91332369	91332714	345	172.0	
29517	chr5	91354814	91355664	850	425.0	
29518	chr5	91361279	91361771	492	246.0	
29519	chr5	91365404	91368633	3229	1614.0	
29520	chr5	91370914	91371364	450	225.0	
29521	chr5	91374763	91375003	240	120.0	
29522	chr5	91379552	91385352	5800	2900.0	
29523	chr5	91390109	91390859	750	375.0	
29524	chr5	91398021	91398142	121	60.0	
29525	chr5	91419527	91420010	483	242.0	
29526	chr5	91433828	91434756	928	464.0	
29527	chr5	91469306	91470257	951	476.0	
29528	chr5	91479464	91479761	297	148.0	
29529	chr5	91499933	91500356	423	212.0	
29530	chr5	93570229	93571055	826	413.0	
29531	chr5	93578236	93582150	3914	1957.0	
29532	chr5	93582679	93583395	716	358.0	
29533	chr5	93583931	93585623	1692	846.0	
29534	chr5	93596747	93597650	903	452.0	
29535	chr5	93604208	93604348	140	70.0	
29536	chr5	93607564	93608448	884	442.0	
29537	chr5	93611896	93612901	1005	502.0	
29538	chr5	93620389	93623558	3169	1584.0	
29539	chr5	93801259	93801605	346	173.0	
29540	chr5	93887010	93887422	412	206.0	
29541	chr5	93915076	93915450	374	187.0	
29542	chr5	94109303	94109612	309	154.0	
29543	chr5	94110814	94112295	1481	740.0	
29544	chr5	94245713	94246057	344	172.0	
29545	chr5	94376724	94377007	283	142.0	
29546	chr5	94422766	94423209	443	222.0	
29547	chr5	94432411	94434105	1694	847.0	
29548	chr5	94485159	94485501	342	171.0	
29549	chr5	94524833	94525255	422	211.0	
29550	chr5	94543999	94544661	662	331.0	
29551	chr5	94545918	94546379	461	230.0	
29552	chr5	94575214	94575602	388	194.0	
29553	chr5	94577804	94578315	511	256.0	
29554	chr5	94595376	94595761	385	192.0	
29555	chr5	94602510	94602944	434	217.0	
29556	chr5	94617773	94619539	1766	883.0	
29557	chr5	94693091	94693624	533	266.0	
29558	chr5	94737811	94738314	503	252.0	
29559	chr5	94746724	94747119	395	198.0	
29560	chr5	94793082	94794224	1142	571.0	
29561	chr5	94850190	94850656	466	233.0	
29562	chr5	94945576	94946321	745	372.0	
29563	chr5	94968497	94968931	434	217.0	
29564	chr5	95023306	95023697	391	196.0	
29565	chr5	95027307	95027985	678	339.0	
29566	chr5	95029576	95029891	315	158.0	
29567	chr5	95036238	95036693	455	228.0	
29568	chr5	95043195	95043681	486	243.0	
29569	chr5	95044933	95045281	348	174.0	
29570	chr5	95048584	95049098	514	257.0	
29571	chr5	95059558	95060328	770	385.0	
29572	chr5	95066237	95066590	353	176.0	
29573	chr5	95068326	95068673	347	174.0	
29574	chr5	95069636	95071411	1775	888.0	
29575	chr5	95081228	95082439	1211	606.0	
29576	chr5	95086975	95088420	1445	722.0	
29577	chr5	95152836	95153062	226	113.0	
29578	chr5	95162321	95162617	296	148.0	
29579	chr5	95184981	95185299	318	159.0	
29580	chr5	95261289	95262279	990	495.0	
29581	chr5	95273958	95274483	525	262.0	
29582	chr5	95283726	95285389	1663	832.0	
29583	chr5	95554246	95555906	1660	830.0	
29584	chr5	95619500	95622938	3438	1719.0	
29585	chr5	95631901	95632796	895	448.0	
29586	chr5	95643994	95644930	936	468.0	
29587	chr5	95646135	95647686	1551	776.0	
29588	chr5	95664124	95664534	410	205.0	
29589	chr5	95718084	95718705	621	310.0	
29590	chr5	95727901	95728119	218	109.0	
29591	chr5	95728921	95728959	38	19.0	
29592	chr5	95730689	95732501	1812	906.0	
29593	chr5	95738034	95738532	498	249.0	
29594	chr5	95759686	95761248	1562	781.0	
29595	chr5	95773308	95774039	731	366.0	
29596	chr5	95779048	95780035	987	494.0	
29597	chr5	95780581	95781711	1130	565.0	
29598	chr5	95807969	95810731	2762	1381.0	
29599	chr5	95811826	95812537	711	356.0	
29600	chr5	95816376	95825414	9038	4519.0	
29601	chr5	95826007	95826239	232	116.0	
29602	chr5	95827190	95828146	956	478.0	
29603	chr5	95832650	95832759	109	54.0	
29604	chr5	95834275	95836825	2550	1275.0	
29605	chr5	95840814	95844157	3343	1672.0	
29606	chr5	95846731	95847437	706	353.0	
29607	chr5	95858244	95859500	1256	628.0	
29608	chr5	95861015	95862239	1224	612.0	
29609	chr5	95863062	95863833	771	386.0	
29610	chr5	95869133	95870882	1749	874.0	
29611	chr5	95892758	95893135	377	188.0	
29612	chr5	95907313	95907662	349	174.0	
29613	chr5	95915896	95916975	1079	540.0	
29614	chr5	95919639	95920040	401	200.0	
29615	chr5	95923887	95925161	1274	637.0	
29616	chr5	95928102	95928505	403	202.0	
29617	chr5	95934362	95934725	363	182.0	
29618	chr5	95936803	95937244	441	220.0	
29619	chr5	95941005	95941841	836	418.0	
29620	chr5	95944611	95946569	1958	979.0	
29621	chr5	95947425	95947444	19	10.0	
29622	chr5	95948812	95948965	153	76.0	
29623	chr5	95952239	95953068	829	414.0	
29624	chr5	95954702	95956703	2001	1000.0	
29625	chr5	95957673	95963177	5504	2752.0	
29626	chr5	95969674	95970098	424	212.0	
29627	chr5	95973825	95974485	660	330.0	
29628	chr5	96043559	96043700	141	70.0	
29629	chr5	96054468	96054689	221	110.0	
29630	chr5	96070562	96071063	501	250.0	
29631	chr5	96143096	96143395	299	150.0	
29632	chr5	96146512	96147195	683	342.0	
29633	chr5	96151725	96152394	669	334.0	
29634	chr5	96196995	96197726	731	366.0	
29635	chr5	96259281	96259907	626	313.0	
29636	chr5	96297790	96298407	617	308.0	
29637	chr5	96300967	96301368	401	200.0	
29638	chr5	96331120	96331575	455	228.0	
29639	chr5	96335979	96337427	1448	724.0	
29640	chr5	96344706	96345695	989	494.0	
29641	chr5	96434188	96434509	321	160.0	
29642	chr5	96439794	96440195	401	200.0	
29643	chr5	96537155	96538079	924	462.0	
29644	chr5	96538755	96539009	254	127.0	
29645	chr5	96584718	96585152	434	217.0	
29646	chr5	96595481	96595844	363	182.0	
29647	chr5	96601668	96602242	574	287.0	
29648	chr5	96613934	96614811	877	438.0	
29649	chr5	96627723	96628072	349	174.0	
29650	chr5	96633706	96634193	487	244.0	
29651	chr5	96648014	96648871	857	428.0	
29652	chr5	96649664	96650303	639	320.0	
29653	chr5	96655628	96655766	138	69.0	
29654	chr5	96656831	96657585	754	377.0	
29655	chr5	96660956	96663830	2874	1437.0	
29656	chr5	96664530	96665071	541	270.0	
29657	chr5	96681067	96681291	224	112.0	
29658	chr5	96687805	96688268	463	232.0	
29659	chr5	96692480	96692930	450	225.0	
29660	chr5	96700946	96701498	552	276.0	
29661	chr5	96702296	96704026	1730	865.0	
29662	chr5	96714452	96716714	2262	1131.0	
29663	chr5	96743365	96743786	421	210.0	
29664	chr5	96752176	96752889	713	356.0	
29665	chr5	96771391	96771633	242	121.0	
29666	chr5	96790962	96791487	525	262.0	
29667	chr5	96794682	96795175	493	246.0	
29668	chr5	96804682	96805362	680	340.0	
29669	chr5	96806394	96809161	2767	1384.0	
29670	chr5	96815954	96817526	1572	786.0	
29671	chr5	96822967	96823466	499	250.0	
29672	chr5	96855576	96855781	205	102.0	
29673	chr5	96868792	96869475	683	342.0	
29674	chr5	96870445	96870796	351	176.0	
29675	chr5	96875499	96877508	2009	1004.0	
29676	chr5	96879704	96882184	2480	1240.0	
29677	chr5	96885721	96886628	907	454.0	
29678	chr5	96895829	96897375	1546	773.0	
29679	chr5	96919680	96920046	366	183.0	
29680	chr5	96924057	96924502	445	222.0	
29681	chr5	96931394	96932023	629	314.0	
29682	chr5	96932705	96937572	4867	2434.0	
29683	chr5	96957204	96958875	1671	836.0	
29684	chr5	96960921	96961564	643	322.0	
29685	chr5	96962104	96963590	1486	743.0	
29686	chr5	96973736	96974193	457	228.0	
29687	chr5	96997266	96997652	386	193.0	
29688	chr5	97009368	97009900	532	266.0	
29689	chr5	97022942	97023273	331	166.0	
29690	chr5	97044266	97044380	114	57.0	
29691	chr5	97049194	97049507	313	156.0	
29692	chr5	97085640	97086255	615	308.0	
29693	chr5	97089481	97089667	186	93.0	
29694	chr5	97095268	97095347	79	40.0	
29695	chr5	97097802	97098231	429	214.0	
29696	chr5	97142583	97143040	457	228.0	
29697	chr5	97161911	97162428	517	258.0	
29698	chr5	97163251	97163695	444	222.0	
29699	chr5	97167370	97167976	606	303.0	
29700	chr5	97182193	97184437	2244	1122.0	
29701	chr5	97194436	97194764	328	164.0	
29702	chr5	97201925	97202089	164	82.0	
29703	chr5	97231020	97231431	411	206.0	
29704	chr5	97525890	97526111	221	110.0	
29705	chr5	97534073	97534658	585	292.0	
29706	chr5	97548031	97548419	388	194.0	
29707	chr5	98768034	98772026	3992	1996.0	
29708	chr5	98772724	98775044	2320	1160.0	
29709	chr5	98796282	98796758	476	238.0	
29710	chr5	98839711	98839944	233	116.0	
29711	chr5	98905783	98907164	1381	690.0	
29712	chr5	98908271	98908365	94	47.0	
29713	chr5	98911150	98912059	909	454.0	
29714	chr5	98913265	98913348	83	42.0	
29715	chr5	98913879	98914557	678	339.0	
29716	chr5	98917070	98918046	976	488.0	
29717	chr5	98920475	98920788	313	156.0	
29718	chr5	98921336	98921365	29	14.0	
29719	chr5	98921920	98922277	357	178.0	
29720	chr5	98923993	98924589	596	298.0	
29721	chr5	98926762	98930405	3643	1822.0	
29722	chr5	98933047	98934274	1227	614.0	
29723	chr5	98941348	98942133	785	392.0	
29724	chr5	98942961	98943255	294	147.0	
29725	chr5	98975969	98976392	423	212.0	
29726	chr5	98989568	98990243	675	338.0	
29727	chr5	99004838	99005544	706	353.0	
29728	chr5	99020225	99020561	336	168.0	
29729	chr5	99025385	99025684	299	150.0	
29730	chr5	99026854	99027963	1109	554.0	
29731	chr5	99030631	99031351	720	360.0	
29732	chr5	99032380	99034445	2065	1032.0	
29733	chr5	99037526	99038445	919	460.0	
29734	chr5	99060117	99060781	664	332.0	
29735	chr5	99061601	99061976	375	188.0	
29736	chr5	99104601	99104920	319	160.0	
29737	chr5	99258797	99259158	361	180.0	
29738	chr5	99315368	99316204	836	418.0	
29739	chr5	99320483	99320783	300	150.0	
29740	chr5	100313625	100314058	433	216.0	
29741	chr5	100430286	100430670	384	192.0	
29742	chr5	100470000	100470076	76	38.0	
29743	chr5	100534630	100536375	1745	872.0	
29744	chr5	100550668	100551002	334	167.0	
29745	chr5	100623699	100624131	432	216.0	
29746	chr5	100647644	100648011	367	184.0	
29747	chr5	100666980	100667943	963	482.0	
29748	chr5	100706566	100707277	711	356.0	
29749	chr5	100731711	100732239	528	264.0	
29750	chr5	100746629	100747160	531	266.0	
29751	chr5	100776160	100776876	716	358.0	
29752	chr5	100777550	100778357	807	404.0	
29753	chr5	100779673	100781008	1335	668.0	
29754	chr5	100790037	100790038	1	0.0	
29755	chr5	100826020	100826634	614	307.0	
29756	chr5	100827555	100828591	1036	518.0	
29757	chr5	100838093	100838359	266	133.0	
29758	chr5	100840273	100841913	1640	820.0	
29759	chr5	100852804	100853629	825	412.0	
29760	chr5	100872428	100872854	426	213.0	
29761	chr5	100877236	100877659	423	212.0	
29762	chr5	100889045	100891261	2216	1108.0	
29763	chr5	100898606	100905766	7160	3580.0	
29764	chr5	100951011	100951259	248	124.0	
29765	chr5	101531057	101531359	302	151.0	
29766	chr5	101678591	101678966	375	188.0	
29767	chr5	101942241	101942617	376	188.0	
29768	chr5	101943840	101944185	345	172.0	
29769	chr5	102153347	102153745	398	199.0	
29770	chr5	102154781	102155722	941	470.0	
29771	chr5	102211048	102211651	603	302.0	
29772	chr5	102223845	102224148	303	152.0	
29773	chr5	102231926	102231931	5	2.0	
29774	chr5	102277082	102277685	603	302.0	
29775	chr5	102283283	102283853	570	285.0	
29776	chr5	102286457	102286920	463	232.0	
29777	chr5	102294878	102297531	2653	1326.0	
29778	chr5	102318798	102319208	410	205.0	
29779	chr5	102453756	102454091	335	168.0	
29780	chr5	102523512	102523999	487	244.0	
29781	chr5	102531370	102532020	650	325.0	
29782	chr5	102562171	102562310	139	70.0	
29783	chr5	102681393	102681822	429	214.0	
29784	chr5	102754060	102756886	2826	1413.0	
29785	chr5	102760111	102760155	44	22.0	
29786	chr5	102760849	102761374	525	262.0	
29787	chr5	102761961	102763957	1996	998.0	
29788	chr5	102764511	102765885	1374	687.0	
29789	chr5	102766435	102766451	16	8.0	
29790	chr5	102780385	102781121	736	368.0	
29791	chr5	102781993	102782539	546	273.0	
29792	chr5	102792706	102793102	396	198.0	
29793	chr5	102801339	102801832	493	246.0	
29794	chr5	102802649	102803131	482	241.0	
29795	chr5	102815460	102815759	299	150.0	
29796	chr5	102836719	102837231	512	256.0	
29797	chr5	102853557	102854021	464	232.0	
29798	chr5	102855644	102856380	736	368.0	
29799	chr5	102865307	102866732	1425	712.0	
29800	chr5	103111418	103111931	513	256.0	
29801	chr5	103119248	103121335	2087	1044.0	
29802	chr5	103139028	103139749	721	360.0	
29803	chr5	103211793	103212705	912	456.0	
29804	chr5	103224188	103225044	856	428.0	
29805	chr5	103230631	103231163	532	266.0	
29806	chr5	103232403	103232811	408	204.0	
29807	chr5	103258060	103260175	2115	1058.0	
29808	chr5	103392957	103393248	291	146.0	
29809	chr5	103475695	103476020	325	162.0	
29810	chr5	103562201	103563016	815	408.0	
29811	chr5	106894866	106895432	566	283.0	
29812	chr5	107248103	107248443	340	170.0	
29813	chr5	107263515	107264011	496	248.0	
29814	chr5	107294150	107294502	352	176.0	
29815	chr5	107296603	107296942	339	170.0	
29816	chr5	107301978	107302314	336	168.0	
29817	chr5	107359492	107360038	546	273.0	
29818	chr5	107361796	107362513	717	358.0	
29819	chr5	107363716	107364197	481	240.0	
29820	chr5	107364718	107366273	1555	778.0	
29821	chr5	107373881	107374259	378	189.0	
29822	chr5	107387787	107390269	2482	1241.0	
29823	chr5	107428332	107428713	381	190.0	
29824	chr5	107467366	107467838	472	236.0	
29825	chr5	107469249	107469988	739	370.0	
29826	chr5	107474420	107475719	1299	650.0	
29827	chr5	107476540	107477391	851	426.0	
29828	chr5	107486359	107487477	1118	559.0	
29829	chr5	107502100	107502471	371	186.0	
29830	chr5	107520024	107520360	336	168.0	
29831	chr5	107534552	107534560	8	4.0	
29832	chr5	107570758	107572630	1872	936.0	
29833	chr5	107670243	107674073	3830	1915.0	
29834	chr5	107990983	107991497	514	257.0	
29835	chr5	108003058	108003604	546	273.0	
29836	chr5	108145388	108145575	187	94.0	
29837	chr5	108260312	108260997	685	342.0	
29838	chr5	108345574	108345955	381	190.0	
29839	chr5	108379871	108383682	3811	1906.0	
29840	chr5	108384240	108384481	241	120.0	
29841	chr5	108522168	108522184	16	8.0	
29842	chr5	108637112	108637526	414	207.0	
29843	chr5	108642203	108642696	493	246.0	
29844	chr5	108681242	108681753	511	256.0	
29845	chr5	108703377	108703757	380	190.0	
29846	chr5	108719518	108719831	313	156.0	
29847	chr5	108720592	108720663	71	36.0	
29848	chr5	108727082	108729372	2290	1145.0	
29849	chr5	108730555	108731051	496	248.0	
29850	chr5	108747465	108750089	2624	1312.0	
29851	chr5	108760519	108760882	363	182.0	
29852	chr5	108769389	108769513	124	62.0	
29853	chr5	108801738	108802165	427	214.0	
29854	chr5	108858847	108859439	592	296.0	
29855	chr5	108867864	108867996	132	66.0	
29856	chr5	109324983	109325297	314	157.0	
29857	chr5	109407970	109412088	4118	2059.0	
29858	chr5	109413151	109413179	28	14.0	
29859	chr5	109438796	109439263	467	234.0	
29860	chr5	109450435	109450488	53	26.0	
29861	chr5	109468647	109469211	564	282.0	
29862	chr5	109483636	109483906	270	135.0	
29863	chr5	109506556	109506995	439	220.0	
29864	chr5	109563825	109564038	213	106.0	
29865	chr5	109618840	109619365	525	262.0	
29866	chr5	109621298	109621667	369	184.0	
29867	chr5	109654407	109655046	639	320.0	
29868	chr5	109656517	109657431	914	457.0	
29869	chr5	109685072	109685269	197	98.0	
29870	chr5	109687534	109687559	25	12.0	
29871	chr5	109688359	109693287	4928	2464.0	
29872	chr5	109693852	109696103	2251	1126.0	
29873	chr5	109711742	109711804	62	31.0	
29874	chr5	109742913	109743600	687	344.0	
29875	chr5	109762823	109763134	311	156.0	
29876	chr5	109849434	109850077	643	322.0	
29877	chr5	109856947	109858359	1412	706.0	
29878	chr5	109921434	109922781	1347	674.0	
29879	chr5	109961686	109962246	560	280.0	
29880	chr5	109963261	109963320	59	30.0	
29881	chr5	110000192	110001247	1055	528.0	
29882	chr5	110053692	110054754	1062	531.0	
29883	chr5	110371726	110371990	264	132.0	
29884	chr5	110401928	110402179	251	126.0	
29885	chr5	110726245	110727325	1080	540.0	
29886	chr5	110736786	110737023	237	118.0	
29887	chr5	110738066	110739837	1771	886.0	
29888	chr5	110752337	110752619	282	141.0	
29889	chr5	110757042	110757534	492	246.0	
29890	chr5	111070633	111071057	424	212.0	
29891	chr5	111072899	111073806	907	454.0	
29892	chr5	111076139	111076513	374	187.0	
29893	chr5	111091710	111093356	1646	823.0	
29894	chr5	111116509	111116965	456	228.0	
29895	chr5	111158033	111158541	508	254.0	
29896	chr5	111223131	111225345	2214	1107.0	
29897	chr5	111225901	111228256	2355	1178.0	
29898	chr5	111228949	111231567	2618	1309.0	
29899	chr5	111232399	111233370	971	486.0	
29900	chr5	111234139	111234558	419	210.0	
29901	chr5	111237136	111238822	1686	843.0	
29902	chr5	111253023	111253547	524	262.0	
29903	chr5	111254356	111255218	862	431.0	
29904	chr5	111278698	111279475	777	388.0	
29905	chr5	111472480	111472902	422	211.0	
29906	chr5	111498420	111498502	82	41.0	
29907	chr5	111509238	111509542	304	152.0	
29908	chr5	111511437	111513510	2073	1036.0	
29909	chr5	111530014	111532195	2181	1090.0	
29910	chr5	111550288	111551167	879	440.0	
29911	chr5	111556508	111556863	355	178.0	
29912	chr5	111583016	111583445	429	214.0	
29913	chr5	111703644	111704047	403	202.0	
29914	chr5	111755920	111758525	2605	1302.0	
29915	chr5	111765955	111766184	229	114.0	
29916	chr5	111776877	111777396	519	260.0	
29917	chr5	111781188	111781514	326	163.0	
29918	chr5	111930461	111931556	1095	548.0	
29919	chr5	112106899	112107192	293	146.0	
29920	chr5	112109481	112110051	570	285.0	
29921	chr5	112119607	112119910	303	152.0	
29922	chr5	112124784	112125176	392	196.0	
29923	chr5	112146851	112147520	669	334.0	
29924	chr5	112160105	112161669	1564	782.0	
29925	chr5	112174867	112175414	547	274.0	
29926	chr5	112186440	112186561	121	60.0	
29927	chr5	112189366	112189711	345	172.0	
29928	chr5	112208641	112209450	809	404.0	
29929	chr5	112417835	112420736	2901	1450.0	
29930	chr5	112492365	112492680	315	158.0	
29931	chr5	112520411	112520911	500	250.0	
29932	chr5	112523076	112524379	1303	652.0	
29933	chr5	112529497	112529925	428	214.0	
29934	chr5	112533278	112533324	46	23.0	
29935	chr5	112551356	112551840	484	242.0	
29936	chr5	112605195	112605395	200	100.0	
29937	chr5	112646571	112646833	262	131.0	
29938	chr5	112691633	112692113	480	240.0	
29939	chr5	112706620	112708694	2074	1037.0	
29940	chr5	112737092	112738650	1558	779.0	
29941	chr5	112757494	112758027	533	266.0	
29942	chr5	112796113	112796204	91	46.0	
29943	chr5	112848010	112848855	845	422.0	
29944	chr5	112860504	112861902	1398	699.0	
29945	chr5	112878751	112879222	471	236.0	
29946	chr5	112881338	112881444	106	53.0	
29947	chr5	112887010	112887360	350	175.0	
29948	chr5	112905248	112905285	37	18.0	
29949	chr5	112913254	112913725	471	236.0	
29950	chr5	112915808	112916355	547	274.0	
29951	chr5	112917457	112917887	430	215.0	
29952	chr5	112920743	112924428	3685	1842.0	
29953	chr5	112929031	112930574	1543	772.0	
29954	chr5	112961052	112961276	224	112.0	
29955	chr5	112963613	112964425	812	406.0	
29956	chr5	112969431	112969832	401	200.0	
29957	chr5	112975867	112978475	2608	1304.0	
29958	chr5	112995804	112996625	821	410.0	
29959	chr5	113022407	113023301	894	447.0	
29960	chr5	113024802	113025234	432	216.0	
29961	chr5	113032660	113033034	374	187.0	
29962	chr5	113047331	113048497	1166	583.0	
29963	chr5	113051095	113051340	245	122.0	
29964	chr5	113073648	113074135	487	244.0	
29965	chr5	113293233	113295463	2230	1115.0	
29966	chr5	113330449	113331270	821	410.0	
29967	chr5	113334847	113335358	511	256.0	
29968	chr5	113378034	113378419	385	192.0	
29969	chr5	113378921	113379375	454	227.0	
29970	chr5	113487393	113489939	2546	1273.0	
29971	chr5	113507676	113508028	352	176.0	
29972	chr5	113510816	113511226	410	205.0	
29973	chr5	113513184	113514821	1637	818.0	
29974	chr5	113524870	113525421	551	276.0	
29975	chr5	113606461	113606972	511	256.0	
29976	chr5	113611747	113612629	882	441.0	
29977	chr5	114449892	114450236	344	172.0	
29978	chr5	114857912	114858470	558	279.0	
29979	chr5	114953790	114953854	64	32.0	
29980	chr5	115068520	115069352	832	416.0	
29981	chr5	115098059	115098494	435	218.0	
29982	chr5	115168830	115171393	2563	1282.0	
29983	chr5	115179024	115180894	1870	935.0	
29984	chr5	115209083	115209833	750	375.0	
29985	chr5	115246336	115246833	497	248.0	
29986	chr5	115261772	115263397	1625	812.0	
29987	chr5	115271630	115272175	545	272.0	
29988	chr5	115274477	115275152	675	338.0	
29989	chr5	115289043	115289481	438	219.0	
29990	chr5	115295718	115297244	1526	763.0	
29991	chr5	115309685	115310160	475	238.0	
29992	chr5	115329599	115329759	160	80.0	
29993	chr5	115419876	115420255	379	190.0	
29994	chr5	115448659	115449017	358	179.0	
29995	chr5	115450547	115451114	567	284.0	
29996	chr5	115460380	115460869	489	244.0	
29997	chr5	115472508	115473169	661	330.0	
29998	chr5	115475776	115476193	417	208.0	
29999	chr5	115484128	115484901	773	386.0	
30000	chr5	115493195	115493406	211	106.0	
30001	chr5	115494230	115494518	288	144.0	
30002	chr5	115542477	115545575	3098	1549.0	
30003	chr5	115549197	115549529	332	166.0	
30004	chr5	115551217	115551910	693	346.0	
30005	chr5	115557666	115558066	400	200.0	
30006	chr5	115574491	115574970	479	240.0	
30007	chr5	115586478	115586932	454	227.0	
30008	chr5	115599446	115600172	726	363.0	
30009	chr5	115601555	115604251	2696	1348.0	
30010	chr5	115623766	115626995	3229	1614.0	
30011	chr5	115634139	115635128	989	494.0	
30012	chr5	115816189	115816662	473	236.0	
30013	chr5	115831042	115831642	600	300.0	
30014	chr5	115838696	115839817	1121	560.0	
30015	chr5	115840609	115843837	3228	1614.0	
30016	chr5	115845283	115845657	374	187.0	
30017	chr5	115963120	115963131	11	6.0	
30018	chr5	116032022	116032542	520	260.0	
30019	chr5	116038781	116039239	458	229.0	
30020	chr5	116068009	116068646	637	318.0	
30021	chr5	116075434	116076967	1533	766.0	
30022	chr5	116084060	116086219	2159	1080.0	
30023	chr5	116135311	116135798	487	244.0	
30024	chr5	116137720	116138184	464	232.0	
30025	chr5	116358794	116359275	481	240.0	
30026	chr5	116372142	116372181	39	20.0	
30027	chr5	116454406	116454883	477	238.0	
30028	chr5	116492238	116492348	110	55.0	
30029	chr5	116574597	116575147	550	275.0	
30030	chr5	116576085	116576445	360	180.0	
30031	chr5	116947928	116948290	362	181.0	
30032	chr5	117454681	117455099	418	209.0	
30033	chr5	117859095	117859582	487	244.0	
30034	chr5	117863576	117864264	688	344.0	
30035	chr5	117888616	117889104	488	244.0	
30036	chr5	118792039	118792407	368	184.0	
30037	chr5	118987670	118989320	1650	825.0	
30038	chr5	119016275	119016886	611	306.0	
30039	chr5	119019476	119019716	240	120.0	
30040	chr5	119021872	119022424	552	276.0	
30041	chr5	119031302	119032128	826	413.0	
30042	chr5	119032665	119033144	479	240.0	
30043	chr5	119049880	119050141	261	130.0	
30044	chr5	119055385	119055630	245	122.0	
30045	chr5	119063660	119064112	452	226.0	
30046	chr5	119070044	119072111	2067	1034.0	
30047	chr5	119074346	119074794	448	224.0	
30048	chr5	119187601	119188224	623	312.0	
30049	chr5	119200915	119201196	281	140.0	
30050	chr5	119220597	119220896	299	150.0	
30051	chr5	119238849	119239349	500	250.0	
30052	chr5	119255947	119256445	498	249.0	
30053	chr5	119267703	119272289	4586	2293.0	
30054	chr5	119273052	119276348	3296	1648.0	
30055	chr5	119277680	119279565	1885	942.0	
30056	chr5	119286512	119288354	1842	921.0	
30057	chr5	119288906	119290983	2077	1038.0	
30058	chr5	119292032	119292307	275	138.0	
30059	chr5	119292951	119293308	357	178.0	
30060	chr5	119299313	119300504	1191	596.0	
30061	chr5	119302821	119304801	1980	990.0	
30062	chr5	119308238	119310117	1879	940.0	
30063	chr5	119312354	119312756	402	201.0	
30064	chr5	119313289	119313591	302	151.0	
30065	chr5	119314387	119317078	2691	1346.0	
30066	chr5	119318148	119318839	691	346.0	
30067	chr5	119320536	119323329	2793	1396.0	
30068	chr5	119324017	119324787	770	385.0	
30069	chr5	119326281	119327469	1188	594.0	
30070	chr5	119328362	119333964	5602	2801.0	
30071	chr5	119334602	119339154	4552	2276.0	
30072	chr5	119339839	119342862	3023	1512.0	
30073	chr5	119343592	119344462	870	435.0	
30074	chr5	119345767	119346771	1004	502.0	
30075	chr5	119350968	119350976	8	4.0	
30076	chr5	119353246	119360197	6951	3476.0	
30077	chr5	119360892	119364322	3430	1715.0	
30078	chr5	119366379	119369092	2713	1356.0	
30079	chr5	119369670	119369828	158	79.0	
30080	chr5	119386898	119387059	161	80.0	
30081	chr5	119389316	119390114	798	399.0	
30082	chr5	119395001	119395580	579	290.0	
30083	chr5	119396157	119396897	740	370.0	
30084	chr5	119397487	119398187	700	350.0	
30085	chr5	119405709	119405713	4	2.0	
30086	chr5	119409294	119409566	272	136.0	
30087	chr5	119411602	119412652	1050	525.0	
30088	chr5	119413951	119414617	666	333.0	
30089	chr5	119418011	119418545	534	267.0	
30090	chr5	119420120	119420634	514	257.0	
30091	chr5	119425990	119426523	533	266.0	
30092	chr5	119427384	119428164	780	390.0	
30093	chr5	119435401	119436129	728	364.0	
30094	chr5	119438534	119439828	1294	647.0	
30095	chr5	119450504	119451005	501	250.0	
30096	chr5	119451972	119453394	1422	711.0	
30097	chr5	119578948	119579324	376	188.0	
30098	chr5	119634530	119634534	4	2.0	
30099	chr5	119651439	119651936	497	248.0	
30100	chr5	119654977	119655538	561	280.0	
30101	chr5	119681596	119681995	399	200.0	
30102	chr5	119744040	119744333	293	146.0	
30103	chr5	120037397	120037855	458	229.0	
30104	chr5	120057909	120058187	278	139.0	
30105	chr5	120093079	120093613	534	267.0	
30106	chr5	120096479	120096909	430	215.0	
30107	chr5	120099123	120099500	377	188.0	
30108	chr5	120138949	120139513	564	282.0	
30109	chr5	120140679	120140966	287	144.0	
30110	chr5	120152439	120152926	487	244.0	
30111	chr5	120155860	120156345	485	242.0	
30112	chr5	120257845	120258621	776	388.0	
30113	chr5	120388102	120388835	733	366.0	
30114	chr5	120457755	120458700	945	472.0	
30115	chr5	120463024	120465606	2582	1291.0	
30116	chr5	120767471	120767785	314	157.0	
30117	chr5	121961218	121963608	2390	1195.0	
30118	chr5	121979521	121980261	740	370.0	
30119	chr5	122696779	122697595	816	408.0	
30120	chr5	122701783	122702869	1086	543.0	
30121	chr5	122723593	122723884	291	146.0	
30122	chr5	122756061	122756765	704	352.0	
30123	chr5	122773528	122776481	2953	1476.0	
30124	chr5	122780401	122780687	286	143.0	
30125	chr5	122844245	122847742	3497	1748.0	
30126	chr5	122849730	122850365	635	318.0	
30127	chr5	122877503	122877939	436	218.0	
30128	chr5	122902323	122902698	375	188.0	
30129	chr5	122999983	123000291	308	154.0	
30130	chr5	123398342	123398682	340	170.0	
30131	chr5	123422093	123424358	2265	1132.0	
30132	chr5	123425432	123425878	446	223.0	
30133	chr5	123429497	123430483	986	493.0	
30134	chr5	123433661	123434060	399	200.0	
30135	chr5	123438855	123439330	475	238.0	
30136	chr5	123452528	123452605	77	38.0	
30137	chr5	123455591	123456105	514	257.0	
30138	chr5	123511256	123513652	2396	1198.0	
30139	chr5	123514339	123514879	540	270.0	
30140	chr5	123515699	123516414	715	358.0	
30141	chr5	123518103	123518504	401	200.0	
30142	chr5	123549259	123550036	777	388.0	
30143	chr5	123610893	123611515	622	311.0	
30144	chr5	123670981	123671341	360	180.0	
30145	chr5	124034902	124035336	434	217.0	
30146	chr5	124056371	124057998	1627	814.0	
30147	chr5	124162825	124163166	341	170.0	
30148	chr5	124410565	124410917	352	176.0	
30149	chr5	124453678	124454079	401	200.0	
30150	chr5	124524646	124524938	292	146.0	
30151	chr5	124583641	124584441	800	400.0	
30152	chr5	124599579	124599920	341	170.0	
30153	chr5	124649315	124650533	1218	609.0	
30154	chr5	124651319	124652400	1081	540.0	
30155	chr5	124656005	124656317	312	156.0	
30156	chr5	124659133	124659797	664	332.0	
30157	chr5	124704775	124705328	553	276.0	
30158	chr5	124707534	124707884	350	175.0	
30159	chr5	124741178	124741194	16	8.0	
30160	chr5	124743719	124744463	744	372.0	
30161	chr5	124746897	124749501	2604	1302.0	
30162	chr5	124825482	124825988	506	253.0	
30163	chr5	124848955	124849346	391	196.0	
30164	chr5	124858578	124859444	866	433.0	
30165	chr5	124867373	124867635	262	131.0	
30166	chr5	124878899	124879392	493	246.0	
30167	chr5	124880916	124881397	481	240.0	
30168	chr5	124902063	124902819	756	378.0	
30169	chr5	124912578	124913005	427	214.0	
30170	chr5	124919139	124919249	110	55.0	
30171	chr5	124921053	124921470	417	208.0	
30172	chr5	124935117	124935350	233	116.0	
30173	chr5	124935953	124936259	306	153.0	
30174	chr5	124951626	124952548	922	461.0	
30175	chr5	124963566	124964013	447	224.0	
30176	chr5	124980712	124980929	217	108.0	
30177	chr5	125002869	125003033	164	82.0	
30178	chr5	125005922	125006617	695	348.0	
30179	chr5	125056509	125056977	468	234.0	
30180	chr5	125536156	125536402	246	123.0	
30181	chr5	126339173	126339630	457	228.0	
30182	chr5	126353892	126354352	460	230.0	
30183	chr5	126373558	126374373	815	408.0	
30184	chr5	126422666	126424023	1357	678.0	
30185	chr5	126424720	126425154	434	217.0	
30186	chr5	126438022	126438555	533	266.0	
30187	chr5	126449476	126451168	1692	846.0	
30188	chr5	126499672	126500387	715	358.0	
30189	chr5	126503717	126504125	408	204.0	
30190	chr5	126508691	126509303	612	306.0	
30191	chr5	126539051	126539607	556	278.0	
30192	chr5	126544209	126544441	232	116.0	
30193	chr5	126594541	126595598	1057	528.0	
30194	chr5	126600296	126601847	1551	776.0	
30195	chr5	126656610	126656715	105	52.0	
30196	chr5	126660082	126660412	330	165.0	
30197	chr5	126671755	126671852	97	48.0	
30198	chr5	126675870	126676732	862	431.0	
30199	chr5	126679522	126679942	420	210.0	
30200	chr5	126695167	126695473	306	153.0	
30201	chr5	126712954	126713530	576	288.0	
30202	chr5	126715021	126715435	414	207.0	
30203	chr5	126730278	126730739	461	230.0	
30204	chr5	126747862	126748613	751	376.0	
30205	chr5	126754599	126754954	355	178.0	
30206	chr5	126758121	126759230	1109	554.0	
30207	chr5	126761633	126763726	2093	1046.0	
30208	chr5	126776081	126780872	4791	2396.0	
30209	chr5	126792354	126792741	387	194.0	
30210	chr5	126793983	126793989	6	3.0	
30211	chr5	126798691	126799092	401	200.0	
30212	chr5	126801751	126802328	577	288.0	
30213	chr5	126808320	126810352	2032	1016.0	
30214	chr5	126810946	126812432	1486	743.0	
30215	chr5	126813744	126814234	490	245.0	
30216	chr5	126816527	126817130	603	302.0	
30217	chr5	126837977	126838314	337	168.0	
30218	chr5	126845435	126846172	737	368.0	
30219	chr5	126851502	126854610	3108	1554.0	
30220	chr5	126869076	126869563	487	244.0	
30221	chr5	126972148	126973561	1413	706.0	
30222	chr5	126987651	126988679	1028	514.0	
30223	chr5	127011973	127012060	87	44.0	
30224	chr5	127014598	127014936	338	169.0	
30225	chr5	127025541	127025673	132	66.0	
30226	chr5	127028752	127032230	3478	1739.0	
30227	chr5	127072782	127073946	1164	582.0	
30228	chr5	127080228	127080575	347	174.0	
30229	chr5	127228965	127230034	1069	534.0	
30230	chr5	127290212	127290262	50	25.0	
30231	chr5	127313806	127314286	480	240.0	
30232	chr5	127492727	127493387	660	330.0	
30233	chr5	127516931	127518672	1741	870.0	
30234	chr5	127564119	127564586	467	234.0	
30235	chr5	127723699	127723837	138	69.0	
30236	chr5	127757536	127757905	369	184.0	
30237	chr5	127785207	127786111	904	452.0	
30238	chr5	127839604	127839813	209	104.0	
30239	chr5	127875507	127876007	500	250.0	
30240	chr5	127936463	127937095	632	316.0	
30241	chr5	128082017	128085295	3278	1639.0	
30242	chr5	128086929	128087168	239	120.0	
30243	chr5	128090859	128091053	194	97.0	
30244	chr5	128094014	128094197	183	92.0	
30245	chr5	128112035	128112275	240	120.0	
30246	chr5	128196803	128197181	378	189.0	
30247	chr5	128197887	128198288	401	200.0	
30248	chr5	128201033	128201966	933	466.0	
30249	chr5	128213349	128213517	168	84.0	
30250	chr5	128340904	128341850	946	473.0	
30251	chr5	128433114	128433149	35	18.0	
30252	chr5	128537250	128539145	1895	948.0	
30253	chr5	128905523	128905908	385	192.0	
30254	chr5	128927563	128928108	545	272.0	
30255	chr5	129093922	129095810	1888	944.0	
30256	chr5	129125720	129127042	1322	661.0	
30257	chr5	129767813	129768303	490	245.0	
30258	chr5	129771325	129771736	411	206.0	
30259	chr5	129852763	129853118	355	178.0	
30260	chr5	129904094	129904996	902	451.0	
30261	chr5	130764793	130765775	982	491.0	
30262	chr5	130836727	130836991	264	132.0	
30263	chr5	130871424	130871889	465	232.0	
30264	chr5	131065451	131065805	354	177.0	
30265	chr5	131067563	131068176	613	306.0	
30266	chr5	131068885	131069768	883	442.0	
30267	chr5	131104387	131104854	467	234.0	
30268	chr5	131109882	131110385	503	252.0	
30269	chr5	131163337	131165961	2624	1312.0	
30270	chr5	131170122	131171922	1800	900.0	
30271	chr5	131209040	131210511	1471	736.0	
30272	chr5	131212336	131212972	636	318.0	
30273	chr5	131224241	131225339	1098	549.0	
30274	chr5	131239712	131240032	320	160.0	
30275	chr5	131242890	131243193	303	152.0	
30276	chr5	131250632	131251456	824	412.0	
30277	chr5	131252241	131255133	2892	1446.0	
30278	chr5	131256516	131258630	2114	1057.0	
30279	chr5	131261697	131267348	5651	2826.0	
30280	chr5	131267910	131268987	1077	538.0	
30281	chr5	131269827	131276618	6791	3396.0	
30282	chr5	131277405	131280018	2613	1306.0	
30283	chr5	131280666	131282458	1792	896.0	
30284	chr5	131285679	131286309	630	315.0	
30285	chr5	131288362	131290531	2169	1084.0	
30286	chr5	131294883	131296740	1857	928.0	
30287	chr5	131299617	131299833	216	108.0	
30288	chr5	131302456	131302612	156	78.0	
30289	chr5	131305204	131306367	1163	582.0	
30290	chr5	131312093	131313405	1312	656.0	
30291	chr5	131322046	131323304	1258	629.0	
30292	chr5	131327225	131327531	306	153.0	
30293	chr5	131328900	131329576	676	338.0	
30294	chr5	131336736	131338168	1432	716.0	
30295	chr5	131338978	131339275	297	148.0	
30296	chr5	131355241	131356255	1014	507.0	
30297	chr5	131356784	131358672	1888	944.0	
30298	chr5	131364180	131365266	1086	543.0	
30299	chr5	131366054	131366130	76	38.0	
30300	chr5	131367201	131368492	1291	646.0	
30301	chr5	131371805	131372258	453	226.0	
30302	chr5	131373150	131373687	537	268.0	
30303	chr5	131374264	131383472	9208	4604.0	
30304	chr5	131384334	131385031	697	348.0	
30305	chr5	131389511	131390019	508	254.0	
30306	chr5	131392445	131392901	456	228.0	
30307	chr5	131393716	131394661	945	472.0	
30308	chr5	131396024	131397293	1269	634.0	
30309	chr5	131398998	131399013	15	8.0	
30310	chr5	131404545	131405003	458	229.0	
30311	chr5	131405545	131406241	696	348.0	
30312	chr5	131413918	131414725	807	404.0	
30313	chr5	131416715	131417760	1045	522.0	
30314	chr5	131423061	131423450	389	194.0	
30315	chr5	131488418	131488947	529	264.0	
30316	chr5	131496300	131496739	439	220.0	
30317	chr5	131498901	131499375	474	237.0	
30318	chr5	131504834	131504967	133	66.0	
30319	chr5	131509742	131510220	478	239.0	
30320	chr5	131513816	131515498	1682	841.0	
30321	chr5	131525670	131526919	1249	624.0	
30322	chr5	131528806	131529735	929	464.0	
30323	chr5	131530704	131531138	434	217.0	
30324	chr5	131531970	131533246	1276	638.0	
30325	chr5	131533827	131534137	310	155.0	
30326	chr5	131536171	131537152	981	490.0	
30327	chr5	131537965	131538785	820	410.0	
30328	chr5	131548107	131548979	872	436.0	
30329	chr5	131589458	131590156	698	349.0	
30330	chr5	131595018	131596068	1050	525.0	
30331	chr5	131629997	131630073	76	38.0	
30332	chr5	131631862	131632390	528	264.0	
30333	chr5	131634158	131636628	2470	1235.0	
30334	chr5	131640181	131640932	751	376.0	
30335	chr5	131646903	131647606	703	352.0	
30336	chr5	131706373	131706658	285	142.0	
30337	chr5	131747061	131748374	1313	656.0	
30338	chr5	131794499	131797983	3484	1742.0	
30339	chr5	131810913	131811066	153	76.0	
30340	chr5	131854092	131854524	432	216.0	
30341	chr5	131902311	131902612	301	150.0	
30342	chr5	131943859	131945116	1257	628.0	
30343	chr5	131974511	131975718	1207	604.0	
30344	chr5	132000703	132001652	949	474.0	
30345	chr5	132007604	132008462	858	429.0	
30346	chr5	132011155	132012951	1796	898.0	
30347	chr5	132017888	132018085	197	98.0	
30348	chr5	132019800	132020995	1195	598.0	
30349	chr5	132026213	132027555	1342	671.0	
30350	chr5	132044207	132044617	410	205.0	
30351	chr5	132050096	132050550	454	227.0	
30352	chr5	132055161	132056876	1715	858.0	
30353	chr5	132058953	132059572	619	310.0	
30354	chr5	132063198	132065781	2583	1292.0	"insulator	insulator	region	insulator"
30355	chr5	132067035	132067047	12	6.0	
30356	chr5	132069461	132069988	527	264.0	
30357	chr5	132070682	132070886	204	102.0	
30358	chr5	132075434	132075733	299	150.0	
30359	chr5	132094839	132095902	1063	532.0	
30360	chr5	132098154	132098411	257	128.0	
30361	chr5	132098938	132104884	5946	2973.0	
30362	chr5	132114448	132114946	498	249.0	
30363	chr5	132117173	132117242	69	34.0	
30364	chr5	132134438	132134627	189	94.0	
30365	chr5	132176963	132177446	483	242.0	
30366	chr5	132180123	132180477	354	177.0	
30367	chr5	132190121	132190610	489	244.0	
30368	chr5	132222604	132222970	366	183.0	
30369	chr5	132227275	132228325	1050	525.0	
30370	chr5	132238193	132238704	511	256.0	
30371	chr5	132271360	132272018	658	329.0	
30372	chr5	132272677	132273185	508	254.0	
30373	chr5	132280407	132280478	71	36.0	
30374	chr5	132293054	132296890	3836	1918.0	"enhancer	sequence_feature"
30375	chr5	132298074	132299103	1029	514.0	
30376	chr5	132301265	132302323	1058	529.0	
30377	chr5	132354256	132355122	866	433.0	
30378	chr5	132357876	132358342	466	233.0	
30379	chr5	132364233	132364969	736	368.0	
30380	chr5	132369159	132370813	1654	827.0	
30381	chr5	132372124	132372633	509	254.0	
30382	chr5	132385209	132388298	3089	1544.0	
30383	chr5	132394601	132395014	413	206.0	
30384	chr5	132407468	132407803	335	168.0	
30385	chr5	132409349	132412719	3370	1685.0	
30386	chr5	132414681	132415489	808	404.0	
30387	chr5	132416379	132417358	979	490.0	
30388	chr5	132418080	132422034	3954	1977.0	
30389	chr5	132422604	132423806	1202	601.0	
30390	chr5	132424879	132428586	3707	1854.0	
30391	chr5	132430698	132432112	1414	707.0	
30392	chr5	132435813	132436370	557	278.0	
30393	chr5	132437181	132440018	2837	1418.0	
30394	chr5	132442399	132442454	55	28.0	
30395	chr5	132444190	132444452	262	131.0	
30396	chr5	132446948	132448348	1400	700.0	
30397	chr5	132454303	132492696	38393	19196.0	
30398	chr5	132494086	132501794	7708	3854.0	
30399	chr5	132506109	132506503	394	197.0	
30400	chr5	132525229	132525718	489	244.0	
30401	chr5	132526467	132527542	1075	538.0	
30402	chr5	132529294	132529394	100	50.0	
30403	chr5	132555284	132555371	87	44.0	
30404	chr5	132556331	132557885	1554	777.0	
30405	chr5	132558555	132558883	328	164.0	
30406	chr5	132604034	132604459	425	212.0	
30407	chr5	132656209	132656890	681	340.0	
30408	chr5	132662992	132664582	1590	795.0	
30409	chr5	132687959	132689008	1049	524.0	
30410	chr5	132714805	132715083	278	139.0	
30411	chr5	132736693	132738249	1556	778.0	
30412	chr5	132746763	132748273	1510	755.0	
30413	chr5	132763181	132763612	431	216.0	
30414	chr5	132776475	132777942	1467	734.0	
30415	chr5	132782160	132782673	513	256.0	
30416	chr5	132812154	132814523	2369	1184.0	
30417	chr5	132819575	132820730	1155	578.0	
30418	chr5	132822956	132823163	207	104.0	
30419	chr5	132825371	132826474	1103	552.0	
30420	chr5	132829449	132831052	1603	802.0	
30421	chr5	132841220	132841839	619	310.0	
30422	chr5	132865783	132867573	1790	895.0	
30423	chr5	132883187	132883727	540	270.0	
30424	chr5	132905974	132906359	385	192.0	
30425	chr5	132915642	132916047	405	202.0	
30426	chr5	132962082	132965395	3313	1656.0	
30427	chr5	132979470	132979983	513	256.0	
30428	chr5	133025397	133027288	1891	946.0	
30429	chr5	133033048	133033838	790	395.0	
30430	chr5	133050508	133053599	3091	1546.0	
30431	chr5	133103247	133103553	306	153.0	
30432	chr5	133105791	133106147	356	178.0	
30433	chr5	133107031	133107103	72	36.0	
30434	chr5	133108396	133108871	475	238.0	
30435	chr5	133111120	133111805	685	342.0	
30436	chr5	133170439	133171446	1007	504.0	
30437	chr5	133240483	133241527	1044	522.0	
30438	chr5	133423710	133424236	526	263.0	
30439	chr5	133457074	133457701	627	314.0	
30440	chr5	133466927	133467907	980	490.0	
30441	chr5	133468636	133468963	327	164.0	
30442	chr5	133471070	133471158	88	44.0	
30443	chr5	133552933	133553303	370	185.0	
30444	chr5	133610910	133612909	1999	1000.0	
30445	chr5	133618160	133618554	394	197.0	
30446	chr5	133825540	133826262	722	361.0	
30447	chr5	133869147	133869561	414	207.0	
30448	chr5	133928612	133929219	607	304.0	
30449	chr5	133929924	133931090	1166	583.0	
30450	chr5	133932543	133933304	761	380.0	
30451	chr5	133935113	133935662	549	274.0	
30452	chr5	133939033	133939221	188	94.0	
30453	chr5	133944293	133944635	342	171.0	
30454	chr5	133967555	133969989	2434	1217.0	
30455	chr5	133979874	133980283	409	204.0	
30456	chr5	133996635	133997060	425	212.0	
30457	chr5	134000007	134000505	498	249.0	
30458	chr5	134002238	134002439	201	100.0	
30459	chr5	134003048	134006078	3030	1515.0	
30460	chr5	134006786	134006787	1	0.0	
30461	chr5	134026472	134026995	523	262.0	
30462	chr5	134039098	134040745	1647	824.0	
30463	chr5	134041826	134041903	77	38.0	
30464	chr5	134053502	134054107	605	302.0	
30465	chr5	134068797	134069186	389	194.0	
30466	chr5	134070781	134071973	1192	596.0	
30467	chr5	134078126	134078561	435	218.0	
30468	chr5	134079763	134080215	452	226.0	
30469	chr5	134086236	134087796	1560	780.0	
30470	chr5	134090028	134091304	1276	638.0	
30471	chr5	134099270	134102531	3261	1630.0	
30472	chr5	134103216	134106239	3023	1512.0	
30473	chr5	134107291	134107394	103	52.0	
30474	chr5	134110468	134156393	45925	22962.0	
30475	chr5	134157033	134157123	90	45.0	
30476	chr5	134157769	134158598	829	414.0	
30477	chr5	134159336	134159732	396	198.0	
30478	chr5	134161231	134162356	1125	562.0	
30479	chr5	134163539	134164457	918	459.0	
30480	chr5	134165285	134166420	1135	568.0	
30481	chr5	134167365	134167649	284	142.0	
30482	chr5	134168763	134169278	515	258.0	
30483	chr5	134172674	134174467	1793	896.0	
30484	chr5	134174997	134178320	3323	1662.0	
30485	chr5	134180301	134180754	453	226.0	
30486	chr5	134183742	134184811	1069	534.0	
30487	chr5	134188203	134188324	121	60.0	
30488	chr5	134191855	134192672	817	408.0	
30489	chr5	134207636	134208073	437	218.0	
30490	chr5	134211044	134211344	300	150.0	
30491	chr5	134216406	134216709	303	152.0	
30492	chr5	134217943	134218078	135	68.0	
30493	chr5	134219360	134219875	515	258.0	
30494	chr5	134220532	134221245	713	356.0	
30495	chr5	134221880	134222705	825	412.0	
30496	chr5	134223815	134227611	3796	1898.0	
30497	chr5	134240692	134240975	283	142.0	
30498	chr5	134249534	134250399	865	432.0	
30499	chr5	134279590	134280134	544	272.0	
30500	chr5	134289424	134289995	571	286.0	
30501	chr5	134302815	134303430	615	308.0	
30502	chr5	134366553	134367695	1142	571.0	
30503	chr5	134370221	134373035	2814	1407.0	
30504	chr5	134409515	134409605	90	45.0	
30505	chr5	134411316	134412713	1397	698.0	
30506	chr5	134436393	134437579	1186	593.0	
30507	chr5	134445934	134446116	182	91.0	
30508	chr5	134446885	134447193	308	154.0	
30509	chr5	134464304	134464308	4	2.0	
30510	chr5	134465395	134467160	1765	882.0	
30511	chr5	134503094	134503921	827	414.0	
30512	chr5	134523136	134528297	5161	2580.0	
30513	chr5	134533317	134533847	530	265.0	
30514	chr5	134536897	134537238	341	170.0	
30515	chr5	134541397	134542107	710	355.0	
30516	chr5	134543611	134545632	2021	1010.0	
30517	chr5	134554232	134556561	2329	1164.0	
30518	chr5	134567928	134568845	917	458.0	
30519	chr5	134576884	134578544	1660	830.0	
30520	chr5	134584011	134584045	34	17.0	
30521	chr5	134586543	134587662	1119	560.0	
30522	chr5	134632120	134633364	1244	622.0	
30523	chr5	134647518	134649855	2337	1168.0	
30524	chr5	134736141	134736537	396	198.0	
30525	chr5	134737569	134739857	2288	1144.0	
30526	chr5	134758089	134759612	1523	762.0	
30527	chr5	134763258	134763542	284	142.0	
30528	chr5	134813335	134814226	891	446.0	
30529	chr5	134845237	134847020	1783	892.0	
30530	chr5	134851320	134851734	414	207.0	
30531	chr5	134873593	134875654	2061	1030.0	
30532	chr5	134876288	134876300	12	6.0	
30533	chr5	134877191	134877640	449	224.0	
30534	chr5	134901898	134902706	808	404.0	
30535	chr5	134904099	134906666	2567	1284.0	
30536	chr5	134964394	134965068	674	337.0	
30537	chr5	135031190	135031509	319	160.0	
30538	chr5	135033481	135033567	86	43.0	
30539	chr5	135034285	135034531	246	123.0	
30540	chr5	135053226	135053798	572	286.0	
30541	chr5	135116158	135117212	1054	527.0	
30542	chr5	135135892	135136159	267	134.0	
30543	chr5	135139754	135141376	1622	811.0	
30544	chr5	135191072	135191809	737	368.0	
30545	chr5	135215018	135215821	803	402.0	
30546	chr5	135223805	135224514	709	354.0	
30547	chr5	135226372	135226595	223	112.0	
30548	chr5	135230283	135231031	748	374.0	
30549	chr5	135245711	135247276	1565	782.0	
30550	chr5	135325289	135325690	401	200.0	
30551	chr5	135332744	135332932	188	94.0	
30552	chr5	135373019	135373035	16	8.0	
30553	chr5	135377205	135378136	931	466.0	
30554	chr5	135386015	135387852	1837	918.0	
30555	chr5	135391858	135394019	2161	1080.0	
30556	chr5	135395513	135396474	961	480.0	
30557	chr5	135397676	135400220	2544	1272.0	
30558	chr5	135423168	135423944	776	388.0	
30559	chr5	135425617	135426889	1272	636.0	
30560	chr5	135433559	135434595	1036	518.0	enhancer
30561	chr5	135437007	135438349	1342	671.0	
30562	chr5	135438877	135439123	246	123.0	
30563	chr5	135441290	135441589	299	150.0	
30564	chr5	135444270	135444757	487	244.0	
30565	chr5	135445547	135445963	416	208.0	
30566	chr5	135452224	135452711	487	244.0	
30567	chr5	135455888	135457907	2019	1010.0	
30568	chr5	135462177	135462751	574	287.0	
30569	chr5	135466034	135466723	689	344.0	
30570	chr5	135481383	135481753	370	185.0	
30571	chr5	135493445	135493838	393	196.0	
30572	chr5	135543461	135544935	1474	737.0	
30573	chr5	135551629	135552266	637	318.0	
30574	chr5	135560707	135561237	530	265.0	
30575	chr5	135566096	135566586	490	245.0	
30576	chr5	135578789	135579333	544	272.0	
30577	chr5	135887323	135887834	511	256.0	
30578	chr5	135945030	135945334	304	152.0	
30579	chr5	135977307	135977990	683	342.0	
30580	chr5	135999092	135999979	887	444.0	
30581	chr5	136000744	136001925	1181	590.0	
30582	chr5	136011953	136012984	1031	516.0	
30583	chr5	136017192	136017507	315	158.0	
30584	chr5	136020257	136020981	724	362.0	
30585	chr5	136024246	136024659	413	206.0	
30586	chr5	136028585	136029678	1093	546.0	
30587	chr5	136031017	136031634	617	308.0	
30588	chr5	136036808	136037783	975	488.0	
30589	chr5	136047777	136048193	416	208.0	
30590	chr5	136062544	136062958	414	207.0	
30591	chr5	136079937	136081218	1281	640.0	
30592	chr5	136082401	136082880	479	240.0	
30593	chr5	136132035	136134230	2195	1098.0	
30594	chr5	136563592	136563967	375	188.0	
30595	chr5	137499147	137499605	458	229.0	
30596	chr5	137563464	137564709	1245	622.0	
30597	chr5	137581821	137582712	891	446.0	
30598	chr5	137613478	137614070	592	296.0	
30599	chr5	137622663	137623356	693	346.0	
30600	chr5	137629490	137630148	658	329.0	
30601	chr5	137660257	137660799	542	271.0	
30602	chr5	137666101	137666630	529	264.0	
30603	chr5	137695523	137696452	929	464.0	enhancer
30604	chr5	137734286	137738252	3966	1983.0	
30605	chr5	137742781	137743491	710	355.0	
30606	chr5	137751640	137755682	4042	2021.0	
30607	chr5	137807584	137807984	400	200.0	
30608	chr5	137858107	137858662	555	278.0	
30609	chr5	137888550	137889967	1417	708.0	
30610	chr5	137901126	137901462	336	168.0	
30611	chr5	137994957	137995505	548	274.0	
30612	chr5	137997849	137998220	371	186.0	
30613	chr5	138028281	138028608	327	164.0	
30614	chr5	138029508	138030330	822	411.0	
30615	chr5	138031716	138034118	2402	1201.0	
30616	chr5	138035698	138036669	971	486.0	
30617	chr5	138042228	138042529	301	150.0	
30618	chr5	138068684	138069186	502	251.0	
30619	chr5	138077033	138077517	484	242.0	
30620	chr5	138081183	138081701	518	259.0	
30621	chr5	138102964	138103431	467	234.0	
30622	chr5	138113716	138114091	375	188.0	
30623	chr5	138132957	138133881	924	462.0	
30624	chr5	138177836	138180693	2857	1428.0	
30625	chr5	138186139	138186444	305	152.0	
30626	chr5	138212722	138214245	1523	762.0	
30627	chr5	138222744	138223235	491	246.0	
30628	chr5	138241036	138241116	80	40.0	
30629	chr5	138241793	138242436	643	322.0	
30630	chr5	138274488	138274659	171	86.0	
30631	chr5	138287261	138287630	369	184.0	
30632	chr5	138331089	138332563	1474	737.0	
30633	chr5	138337001	138340131	3130	1565.0	
30634	chr5	138340801	138341379	578	289.0	
30635	chr5	138343094	138355660	12566	6283.0	
30636	chr5	138366913	138366931	18	9.0	
30637	chr5	138368995	138370207	1212	606.0	
30638	chr5	138411061	138411362	301	150.0	
30639	chr5	138437824	138439812	1988	994.0	
30640	chr5	138449408	138450603	1195	598.0	
30641	chr5	138457545	138460696	3151	1576.0	
30642	chr5	138461348	138461795	447	224.0	
30643	chr5	138463373	138488980	25607	12804.0	
30644	chr5	138489652	138490376	724	362.0	
30645	chr5	138490900	138494247	3347	1674.0	
30646	chr5	138501380	138502428	1048	524.0	
30647	chr5	138503414	138504744	1330	665.0	
30648	chr5	138507426	138508315	889	444.0	
30649	chr5	138514002	138514520	518	259.0	
30650	chr5	138519038	138519607	569	284.0	
30651	chr5	138520538	138520969	431	216.0	
30652	chr5	138522911	138524710	1799	900.0	
30653	chr5	138526636	138528018	1382	691.0	
30654	chr5	138529359	138537457	8098	4049.0	
30655	chr5	138539112	138545716	6604	3302.0	
30656	chr5	138546721	138548662	1941	970.0	
30657	chr5	138551234	138551586	352	176.0	
30658	chr5	138552827	138552837	10	5.0	
30659	chr5	138564995	138566368	1373	686.0	
30660	chr5	138568266	138568876	610	305.0	
30661	chr5	138570378	138572254	1876	938.0	
30662	chr5	138574301	138576552	2251	1126.0	
30663	chr5	138579035	138579858	823	412.0	
30664	chr5	138601505	138601723	218	109.0	
30665	chr5	138605322	138605846	524	262.0	
30666	chr5	138611226	138612075	849	424.0	
30667	chr5	138625205	138625587	382	191.0	
30668	chr5	138632917	138633545	628	314.0	
30669	chr5	138641745	138642265	520	260.0	
30670	chr5	138653903	138655041	1138	569.0	
30671	chr5	138661309	138661719	410	205.0	
30672	chr5	138662599	138663585	986	493.0	
30673	chr5	138668393	138669065	672	336.0	
30674	chr5	138724327	138724917	590	295.0	
30675	chr5	138742018	138742912	894	447.0	
30676	chr5	138751667	138754558	2891	1446.0	
30677	chr5	138789667	138790103	436	218.0	
30678	chr5	138825305	138825599	294	147.0	
30679	chr5	138953012	138953807	795	398.0	
30680	chr5	138979852	138980303	451	226.0	
30681	chr5	138981713	138982058	345	172.0	
30682	chr5	139075261	139076020	759	380.0	
30683	chr5	139149677	139150523	846	423.0	
30684	chr5	139173727	139174138	411	206.0	
30685	chr5	139177831	139178757	926	463.0	
30686	chr5	139182049	139182905	856	428.0	
30687	chr5	139193971	139194326	355	178.0	
30688	chr5	139196181	139196966	785	392.0	
30689	chr5	139197562	139199105	1543	772.0	
30690	chr5	139199631	139199667	36	18.0	
30691	chr5	139205330	139205363	33	16.0	
30692	chr5	139246211	139246792	581	290.0	
30693	chr5	139251200	139251692	492	246.0	
30694	chr5	139262489	139263096	607	304.0	
30695	chr5	139272426	139275059	2633	1316.0	
30696	chr5	139288219	139288599	380	190.0	
30697	chr5	139292798	139296167	3369	1684.0	
30698	chr5	139297046	139297170	124	62.0	
30699	chr5	139297761	139300340	2579	1290.0	
30700	chr5	139302145	139302146	1	0.0	
30701	chr5	139303330	139303763	433	216.0	
30702	chr5	139306266	139306707	441	220.0	
30703	chr5	139310554	139311307	753	376.0	
30704	chr5	139334132	139336881	2749	1374.0	
30705	chr5	139340921	139343683	2762	1381.0	
30706	chr5	139344350	139344686	336	168.0	
30707	chr5	139346816	139347054	238	119.0	
30708	chr5	139384560	139386418	1858	929.0	
30709	chr5	139387761	139394772	7011	3506.0	
30710	chr5	139399717	139399900	183	92.0	
30711	chr5	139402533	139404858	2325	1162.0	
30712	chr5	139407438	139407961	523	262.0	
30713	chr5	139422197	139422803	606	303.0	
30714	chr5	139430038	139430109	71	36.0	
30715	chr5	139438564	139440182	1618	809.0	
30716	chr5	139443770	139444181	411	206.0	
30717	chr5	139457715	139459821	2106	1053.0	
30718	chr5	139468314	139469129	815	408.0	
30719	chr5	139470455	139471791	1336	668.0	
30720	chr5	139472352	139472940	588	294.0	
30721	chr5	139474830	139476535	1705	852.0	
30722	chr5	139479466	139479687	221	110.0	
30723	chr5	139480864	139483287	2423	1212.0	
30724	chr5	139488002	139488822	820	410.0	
30725	chr5	139492735	139493285	550	275.0	
30726	chr5	139495657	139496053	396	198.0	
30727	chr5	139511588	139514156	2568	1284.0	
30728	chr5	139517475	139518798	1323	662.0	
30729	chr5	139543227	139544040	813	406.0	
30730	chr5	139551326	139551779	453	226.0	
30731	chr5	139560453	139564164	3711	1856.0	
30732	chr5	139565048	139566287	1239	620.0	
30733	chr5	139566959	139567000	41	20.0	
30734	chr5	139574838	139576178	1340	670.0	
30735	chr5	139576877	139578478	1601	800.0	
30736	chr5	139589834	139590496	662	331.0	
30737	chr5	139632968	139634039	1071	536.0	
30738	chr5	139635436	139639152	3716	1858.0	
30739	chr5	139645240	139645250	10	5.0	
30740	chr5	139646833	139654061	7228	3614.0	
30741	chr5	139657437	139663016	5579	2790.0	
30742	chr5	139663521	139665199	1678	839.0	
30743	chr5	139666520	139672014	5494	2747.0	
30744	chr5	139685102	139685118	16	8.0	
30745	chr5	139687166	139687425	259	130.0	
30746	chr5	139689675	139690660	985	492.0	
30747	chr5	139696497	139698044	1547	774.0	
30748	chr5	139699952	139700317	365	182.0	
30749	chr5	139701045	139701765	720	360.0	
30750	chr5	139705810	139706151	341	170.0	
30751	chr5	139708456	139712239	3783	1892.0	
30752	chr5	139727578	139728045	467	234.0	
30753	chr5	139740446	139740819	373	186.0	
30754	chr5	139744956	139749315	4359	2180.0	
30755	chr5	139750587	139750683	96	48.0	
30756	chr5	139751278	139751301	23	12.0	
30757	chr5	139755184	139756562	1378	689.0	
30758	chr5	139759396	139759563	167	84.0	
30759	chr5	139764007	139766477	2470	1235.0	
30760	chr5	139774834	139775961	1127	564.0	
30761	chr5	139787153	139788885	1732	866.0	
30762	chr5	139795347	139796601	1254	627.0	
30763	chr5	139808557	139808929	372	186.0	
30764	chr5	139844349	139844869	520	260.0	
30765	chr5	139847270	139849677	2407	1204.0	
30766	chr5	139850287	139850514	227	114.0	
30767	chr5	139863994	139864521	527	264.0	
30768	chr5	139897415	139897670	255	128.0	
30769	chr5	139904040	139904383	343	172.0	
30770	chr5	139925832	139926620	788	394.0	
30771	chr5	139946357	139946894	537	268.0	
30772	chr5	139968494	139969275	781	390.0	
30773	chr5	140038632	140039033	401	200.0	
30774	chr5	140041655	140043887	2232	1116.0	
30775	chr5	140073225	140073631	406	203.0	
30776	chr5	140106138	140109325	3187	1594.0	
30777	chr5	140111650	140112315	665	332.0	
30778	chr5	140112869	140115494	2625	1312.0	
30779	chr5	140131775	140132522	747	374.0	
30780	chr5	140143899	140144843	944	472.0	
30781	chr5	140145510	140146645	1135	568.0	
30782	chr5	140156815	140157923	1108	554.0	
30783	chr5	140166938	140167269	331	166.0	
30784	chr5	140173505	140176865	3360	1680.0	
30785	chr5	140177454	140177621	167	84.0	
30786	chr5	140180900	140181556	656	328.0	
30787	chr5	140182356	140183563	1207	604.0	
30788	chr5	140186406	140186644	238	119.0	
30789	chr5	140196375	140196523	148	74.0	
30790	chr5	140207498	140208070	572	286.0	
30791	chr5	140214870	140215223	353	176.0	
30792	chr5	140235706	140237324	1618	809.0	
30793	chr5	140239788	140240311	523	262.0	
30794	chr5	140244244	140245805	1561	780.0	
30795	chr5	140251307	140252173	866	433.0	
30796	chr5	140253743	140254691	948	474.0	
30797	chr5	140259470	140259804	334	167.0	
30798	chr5	140261249	140262380	1131	566.0	
30799	chr5	140266955	140267912	957	478.0	
30800	chr5	140273139	140274066	927	464.0	
30801	chr5	140275122	140275661	539	270.0	
30802	chr5	140284602	140285249	647	324.0	
30803	chr5	140293512	140293561	49	24.0	
30804	chr5	140295484	140295718	234	117.0	
30805	chr5	140302523	140303781	1258	629.0	
30806	chr5	140310451	140310688	237	118.0	
30807	chr5	140312005	140312449	444	222.0	
30808	chr5	140319547	140320335	788	394.0	
30809	chr5	140321475	140322425	950	475.0	
30810	chr5	140324438	140325527	1089	544.0	
30811	chr5	140338892	140339309	417	208.0	
30812	chr5	140340680	140343372	2692	1346.0	
30813	chr5	140344705	140345129	424	212.0	
30814	chr5	140345876	140347137	1261	630.0	
30815	chr5	140351506	140352171	665	332.0	
30816	chr5	140356990	140358274	1284	642.0	
30817	chr5	140362907	140363945	1038	519.0	
30818	chr5	140372800	140373441	641	320.0	
30819	chr5	140400198	140403239	3041	1520.0	
30820	chr5	140408873	140409085	212	106.0	
30821	chr5	140433161	140433287	126	63.0	
30822	chr5	140533899	140534336	437	218.0	
30823	chr5	140546175	140550206	4031	2016.0	
30824	chr5	140552877	140552886	9	4.0	
30825	chr5	140553530	140554924	1394	697.0	
30826	chr5	140555824	140558414	2590	1295.0	
30827	chr5	140560614	140560683	69	34.0	
30828	chr5	140563469	140565649	2180	1090.0	
30829	chr5	140568597	140570238	1641	820.0	
30830	chr5	140575308	140575809	501	250.0	
30831	chr5	140576687	140576854	167	84.0	
30832	chr5	140588901	140589636	735	368.0	
30833	chr5	140591687	140592401	714	357.0	
30834	chr5	140594942	140596691	1749	874.0	
30835	chr5	140602001	140604131	2130	1065.0	
30836	chr5	140606959	140607611	652	326.0	
30837	chr5	140608675	140609669	994	497.0	
30838	chr5	140611198	140612791	1593	796.0	
30839	chr5	140628763	140629097	334	167.0	
30840	chr5	140630188	140634038	3850	1925.0	
30841	chr5	140634819	140635580	761	380.0	
30842	chr5	140638637	140640283	1646	823.0	
30843	chr5	140646828	140648635	1807	904.0	
30844	chr5	140663006	140665712	2706	1353.0	
30845	chr5	140673415	140673808	393	196.0	
30846	chr5	140690508	140692076	1568	784.0	
30847	chr5	140699721	140701218	1497	748.0	
30848	chr5	140710257	140711839	1582	791.0	
30849	chr5	140719999	140720638	639	320.0	
30850	chr5	140725680	140726558	878	439.0	
30851	chr5	140926459	140926715	256	128.0	sequence_feature
30852	chr5	141041065	141041536	471	236.0	
30853	chr5	141084405	141084830	425	212.0	
30854	chr5	141319848	141321577	1729	864.0	sequence_feature
30855	chr5	141325928	141326851	923	462.0	
30856	chr5	141330252	141330653	401	200.0	
30857	chr5	141349927	141350173	246	123.0	
30858	chr5	141355028	141355163	135	68.0	sequence_feature
30859	chr5	141359770	141360372	602	301.0	sequence_feature
30860	chr5	141370003	141370451	448	224.0	sequence_feature
30861	chr5	141387492	141387800	308	154.0	
30862	chr5	141397741	141398085	344	172.0	sequence_feature
30863	chr5	141407725	141408388	663	332.0	sequence_feature
30864	chr5	141412730	141413640	910	455.0	sequence_feature
30865	chr5	141417390	141418086	696	348.0	"sequence_feature	sequence_feature"
30866	chr5	141420771	141421643	872	436.0	sequence_feature
30867	chr5	141430321	141430771	450	225.0	sequence_feature
30868	chr5	141475639	141476456	817	408.0	sequence_feature
30869	chr5	141492021	141492932	911	456.0	sequence_feature
30870	chr5	141507609	141508002	393	196.0	
30871	chr5	141508793	141509663	870	435.0	
30872	chr5	141511132	141515423	4291	2146.0	"sequence_feature	sequence_feature"
30873	chr5	141519894	141521672	1778	889.0	
30874	chr5	141522364	141522699	335	168.0	
30875	chr5	141524483	141525531	1048	524.0	
30876	chr5	141550400	141550615	215	108.0	
30877	chr5	141557558	141558629	1071	536.0	
30878	chr5	141560835	141561170	335	168.0	
30879	chr5	141563824	141564856	1032	516.0	
30880	chr5	141567297	141567921	624	312.0	
30881	chr5	141570610	141571214	604	302.0	
30882	chr5	141581914	141582468	554	277.0	
30883	chr5	141590138	141590744	606	303.0	
30884	chr5	141591777	141592827	1050	525.0	
30885	chr5	141597295	141598020	725	362.0	
30886	chr5	141598659	141600279	1620	810.0	
30887	chr5	141602054	141606674	4620	2310.0	
30888	chr5	141608201	141608839	638	319.0	
30889	chr5	141609591	141609653	62	31.0	
30890	chr5	141615810	141619828	4018	2009.0	
30891	chr5	141622884	141623892	1008	504.0	
30892	chr5	141634106	141634680	574	287.0	
30893	chr5	141636026	141639093	3067	1534.0	
30894	chr5	141641850	141642239	389	194.0	
30895	chr5	141650510	141652224	1714	857.0	
30896	chr5	141664747	141665576	829	414.0	
30897	chr5	141680908	141683876	2968	1484.0	
30898	chr5	141685718	141685729	11	6.0	
30899	chr5	141691465	141693925	2460	1230.0	
30900	chr5	141701678	141703697	2019	1010.0	
30901	chr5	141747859	141748181	322	161.0	
30902	chr5	141811481	141811982	501	250.0	
30903	chr5	141814041	141814456	415	208.0	
30904	chr5	141826193	141826527	334	167.0	
30905	chr5	141845501	141845793	292	146.0	
30906	chr5	141848820	141852428	3608	1804.0	
30907	chr5	141875422	141880052	4630	2315.0	
30908	chr5	141883344	141883790	446	223.0	
30909	chr5	141898339	141899026	687	344.0	
30910	chr5	141903020	141903683	663	332.0	
30911	chr5	141914002	141914798	796	398.0	
30912	chr5	141923068	141924797	1729	864.0	
30913	chr5	141940901	141941733	832	416.0	
30914	chr5	141945691	141946203	512	256.0	
30915	chr5	141951239	141951671	432	216.0	
30916	chr5	141953973	141954653	680	340.0	
30917	chr5	141957660	141959316	1656	828.0	
30918	chr5	141959983	141961919	1936	968.0	
30919	chr5	141968310	141970769	2459	1230.0	
30920	chr5	141992306	141992797	491	246.0	
30921	chr5	142006503	142007555	1052	526.0	
30922	chr5	142011981	142013601	1620	810.0	
30923	chr5	142014865	142016999	2134	1067.0	
30924	chr5	142018106	142018505	399	200.0	
30925	chr5	142024595	142025825	1230	615.0	
30926	chr5	142046199	142046537	338	169.0	
30927	chr5	142053363	142054283	920	460.0	
30928	chr5	142063652	142064409	757	378.0	
30929	chr5	142065551	142065643	92	46.0	
30930	chr5	142088335	142088765	430	215.0	
30931	chr5	142094995	142096874	1879	940.0	
30932	chr5	142097859	142098263	404	202.0	
30933	chr5	142104355	142105170	815	408.0	
30934	chr5	142108116	142110646	2530	1265.0	
30935	chr5	142128762	142129181	419	210.0	
30936	chr5	142133382	142133773	391	196.0	
30937	chr5	142143866	142144323	457	228.0	
30938	chr5	142145096	142145796	700	350.0	
30939	chr5	142151821	142152260	439	220.0	
30940	chr5	142221158	142221376	218	109.0	
30941	chr5	142222096	142224364	2268	1134.0	
30942	chr5	142316066	142316252	186	93.0	
30943	chr5	142324162	142326707	2545	1272.0	
30944	chr5	142350738	142350884	146	73.0	
30945	chr5	142353012	142353361	349	174.0	
30946	chr5	142356347	142358456	2109	1054.0	
30947	chr5	142360256	142360478	222	111.0	
30948	chr5	142388646	142389047	401	200.0	
30949	chr5	142419362	142420179	817	408.0	
30950	chr5	142426025	142426735	710	355.0	
30951	chr5	142432191	142433463	1272	636.0	
30952	chr5	142441722	142442072	350	175.0	
30953	chr5	142456045	142456049	4	2.0	
30954	chr5	142472292	142472686	394	197.0	
30955	chr5	142527998	142528011	13	6.0	
30956	chr5	142548786	142549169	383	192.0	
30957	chr5	142580156	142580750	594	297.0	
30958	chr5	142611036	142611480	444	222.0	
30959	chr5	142655621	142656091	470	235.0	
30960	chr5	142698903	142699607	704	352.0	
30961	chr5	142711283	142711414	131	66.0	
30962	chr5	142712840	142713965	1125	562.0	
30963	chr5	142716877	142717963	1086	543.0	
30964	chr5	142725974	142726760	786	393.0	
30965	chr5	142727423	142727778	355	178.0	
30966	chr5	142733783	142734971	1188	594.0	
30967	chr5	142737194	142737623	429	214.0	
30968	chr5	142746993	142747085	92	46.0	
30969	chr5	142748539	142749755	1216	608.0	
30970	chr5	142758260	142759178	918	459.0	
30971	chr5	142762542	142762831	289	144.0	
30972	chr5	142767885	142768434	549	274.0	
30973	chr5	142769192	142773059	3867	1934.0	
30974	chr5	142773719	142773737	18	9.0	
30975	chr5	142774518	142774743	225	112.0	
30976	chr5	142776357	142778329	1972	986.0	
30977	chr5	142778910	142779716	806	403.0	
30978	chr5	142781031	142781047	16	8.0	
30979	chr5	142782084	142787544	5460	2730.0	
30980	chr5	142789521	142790849	1328	664.0	
30981	chr5	142792895	142793228	333	166.0	
30982	chr5	142793849	142795784	1935	968.0	
30983	chr5	142796525	142801835	5310	2655.0	
30984	chr5	142803181	142804347	1166	583.0	
30985	chr5	142806798	142808311	1513	756.0	
30986	chr5	142809192	142809677	485	242.0	
30987	chr5	142811749	142812636	887	444.0	
30988	chr5	142813860	142814927	1067	534.0	
30989	chr5	142816519	142818313	1794	897.0	
30990	chr5	142819291	142819608	317	158.0	
30991	chr5	142821850	142822551	701	350.0	
30992	chr5	142825178	142825554	376	188.0	
30993	chr5	142826659	142827586	927	464.0	
30994	chr5	142837070	142837930	860	430.0	
30995	chr5	142839632	142840136	504	252.0	
30996	chr5	142840686	142841008	322	161.0	
30997	chr5	142844913	142847031	2118	1059.0	
30998	chr5	142847796	142848020	224	112.0	
30999	chr5	142866626	142867517	891	446.0	
31000	chr5	142880237	142881855	1618	809.0	
31001	chr5	142888428	142888888	460	230.0	
31002	chr5	142902498	142903049	551	276.0	
31003	chr5	142915852	142916206	354	177.0	
31004	chr5	142922123	142922597	474	237.0	
31005	chr5	142924176	142925164	988	494.0	
31006	chr5	142925682	142926326	644	322.0	
31007	chr5	142929362	142930506	1144	572.0	
31008	chr5	142935247	142936324	1077	538.0	
31009	chr5	142941268	142941504	236	118.0	
31010	chr5	142950690	142951668	978	489.0	
31011	chr5	142959593	142960677	1084	542.0	
31012	chr5	142965058	142965658	600	300.0	
31013	chr5	142969838	142970023	185	92.0	
31014	chr5	142971290	142972538	1248	624.0	
31015	chr5	142973860	142974050	190	95.0	
31016	chr5	142976752	142979027	2275	1138.0	
31017	chr5	142981981	142982635	654	327.0	
31018	chr5	142983994	142984343	349	174.0	
31019	chr5	142994045	142994724	679	340.0	
31020	chr5	142996266	142998865	2599	1300.0	
31021	chr5	143001716	143003728	2012	1006.0	
31022	chr5	143004288	143005250	962	481.0	
31023	chr5	143006640	143006786	146	73.0	
31024	chr5	143008392	143010336	1944	972.0	
31025	chr5	143011591	143012018	427	214.0	
31026	chr5	143014004	143014403	399	200.0	
31027	chr5	143016744	143017177	433	216.0	
31028	chr5	143023591	143024184	593	296.0	
31029	chr5	143030296	143030826	530	265.0	
31030	chr5	143051357	143052079	722	361.0	
31031	chr5	143054431	143054713	282	141.0	
31032	chr5	143057665	143057988	323	162.0	
31033	chr5	143064727	143065602	875	438.0	
31034	chr5	143066786	143067152	366	183.0	
31035	chr5	143101094	143102086	992	496.0	
31036	chr5	143113744	143113831	87	44.0	
31037	chr5	143117802	143119677	1875	938.0	
31038	chr5	143121012	143121467	455	228.0	
31039	chr5	143124600	143125037	437	218.0	
31040	chr5	143141632	143142091	459	230.0	
31041	chr5	143145425	143145795	370	185.0	
31042	chr5	143161772	143162394	622	311.0	
31043	chr5	143165123	143165592	469	234.0	
31044	chr5	143176065	143176486	421	210.0	
31045	chr5	143182848	143183818	970	485.0	
31046	chr5	143186712	143186792	80	40.0	
31047	chr5	143205707	143206321	614	307.0	
31048	chr5	143215710	143216065	355	178.0	
31049	chr5	143216940	143217476	536	268.0	
31050	chr5	143220727	143221078	351	176.0	
31051	chr5	143221703	143223672	1969	984.0	
31052	chr5	143229436	143230629	1193	596.0	
31053	chr5	143261705	143262788	1083	542.0	
31054	chr5	143276017	143276108	91	46.0	
31055	chr5	143349859	143351264	1405	702.0	
31056	chr5	143352632	143353172	540	270.0	
31057	chr5	143353843	143354478	635	318.0	
31058	chr5	143355703	143356170	467	234.0	
31059	chr5	143384036	143384331	295	148.0	
31060	chr5	143386906	143386999	93	46.0	
31061	chr5	143400204	143400907	703	352.0	
31062	chr5	143401838	143406068	4230	2115.0	
31063	chr5	143414182	143414504	322	161.0	
31064	chr5	143418115	143418884	769	384.0	
31065	chr5	143428018	143429468	1450	725.0	
31066	chr5	143433732	143435834	2102	1051.0	
31067	chr5	143453655	143454133	478	239.0	
31068	chr5	143495202	143496128	926	463.0	
31069	chr5	143554112	143554705	593	296.0	
31070	chr5	143557492	143557786	294	147.0	
31071	chr5	143564216	143564842	626	313.0	
31072	chr5	143582882	143583679	797	398.0	
31073	chr5	143601755	143602296	541	270.0	
31074	chr5	143604079	143606752	2673	1336.0	
31075	chr5	143619163	143619427	264	132.0	
31076	chr5	143693687	143694431	744	372.0	
31077	chr5	143717429	143717770	341	170.0	
31078	chr5	143741418	143741819	401	200.0	
31079	chr5	143775367	143775622	255	128.0	
31080	chr5	143791863	143792686	823	412.0	
31081	chr5	143796702	143797212	510	255.0	
31082	chr5	143825001	143825561	560	280.0	
31083	chr5	143828587	143829075	488	244.0	
31084	chr5	144142070	144142719	649	324.0	
31085	chr5	144169910	144171418	1508	754.0	
31086	chr5	144177502	144177839	337	168.0	
31087	chr5	144183238	144183742	504	252.0	
31088	chr5	144187505	144188673	1168	584.0	
31089	chr5	144189245	144190583	1338	669.0	
31090	chr5	144191573	144192695	1122	561.0	
31091	chr5	144203707	144204171	464	232.0	
31092	chr5	145681559	145682017	458	229.0	
31093	chr5	145689088	145689717	629	314.0	
31094	chr5	145743853	145743993	140	70.0	
31095	chr5	145825657	145826051	394	197.0	
31096	chr5	145834852	145835867	1015	508.0	
31097	chr5	145856412	145856872	460	230.0	
31098	chr5	145984036	145984600	564	282.0	
31099	chr5	146006329	146007591	1262	631.0	
31100	chr5	146049618	146049627	9	4.0	
31101	chr5	146181827	146183561	1734	867.0	
31102	chr5	146202794	146205979	3185	1592.0	
31103	chr5	146291418	146291857	439	220.0	
31104	chr5	146313023	146313380	357	178.0	
31105	chr5	146363158	146363603	445	222.0	
31106	chr5	146427072	146427652	580	290.0	
31107	chr5	146446648	146448467	1819	910.0	
31108	chr5	146474025	146474426	401	200.0	
31109	chr5	146533184	146533696	512	256.0	
31110	chr5	146542209	146542663	454	227.0	
31111	chr5	146565718	146566209	491	246.0	
31112	chr5	146662158	146662536	378	189.0	
31113	chr5	146751538	146752486	948	474.0	
31114	chr5	146765063	146765583	520	260.0	
31115	chr5	146799409	146799581	172	86.0	
31116	chr5	146876899	146879193	2294	1147.0	"repeat_region	sequence_feature"
31117	chr5	146919563	146919576	13	6.0	
31118	chr5	146947207	146947618	411	206.0	
31119	chr5	146965963	146966509	546	273.0	
31120	chr5	147188799	147189200	401	200.0	
31121	chr5	147207873	147208201	328	164.0	
31122	chr5	147310295	147310692	397	198.0	
31123	chr5	147403902	147404678	776	388.0	
31124	chr5	147453183	147454540	1357	678.0	
31125	chr5	147481470	147483065	1595	798.0	
31126	chr5	147576949	147577340	391	196.0	
31127	chr5	147627987	147628505	518	259.0	
31128	chr5	147781963	147783213	1250	625.0	
31129	chr5	147784470	147784826	356	178.0	
31130	chr5	147803162	147803640	478	239.0	
31131	chr5	147804653	147805810	1157	578.0	
31132	chr5	147822121	147823167	1046	523.0	
31133	chr5	147857502	147857939	437	218.0	
31134	chr5	147912166	147912311	145	72.0	
31135	chr5	147921212	147921476	264	132.0	
31136	chr5	147930731	147931204	473	236.0	
31137	chr5	147935086	147935405	319	160.0	
31138	chr5	147964353	147964365	12	6.0	
31139	chr5	148179223	148179668	445	222.0	
31140	chr5	148186157	148186798	641	320.0	
31141	chr5	148201159	148201776	617	308.0	
31142	chr5	148372386	148372513	127	64.0	
31143	chr5	148374686	148375157	471	236.0	
31144	chr5	148383103	148384901	1798	899.0	
31145	chr5	148385619	148386029	410	205.0	
31146	chr5	148397939	148398584	645	322.0	
31147	chr5	148401641	148402094	453	226.0	
31148	chr5	148403232	148403885	653	326.0	
31149	chr5	148443856	148444377	521	260.0	
31150	chr5	148457259	148457701	442	221.0	
31151	chr5	148465695	148466324	629	314.0	
31152	chr5	148482810	148483303	493	246.0	
31153	chr5	148620661	148621123	462	231.0	
31154	chr5	148730703	148731790	1087	544.0	
31155	chr5	148733563	148734119	556	278.0	
31156	chr5	148740286	148741692	1406	703.0	
31157	chr5	148746806	148747485	679	340.0	
31158	chr5	148748641	148749403	762	381.0	
31159	chr5	148759130	148759476	346	173.0	
31160	chr5	148761180	148761264	84	42.0	
31161	chr5	148766374	148767070	696	348.0	
31162	chr5	148768985	148769192	207	104.0	
31163	chr5	148791543	148791551	8	4.0	
31164	chr5	148792840	148793218	378	189.0	
31165	chr5	148794785	148795398	613	306.0	
31166	chr5	148805351	148806486	1135	568.0	
31167	chr5	148807679	148811230	3551	1776.0	
31168	chr5	148812189	148812495	306	153.0	
31169	chr5	148819580	148819986	406	203.0	
31170	chr5	148820765	148821257	492	246.0	
31171	chr5	148822712	148823284	572	286.0	
31172	chr5	148823855	148824271	416	208.0	
31173	chr5	148825511	148833574	8063	4032.0	
31174	chr5	148834344	148835139	795	398.0	
31175	chr5	148836302	148837039	737	368.0	
31176	chr5	148839720	148840593	873	436.0	
31177	chr5	148841617	148842542	925	462.0	
31178	chr5	148843928	148845326	1398	699.0	
31179	chr5	148845946	148846008	62	31.0	
31180	chr5	148847495	148850108	2613	1306.0	
31181	chr5	148853830	148854264	434	217.0	
31182	chr5	148855374	148856505	1131	566.0	
31183	chr5	148859708	148860109	401	200.0	
31184	chr5	148861097	148861463	366	183.0	
31185	chr5	148877511	148877770	259	130.0	
31186	chr5	148957546	148958061	515	258.0	
31187	chr5	148963483	148964297	814	407.0	
31188	chr5	148972944	148973389	445	222.0	
31189	chr5	148998149	148998608	459	230.0	
31190	chr5	149035246	149035911	665	332.0	
31191	chr5	149037796	149038272	476	238.0	
31192	chr5	149039538	149039904	366	183.0	
31193	chr5	149044535	149044810	275	138.0	
31194	chr5	149062415	149062808	393	196.0	
31195	chr5	149114656	149115175	519	260.0	
31196	chr5	149128033	149128369	336	168.0	
31197	chr5	149134544	149134707	163	82.0	
31198	chr5	149141194	149142414	1220	610.0	
31199	chr5	149153898	149154364	466	233.0	
31200	chr5	149223205	149223449	244	122.0	
31201	chr5	149240307	149240859	552	276.0	
31202	chr5	149264659	149265097	438	219.0	
31203	chr5	149268941	149269394	453	226.0	
31204	chr5	149271538	149272617	1079	540.0	
31205	chr5	149295107	149295224	117	58.0	
31206	chr5	149317140	149317792	652	326.0	
31207	chr5	149343613	149346707	3094	1547.0	
31208	chr5	149348354	149349088	734	367.0	
31209	chr5	149357282	149359007	1725	862.0	
31210	chr5	149359649	149360916	1267	634.0	
31211	chr5	149367259	149368059	800	400.0	
31212	chr5	149371302	149371829	527	264.0	
31213	chr5	149381786	149382351	565	282.0	
31214	chr5	149428940	149429299	359	180.0	
31215	chr5	149430953	149431482	529	264.0	
31216	chr5	149434417	149434828	411	206.0	
31217	chr5	149442457	149442967	510	255.0	
31218	chr5	149544099	149544411	312	156.0	
31219	chr5	149545453	149545501	48	24.0	
31220	chr5	149546984	149547337	353	176.0	
31221	chr5	149549205	149552325	3120	1560.0	
31222	chr5	149564528	149565231	703	352.0	
31223	chr5	149581058	149581792	734	367.0	
31224	chr5	149605977	149606612	635	318.0	
31225	chr5	149618697	149619088	391	196.0	
31226	chr5	149628213	149628583	370	185.0	
31227	chr5	149636745	149637247	502	251.0	
31228	chr5	149648281	149649402	1121	560.0	
31229	chr5	149651780	149652092	312	156.0	
31230	chr5	149652864	149652870	6	3.0	
31231	chr5	149656586	149657011	425	212.0	
31232	chr5	149666024	149666620	596	298.0	
31233	chr5	149667370	149668296	926	463.0	
31234	chr5	149677635	149678375	740	370.0	
31235	chr5	149680208	149681434	1226	613.0	
31236	chr5	149682703	149683089	386	193.0	
31237	chr5	149687022	149688243	1221	610.0	
31238	chr5	149724425	149724872	447	224.0	
31239	chr5	149729745	149732566	2821	1410.0	
31240	chr5	149734986	149735638	652	326.0	
31241	chr5	149749319	149749959	640	320.0	
31242	chr5	149780611	149781149	538	269.0	
31243	chr5	149805757	149806312	555	278.0	
31244	chr5	149828151	149828949	798	399.0	
31245	chr5	149834209	149834643	434	217.0	
31246	chr5	149853001	149853423	422	211.0	
31247	chr5	149860827	149861205	378	189.0	
31248	chr5	149904885	149905354	469	234.0	
31249	chr5	149938862	149940510	1648	824.0	
31250	chr5	149959095	149962486	3391	1696.0	
31251	chr5	149990562	149991211	649	324.0	
31252	chr5	149999566	150002360	2794	1397.0	
31253	chr5	150002923	150002931	8	4.0	
31254	chr5	150035120	150035566	446	223.0	
31255	chr5	150043812	150044481	669	334.0	
31256	chr5	150045876	150046563	687	344.0	
31257	chr5	150051777	150051778	1	0.0	
31258	chr5	150052705	150053594	889	444.0	
31259	chr5	150058433	150059439	1006	503.0	
31260	chr5	150065389	150066463	1074	537.0	
31261	chr5	150066992	150067738	746	373.0	
31262	chr5	150081648	150083348	1700	850.0	
31263	chr5	150086155	150086877	722	361.0	
31264	chr5	150102824	150103291	467	234.0	
31265	chr5	150106600	150106895	295	148.0	
31266	chr5	150113039	150113529	490	245.0	
31267	chr5	150122050	150122634	584	292.0	
31268	chr5	150123446	150124719	1273	636.0	
31269	chr5	150129873	150130558	685	342.0	
31270	chr5	150131936	150132501	565	282.0	
31271	chr5	150140176	150140255	79	40.0	
31272	chr5	150142676	150143621	945	472.0	
31273	chr5	150144935	150145305	370	185.0	
31274	chr5	150155633	150156165	532	266.0	
31275	chr5	150161223	150162082	859	430.0	
31276	chr5	150180764	150181133	369	184.0	
31277	chr5	150185490	150186009	519	260.0	
31278	chr5	150208800	150209775	975	488.0	
31279	chr5	150217876	150218617	741	370.0	
31280	chr5	150234547	150235017	470	235.0	
31281	chr5	150264238	150264478	240	120.0	
31282	chr5	150350456	150351277	821	410.0	
31283	chr5	150356835	150358473	1638	819.0	
31284	chr5	150376671	150377688	1017	508.0	
31285	chr5	150382783	150384669	1886	943.0	
31286	chr5	150385372	150414971	29599	14800.0	
31287	chr5	150419477	150420056	579	290.0	
31288	chr5	150429433	150430080	647	324.0	
31289	chr5	150431599	150431821	222	111.0	
31290	chr5	150435819	150436808	989	494.0	
31291	chr5	150439148	150439569	421	210.0	
31292	chr5	150448244	150450529	2285	1142.0	
31293	chr5	150454049	150454415	366	183.0	
31294	chr5	150457089	150457552	463	232.0	
31295	chr5	150458583	150459658	1075	538.0	
31296	chr5	150461215	150461647	432	216.0	
31297	chr5	150466730	150466906	176	88.0	
31298	chr5	150477208	150478742	1534	767.0	
31299	chr5	150485410	150491199	5789	2894.0	
31300	chr5	150523703	150524182	479	240.0	
31301	chr5	150544615	150545191	576	288.0	
31302	chr5	150560656	150561374	718	359.0	
31303	chr5	150567327	150567731	404	202.0	
31304	chr5	150623469	150625128	1659	830.0	
31305	chr5	150626009	150626433	424	212.0	
31306	chr5	150656026	150657590	1564	782.0	
31307	chr5	150671429	150673052	1623	812.0	
31308	chr5	150687885	150688524	639	320.0	
31309	chr5	150699900	150701885	1985	992.0	
31310	chr5	150703714	150704212	498	249.0	
31311	chr5	150734263	150735208	945	472.0	
31312	chr5	150757996	150759715	1719	860.0	
31313	chr5	150762134	150764009	1875	938.0	
31314	chr5	150764801	150766201	1400	700.0	
31315	chr5	150777863	150781476	3613	1806.0	
31316	chr5	150783008	150784458	1450	725.0	
31317	chr5	150787677	150788070	393	196.0	
31318	chr5	150789984	150790757	773	386.0	
31319	chr5	150801000	150801745	745	372.0	
31320	chr5	150846112	150847730	1618	809.0	
31321	chr5	150853528	150854009	481	240.0	
31322	chr5	150862066	150862526	460	230.0	
31323	chr5	150904534	150905472	938	469.0	
31324	chr5	151006265	151006657	392	196.0	
31325	chr5	151013095	151013206	111	56.0	
31326	chr5	151016509	151017237	728	364.0	
31327	chr5	151020119	151021161	1042	521.0	
31328	chr5	151023544	151024971	1427	714.0	
31329	chr5	151026645	151027214	569	284.0	
31330	chr5	151047783	151048278	495	248.0	
31331	chr5	151051572	151052508	936	468.0	
31332	chr5	151056225	151057382	1157	578.0	
31333	chr5	151058380	151060784	2404	1202.0	
31334	chr5	151063087	151064004	917	458.0	
31335	chr5	151068153	151069335	1182	591.0	
31336	chr5	151075864	151076265	401	200.0	
31337	chr5	151078445	151083899	5454	2727.0	
31338	chr5	151084996	151087782	2786	1393.0	
31339	chr5	151089026	151089302	276	138.0	
31340	chr5	151092631	151096217	3586	1793.0	
31341	chr5	151096772	151099265	2493	1246.0	
31342	chr5	151100109	151100619	510	255.0	
31343	chr5	151115192	151115939	747	374.0	
31344	chr5	151123674	151124779	1105	552.0	
31345	chr5	151125316	151126784	1468	734.0	
31346	chr5	151132859	151133551	692	346.0	
31347	chr5	151134863	151135751	888	444.0	
31348	chr5	151138688	151139991	1303	652.0	
31349	chr5	151141201	151142087	886	443.0	
31350	chr5	151146049	151146496	447	224.0	
31351	chr5	151148455	151149044	589	294.0	
31352	chr5	151149885	151152428	2543	1272.0	
31353	chr5	151153765	151154131	366	183.0	
31354	chr5	151154654	151158795	4141	2070.0	
31355	chr5	151164530	151165263	733	366.0	
31356	chr5	151171365	151172118	753	376.0	
31357	chr5	151195550	151197133	1583	792.0	
31358	chr5	151202465	151203268	803	402.0	
31359	chr5	151208243	151209726	1483	742.0	
31360	chr5	151210886	151215968	5082	2541.0	
31361	chr5	151217846	151218242	396	198.0	
31362	chr5	151219805	151224824	5019	2510.0	
31363	chr5	151233729	151235331	1602	801.0	
31364	chr5	151238343	151239862	1519	760.0	
31365	chr5	151241430	151242048	618	309.0	
31366	chr5	151244319	151244759	440	220.0	
31367	chr5	151249261	151249597	336	168.0	
31368	chr5	151250951	151255000	4049	2024.0	
31369	chr5	151255684	151256382	698	349.0	
31370	chr5	151257396	151259046	1650	825.0	
31371	chr5	151264012	151264553	541	270.0	
31372	chr5	151270514	151271766	1252	626.0	
31373	chr5	151296195	151296480	285	142.0	
31374	chr5	151315968	151316422	454	227.0	
31375	chr5	151328729	151329129	400	200.0	
31376	chr5	151427271	151427689	418	209.0	
31377	chr5	151447198	151448942	1744	872.0	
31378	chr5	151483007	151484008	1001	500.0	
31379	chr5	151500559	151501238	679	340.0	
31380	chr5	151523350	151523791	441	220.0	
31381	chr5	151556459	151557324	865	432.0	
31382	chr5	151577463	151578758	1295	648.0	
31383	chr5	151597752	151598138	386	193.0	
31384	chr5	151612452	151613560	1108	554.0	
31385	chr5	151643383	151643849	466	233.0	
31386	chr5	151647151	151647798	647	324.0	
31387	chr5	151651934	151652657	723	362.0	
31388	chr5	151658793	151659523	730	365.0	
31389	chr5	151663490	151664110	620	310.0	
31390	chr5	151665319	151665533	214	107.0	
31391	chr5	151672537	151672885	348	174.0	
31392	chr5	151674582	151676157	1575	788.0	
31393	chr5	151677703	151678496	793	396.0	
31394	chr5	151684248	151684560	312	156.0	
31395	chr5	151686665	151687215	550	275.0	
31396	chr5	151719272	151719622	350	175.0	
31397	chr5	151720264	151720625	361	180.0	
31398	chr5	151721293	151721714	421	210.0	
31399	chr5	151740396	151741238	842	421.0	
31400	chr5	151744745	151746472	1727	864.0	
31401	chr5	151749440	151750080	640	320.0	
31402	chr5	151750984	151751523	539	270.0	
31403	chr5	151756312	151759468	3156	1578.0	
31404	chr5	151770295	151774350	4055	2028.0	
31405	chr5	151825340	151825792	452	226.0	
31406	chr5	151868385	151868968	583	292.0	
31407	chr5	151924527	151925004	477	238.0	
31408	chr5	152026413	152027204	791	396.0	
31409	chr5	152038885	152039287	402	201.0	
31410	chr5	152113340	152113881	541	270.0	
31411	chr5	152142821	152143268	447	224.0	
31412	chr5	152237547	152237953	406	203.0	
31413	chr5	152505401	152505855	454	227.0	
31414	chr5	152527448	152527836	388	194.0	
31415	chr5	153352733	153352936	203	102.0	
31416	chr5	153896791	153896998	207	104.0	
31417	chr5	153960447	153960939	492	246.0	
31418	chr5	153965009	153965420	411	206.0	
31419	chr5	153974338	153974843	505	252.0	
31420	chr5	154038052	154039647	1595	798.0	
31421	chr5	154042796	154043114	318	159.0	
31422	chr5	154044692	154044900	208	104.0	
31423	chr5	154058692	154059151	459	230.0	
31424	chr5	154071840	154072943	1103	552.0	
31425	chr5	154075201	154075856	655	328.0	
31426	chr5	154180047	154180734	687	344.0	
31427	chr5	154189265	154192680	3415	1708.0	
31428	chr5	154196953	154198843	1890	945.0	
31429	chr5	154202543	154203535	992	496.0	
31430	chr5	154206344	154206689	345	172.0	
31431	chr5	154214472	154214781	309	154.0	
31432	chr5	154221342	154222073	731	366.0	
31433	chr5	154228665	154229054	389	194.0	
31434	chr5	154238957	154239410	453	226.0	
31435	chr5	154265459	154265502	43	22.0	
31436	chr5	154272948	154273581	633	316.0	
31437	chr5	154284354	154284765	411	206.0	
31438	chr5	154298033	154298530	497	248.0	
31439	chr5	154311334	154311921	587	294.0	
31440	chr5	154384371	154385969	1598	799.0	
31441	chr5	154395692	154395968	276	138.0	
31442	chr5	154404955	154405808	853	426.0	
31443	chr5	154444517	154447932	3415	1708.0	
31444	chr5	154467590	154468246	656	328.0	
31445	chr5	154473584	154474854	1270	635.0	
31446	chr5	154477569	154478037	468	234.0	
31447	chr5	154503412	154503759	347	174.0	
31448	chr5	154544639	154544963	324	162.0	
31449	chr5	154610319	154610789	470	235.0	
31450	chr5	154646782	154647957	1175	588.0	
31451	chr5	154650091	154650618	527	264.0	
31452	chr5	154682064	154683894	1830	915.0	
31453	chr5	154692174	154692560	386	193.0	
31454	chr5	154708711	154709437	726	363.0	
31455	chr5	154713833	154715096	1263	632.0	
31456	chr5	154734418	154735243	825	412.0	
31457	chr5	154754213	154758722	4509	2254.0	
31458	chr5	154760828	154761802	974	487.0	
31459	chr5	154766649	154768013	1364	682.0	
31460	chr5	154769917	154770652	735	368.0	
31461	chr5	154784220	154784600	380	190.0	
31462	chr5	154811633	154812750	1117	558.0	
31463	chr5	154813629	154814218	589	294.0	
31464	chr5	154822461	154822715	254	127.0	
31465	chr5	154829923	154830300	377	188.0	
31466	chr5	154850396	154850989	593	296.0	
31467	chr5	154856984	154861280	4296	2148.0	
31468	chr5	154862768	154863054	286	143.0	
31469	chr5	154868655	154869066	411	206.0	
31470	chr5	154885473	154885806	333	166.0	
31471	chr5	154937469	154938712	1243	622.0	
31472	chr5	154940434	154941729	1295	648.0	
31473	chr5	154945474	154946085	611	306.0	
31474	chr5	155024078	155024216	138	69.0	
31475	chr5	155434700	155434918	218	109.0	
31476	chr5	155700375	155700636	261	130.0	
31477	chr5	155727981	155729986	2005	1002.0	
31478	chr5	155746398	155746818	420	210.0	
31479	chr5	155765759	155766123	364	182.0	
31480	chr5	155767072	155768796	1724	862.0	
31481	chr5	155773611	155774149	538	269.0	
31482	chr5	155834263	155835086	823	412.0	
31483	chr5	155884178	155884231	53	26.0	
31484	chr5	155885194	155885569	375	188.0	
31485	chr5	155943816	155944198	382	191.0	
31486	chr5	156402259	156403101	842	421.0	
31487	chr5	156913710	156914501	791	396.0	
31488	chr5	156920325	156920842	517	258.0	
31489	chr5	156922320	156922843	523	262.0	
31490	chr5	156934787	156935258	471	236.0	
31491	chr5	156951548	156951587	39	20.0	
31492	chr5	156981536	156981914	378	189.0	
31493	chr5	157024825	157025963	1138	569.0	
31494	chr5	157027068	157028081	1013	506.0	
31495	chr5	157030696	157031151	455	228.0	
31496	chr5	157074988	157075287	299	150.0	
31497	chr5	157100014	157100848	834	417.0	
31498	chr5	157106356	157107877	1521	760.0	
31499	chr5	157108761	157110265	1504	752.0	
31500	chr5	157112937	157113600	663	332.0	
31501	chr5	157131766	157132429	663	332.0	
31502	chr5	157142056	157144095	2039	1020.0	
31503	chr5	157148441	157149461	1020	510.0	
31504	chr5	157154762	157155381	619	310.0	
31505	chr5	157159045	157160434	1389	694.0	
31506	chr5	157167132	157167616	484	242.0	
31507	chr5	157172109	157173071	962	481.0	
31508	chr5	157178035	157178371	336	168.0	
31509	chr5	157179059	157179420	361	180.0	
31510	chr5	157180158	157181398	1240	620.0	
31511	chr5	157183888	157184442	554	277.0	
31512	chr5	157185194	157185482	288	144.0	
31513	chr5	157186493	157187755	1262	631.0	
31514	chr5	157188506	157188649	143	72.0	
31515	chr5	157189220	157189751	531	266.0	
31516	chr5	157190424	157190808	384	192.0	
31517	chr5	157193431	157194494	1063	532.0	
31518	chr5	157195971	157196497	526	263.0	
31519	chr5	157197031	157197542	511	256.0	
31520	chr5	157198142	157199089	947	474.0	
31521	chr5	157201944	157202218	274	137.0	
31522	chr5	157203023	157205255	2232	1116.0	
31523	chr5	157210574	157211052	478	239.0	
31524	chr5	157213482	157218133	4651	2326.0	
31525	chr5	157219586	157220407	821	410.0	
31526	chr5	157221888	157223405	1517	758.0	
31527	chr5	157225745	157226262	517	258.0	
31528	chr5	157226774	157227437	663	332.0	
31529	chr5	157233346	157234111	765	382.0	
31530	chr5	157247215	157247727	512	256.0	
31531	chr5	157248536	157249708	1172	586.0	
31532	chr5	157252444	157254091	1647	824.0	
31533	chr5	157255699	157258076	2377	1188.0	
31534	chr5	157263457	157263959	502	251.0	
31535	chr5	157265129	157270374	5245	2622.0	
31536	chr5	157271144	157274595	3451	1726.0	
31537	chr5	157281107	157281169	62	31.0	
31538	chr5	157283206	157283921	715	358.0	
31539	chr5	157291386	157291829	443	222.0	
31540	chr5	157303439	157304456	1017	508.0	
31541	chr5	157306411	157307568	1157	578.0	
31542	chr5	157309071	157309526	455	228.0	
31543	chr5	157312353	157312887	534	267.0	
31544	chr5	157323119	157323482	363	182.0	
31545	chr5	157327686	157329029	1343	672.0	
31546	chr5	157342759	157343295	536	268.0	
31547	chr5	157344191	157344885	694	347.0	
31548	chr5	157361863	157362272	409	204.0	
31549	chr5	157389840	157391097	1257	628.0	
31550	chr5	157393168	157393781	613	306.0	
31551	chr5	157431581	157432283	702	351.0	
31552	chr5	157457704	157458229	525	262.0	
31553	chr5	157459673	157460576	903	452.0	
31554	chr5	157464137	157464924	787	394.0	
31555	chr5	157473281	157473747	466	233.0	
31556	chr5	157476903	157477370	467	234.0	
31557	chr5	157481209	157481673	464	232.0	
31558	chr5	157484723	157485291	568	284.0	
31559	chr5	157485793	157488007	2214	1107.0	
31560	chr5	157494238	157495092	854	427.0	
31561	chr5	157499872	157500089	217	108.0	
31562	chr5	157501821	157502818	997	498.0	
31563	chr5	157511635	157511978	343	172.0	
31564	chr5	157540078	157542105	2027	1014.0	
31565	chr5	157544231	157545263	1032	516.0	
31566	chr5	157547936	157548692	756	378.0	
31567	chr5	157551949	157552438	489	244.0	
31568	chr5	157554563	157555871	1308	654.0	
31569	chr5	157566836	157567710	874	437.0	
31570	chr5	157569888	157572252	2364	1182.0	
31571	chr5	157574590	157576983	2393	1196.0	
31572	chr5	157581831	157582271	440	220.0	
31573	chr5	157582777	157583084	307	154.0	
31574	chr5	157592418	157593083	665	332.0	
31575	chr5	157595032	157595522	490	245.0	
31576	chr5	157596341	157596949	608	304.0	
31577	chr5	157598537	157598808	271	136.0	
31578	chr5	157599506	157600011	505	252.0	
31579	chr5	157602364	157604083	1719	860.0	
31580	chr5	157607338	157608340	1002	501.0	
31581	chr5	157611525	157612037	512	256.0	
31582	chr5	157613333	157614022	689	344.0	
31583	chr5	157651313	157652427	1114	557.0	
31584	chr5	157665637	157666136	499	250.0	
31585	chr5	157668882	157669367	485	242.0	
31586	chr5	157670344	157671757	1413	706.0	
31587	chr5	157690352	157690816	464	232.0	
31588	chr5	157718431	157718992	561	280.0	
31589	chr5	157729798	157730340	542	271.0	
31590	chr5	157730892	157732336	1444	722.0	
31591	chr5	157740265	157740666	401	200.0	
31592	chr5	157743019	157745054	2035	1018.0	
31593	chr5	157761880	157762406	526	263.0	
31594	chr5	157816714	157816862	148	74.0	
31595	chr5	157820674	157821030	356	178.0	
31596	chr5	157828136	157828433	297	148.0	
31597	chr5	157829011	157829387	376	188.0	
31598	chr5	157855346	157855883	537	268.0	
31599	chr5	157857483	157859729	2246	1123.0	
31600	chr5	157871480	157871829	349	174.0	
31601	chr5	157890771	157891555	784	392.0	
31602	chr5	157917914	157918332	418	209.0	
31603	chr5	157918976	157920585	1609	804.0	
31604	chr5	157948711	157949259	548	274.0	
31605	chr5	157994229	157995334	1105	552.0	
31606	chr5	157997842	157998373	531	266.0	
31607	chr5	158075237	158075659	422	211.0	
31608	chr5	158174897	158175354	457	228.0	
31609	chr5	158224071	158224802	731	366.0	
31610	chr5	158233746	158234721	975	488.0	
31611	chr5	158373536	158374087	551	276.0	
31612	chr5	158375763	158375793	30	15.0	
31613	chr5	158379767	158380254	487	244.0	
31614	chr5	158382342	158382923	581	290.0	
31615	chr5	158383461	158383842	381	190.0	
31616	chr5	158384444	158385651	1207	604.0	
31617	chr5	158390556	158390923	367	184.0	
31618	chr5	158406948	158407068	120	60.0	
31619	chr5	158413017	158413716	699	350.0	
31620	chr5	158435042	158435682	640	320.0	
31621	chr5	158464031	158465228	1197	598.0	
31622	chr5	158466142	158466615	473	236.0	
31623	chr5	158502682	158503118	436	218.0	
31624	chr5	158511447	158511812	365	182.0	
31625	chr5	158598024	158598342	318	159.0	
31626	chr5	158695462	158696110	648	324.0	
31627	chr5	158775233	158775673	440	220.0	
31628	chr5	158807887	158808374	487	244.0	
31629	chr5	158812219	158812820	601	300.0	
31630	chr5	158820376	158821321	945	472.0	
31631	chr5	158848686	158848953	267	134.0	
31632	chr5	158875169	158875652	483	242.0	
31633	chr5	158898207	158898872	665	332.0	
31634	chr5	158953846	158954484	638	319.0	
31635	chr5	158958174	158958729	555	278.0	
31636	chr5	159003342	159003636	294	147.0	
31637	chr5	159010835	159012158	1323	662.0	
31638	chr5	159017812	159018259	447	224.0	
31639	chr5	159021826	159022134	308	154.0	
31640	chr5	159040073	159040555	482	241.0	
31641	chr5	159051350	159051755	405	202.0	
31642	chr5	159084080	159084441	361	180.0	
31643	chr5	159094981	159095103	122	61.0	
31644	chr5	159097356	159101257	3901	1950.0	
31645	chr5	159104902	159107356	2454	1227.0	
31646	chr5	159120193	159121066	873	436.0	
31647	chr5	159133132	159133617	485	242.0	
31648	chr5	159156011	159157214	1203	602.0	
31649	chr5	159175646	159175785	139	70.0	
31650	chr5	159178906	159179435	529	264.0	
31651	chr5	159187763	159188113	350	175.0	
31652	chr5	159198272	159199262	990	495.0	
31653	chr5	159206353	159206660	307	154.0	
31654	chr5	159207231	159210885	3654	1827.0	
31655	chr5	159262330	159264804	2474	1237.0	
31656	chr5	159286452	159286822	370	185.0	
31657	chr5	159310518	159310950	432	216.0	
31658	chr5	159316765	159317188	423	212.0	
31659	chr5	159330961	159332206	1245	622.0	
31660	chr5	159332756	159333198	442	221.0	
31661	chr5	159337240	159338492	1252	626.0	
31662	chr5	159340435	159344509	4074	2037.0	
31663	chr5	159345293	159345829	536	268.0	
31664	chr5	159359332	159359859	527	264.0	
31665	chr5	159362031	159362803	772	386.0	
31666	chr5	159405860	159406035	175	88.0	
31667	chr5	159409841	159410190	349	174.0	
31668	chr5	159412041	159413107	1066	533.0	
31669	chr5	159427193	159428106	913	456.0	
31670	chr5	159444471	159444872	401	200.0	
31671	chr5	159452760	159453188	428	214.0	
31672	chr5	159456720	159457121	401	200.0	
31673	chr5	159458249	159458800	551	276.0	
31674	chr5	159459859	159460690	831	416.0	
31675	chr5	159469483	159469947	464	232.0	
31676	chr5	159478931	159479462	531	266.0	
31677	chr5	159515775	159516403	628	314.0	
31678	chr5	159773029	159773986	957	478.0	
31679	chr5	159802675	159803028	353	176.0	
31680	chr5	159805007	159805537	530	265.0	
31681	chr5	159916118	159916666	548	274.0	
31682	chr5	159933522	159933968	446	223.0	
31683	chr5	159986903	159987824	921	460.0	
31684	chr5	160008715	160010150	1435	718.0	
31685	chr5	160021581	160022282	701	350.0	
31686	chr5	160033879	160033920	41	20.0	
31687	chr5	160080764	160081403	639	320.0	
31688	chr5	160098012	160098587	575	288.0	
31689	chr5	160101385	160101724	339	170.0	
31690	chr5	160105548	160106173	625	312.0	
31691	chr5	160118187	160120515	2328	1164.0	
31692	chr5	160185641	160186357	716	358.0	
31693	chr5	160188294	160188671	377	188.0	
31694	chr5	160199124	160200000	876	438.0	
31695	chr5	160230914	160231579	665	332.0	
31696	chr5	160260968	160261368	400	200.0	
31697	chr5	160268256	160269714	1458	729.0	
31698	chr5	160271379	160271836	457	228.0	
31699	chr5	160274585	160274857	272	136.0	
31700	chr5	160293805	160294520	715	358.0	
31701	chr5	160297791	160298622	831	416.0	
31702	chr5	160311835	160313015	1180	590.0	
31703	chr5	160318195	160318869	674	337.0	
31704	chr5	160333540	160334426	886	443.0	
31705	chr5	160345107	160345789	682	341.0	
31706	chr5	160369952	160370644	692	346.0	
31707	chr5	160399361	160400464	1103	552.0	
31708	chr5	160417689	160420071	2382	1191.0	
31709	chr5	160421333	160423330	1997	998.0	
31710	chr5	160425404	160425658	254	127.0	
31711	chr5	160433960	160434395	435	218.0	
31712	chr5	160436647	160437113	466	233.0	
31713	chr5	160438127	160439770	1643	822.0	
31714	chr5	160467172	160469945	2773	1386.0	
31715	chr5	160470639	160472148	1509	754.0	
31716	chr5	160486291	160487039	748	374.0	
31717	chr5	160489143	160489342	199	100.0	
31718	chr5	160499858	160501403	1545	772.0	
31719	chr5	160504838	160505161	323	162.0	
31720	chr5	160505809	160507850	2041	1020.0	
31721	chr5	160508354	160509407	1053	526.0	
31722	chr5	160640444	160640781	337	168.0	
31723	chr5	160643571	160644246	675	338.0	
31724	chr5	160676018	160676633	615	308.0	
31725	chr5	160685710	160686026	316	158.0	
31726	chr5	160694809	160695353	544	272.0	
31727	chr5	160702698	160703525	827	414.0	
31728	chr5	160799051	160799666	615	308.0	
31729	chr5	160824547	160824987	440	220.0	
31730	chr5	160843220	160843621	401	200.0	
31731	chr5	161544304	161544642	338	169.0	
31732	chr5	163309779	163310402	623	312.0	
31733	chr5	163347579	163347946	367	184.0	
31734	chr5	163349998	163350411	413	206.0	
31735	chr5	163354452	163355168	716	358.0	
31736	chr5	163360608	163361177	569	284.0	
31737	chr5	163396626	163397410	784	392.0	
31738	chr5	163407326	163407434	108	54.0	
31739	chr5	163408195	163409057	862	431.0	
31740	chr5	163436805	163438672	1867	934.0	
31741	chr5	163459094	163462753	3659	1830.0	
31742	chr5	163473640	163474050	410	205.0	
31743	chr5	163489005	163489398	393	196.0	
31744	chr5	163502924	163507203	4279	2140.0	
31745	chr5	163508283	163509746	1463	732.0	
31746	chr5	163564305	163564745	440	220.0	
31747	chr5	163565895	163566710	815	408.0	
31748	chr5	163696254	163696718	464	232.0	
31749	chr5	163727003	163727429	426	213.0	
31750	chr5	163757212	163757888	676	338.0	
31751	chr5	163894760	163894892	132	66.0	
31752	chr5	163907803	163908625	822	411.0	
31753	chr5	163913576	163913879	303	152.0	
31754	chr5	163914799	163917304	2505	1252.0	
31755	chr5	163921175	163921436	261	130.0	
31756	chr5	163938614	163938974	360	180.0	
31757	chr5	163943348	163944127	779	390.0	
31758	chr5	163948049	163948190	141	70.0	
31759	chr5	163963965	163964363	398	199.0	
31760	chr5	164013106	164013469	363	182.0	
31761	chr5	164504213	164504338	125	62.0	
31762	chr5	164627059	164627438	379	190.0	
31763	chr5	164651898	164652423	525	262.0	
31764	chr5	164868737	164869109	372	186.0	
31765	chr5	165014395	165015751	1356	678.0	
31766	chr5	165029458	165029884	426	213.0	
31767	chr5	165127951	165128352	401	200.0	
31768	chr5	165139620	165140077	457	228.0	
31769	chr5	165185895	165186040	145	72.0	
31770	chr5	165188531	165189343	812	406.0	
31771	chr5	165393781	165394333	552	276.0	
31772	chr5	165405573	165405784	211	106.0	
31773	chr5	165630253	165630545	292	146.0	
31774	chr5	167723245	167723707	462	231.0	
31775	chr5	167783441	167783740	299	150.0	
31776	chr5	167784996	167786341	1345	672.0	
31777	chr5	167816416	167816716	300	150.0	
31778	chr5	167920592	167920905	313	156.0	
31779	chr5	168114410	168114795	385	192.0	
31780	chr5	168143616	168143643	27	14.0	
31781	chr5	168159306	168159889	583	292.0	
31782	chr5	168219616	168220220	604	302.0	
31783	chr5	168227966	168228425	459	230.0	
31784	chr5	168269174	168269795	621	310.0	
31785	chr5	168291321	168292053	732	366.0	
31786	chr5	168377728	168377807	79	40.0	
31787	chr5	168485901	168487622	1721	860.0	
31788	chr5	168528909	168529533	624	312.0	
31789	chr5	168578119	168580495	2376	1188.0	
31790	chr5	168583747	168584099	352	176.0	
31791	chr5	168612909	168613584	675	338.0	
31792	chr5	168679453	168679829	376	188.0	
31793	chr5	168683655	168683994	339	170.0	
31794	chr5	168794400	168794617	217	108.0	
31795	chr5	168851944	168852270	326	163.0	
31796	chr5	168920549	168920735	186	93.0	
31797	chr5	168947497	168947564	67	34.0	
31798	chr5	168987559	168987924	365	182.0	
31799	chr5	169581380	169582230	850	425.0	
31800	chr5	169583040	169584648	1608	804.0	
31801	chr5	169635932	169638647	2715	1358.0	
31802	chr5	169647479	169650052	2573	1286.0	
31803	chr5	169650659	169651694	1035	518.0	
31804	chr5	169655371	169656579	1208	604.0	
31805	chr5	169657173	169657467	294	147.0	
31806	chr5	169716249	169717832	1583	792.0	
31807	chr5	169742098	169742443	345	172.0	
31808	chr5	169753722	169754231	509	254.0	
31809	chr5	169779252	169779373	121	60.0	
31810	chr5	169788078	169788583	505	252.0	
31811	chr5	169801285	169801624	339	170.0	
31812	chr5	169802955	169803418	463	232.0	
31813	chr5	169805668	169805738	70	35.0	
31814	chr5	169809463	169809696	233	116.0	
31815	chr5	169873621	169873983	362	181.0	
31816	chr5	169874604	169875854	1250	625.0	
31817	chr5	169880009	169880770	761	380.0	
31818	chr5	169881979	169882039	60	30.0	
31819	chr5	169953097	169953677	580	290.0	
31820	chr5	169980372	169980952	580	290.0	
31821	chr5	170095616	170096163	547	274.0	
31822	chr5	170097893	170098353	460	230.0	
31823	chr5	170100310	170100785	475	238.0	
31824	chr5	170113364	170114054	690	345.0	
31825	chr5	170145487	170145892	405	202.0	
31826	chr5	170184057	170184451	394	197.0	
31827	chr5	170225789	170226295	506	253.0	
31828	chr5	170249343	170249868	525	262.0	
31829	chr5	170253879	170254893	1014	507.0	
31830	chr5	170261822	170263038	1216	608.0	
31831	chr5	170266360	170271179	4819	2410.0	
31832	chr5	170272204	170272710	506	253.0	
31833	chr5	170273746	170281714	7968	3984.0	
31834	chr5	170282642	170284072	1430	715.0	
31835	chr5	170287254	170293872	6618	3309.0	
31836	chr5	170294643	170298684	4041	2020.0	
31837	chr5	170300420	170301442	1022	511.0	
31838	chr5	170302013	170304023	2010	1005.0	
31839	chr5	170307287	170309121	1834	917.0	
31840	chr5	170310227	170310750	523	262.0	
31841	chr5	170311768	170315420	3652	1826.0	
31842	chr5	170327248	170328358	1110	555.0	
31843	chr5	170330069	170335445	5376	2688.0	
31844	chr5	170336212	170337807	1595	798.0	
31845	chr5	170338455	170339579	1124	562.0	
31846	chr5	170342286	170342803	517	258.0	
31847	chr5	170348306	170348444	138	69.0	
31848	chr5	170353412	170353450	38	19.0	
31849	chr5	170357700	170358672	972	486.0	
31850	chr5	170360666	170361554	888	444.0	
31851	chr5	170362264	170362496	232	116.0	
31852	chr5	170363262	170364325	1063	532.0	
31853	chr5	170365029	170365461	432	216.0	
31854	chr5	170368577	170368919	342	171.0	
31855	chr5	170388785	170389929	1144	572.0	
31856	chr5	170393175	170394459	1284	642.0	
31857	chr5	170404261	170404953	692	346.0	
31858	chr5	170405791	170406232	441	220.0	
31859	chr5	170420756	170421270	514	257.0	
31860	chr5	170434922	170435443	521	260.0	
31861	chr5	170451950	170452708	758	379.0	
31862	chr5	170466863	170467648	785	392.0	
31863	chr5	170471526	170471920	394	197.0	
31864	chr5	170475353	170475654	301	150.0	
31865	chr5	170484704	170485628	924	462.0	
31866	chr5	170491327	170491906	579	290.0	
31867	chr5	170504117	170504293	176	88.0	
31868	chr5	170538958	170539392	434	217.0	
31869	chr5	170604001	170604273	272	136.0	
31870	chr5	170630855	170631266	411	206.0	
31871	chr5	170632782	170633856	1074	537.0	
31872	chr5	170638666	170639129	463	232.0	
31873	chr5	170861644	170862314	670	335.0	
31874	chr5	171207398	171207554	156	78.0	
31875	chr5	171311437	171311447	10	5.0	
31876	chr5	171342447	171342712	265	132.0	
31877	chr5	171355369	171355820	451	226.0	
31878	chr5	171386829	171392536	5707	2854.0	
31879	chr5	171393817	171396050	2233	1116.0	
31880	chr5	171396712	171401665	4953	2476.0	
31881	chr5	171405503	171406752	1249	624.0	
31882	chr5	171409161	171410121	960	480.0	
31883	chr5	171411085	171417609	6524	3262.0	
31884	chr5	171418248	171422747	4499	2250.0	
31885	chr5	171450737	171451299	562	281.0	
31886	chr5	171484464	171484770	306	153.0	
31887	chr5	171600928	171601534	606	303.0	
31888	chr5	171629948	171630457	509	254.0	
31889	chr5	171633972	171634723	751	376.0	
31890	chr5	171676141	171676854	713	356.0	
31891	chr5	171681628	171682219	591	296.0	
31892	chr5	171721584	171721633	49	24.0	
31893	chr5	171743100	171743418	318	159.0	
31894	chr5	171797569	171797831	262	131.0	
31895	chr5	171840665	171841335	670	335.0	
31896	chr5	171852268	171852825	557	278.0	
31897	chr5	171856056	171856222	166	83.0	
31898	chr5	171871735	171872083	348	174.0	
31899	chr5	171874110	171874939	829	414.0	
31900	chr5	171904958	171905162	204	102.0	
31901	chr5	171907653	171908161	508	254.0	
31902	chr5	171912091	171912554	463	232.0	
31903	chr5	171926369	171926707	338	169.0	
31904	chr5	171940565	171940704	139	70.0	
31905	chr5	171957451	171958275	824	412.0	
31906	chr5	171961010	171961470	460	230.0	
31907	chr5	171965787	171966231	444	222.0	
31908	chr5	171968511	171968938	427	214.0	
31909	chr5	171978586	171978909	323	162.0	
31910	chr5	171984989	171985646	657	328.0	
31911	chr5	171999816	172000299	483	242.0	
31912	chr5	172002267	172003192	925	462.0	
31913	chr5	172004679	172008016	3337	1668.0	
31914	chr5	172039937	172043154	3217	1608.0	
31915	chr5	172043881	172044207	326	163.0	
31916	chr5	172045046	172045398	352	176.0	
31917	chr5	172047558	172047599	41	20.0	
31918	chr5	172048610	172048614	4	2.0	
31919	chr5	172054904	172055095	191	96.0	
31920	chr5	172055705	172055725	20	10.0	
31921	chr5	172057257	172057876	619	310.0	
31922	chr5	172059493	172060088	595	298.0	
31923	chr5	172066106	172067430	1324	662.0	
31924	chr5	172068082	172068851	769	384.0	
31925	chr5	172071426	172072055	629	314.0	
31926	chr5	172077837	172079374	1537	768.0	
31927	chr5	172081424	172082301	877	438.0	
31928	chr5	172085644	172087215	1571	786.0	
31929	chr5	172088830	172089243	413	206.0	
31930	chr5	172089985	172090361	376	188.0	
31931	chr5	172090929	172091512	583	292.0	
31932	chr5	172098929	172099162	233	116.0	
31933	chr5	172103031	172103182	151	76.0	
31934	chr5	172104048	172104459	411	206.0	
31935	chr5	172106442	172107902	1460	730.0	
31936	chr5	172110623	172116846	6223	3112.0	
31937	chr5	172117530	172117563	33	16.0	
31938	chr5	172118105	172118859	754	377.0	
31939	chr5	172129110	172129901	791	396.0	
31940	chr5	172131085	172131819	734	367.0	
31941	chr5	172132939	172134233	1294	647.0	
31942	chr5	172144301	172144754	453	226.0	
31943	chr5	172147789	172148298	509	254.0	
31944	chr5	172150164	172151482	1318	659.0	
31945	chr5	172152982	172153908	926	463.0	
31946	chr5	172160008	172160310	302	151.0	
31947	chr5	172164053	172164516	463	232.0	
31948	chr5	172168589	172168661	72	36.0	
31949	chr5	172172766	172181450	8684	4342.0	
31950	chr5	172182269	172183542	1273	636.0	
31951	chr5	172184264	172189278	5014	2507.0	
31952	chr5	172199490	172200458	968	484.0	
31953	chr5	172235267	172235483	216	108.0	
31954	chr5	172274804	172275721	917	458.0	
31955	chr5	172282827	172284941	2114	1057.0	
31956	chr5	172293072	172293935	863	432.0	
31957	chr5	172353509	172354231	722	361.0	
31958	chr5	172361264	172362286	1022	511.0	
31959	chr5	172364809	172365307	498	249.0	
31960	chr5	172370634	172370993	359	180.0	
31961	chr5	172378013	172378219	206	103.0	
31962	chr5	172409889	172410753	864	432.0	
31963	chr5	172411705	172413410	1705	852.0	
31964	chr5	172418210	172418598	388	194.0	
31965	chr5	172420139	172420672	533	266.0	
31966	chr5	172429015	172429834	819	410.0	
31967	chr5	172437591	172437827	236	118.0	
31968	chr5	172443474	172443822	348	174.0	
31969	chr5	172451158	172451597	439	220.0	
31970	chr5	172453936	172455100	1164	582.0	
31971	chr5	172460927	172461362	435	218.0	
31972	chr5	172462075	172462599	524	262.0	
31973	chr5	172478886	172479439	553	276.0	
31974	chr5	172640869	172641565	696	348.0	
31975	chr5	172659627	172660319	692	346.0	
31976	chr5	172680860	172681295	435	218.0	
31977	chr5	172683631	172684833	1202	601.0	
31978	chr5	172688636	172689077	441	220.0	
31979	chr5	172696919	172698267	1348	674.0	
31980	chr5	172701178	172702163	985	492.0	
31981	chr5	172710993	172710997	4	2.0	
31982	chr5	172712631	172715506	2875	1438.0	
31983	chr5	172716489	172717428	939	470.0	
31984	chr5	172721831	172722769	938	469.0	
31985	chr5	172733406	172733432	26	13.0	
31986	chr5	172740215	172741293	1078	539.0	
31987	chr5	172742047	172742166	119	60.0	
31988	chr5	172744130	172745003	873	436.0	
31989	chr5	172751345	172751990	645	322.0	
31990	chr5	172757567	172760010	2443	1222.0	
31991	chr5	172760856	172776380	15524	7762.0	enhancer
31992	chr5	172777005	172778665	1660	830.0	
31993	chr5	172782193	172782659	466	233.0	
31994	chr5	172788785	172789736	951	476.0	
31995	chr5	172793972	172794651	679	340.0	
31996	chr5	172797663	172799233	1570	785.0	
31997	chr5	172799840	172800923	1083	542.0	
31998	chr5	172805607	172808135	2528	1264.0	
31999	chr5	172815636	172815974	338	169.0	
32000	chr5	172830696	172831666	970	485.0	
32001	chr5	172832493	172836021	3528	1764.0	
32002	chr5	172837398	172838251	853	426.0	
32003	chr5	172845233	172845281	48	24.0	
32004	chr5	172849638	172850665	1027	514.0	
32005	chr5	172852878	172853391	513	256.0	
32006	chr5	172854147	172854826	679	340.0	
32007	chr5	172870167	172870984	817	408.0	
32008	chr5	172877583	172878444	861	430.0	
32009	chr5	172881650	172882569	919	460.0	
32010	chr5	172885543	172886055	512	256.0	
32011	chr5	172886678	172888264	1586	793.0	
32012	chr5	172897134	172898015	881	440.0	
32013	chr5	172903100	172903165	65	32.0	
32014	chr5	172909999	172911584	1585	792.0	
32015	chr5	172918334	172919575	1241	620.0	
32016	chr5	172932152	172933005	853	426.0	
32017	chr5	172956971	172957401	430	215.0	
32018	chr5	172958150	172960206	2056	1028.0	
32019	chr5	172968918	172969620	702	351.0	
32020	chr5	172978672	172979217	545	272.0	
32021	chr5	172983083	172985051	1968	984.0	
32022	chr5	172985934	172985960	26	13.0	
32023	chr5	173001413	173001808	395	198.0	
32024	chr5	173007864	173008252	388	194.0	
32025	chr5	173010514	173011975	1461	730.0	
32026	chr5	173014658	173015052	394	197.0	
32027	chr5	173016540	173016864	324	162.0	
32028	chr5	173018360	173018859	499	250.0	
32029	chr5	173029329	173030026	697	348.0	
32030	chr5	173035107	173036582	1475	738.0	
32031	chr5	173055330	173058075	2745	1372.0	
32032	chr5	173065080	173065618	538	269.0	
32033	chr5	173069744	173070146	402	201.0	
32034	chr5	173144094	173145564	1470	735.0	
32035	chr5	173204231	173204617	386	193.0	
32036	chr5	173271353	173271892	539	270.0	
32037	chr5	173283595	173284238	643	322.0	
32038	chr5	173293695	173294446	751	376.0	
32039	chr5	173331875	173332420	545	272.0	
32040	chr5	173451992	173452603	611	306.0	
32041	chr5	173573007	173573490	483	242.0	
32042	chr5	173581713	173581986	273	136.0	
32043	chr5	173615594	173617283	1689	844.0	
32044	chr5	173618813	173619563	750	375.0	
32045	chr5	173625946	173625961	15	8.0	
32046	chr5	173664094	173664582	488	244.0	
32047	chr5	173680683	173681031	348	174.0	
32048	chr5	173689956	173690199	243	122.0	
32049	chr5	173698859	173699176	317	158.0	
32050	chr5	173707392	173707665	273	136.0	
32051	chr5	173714371	173715309	938	469.0	
32052	chr5	173717895	173718429	534	267.0	
32053	chr5	173733778	173734406	628	314.0	
32054	chr5	173736934	173737513	579	290.0	
32055	chr5	173741660	173742863	1203	602.0	
32056	chr5	173745043	173745607	564	282.0	
32057	chr5	173764410	173764811	401	200.0	
32058	chr5	173772214	173772731	517	258.0	
32059	chr5	173775726	173776182	456	228.0	
32060	chr5	173777937	173779154	1217	608.0	
32061	chr5	173781680	173782703	1023	512.0	
32062	chr5	173786506	173787139	633	316.0	
32063	chr5	173789156	173789221	65	32.0	
32064	chr5	173802583	173803148	565	282.0	
32065	chr5	173808261	173808910	649	324.0	
32066	chr5	173821004	173821653	649	324.0	
32067	chr5	173829812	173830122	310	155.0	
32068	chr5	173832994	173833541	547	274.0	
32069	chr5	173835083	173835849	766	383.0	
32070	chr5	173864356	173864800	444	222.0	
32071	chr5	173866074	173866986	912	456.0	
32072	chr5	173868429	173868938	509	254.0	
32073	chr5	173873003	173873732	729	364.0	
32074	chr5	173884418	173886330	1912	956.0	
32075	chr5	173887272	173889203	1931	966.0	
32076	chr5	173890225	173890851	626	313.0	
32077	chr5	173907749	173908431	682	341.0	
32078	chr5	173913743	173914088	345	172.0	
32079	chr5	173916271	173916623	352	176.0	
32080	chr5	173917334	173918993	1659	830.0	
32081	chr5	173920328	173921781	1453	726.0	
32082	chr5	173925489	173925871	382	191.0	
32083	chr5	173929147	173929568	421	210.0	
32084	chr5	173972889	173974013	1124	562.0	
32085	chr5	174311946	174312365	419	210.0	
32086	chr5	174419298	174419966	668	334.0	
32087	chr5	174446377	174446923	546	273.0	
32088	chr5	174453956	174454940	984	492.0	
32089	chr5	174532269	174533018	749	374.0	
32090	chr5	174533644	174534340	696	348.0	
32091	chr5	174608761	174608869	108	54.0	
32092	chr5	174724275	174724758	483	242.0	
32093	chr5	174793717	174794021	304	152.0	
32094	chr5	174910227	174910625	398	199.0	
32095	chr5	174951160	174951572	412	206.0	
32096	chr5	174997648	174998556	908	454.0	
32097	chr5	175059896	175060411	515	258.0	
32098	chr5	175444621	175445039	418	209.0	
32099	chr5	175464609	175465097	488	244.0	
32100	chr5	175478015	175481027	3012	1506.0	
32101	chr5	175507638	175508066	428	214.0	
32102	chr5	175517659	175517861	202	101.0	
32103	chr5	175521253	175522007	754	377.0	
32104	chr5	175533901	175534763	862	431.0	
32105	chr5	175576150	175576260	110	55.0	
32106	chr5	175590307	175590990	683	342.0	
32107	chr5	175638238	175638792	554	277.0	
32108	chr5	175651885	175652111	226	113.0	
32109	chr5	175652744	175653731	987	494.0	
32110	chr5	175655036	175655112	76	38.0	
32111	chr5	175657419	175659209	1790	895.0	
32112	chr5	175668124	175668170	46	23.0	
32113	chr5	175670580	175671492	912	456.0	
32114	chr5	175673368	175674029	661	330.0	
32115	chr5	175675055	175675276	221	110.0	
32116	chr5	175677546	175677964	418	209.0	
32117	chr5	175680493	175680784	291	146.0	
32118	chr5	175688918	175690202	1284	642.0	
32119	chr5	175690904	175691506	602	301.0	
32120	chr5	175693273	175697182	3909	1954.0	
32121	chr5	175718756	175719180	424	212.0	
32122	chr5	175729537	175730380	843	422.0	
32123	chr5	175796577	175797571	994	497.0	
32124	chr5	175852751	175854282	1531	766.0	
32125	chr5	175871444	175873346	1902	951.0	
32126	chr5	175895442	175896295	853	426.0	
32127	chr5	175915095	175915958	863	432.0	
32128	chr5	175967828	175968545	717	358.0	
32129	chr5	176235079	176235581	502	251.0	
32130	chr5	176237864	176238714	850	425.0	
32131	chr5	176360879	176362696	1817	908.0	
32132	chr5	176364870	176366383	1513	756.0	
32133	chr5	176372073	176372631	558	279.0	
32134	chr5	176373350	176373719	369	184.0	
32135	chr5	176387904	176389950	2046	1023.0	
32136	chr5	176392014	176392358	344	172.0	
32137	chr5	176395230	176395298	68	34.0	
32138	chr5	176413315	176414720	1405	702.0	
32139	chr5	176415579	176417261	1682	841.0	
32140	chr5	176436514	176437265	751	376.0	
32141	chr5	176446926	176449246	2320	1160.0	
32142	chr5	176466469	176466967	498	249.0	
32143	chr5	176517216	176517702	486	243.0	
32144	chr5	176525990	176526002	12	6.0	
32145	chr5	176527395	176527655	260	130.0	
32146	chr5	176529123	176531721	2598	1299.0	
32147	chr5	176532861	176538682	5821	2910.0	
32148	chr5	176539686	176544407	4721	2360.0	
32149	chr5	176547179	176548246	1067	534.0	
32150	chr5	176550167	176551120	953	476.0	
32151	chr5	176554193	176555224	1031	516.0	
32152	chr5	176559677	176560083	406	203.0	
32153	chr5	176573752	176574498	746	373.0	
32154	chr5	176578294	176578759	465	232.0	
32155	chr5	176596316	176597637	1321	660.0	
32156	chr5	176609245	176611782	2537	1268.0	
32157	chr5	176618885	176620940	2055	1028.0	
32158	chr5	176629948	176630893	945	472.0	
32159	chr5	176646256	176649676	3420	1710.0	
32160	chr5	176653220	176653901	681	340.0	
32161	chr5	176657753	176659545	1792	896.0	
32162	chr5	176660496	176661430	934	467.0	
32163	chr5	176723378	176723887	509	254.0	
32164	chr5	176726677	176727172	495	248.0	
32165	chr5	176745636	176746056	420	210.0	
32166	chr5	176809969	176811206	1237	618.0	
32167	chr5	176817616	176819096	1480	740.0	
32168	chr5	176837549	176838079	530	265.0	
32169	chr5	176876065	176876132	67	34.0	
32170	chr5	176893726	176893799	73	36.0	
32171	chr5	176895223	176896429	1206	603.0	
32172	chr5	176897283	176897555	272	136.0	
32173	chr5	176898981	176899968	987	494.0	
32174	chr5	176901499	176902478	979	490.0	
32175	chr5	176908976	176909382	406	203.0	
32176	chr5	176959081	176959480	399	200.0	
32177	chr5	176985473	176985922	449	224.0	
32178	chr5	176994411	176995267	856	428.0	
32179	chr5	176995796	176996668	872	436.0	
32180	chr5	177000269	177000436	167	84.0	
32181	chr5	177005074	177007446	2372	1186.0	
32182	chr5	177021880	177023805	1925	962.0	
32183	chr5	177070836	177072271	1435	718.0	
32184	chr5	177085933	177087723	1790	895.0	"region	promoter	protein_binding_site	protein_binding_site	protein_binding_site	region	enhancer	protein_binding_site	protein_binding_site	protein_binding_site	protein_binding_site"
32185	chr5	177111619	177112439	820	410.0	
32186	chr5	177113585	177115232	1647	824.0	
32187	chr5	177116410	177117503	1093	546.0	
32188	chr5	177124400	177124738	338	169.0	
32189	chr5	177128485	177129568	1083	542.0	
32190	chr5	177131215	177131556	341	170.0	
32191	chr5	177132214	177135074	2860	1430.0	
32192	chr5	177295740	177297055	1315	658.0	
32193	chr5	177299264	177305239	5975	2988.0	
32194	chr5	177306511	177308377	1866	933.0	
32195	chr5	177309094	177313335	4241	2120.0	
32196	chr5	177317635	177318511	876	438.0	
32197	chr5	177319930	177320330	400	200.0	
32198	chr5	177320851	177321366	515	258.0	
32199	chr5	177327449	177328391	942	471.0	
32200	chr5	177331498	177331812	314	157.0	
32201	chr5	177336101	177336580	479	240.0	
32202	chr5	177339265	177339618	353	176.0	
32203	chr5	177350947	177352569	1622	811.0	
32204	chr5	177353127	177353479	352	176.0	
32205	chr5	177354904	177355091	187	94.0	
32206	chr5	177355922	177356086	164	82.0	
32207	chr5	177356990	177358852	1862	931.0	
32208	chr5	177361503	177363735	2232	1116.0	
32209	chr5	177368887	177369693	806	403.0	
32210	chr5	177370348	177373399	3051	1526.0	
32211	chr5	177382629	177383016	387	194.0	
32212	chr5	177385696	177386072	376	188.0	
32213	chr5	177388783	177391317	2534	1267.0	enhancer
32214	chr5	177393028	177393659	631	316.0	
32215	chr5	177402181	177406320	4139	2070.0	
32216	chr5	177410610	177411011	401	200.0	
32217	chr5	177412390	177413269	879	440.0	
32218	chr5	177415813	177416924	1111	556.0	
32219	chr5	177419589	177420100	511	256.0	
32220	chr5	177425243	177432691	7448	3724.0	
32221	chr5	177434285	177435255	970	485.0	
32222	chr5	177437622	177437921	299	150.0	
32223	chr5	177438716	177438776	60	30.0	
32224	chr5	177439854	177440848	994	497.0	
32225	chr5	177442104	177449026	6922	3461.0	
32226	chr5	177449868	177450245	377	188.0	
32227	chr5	177450881	177451198	317	158.0	
32228	chr5	177452108	177459027	6919	3460.0	
32229	chr5	177459975	177460022	47	24.0	
32230	chr5	177462026	177463633	1607	804.0	
32231	chr5	177471108	177475339	4231	2116.0	
32232	chr5	177478850	177480273	1423	712.0	
32233	chr5	177487934	177488261	327	164.0	
32234	chr5	177490339	177490684	345	172.0	
32235	chr5	177491435	177491861	426	213.0	
32236	chr5	177493451	177498704	5253	2626.0	
32237	chr5	177500667	177502793	2126	1063.0	
32238	chr5	177507241	177511583	4342	2171.0	
32239	chr5	177516184	177517863	1679	840.0	
32240	chr5	177521452	177521745	293	146.0	
32241	chr5	177545350	177546912	1562	781.0	
32242	chr5	177550356	177550435	79	40.0	
32243	chr5	177553571	177555269	1698	849.0	
32244	chr5	177557063	177557459	396	198.0	
32245	chr5	177561237	177561657	420	210.0	
32246	chr5	177581590	177581990	400	200.0	
32247	chr5	177591710	177592959	1249	624.0	
32248	chr5	177598855	177601139	2284	1142.0	
32249	chr5	177607258	177608050	792	396.0	
32250	chr5	177671887	177672695	808	404.0	
32251	chr5	177812261	177813233	972	486.0	
32252	chr5	177837394	177837719	325	162.0	
32253	chr5	177875342	177875969	627	314.0	
32254	chr5	177939331	177939615	284	142.0	
32255	chr5	177944274	177944711	437	218.0	
32256	chr5	177945935	177946177	242	121.0	
32257	chr5	178006498	178007121	623	312.0	
32258	chr5	178061934	178062474	540	270.0	
32259	chr5	178068418	178068775	357	178.0	
32260	chr5	178069948	178070332	384	192.0	
32261	chr5	178075792	178076751	959	480.0	
32262	chr5	178108683	178109364	681	340.0	
32263	chr5	178112917	178117240	4323	2162.0	
32264	chr5	178118120	178118762	642	321.0	
32265	chr5	178120600	178121729	1129	564.0	
32266	chr5	178130275	178131814	1539	770.0	
32267	chr5	178145780	178146654	874	437.0	
32268	chr5	178153144	178154724	1580	790.0	
32269	chr5	178163882	178164788	906	453.0	
32270	chr5	178182275	178182736	461	230.0	
32271	chr5	178193202	178194550	1348	674.0	
32272	chr5	178201884	178202343	459	230.0	
32273	chr5	178203720	178217110	13390	6695.0	
32274	chr5	178219914	178225445	5531	2766.0	
32275	chr5	178227778	178227781	3	2.0	
32276	chr5	178230936	178233538	2602	1301.0	
32277	chr5	178234541	178235794	1253	626.0	
32278	chr5	178236663	178237812	1149	574.0	
32279	chr5	178238737	178242355	3618	1809.0	
32280	chr5	178247710	178248146	436	218.0	
32281	chr5	178249034	178250196	1162	581.0	
32282	chr5	178279903	178280411	508	254.0	
32283	chr5	178312506	178313356	850	425.0	
32284	chr5	178334889	178335592	703	352.0	
32285	chr5	178340236	178340625	389	194.0	
32286	chr5	178350413	178350805	392	196.0	
32287	chr5	178356844	178357559	715	358.0	
32288	chr5	178393047	178393530	483	242.0	
32289	chr5	178461026	178461573	547	274.0	
32290	chr5	178467252	178468254	1002	501.0	
32291	chr5	178473889	178474208	319	160.0	
32292	chr5	178476832	178478034	1202	601.0	
32293	chr5	178483532	178484175	643	322.0	
32294	chr5	178486257	178486804	547	274.0	
32295	chr5	178491125	178491753	628	314.0	
32296	chr5	178496846	178496917	71	36.0	
32297	chr5	178532683	178533124	441	220.0	
32298	chr5	178585507	178585887	380	190.0	
32299	chr5	178589450	178591058	1608	804.0	
32300	chr5	178625044	178627840	2796	1398.0	
32301	chr5	178631018	178631136	118	59.0	
32302	chr5	178637385	178638042	657	328.0	
32303	chr5	178649578	178650239	661	330.0	
32304	chr5	178729719	178732021	2302	1151.0	
32305	chr5	178777516	178777951	435	218.0	
32306	chr5	178790489	178790575	86	43.0	
32307	chr5	178839374	178839749	375	188.0	
32308	chr5	178859479	178860816	1337	668.0	
32309	chr5	178895634	178896456	822	411.0	
32310	chr5	179023110	179024517	1407	704.0	
32311	chr5	179059825	179061071	1246	623.0	
32312	chr5	179166826	179167537	711	356.0	
32313	chr5	179345488	179345728	240	120.0	
32314	chr5	179494078	179494441	363	182.0	
32315	chr5	179508100	179508264	164	82.0	
32316	chr5	179530078	179531089	1011	506.0	
32317	chr5	179534180	179534856	676	338.0	
32318	chr5	179544409	179545165	756	378.0	
32319	chr5	179549740	179551665	1925	962.0	
32320	chr5	179558918	179560333	1415	708.0	
32321	chr5	179599206	179600476	1270	635.0	
32322	chr5	179601880	179616579	14699	7350.0	
32323	chr5	179617638	179619460	1822	911.0	
32324	chr5	179620299	179625009	4710	2355.0	
32325	chr5	179658291	179658929	638	319.0	
32326	chr5	179668338	179668834	496	248.0	
32327	chr5	179677553	179680302	2749	1374.0	
32328	chr5	179697730	179700941	3211	1606.0	
32329	chr5	179709120	179709583	463	232.0	
32330	chr5	179727067	179727623	556	278.0	
32331	chr5	179731725	179733976	2251	1126.0	
32332	chr5	179734492	179734766	274	137.0	
32333	chr5	179747664	179748330	666	333.0	
32334	chr5	179755122	179755123	1	0.0	
32335	chr5	179758894	179760955	2061	1030.0	
32336	chr5	179761914	179763742	1828	914.0	
32337	chr5	179765302	179765885	583	292.0	
32338	chr5	179769332	179770111	779	390.0	
32339	chr5	179772375	179772763	388	194.0	
32340	chr5	179776359	179776845	486	243.0	
32341	chr5	179777732	179778321	589	294.0	
32342	chr5	179780305	179780771	466	233.0	
32343	chr5	179791676	179797334	5658	2829.0	
32344	chr5	179801556	179807944	6388	3194.0	
32345	chr5	179810916	179811850	934	467.0	
32346	chr5	179816559	179828261	11702	5851.0	
32347	chr5	179828959	179830119	1160	580.0	
32348	chr5	179831014	179834322	3308	1654.0	
32349	chr5	179835917	179844282	8365	4182.0	
32350	chr5	179852727	179853353	626	313.0	
32351	chr5	179857779	179859577	1798	899.0	
32352	chr5	179866805	179867044	239	120.0	
32353	chr5	179906822	179908742	1920	960.0	
32354	chr5	179913908	179914695	787	394.0	
32355	chr5	179923389	179923908	519	260.0	
32356	chr5	179970885	179971786	901	450.0	
32357	chr5	179975101	179975644	543	272.0	
32358	chr5	180006815	180007099	284	142.0	
32359	chr5	180020192	180020592	400	200.0	
32360	chr5	180026312	180026774	462	231.0	
32361	chr5	180069366	180072928	3562	1781.0	
32362	chr5	180079815	180081128	1313	656.0	
32363	chr5	180084882	180085315	433	216.0	
32364	chr5	180085835	180086281	446	223.0	
32365	chr5	180089966	180091096	1130	565.0	
32366	chr5	180093569	180094153	584	292.0	
32367	chr5	180126978	180127450	472	236.0	
32368	chr5	180135091	180135496	405	202.0	
32369	chr5	180160694	180161299	605	302.0	
32370	chr5	180161981	180162296	315	158.0	
32371	chr5	180166221	180166626	405	202.0	
32372	chr5	180177235	180177786	551	276.0	
32373	chr5	180208562	180209518	956	478.0	
32374	chr5	180291046	180294789	3743	1872.0	
32375	chr5	180313537	180314481	944	472.0	
32376	chr5	180315601	180316298	697	348.0	
32377	chr5	180328418	180329142	724	362.0	
32378	chr5	180344095	180344454	359	180.0	
32379	chr5	180351841	180354399	2558	1279.0	
32380	chr5	180367088	180367981	893	446.0	
32381	chr5	180373598	180373648	50	25.0	
32382	chr5	180470917	180471411	494	247.0	
32383	chr5	180493652	180495515	1863	932.0	
32384	chr5	180518963	180519465	502	251.0	
32385	chr5	180525480	180525718	238	119.0	
32386	chr5	180562728	180563156	428	214.0	
32387	chr5	180568852	180569319	467	234.0	
32388	chr5	180589909	180591962	2053	1026.0	
32389	chr5	180605672	180606359	687	344.0	
32390	chr5	180618753	180619569	816	408.0	
32391	chr5	180648762	180650554	1792	896.0	
32392	chr5	180670492	180670951	459	230.0	
32393	chr5	180673833	180674334	501	250.0	
32394	chr5	180684793	180685062	269	134.0	
32395	chr5	180689031	180689865	834	417.0	
32396	chr5	180718692	180719111	419	210.0	
32397	chr5	180720515	180720861	346	173.0	
32398	chr5	180784434	180784924	490	245.0	
32399	chr5	180786035	180786061	26	13.0	
32400	chr5	180789922	180790379	457	228.0	
32401	chr5	180797481	180797508	27	14.0	
32402	chr5	180799175	180800973	1798	899.0	
32403	chr5	180801628	180807117	5489	2744.0	
32404	chr5	180807712	180811900	4188	2094.0	
32405	chr5	180813452	180814647	1195	598.0	
32406	chr5	180815197	180817344	2147	1074.0	
32407	chr5	180820623	180821570	947	474.0	
32408	chr5	180828916	180829573	657	328.0	
32409	chr5	180830137	180833586	3449	1724.0	
32410	chr5	180860240	180862134	1894	947.0	
32411	chr5	180868928	180869410	482	241.0	
32412	chr5	180873390	180874439	1049	524.0	
32413	chr5	180889442	180889755	313	156.0	
32414	chr5	180975332	180975770	438	219.0	
32415	chr5	181052816	181053563	747	374.0	
32416	chr5	181122030	181122345	315	158.0	
32417	chr5	181159034	181161934	2900	1450.0	
32418	chr5	181163455	181164273	818	409.0	
32419	chr5	181165306	181165562	256	128.0	
32420	chr5	181167809	181168223	414	207.0	
32421	chr5	181169414	181170285	871	436.0	
32422	chr5	181172954	181173967	1013	506.0	
32423	chr5	181181681	181184928	3247	1624.0	
32424	chr5	181186542	181192804	6262	3131.0	
32425	chr5	181200241	181200552	311	156.0	
32426	chr5	181202859	181208652	5793	2896.0	
32427	chr5	181216058	181218990	2932	1466.0	
32428	chr5	181221117	181225643	4526	2263.0	
32429	chr5	181234815	181234886	71	36.0	
32430	chr5	181235395	181236485	1090	545.0	
32431	chr5	181241090	181244772	3682	1841.0	
32432	chr5	181245618	181250011	4393	2196.0	
32433	chr5	181259536	181262870	3334	1667.0	
32434	chr5	181273409	181273747	338	169.0	
32435	chr6	209082	210223	1141	570.0	
32436	chr6	215505	216154	649	324.0	
32437	chr6	217072	217420	348	174.0	
32438	chr6	218368	218629	261	130.0	
32439	chr6	219157	220359	1202	601.0	
32440	chr6	224962	226201	1239	620.0	
32441	chr6	227295	227647	352	176.0	
32442	chr6	232925	233243	318	159.0	
32443	chr6	235677	236687	1010	505.0	
32444	chr6	248072	248460	388	194.0	
32445	chr6	252921	253562	641	320.0	
32446	chr6	255055	256297	1242	621.0	
32447	chr6	256987	257743	756	378.0	
32448	chr6	259766	260361	595	298.0	
32449	chr6	271212	271517	305	152.0	
32450	chr6	290437	293915	3478	1739.0	
32451	chr6	294733	294966	233	116.0	
32452	chr6	296097	297137	1040	520.0	
32453	chr6	298198	299236	1038	519.0	
32454	chr6	311648	312141	493	246.0	
32455	chr6	312741	313635	894	447.0	
32456	chr6	317811	318207	396	198.0	
32457	chr6	321507	322042	535	268.0	
32458	chr6	328010	328544	534	267.0	
32459	chr6	336189	337272	1083	542.0	
32460	chr6	337773	342575	4802	2401.0	
32461	chr6	347324	347530	206	103.0	
32462	chr6	348477	348690	213	106.0	
32463	chr6	356804	357153	349	174.0	
32464	chr6	358404	358978	574	287.0	
32465	chr6	372552	373015	463	232.0	
32466	chr6	379606	379607	1	0.0	
32467	chr6	384517	384824	307	154.0	
32468	chr6	387389	387723	334	167.0	
32469	chr6	388466	388922	456	228.0	
32470	chr6	389523	390230	707	354.0	
32471	chr6	390880	394363	3483	1742.0	
32472	chr6	399684	400353	669	334.0	
32473	chr6	403459	405352	1893	946.0	
32474	chr6	408477	409240	763	382.0	
32475	chr6	432075	432411	336	168.0	
32476	chr6	434708	435055	347	174.0	
32477	chr6	444828	448114	3286	1643.0	
32478	chr6	474492	475272	780	390.0	
32479	chr6	487902	488413	511	256.0	
32480	chr6	489010	489417	407	204.0	
32481	chr6	490354	490739	385	192.0	
32482	chr6	491372	491748	376	188.0	
32483	chr6	493002	493207	205	102.0	
32484	chr6	498816	500063	1247	624.0	
32485	chr6	501712	502588	876	438.0	
32486	chr6	509684	509989	305	152.0	
32487	chr6	593116	593562	446	223.0	
32488	chr6	610826	611440	614	307.0	
32489	chr6	684866	685235	369	184.0	
32490	chr6	692172	693803	1631	816.0	
32491	chr6	710525	711994	1469	734.0	
32492	chr6	721958	722418	460	230.0	
32493	chr6	786968	787305	337	168.0	
32494	chr6	816643	817115	472	236.0	
32495	chr6	1263111	1263528	417	208.0	
32496	chr6	1285913	1286438	525	262.0	
32497	chr6	1287093	1287814	721	360.0	
32498	chr6	1311643	1312158	515	258.0	
32499	chr6	1312738	1313781	1043	522.0	
32500	chr6	1381737	1382246	509	254.0	
32501	chr6	1390153	1390667	514	257.0	
32502	chr6	1396971	1397396	425	212.0	
32503	chr6	1404138	1404294	156	78.0	
32504	chr6	1436612	1437097	485	242.0	
32505	chr6	1523843	1524764	921	460.0	
32506	chr6	1526744	1527732	988	494.0	
32507	chr6	1535208	1535677	469	234.0	
32508	chr6	1536913	1537140	227	114.0	
32509	chr6	1552378	1552903	525	262.0	
32510	chr6	1554087	1555674	1587	794.0	
32511	chr6	1595267	1595351	84	42.0	
32512	chr6	1596011	1596869	858	429.0	
32513	chr6	1604087	1612324	8237	4118.0	
32514	chr6	1613913	1615337	1424	712.0	
32515	chr6	1619732	1620228	496	248.0	
32516	chr6	1624297	1625433	1136	568.0	
32517	chr6	1665136	1665743	607	304.0	
32518	chr6	1709184	1709735	551	276.0	
32519	chr6	1724658	1725059	401	200.0	
32520	chr6	1739606	1740024	418	209.0	
32521	chr6	1770262	1770850	588	294.0	
32522	chr6	1856373	1856738	365	182.0	
32523	chr6	1868861	1869331	470	235.0	
32524	chr6	1973067	1973274	207	104.0	
32525	chr6	2038113	2038514	401	200.0	
32526	chr6	2081710	2081761	51	26.0	
32527	chr6	2104237	2104636	399	200.0	
32528	chr6	2127306	2128082	776	388.0	
32529	chr6	2129313	2129414	101	50.0	
32530	chr6	2193074	2193362	288	144.0	
32531	chr6	2196064	2196501	437	218.0	
32532	chr6	2209255	2209649	394	197.0	
32533	chr6	2221680	2222877	1197	598.0	
32534	chr6	2243410	2246791	3381	1690.0	
32535	chr6	2410991	2411331	340	170.0	
32536	chr6	2448769	2449175	406	203.0	
32537	chr6	2480457	2480526	69	34.0	
32538	chr6	2522572	2522987	415	208.0	
32539	chr6	2531921	2532136	215	108.0	
32540	chr6	2534324	2534965	641	320.0	
32541	chr6	2542611	2543584	973	486.0	
32542	chr6	2547083	2547766	683	342.0	
32543	chr6	2634019	2634982	963	482.0	
32544	chr6	2651557	2651957	400	200.0	
32545	chr6	2658823	2659311	488	244.0	
32546	chr6	2663218	2663609	391	196.0	
32547	chr6	2695522	2695845	323	162.0	
32548	chr6	2726123	2726794	671	336.0	
32549	chr6	2733048	2733967	919	460.0	
32550	chr6	2734988	2734991	3	2.0	
32551	chr6	2738143	2738825	682	341.0	
32552	chr6	2749749	2750426	677	338.0	
32553	chr6	2756305	2756627	322	161.0	
32554	chr6	2760957	2761783	826	413.0	
32555	chr6	2763149	2766853	3704	1852.0	
32556	chr6	2767516	2768508	992	496.0	
32557	chr6	2770258	2770512	254	127.0	
32558	chr6	2783279	2783663	384	192.0	
32559	chr6	2790593	2792778	2185	1092.0	
32560	chr6	2793364	2794695	1331	666.0	
32561	chr6	2795532	2797381	1849	924.0	
32562	chr6	2799895	2800301	406	203.0	
32563	chr6	2810244	2810694	450	225.0	
32564	chr6	2831703	2831781	78	39.0	
32565	chr6	2839160	2842579	3419	1710.0	
32566	chr6	2846030	2847107	1077	538.0	
32567	chr6	2848516	2849304	788	394.0	
32568	chr6	2852593	2855463	2870	1435.0	enhancer
32569	chr6	2856649	2859669	3020	1510.0	
32570	chr6	2861292	2863486	2194	1097.0	
32571	chr6	2868981	2869800	819	410.0	
32572	chr6	2872302	2872968	666	333.0	
32573	chr6	2874728	2878489	3761	1880.0	
32574	chr6	2880077	2880646	569	284.0	
32575	chr6	2881229	2881916	687	344.0	
32576	chr6	2883926	2883958	32	16.0	
32577	chr6	2885967	2886770	803	402.0	
32578	chr6	2890791	2892373	1582	791.0	
32579	chr6	2897879	2903811	5932	2966.0	
32580	chr6	2908501	2908770	269	134.0	
32581	chr6	2911165	2912204	1039	520.0	
32582	chr6	2916447	2916741	294	147.0	
32583	chr6	2918828	2919519	691	346.0	
32584	chr6	2931877	2932826	949	474.0	
32585	chr6	2936394	2937762	1368	684.0	
32586	chr6	2939743	2941076	1333	666.0	
32587	chr6	2942518	2943837	1319	660.0	
32588	chr6	2951616	2953192	1576	788.0	
32589	chr6	2958241	2958779	538	269.0	
32590	chr6	2970476	2972396	1920	960.0	
32591	chr6	2973653	2974113	460	230.0	
32592	chr6	2981373	2982014	641	320.0	
32593	chr6	2987764	2991154	3390	1695.0	
32594	chr6	2998024	3000619	2595	1298.0	
32595	chr6	3001665	3002452	787	394.0	
32596	chr6	3012728	3013961	1233	616.0	
32597	chr6	3022648	3027734	5086	2543.0	
32598	chr6	3031893	3032236	343	172.0	
32599	chr6	3037287	3037994	707	354.0	
32600	chr6	3046356	3046715	359	180.0	
32601	chr6	3053182	3054508	1326	663.0	
32602	chr6	3055597	3056548	951	476.0	
32603	chr6	3063292	3065995	2703	1352.0	
32604	chr6	3067890	3069996	2106	1053.0	
32605	chr6	3075520	3075970	450	225.0	
32606	chr6	3081880	3082506	626	313.0	
32607	chr6	3088500	3088764	264	132.0	
32608	chr6	3090059	3090257	198	99.0	
32609	chr6	3117751	3119547	1796	898.0	
32610	chr6	3126274	3127026	752	376.0	
32611	chr6	3139149	3140009	860	430.0	
32612	chr6	3152751	3152789	38	19.0	
32613	chr6	3155171	3155552	381	190.0	
32614	chr6	3156190	3158620	2430	1215.0	
32615	chr6	3159465	3161116	1651	826.0	
32616	chr6	3162058	3163715	1657	828.0	
32617	chr6	3165736	3165936	200	100.0	
32618	chr6	3176697	3177131	434	217.0	
32619	chr6	3209345	3209536	191	96.0	
32620	chr6	3226767	3230035	3268	1634.0	
32621	chr6	3231009	3232077	1068	534.0	
32622	chr6	3251018	3252802	1784	892.0	
32623	chr6	3254146	3254546	400	200.0	
32624	chr6	3258295	3260187	1892	946.0	
32625	chr6	3279456	3280144	688	344.0	
32626	chr6	3318235	3318510	275	138.0	
32627	chr6	3337845	3338143	298	149.0	
32628	chr6	3355169	3357001	1832	916.0	
32629	chr6	3367564	3368125	561	280.0	
32630	chr6	3370379	3371228	849	424.0	
32631	chr6	3378316	3378734	418	209.0	
32632	chr6	3388694	3389156	462	231.0	
32633	chr6	3410862	3411322	460	230.0	
32634	chr6	3455019	3458152	3133	1566.0	
32635	chr6	3592292	3592961	669	334.0	
32636	chr6	3623445	3623807	362	181.0	
32637	chr6	3732462	3732999	537	268.0	
32638	chr6	3742252	3743432	1180	590.0	
32639	chr6	3746229	3746781	552	276.0	
32640	chr6	3748221	3748766	545	272.0	
32641	chr6	3749452	3752671	3219	1610.0	
32642	chr6	3767637	3767879	242	121.0	
32643	chr6	3847567	3847759	192	96.0	
32644	chr6	3848599	3851137	2538	1269.0	
32645	chr6	3915021	3915659	638	319.0	
32646	chr6	3933027	3933499	472	236.0	
32647	chr6	3978147	3978757	610	305.0	
32648	chr6	3990605	3991321	716	358.0	
32649	chr6	4008249	4008828	579	290.0	
32650	chr6	4010658	4011245	587	294.0	
32651	chr6	4017614	4019416	1802	901.0	
32652	chr6	4020751	4024134	3383	1692.0	
32653	chr6	4029770	4031070	1300	650.0	
32654	chr6	4059121	4060091	970	485.0	
32655	chr6	4133931	4136871	2940	1470.0	
32656	chr6	4155664	4156304	640	320.0	
32657	chr6	4210587	4211020	433	216.0	
32658	chr6	4281658	4282419	761	380.0	
32659	chr6	4316849	4317425	576	288.0	
32660	chr6	4407563	4408484	921	460.0	
32661	chr6	4489515	4489915	400	200.0	
32662	chr6	4594003	4594205	202	101.0	
32663	chr6	4603114	4603815	701	350.0	
32664	chr6	4607494	4608252	758	379.0	
32665	chr6	4647605	4647714	109	54.0	
32666	chr6	4687969	4688672	703	352.0	
32667	chr6	4693649	4694028	379	190.0	
32668	chr6	4774579	4778466	3887	1944.0	
32669	chr6	4781470	4781787	317	158.0	
32670	chr6	4789172	4789605	433	216.0	
32671	chr6	4790478	4790735	257	128.0	
32672	chr6	4801540	4801923	383	192.0	
32673	chr6	4806041	4806437	396	198.0	
32674	chr6	4812051	4812537	486	243.0	
32675	chr6	4864572	4864800	228	114.0	
32676	chr6	4884841	4885039	198	99.0	
32677	chr6	4889749	4890027	278	139.0	
32678	chr6	4901299	4902755	1456	728.0	
32679	chr6	4905858	4907012	1154	577.0	
32680	chr6	4935630	4935646	16	8.0	
32681	chr6	4936624	4936710	86	43.0	
32682	chr6	4942165	4942620	455	228.0	
32683	chr6	5003070	5004772	1702	851.0	
32684	chr6	5026041	5026784	743	372.0	
32685	chr6	5030570	5031150	580	290.0	
32686	chr6	5034381	5034817	436	218.0	
32687	chr6	5082491	5083026	535	268.0	
32688	chr6	5084408	5086287	1879	940.0	
32689	chr6	5087373	5087944	571	286.0	
32690	chr6	5132697	5133145	448	224.0	
32691	chr6	5135760	5136216	456	228.0	
32692	chr6	5143550	5144075	525	262.0	
32693	chr6	5173822	5176100	2278	1139.0	
32694	chr6	5178592	5179049	457	228.0	
32695	chr6	5181641	5181870	229	114.0	
32696	chr6	5204460	5204717	257	128.0	
32697	chr6	5205781	5206481	700	350.0	
32698	chr6	5230639	5231062	423	212.0	
32699	chr6	5234839	5235277	438	219.0	
32700	chr6	5259817	5262530	2713	1356.0	
32701	chr6	5294381	5294850	469	234.0	
32702	chr6	5302689	5303666	977	488.0	
32703	chr6	5398475	5398862	387	194.0	
32704	chr6	5470924	5471391	467	234.0	
32705	chr6	5506917	5507770	853	426.0	
32706	chr6	5517726	5518325	599	300.0	
32707	chr6	5518862	5519462	600	300.0	
32708	chr6	5521555	5521629	74	37.0	
32709	chr6	5522265	5522354	89	44.0	
32710	chr6	5619244	5619650	406	203.0	
32711	chr6	5626838	5627554	716	358.0	
32712	chr6	5657613	5658516	903	452.0	
32713	chr6	5665125	5665660	535	268.0	
32714	chr6	5667735	5668254	519	260.0	
32715	chr6	5671008	5671712	704	352.0	
32716	chr6	5672521	5673330	809	404.0	
32717	chr6	5674668	5675183	515	258.0	
32718	chr6	5679651	5680132	481	240.0	
32719	chr6	5695130	5695695	565	282.0	
32720	chr6	5698820	5699653	833	416.0	
32721	chr6	5712615	5712756	141	70.0	
32722	chr6	5718320	5718720	400	200.0	
32723	chr6	5723713	5724800	1087	544.0	
32724	chr6	5809764	5809766	2	1.0	
32725	chr6	5813518	5814149	631	316.0	
32726	chr6	5824368	5824994	626	313.0	
32727	chr6	5831174	5832871	1697	848.0	
32728	chr6	5850634	5851980	1346	673.0	
32729	chr6	5865599	5865815	216	108.0	
32730	chr6	5866326	5867352	1026	513.0	
32731	chr6	5869459	5870122	663	332.0	
32732	chr6	5891699	5892585	886	443.0	
32733	chr6	5950509	5950869	360	180.0	
32734	chr6	5979544	5980426	882	441.0	
32735	chr6	5989360	5989958	598	299.0	
32736	chr6	5994290	5998100	3810	1905.0	
32737	chr6	5999143	6000216	1073	536.0	
32738	chr6	6001851	6004543	2692	1346.0	
32739	chr6	6007042	6009544	2502	1251.0	
32740	chr6	6057465	6057808	343	172.0	
32741	chr6	6277555	6277744	189	94.0	
32742	chr6	6315642	6316047	405	202.0	
32743	chr6	6319952	6320852	900	450.0	
32744	chr6	6331457	6331652	195	98.0	
32745	chr6	6332177	6332834	657	328.0	
32746	chr6	6333668	6333860	192	96.0	
32747	chr6	6379650	6379889	239	120.0	
32748	chr6	6385955	6386483	528	264.0	
32749	chr6	6391047	6391698	651	326.0	
32750	chr6	6392689	6393184	495	248.0	
32751	chr6	6395767	6396268	501	250.0	
32752	chr6	6402243	6402354	111	56.0	
32753	chr6	6406966	6407918	952	476.0	
32754	chr6	6414950	6415296	346	173.0	
32755	chr6	6469040	6469560	520	260.0	
32756	chr6	6494148	6495080	932	466.0	
32757	chr6	6515697	6516418	721	360.0	
32758	chr6	6546063	6547532	1469	734.0	
32759	chr6	6556498	6557359	861	430.0	
32760	chr6	6579302	6579728	426	213.0	
32761	chr6	6584657	6585042	385	192.0	
32762	chr6	6586788	6587456	668	334.0	
32763	chr6	6588169	6589766	1597	798.0	
32764	chr6	6591650	6593472	1822	911.0	
32765	chr6	6596528	6596931	403	202.0	
32766	chr6	6609832	6610821	989	494.0	
32767	chr6	6613959	6615424	1465	732.0	
32768	chr6	6616745	6617018	273	136.0	
32769	chr6	6636732	6637143	411	206.0	
32770	chr6	6654533	6655263	730	365.0	
32771	chr6	6658675	6660373	1698	849.0	
32772	chr6	6661623	6662144	521	260.0	
32773	chr6	6676732	6677508	776	388.0	
32774	chr6	6684406	6684831	425	212.0	
32775	chr6	6686757	6687641	884	442.0	
32776	chr6	6688195	6688694	499	250.0	
32777	chr6	6689412	6689806	394	197.0	
32778	chr6	6694220	6696036	1816	908.0	
32779	chr6	6696845	6697389	544	272.0	
32780	chr6	6699993	6700347	354	177.0	
32781	chr6	6707057	6707676	619	310.0	
32782	chr6	6711774	6713444	1670	835.0	
32783	chr6	6717912	6718461	549	274.0	
32784	chr6	6723391	6726371	2980	1490.0	
32785	chr6	6737204	6737553	349	174.0	
32786	chr6	6748630	6748770	140	70.0	
32787	chr6	6749703	6750623	920	460.0	
32788	chr6	6751470	6752076	606	303.0	
32789	chr6	6758925	6759663	738	369.0	
32790	chr6	6771538	6771975	437	218.0	
32791	chr6	6788381	6788817	436	218.0	
32792	chr6	6793785	6794428	643	322.0	
32793	chr6	6796835	6797201	366	183.0	
32794	chr6	6798645	6798921	276	138.0	
32795	chr6	6799749	6801287	1538	769.0	
32796	chr6	6803556	6804146	590	295.0	
32797	chr6	6806527	6807532	1005	502.0	
32798	chr6	6810720	6812118	1398	699.0	
32799	chr6	6823441	6824002	561	280.0	
32800	chr6	6826200	6827082	882	441.0	
32801	chr6	6840676	6841409	733	366.0	
32802	chr6	6856414	6857717	1303	652.0	
32803	chr6	6858471	6859250	779	390.0	
32804	chr6	6865652	6865966	314	157.0	
32805	chr6	6870972	6871247	275	138.0	
32806	chr6	6875799	6876203	404	202.0	
32807	chr6	6879007	6879967	960	480.0	
32808	chr6	6880849	6881119	270	135.0	
32809	chr6	6881863	6882053	190	95.0	
32810	chr6	6882708	6882944	236	118.0	
32811	chr6	6884260	6884701	441	220.0	
32812	chr6	6885370	6886494	1124	562.0	
32813	chr6	6890243	6890941	698	349.0	
32814	chr6	6892164	6892565	401	200.0	
32815	chr6	6900571	6900979	408	204.0	
32816	chr6	6913406	6913496	90	45.0	
32817	chr6	6915698	6916662	964	482.0	
32818	chr6	6918536	6919031	495	248.0	
32819	chr6	6927685	6928534	849	424.0	
32820	chr6	6931206	6931457	251	126.0	
32821	chr6	6942771	6943264	493	246.0	
32822	chr6	7042317	7042687	370	185.0	
32823	chr6	7047982	7048362	380	190.0	
32824	chr6	7050028	7050429	401	200.0	
32825	chr6	7050944	7053181	2237	1118.0	
32826	chr6	7058458	7058724	266	133.0	
32827	chr6	7073432	7074333	901	450.0	
32828	chr6	7085916	7088436	2520	1260.0	
32829	chr6	7106189	7110732	4543	2272.0	
32830	chr6	7112407	7113326	919	460.0	
32831	chr6	7115638	7116261	623	312.0	
32832	chr6	7126688	7127218	530	265.0	
32833	chr6	7129343	7130855	1512	756.0	
32834	chr6	7135831	7136139	308	154.0	
32835	chr6	7136701	7139425	2724	1362.0	
32836	chr6	7140516	7141940	1424	712.0	
32837	chr6	7145651	7146994	1343	672.0	
32838	chr6	7153801	7155470	1669	834.0	
32839	chr6	7156050	7156359	309	154.0	
32840	chr6	7165967	7167413	1446	723.0	
32841	chr6	7188288	7189025	737	368.0	
32842	chr6	7195897	7196272	375	188.0	
32843	chr6	7201514	7202734	1220	610.0	
32844	chr6	7207757	7208100	343	172.0	
32845	chr6	7224741	7225185	444	222.0	
32846	chr6	7236567	7236568	1	0.0	
32847	chr6	7238728	7239305	577	288.0	
32848	chr6	7242893	7244131	1238	619.0	
32849	chr6	7252381	7252855	474	237.0	
32850	chr6	7254692	7255895	1203	602.0	
32851	chr6	7260558	7261952	1394	697.0	
32852	chr6	7263003	7263726	723	362.0	
32853	chr6	7266308	7266611	303	152.0	
32854	chr6	7275854	7276405	551	276.0	
32855	chr6	7277380	7278501	1121	560.0	
32856	chr6	7282094	7282681	587	294.0	
32857	chr6	7312183	7314574	2391	1196.0	
32858	chr6	7324194	7325209	1015	508.0	
32859	chr6	7328107	7328771	664	332.0	
32860	chr6	7331997	7332422	425	212.0	
32861	chr6	7339061	7339553	492	246.0	
32862	chr6	7388957	7391679	2722	1361.0	
32863	chr6	7402740	7403119	379	190.0	
32864	chr6	7431197	7431877	680	340.0	
32865	chr6	7439161	7439693	532	266.0	
32866	chr6	7468549	7469108	559	280.0	
32867	chr6	7471232	7471525	293	146.0	
32868	chr6	7505398	7505487	89	44.0	
32869	chr6	7541241	7543365	2124	1062.0	
32870	chr6	7589696	7591336	1640	820.0	
32871	chr6	7615414	7616085	671	336.0	
32872	chr6	7617964	7619051	1087	544.0	
32873	chr6	7624803	7625156	353	176.0	
32874	chr6	7697753	7698877	1124	562.0	
32875	chr6	7701466	7701877	411	206.0	
32876	chr6	7722952	7723481	529	264.0	
32877	chr6	7725657	7727198	1541	770.0	
32878	chr6	7727817	7728628	811	406.0	
32879	chr6	7900675	7900707	32	16.0	
32880	chr6	7909332	7911570	2238	1119.0	
32881	chr6	7917035	7917278	243	122.0	
32882	chr6	7938656	7939007	351	176.0	
32883	chr6	8063478	8065289	1811	906.0	
32884	chr6	8075674	8076111	437	218.0	
32885	chr6	8079902	8080715	813	406.0	
32886	chr6	8085023	8085487	464	232.0	
32887	chr6	8101649	8103185	1536	768.0	
32888	chr6	8131275	8131623	348	174.0	
32889	chr6	8181515	8181828	313	156.0	
32890	chr6	8219345	8219771	426	213.0	
32891	chr6	8434710	8436243	1533	766.0	
32892	chr6	8743150	8743733	583	292.0	
32893	chr6	8831561	8832163	602	301.0	
32894	chr6	8881673	8882079	406	203.0	
32895	chr6	8983115	8983521	406	203.0	
32896	chr6	9646314	9646783	469	234.0	
32897	chr6	10081389	10081393	4	2.0	
32898	chr6	10081950	10083002	1052	526.0	
32899	chr6	10087766	10088265	499	250.0	
32900	chr6	10099634	10099968	334	167.0	
32901	chr6	10147202	10147241	39	20.0	
32902	chr6	10383503	10383599	96	48.0	
32903	chr6	10403684	10405012	1328	664.0	
32904	chr6	10411354	10413354	2000	1000.0	
32905	chr6	10413934	10414335	401	200.0	
32906	chr6	10417034	10417207	173	86.0	
32907	chr6	10426344	10426570	226	113.0	
32908	chr6	10429795	10430460	665	332.0	
32909	chr6	10478406	10478831	425	212.0	
32910	chr6	10510466	10510980	514	257.0	
32911	chr6	10518640	10519331	691	346.0	
32912	chr6	10520429	10521550	1121	560.0	
32913	chr6	10527959	10529652	1693	846.0	
32914	chr6	10531218	10532394	1176	588.0	
32915	chr6	10533479	10536940	3461	1730.0	
32916	chr6	10542330	10542711	381	190.0	
32917	chr6	10587728	10587987	259	130.0	
32918	chr6	10595676	10596520	844	422.0	
32919	chr6	10597854	10598834	980	490.0	
32920	chr6	10603122	10603764	642	321.0	
32921	chr6	10633146	10633751	605	302.0	
32922	chr6	10642859	10643790	931	466.0	
32923	chr6	10655625	10656129	504	252.0	
32924	chr6	10659974	10660046	72	36.0	
32925	chr6	10693849	10695712	1863	932.0	
32926	chr6	10719164	10721562	2398	1199.0	
32927	chr6	10722091	10723835	1744	872.0	
32928	chr6	10726460	10727570	1110	555.0	
32929	chr6	10732910	10733750	840	420.0	
32930	chr6	10746893	10748503	1610	805.0	
32931	chr6	10751549	10752204	655	328.0	
32932	chr6	10759322	10759753	431	216.0	
32933	chr6	10801191	10801671	480	240.0	
32934	chr6	10831612	10831982	370	185.0	
32935	chr6	10837258	10839435	2177	1088.0	
32936	chr6	10886649	10887494	845	422.0	
32937	chr6	10889306	10889883	577	288.0	
32938	chr6	10901614	10902364	750	375.0	
32939	chr6	10954481	10954928	447	224.0	
32940	chr6	11043601	11044745	1144	572.0	
32941	chr6	11092880	11095079	2199	1100.0	
32942	chr6	11096119	11096605	486	243.0	
32943	chr6	11111500	11112275	775	388.0	
32944	chr6	11116128	11116268	140	70.0	
32945	chr6	11143487	11144923	1436	718.0	
32946	chr6	11154179	11154560	381	190.0	
32947	chr6	11172409	11173296	887	444.0	
32948	chr6	11198596	11199623	1027	514.0	
32949	chr6	11202735	11203571	836	418.0	
32950	chr6	11206559	11207907	1348	674.0	
32951	chr6	11210751	11210949	198	99.0	
32952	chr6	11212235	11213196	961	480.0	
32953	chr6	11218553	11219830	1277	638.0	
32954	chr6	11220672	11220717	45	22.0	
32955	chr6	11222243	11223214	971	486.0	
32956	chr6	11224084	11225631	1547	774.0	
32957	chr6	11230695	11233713	3018	1509.0	
32958	chr6	11236132	11236866	734	367.0	
32959	chr6	11257617	11259152	1535	768.0	
32960	chr6	11260681	11260957	276	138.0	
32961	chr6	11263453	11263854	401	200.0	
32962	chr6	11275610	11276175	565	282.0	
32963	chr6	11277509	11277995	486	243.0	
32964	chr6	11294337	11294552	215	108.0	
32965	chr6	11310098	11310448	350	175.0	
32966	chr6	11316059	11316442	383	192.0	
32967	chr6	11317793	11318955	1162	581.0	
32968	chr6	11323104	11324466	1362	681.0	
32969	chr6	11330250	11331342	1092	546.0	
32970	chr6	11341859	11342294	435	218.0	
32971	chr6	11349960	11351310	1350	675.0	
32972	chr6	11353945	11354527	582	291.0	
32973	chr6	11356778	11357143	365	182.0	
32974	chr6	11359261	11359796	535	268.0	
32975	chr6	11364227	11364601	374	187.0	
32976	chr6	11366315	11367964	1649	824.0	
32977	chr6	11370312	11370854	542	271.0	
32978	chr6	11372316	11372821	505	252.0	
32979	chr6	11374009	11375066	1057	528.0	
32980	chr6	11376799	11377550	751	376.0	
32981	chr6	11380550	11382992	2442	1221.0	
32982	chr6	11386336	11386706	370	185.0	
32983	chr6	11387824	11388422	598	299.0	
32984	chr6	11392761	11393330	569	284.0	
32985	chr6	11397732	11398266	534	267.0	
32986	chr6	11403917	11405342	1425	712.0	
32987	chr6	11413484	11415062	1578	789.0	
32988	chr6	11416693	11417064	371	186.0	
32989	chr6	11439026	11439536	510	255.0	
32990	chr6	11459032	11461425	2393	1196.0	
32991	chr6	11462732	11463465	733	366.0	
32992	chr6	11491992	11492552	560	280.0	
32993	chr6	11494719	11495105	386	193.0	
32994	chr6	11496081	11497557	1476	738.0	
32995	chr6	11519191	11520145	954	477.0	
32996	chr6	11522851	11523622	771	386.0	
32997	chr6	11525476	11526413	937	468.0	
32998	chr6	11535894	11539140	3246	1623.0	
32999	chr6	11542831	11543204	373	186.0	
33000	chr6	11547910	11548217	307	154.0	
33001	chr6	11552338	11553007	669	334.0	
33002	chr6	11575284	11575978	694	347.0	
33003	chr6	11580933	11581481	548	274.0	
33004	chr6	11598479	11599225	746	373.0	
33005	chr6	11604219	11604617	398	199.0	
33006	chr6	11655475	11656020	545	272.0	
33007	chr6	11683949	11684135	186	93.0	
33008	chr6	11693002	11693480	478	239.0	
33009	chr6	11700160	11700537	377	188.0	
33010	chr6	11702004	11702832	828	414.0	
33011	chr6	11710143	11710655	512	256.0	
33012	chr6	11711628	11713332	1704	852.0	
33013	chr6	11714169	11715020	851	426.0	
33014	chr6	11723306	11723404	98	49.0	
33015	chr6	11727665	11729592	1927	964.0	
33016	chr6	11730563	11731117	554	277.0	
33017	chr6	11731798	11732847	1049	524.0	
33018	chr6	11738694	11739128	434	217.0	
33019	chr6	11748741	11749222	481	240.0	
33020	chr6	11770387	11771375	988	494.0	
33021	chr6	11772594	11772802	208	104.0	
33022	chr6	11774439	11774963	524	262.0	
33023	chr6	11778646	11778936	290	145.0	
33024	chr6	11779528	11779807	279	140.0	
33025	chr6	11786020	11786465	445	222.0	
33026	chr6	11804213	11804476	263	132.0	
33027	chr6	11876961	11877429	468	234.0	
33028	chr6	11975404	11976060	656	328.0	
33029	chr6	11978433	11978721	288	144.0	
33030	chr6	12008015	12013880	5865	2932.0	
33031	chr6	12017343	12017744	401	200.0	
33032	chr6	12020342	12020343	1	0.0	
33033	chr6	12044681	12045475	794	397.0	
33034	chr6	12047276	12047702	426	213.0	
33035	chr6	12049276	12050214	938	469.0	
33036	chr6	12051679	12052500	821	410.0	
33037	chr6	12058169	12058520	351	176.0	
33038	chr6	12060479	12061529	1050	525.0	
33039	chr6	12065763	12066107	344	172.0	
33040	chr6	12075054	12075559	505	252.0	
33041	chr6	12081930	12082084	154	77.0	
33042	chr6	12110466	12110800	334	167.0	
33043	chr6	12114187	12114347	160	80.0	
33044	chr6	12118986	12119611	625	312.0	
33045	chr6	12126120	12126352	232	116.0	
33046	chr6	12138367	12138849	482	241.0	
33047	chr6	12151075	12151126	51	26.0	
33048	chr6	12163170	12163572	402	201.0	
33049	chr6	12199985	12200411	426	213.0	
33050	chr6	12208005	12208987	982	491.0	
33051	chr6	12232309	12232804	495	248.0	
33052	chr6	12233537	12234605	1068	534.0	
33053	chr6	12241731	12242326	595	298.0	
33054	chr6	12261471	12261869	398	199.0	
33055	chr6	12265278	12266970	1692	846.0	
33056	chr6	12270898	12270957	59	30.0	
33057	chr6	12275114	12275458	344	172.0	
33058	chr6	12277408	12277581	173	86.0	
33059	chr6	12279747	12280055	308	154.0	
33060	chr6	12289261	12290671	1410	705.0	
33061	chr6	12332448	12332713	265	132.0	
33062	chr6	12357212	12357943	731	366.0	
33063	chr6	12358964	12359505	541	270.0	
33064	chr6	12363380	12364243	863	432.0	
33065	chr6	12369594	12370321	727	364.0	
33066	chr6	12587078	12587431	353	176.0	
33067	chr6	12595206	12596053	847	424.0	
33068	chr6	12605747	12606238	491	246.0	
33069	chr6	12608192	12608703	511	256.0	
33070	chr6	12621674	12622219	545	272.0	
33071	chr6	12637887	12638447	560	280.0	
33072	chr6	12893810	12894259	449	224.0	
33073	chr6	12903233	12903689	456	228.0	
33074	chr6	12944928	12945513	585	292.0	
33075	chr6	12957176	12958097	921	460.0	
33076	chr6	12962891	12963478	587	294.0	
33077	chr6	13012166	13012666	500	250.0	
33078	chr6	13044342	13044801	459	230.0	
33079	chr6	13068624	13068969	345	172.0	
33080	chr6	13098830	13099164	334	167.0	
33081	chr6	13178113	13178435	322	161.0	
33082	chr6	13194854	13195312	458	229.0	
33083	chr6	13203176	13203532	356	178.0	
33084	chr6	13216710	13216954	244	122.0	
33085	chr6	13229408	13230186	778	389.0	
33086	chr6	13235606	13235651	45	22.0	
33087	chr6	13253265	13253745	480	240.0	
33088	chr6	13256230	13257193	963	482.0	
33089	chr6	13260086	13260537	451	226.0	
33090	chr6	13261078	13262984	1906	953.0	
33091	chr6	13271906	13275503	3597	1798.0	
33092	chr6	13277807	13278578	771	386.0	
33093	chr6	13280247	13280633	386	193.0	
33094	chr6	13285520	13286614	1094	547.0	
33095	chr6	13302283	13304910	2627	1314.0	
33096	chr6	13307405	13308185	780	390.0	
33097	chr6	13327645	13329241	1596	798.0	
33098	chr6	13331557	13332225	668	334.0	
33099	chr6	13336386	13337117	731	366.0	
33100	chr6	13337741	13338624	883	442.0	
33101	chr6	13340290	13340393	103	52.0	
33102	chr6	13354376	13356661	2285	1142.0	
33103	chr6	13360775	13360944	169	84.0	
33104	chr6	13375227	13375876	649	324.0	
33105	chr6	13377598	13377691	93	46.0	
33106	chr6	13383128	13384112	984	492.0	
33107	chr6	13390673	13391106	433	216.0	
33108	chr6	13395299	13396577	1278	639.0	
33109	chr6	13397188	13398116	928	464.0	
33110	chr6	13404134	13404885	751	376.0	
33111	chr6	13406781	13408381	1600	800.0	
33112	chr6	13411499	13411816	317	158.0	
33113	chr6	13412634	13412714	80	40.0	
33114	chr6	13414107	13414567	460	230.0	
33115	chr6	13419490	13419823	333	166.0	
33116	chr6	13426161	13426473	312	156.0	
33117	chr6	13427341	13429723	2382	1191.0	
33118	chr6	13430961	13435892	4931	2466.0	
33119	chr6	13448054	13448856	802	401.0	
33120	chr6	13453704	13455671	1967	984.0	
33121	chr6	13461479	13462381	902	451.0	
33122	chr6	13464687	13465084	397	198.0	
33123	chr6	13465825	13466059	234	117.0	
33124	chr6	13478655	13479793	1138	569.0	
33125	chr6	13484097	13484619	522	261.0	
33126	chr6	13485541	13488837	3296	1648.0	
33127	chr6	13522688	13523062	374	187.0	
33128	chr6	13526365	13527674	1309	654.0	
33129	chr6	13538093	13538441	348	174.0	
33130	chr6	13561835	13562232	397	198.0	
33131	chr6	13573650	13575647	1997	998.0	
33132	chr6	13581658	13582037	379	190.0	
33133	chr6	13583049	13583356	307	154.0	
33134	chr6	13614213	13616382	2169	1084.0	
33135	chr6	13624768	13625263	495	248.0	
33136	chr6	13636342	13636352	10	5.0	
33137	chr6	13647800	13648267	467	234.0	
33138	chr6	13666693	13667112	419	210.0	
33139	chr6	13668579	13668935	356	178.0	
33140	chr6	13671760	13671957	197	98.0	
33141	chr6	13681204	13682152	948	474.0	
33142	chr6	13687638	13688974	1336	668.0	
33143	chr6	13695173	13695580	407	204.0	
33144	chr6	13702704	13703367	663	332.0	
33145	chr6	13708144	13712997	4853	2426.0	
33146	chr6	13715515	13715866	351	176.0	
33147	chr6	13724099	13724511	412	206.0	
33148	chr6	13725509	13726153	644	322.0	
33149	chr6	13747415	13748076	661	330.0	
33150	chr6	13762502	13763197	695	348.0	
33151	chr6	13767343	13767947	604	302.0	
33152	chr6	13795013	13795557	544	272.0	
33153	chr6	13812065	13812255	190	95.0	
33154	chr6	13813448	13815225	1777	888.0	
33155	chr6	13872596	13874325	1729	864.0	
33156	chr6	13908828	13909474	646	323.0	
33157	chr6	13924153	13925273	1120	560.0	
33158	chr6	13985650	13986026	376	188.0	
33159	chr6	14024949	14025682	733	366.0	
33160	chr6	14037004	14037557	553	276.0	
33161	chr6	14044146	14044472	326	163.0	
33162	chr6	14046430	14046897	467	234.0	
33163	chr6	14066731	14067426	695	348.0	
33164	chr6	14073568	14075899	2331	1166.0	
33165	chr6	14089347	14089603	256	128.0	
33166	chr6	14092362	14092670	308	154.0	
33167	chr6	14093990	14096027	2037	1018.0	
33168	chr6	14098452	14098801	349	174.0	
33169	chr6	14100123	14100667	544	272.0	
33170	chr6	14108487	14110533	2046	1023.0	
33171	chr6	14116990	14140477	23487	11744.0	
33172	chr6	14140990	14142536	1546	773.0	
33173	chr6	14144503	14145355	852	426.0	
33174	chr6	14148993	14149510	517	258.0	
33175	chr6	14209543	14211978	2435	1218.0	
33176	chr6	14224755	14225118	363	182.0	
33177	chr6	14254500	14254969	469	234.0	
33178	chr6	14270839	14271613	774	387.0	
33179	chr6	14276356	14277670	1314	657.0	
33180	chr6	14312578	14312837	259	130.0	
33181	chr6	14337166	14337557	391	196.0	
33182	chr6	14348459	14348707	248	124.0	
33183	chr6	14371350	14371905	555	278.0	
33184	chr6	14376094	14376213	119	60.0	
33185	chr6	14383295	14384243	948	474.0	
33186	chr6	14386555	14386964	409	204.0	
33187	chr6	14442287	14442632	345	172.0	
33188	chr6	14452490	14453516	1026	513.0	
33189	chr6	14478507	14478590	83	42.0	
33190	chr6	14596304	14596829	525	262.0	
33191	chr6	14598482	14598821	339	170.0	
33192	chr6	14621564	14621581	17	8.0	
33193	chr6	14634072	14634471	399	200.0	
33194	chr6	14635145	14636720	1575	788.0	
33195	chr6	14638737	14639679	942	471.0	
33196	chr6	14656035	14657114	1079	540.0	
33197	chr6	14658865	14659565	700	350.0	
33198	chr6	14660739	14661743	1004	502.0	
33199	chr6	14664016	14664821	805	402.0	
33200	chr6	14665665	14666477	812	406.0	
33201	chr6	14681989	14682736	747	374.0	
33202	chr6	14700010	14700084	74	37.0	
33203	chr6	14707456	14707549	93	46.0	
33204	chr6	14710969	14711658	689	344.0	
33205	chr6	14717233	14717747	514	257.0	
33206	chr6	14720693	14721694	1001	500.0	
33207	chr6	14722717	14723031	314	157.0	
33208	chr6	14727097	14729949	2852	1426.0	
33209	chr6	14732673	14733277	604	302.0	
33210	chr6	14734556	14735464	908	454.0	
33211	chr6	14738860	14739384	524	262.0	
33212	chr6	14743427	14744450	1023	512.0	
33213	chr6	14754523	14755503	980	490.0	
33214	chr6	14758267	14758848	581	290.0	
33215	chr6	14759426	14759506	80	40.0	
33216	chr6	14765731	14766162	431	216.0	
33217	chr6	14784868	14785188	320	160.0	
33218	chr6	14799811	14800424	613	306.0	
33219	chr6	14804117	14804296	179	90.0	
33220	chr6	14828336	14828389	53	26.0	
33221	chr6	14841744	14842202	458	229.0	
33222	chr6	14857047	14858236	1189	594.0	
33223	chr6	14861377	14861820	443	222.0	
33224	chr6	14865442	14866378	936	468.0	
33225	chr6	14875317	14875843	526	263.0	
33226	chr6	14876832	14877788	956	478.0	
33227	chr6	14881350	14881764	414	207.0	
33228	chr6	14883899	14884255	356	178.0	
33229	chr6	14889222	14889604	382	191.0	
33230	chr6	14890141	14890600	459	230.0	
33231	chr6	14897797	14898227	430	215.0	
33232	chr6	14910342	14911660	1318	659.0	
33233	chr6	14919405	14919916	511	256.0	
33234	chr6	14920914	14923453	2539	1270.0	
33235	chr6	14927414	14927774	360	180.0	
33236	chr6	14929543	14929598	55	28.0	
33237	chr6	14946814	14947795	981	490.0	
33238	chr6	14953922	14954186	264	132.0	
33239	chr6	14957641	14958089	448	224.0	
33240	chr6	14967014	14967799	785	392.0	
33241	chr6	14972689	14973022	333	166.0	
33242	chr6	14975433	14975897	464	232.0	
33243	chr6	14981990	14982391	401	200.0	
33244	chr6	15017306	15017729	423	212.0	
33245	chr6	15021780	15022166	386	193.0	
33246	chr6	15023218	15023928	710	355.0	
33247	chr6	15061133	15061839	706	353.0	
33248	chr6	15062391	15063913	1522	761.0	
33249	chr6	15066521	15067507	986	493.0	
33250	chr6	15084532	15085081	549	274.0	
33251	chr6	15086732	15086906	174	87.0	
33252	chr6	15089700	15090153	453	226.0	
33253	chr6	15091340	15091889	549	274.0	
33254	chr6	15129966	15130366	400	200.0	
33255	chr6	15133302	15133307	5	2.0	
33256	chr6	15151102	15151688	586	293.0	
33257	chr6	15193518	15193872	354	177.0	
33258	chr6	15194600	15194805	205	102.0	
33259	chr6	15219397	15220229	832	416.0	
33260	chr6	15223033	15223729	696	348.0	
33261	chr6	15232886	15233170	284	142.0	
33262	chr6	15243384	15243507	123	62.0	
33263	chr6	15244458	15255003	10545	5272.0	enhancer
33264	chr6	15255525	15256371	846	423.0	
33265	chr6	15258721	15259868	1147	574.0	
33266	chr6	15260759	15260776	17	8.0	
33267	chr6	15261419	15261437	18	9.0	
33268	chr6	15262619	15262670	51	26.0	
33269	chr6	15264771	15267647	2876	1438.0	
33270	chr6	15287439	15288322	883	442.0	
33271	chr6	15293173	15293557	384	192.0	
33272	chr6	15296571	15297151	580	290.0	
33273	chr6	15297887	15298228	341	170.0	
33274	chr6	15299189	15301163	1974	987.0	
33275	chr6	15305290	15306294	1004	502.0	
33276	chr6	15308257	15309167	910	455.0	
33277	chr6	15312455	15314056	1601	800.0	
33278	chr6	15318338	15318542	204	102.0	
33279	chr6	15325479	15326539	1060	530.0	
33280	chr6	15327241	15327751	510	255.0	
33281	chr6	15329175	15329518	343	172.0	
33282	chr6	15330440	15331528	1088	544.0	
33283	chr6	15335432	15335833	401	200.0	
33284	chr6	15336882	15338871	1989	994.0	
33285	chr6	15340432	15341356	924	462.0	
33286	chr6	15343819	15344224	405	202.0	
33287	chr6	15352312	15352588	276	138.0	
33288	chr6	15355711	15356577	866	433.0	
33289	chr6	15358798	15359116	318	159.0	
33290	chr6	15362756	15363103	347	174.0	
33291	chr6	15364062	15364457	395	198.0	
33292	chr6	15365180	15365756	576	288.0	
33293	chr6	15368116	15368852	736	368.0	
33294	chr6	15384793	15385213	420	210.0	
33295	chr6	15389627	15390726	1099	550.0	
33296	chr6	15398419	15399291	872	436.0	
33297	chr6	15400600	15401097	497	248.0	
33298	chr6	15403791	15404827	1036	518.0	
33299	chr6	15420861	15421764	903	452.0	
33300	chr6	15422325	15422842	517	258.0	
33301	chr6	15426927	15428200	1273	636.0	
33302	chr6	15429102	15430196	1094	547.0	
33303	chr6	15432196	15433676	1480	740.0	
33304	chr6	15437060	15437597	537	268.0	
33305	chr6	15438823	15439219	396	198.0	
33306	chr6	15441173	15441693	520	260.0	
33307	chr6	15443125	15443509	384	192.0	
33308	chr6	15452092	15452621	529	264.0	
33309	chr6	15464245	15464719	474	237.0	
33310	chr6	15473614	15474694	1080	540.0	
33311	chr6	15486156	15486400	244	122.0	
33312	chr6	15491145	15491971	826	413.0	
33313	chr6	15498716	15498717	1	0.0	
33314	chr6	15505615	15505786	171	86.0	
33315	chr6	15508278	15509188	910	455.0	
33316	chr6	15512750	15513656	906	453.0	
33317	chr6	15514251	15514652	401	200.0	
33318	chr6	15517614	15517974	360	180.0	
33319	chr6	15522286	15522843	557	278.0	
33320	chr6	15534832	15535484	652	326.0	
33321	chr6	15543279	15543896	617	308.0	
33322	chr6	15580354	15580719	365	182.0	
33323	chr6	15595327	15595931	604	302.0	
33324	chr6	15612551	15613293	742	371.0	
33325	chr6	15621635	15622649	1014	507.0	
33326	chr6	15623449	15623936	487	244.0	
33327	chr6	15628741	15629114	373	186.0	
33328	chr6	15658375	15658745	370	185.0	
33329	chr6	15661810	15663851	2041	1020.0	
33330	chr6	15672204	15672733	529	264.0	
33331	chr6	15674596	15676082	1486	743.0	
33332	chr6	15689762	15690271	509	254.0	
33333	chr6	15691062	15691757	695	348.0	
33334	chr6	15744958	15745058	100	50.0	
33335	chr6	15795483	15796066	583	292.0	
33336	chr6	15876321	15877619	1298	649.0	
33337	chr6	15879943	15880413	470	235.0	
33338	chr6	15881044	15881627	583	292.0	
33339	chr6	15897078	15897564	486	243.0	
33340	chr6	15900985	15902278	1293	646.0	
33341	chr6	15905710	15906200	490	245.0	
33342	chr6	15929666	15930060	394	197.0	
33343	chr6	15936519	15937001	482	241.0	
33344	chr6	15961329	15961695	366	183.0	
33345	chr6	15993889	15994152	263	132.0	
33346	chr6	16097349	16097750	401	200.0	
33347	chr6	16105860	16106349	489	244.0	
33348	chr6	16109956	16110017	61	30.0	
33349	chr6	16124433	16124820	387	194.0	
33350	chr6	16128269	16131624	3355	1678.0	
33351	chr6	16132808	16137777	4969	2484.0	
33352	chr6	16138302	16141895	3593	1796.0	
33353	chr6	16142450	16147862	5412	2706.0	
33354	chr6	16148479	16161361	12882	6441.0	
33355	chr6	16161948	16162423	475	238.0	
33356	chr6	16163427	16163770	343	172.0	
33357	chr6	16165425	16165991	566	283.0	
33358	chr6	16168144	16169306	1162	581.0	
33359	chr6	16179523	16180838	1315	658.0	
33360	chr6	16183019	16184574	1555	778.0	
33361	chr6	16205265	16207043	1778	889.0	
33362	chr6	16224432	16224811	379	190.0	
33363	chr6	16236541	16237229	688	344.0	
33364	chr6	16237884	16240072	2188	1094.0	
33365	chr6	16252653	16253085	432	216.0	
33366	chr6	16286328	16286329	1	0.0	
33367	chr6	16305321	16305844	523	262.0	
33368	chr6	16316479	16317273	794	397.0	
33369	chr6	16318573	16320842	2269	1134.0	
33370	chr6	16322218	16323995	1777	888.0	
33371	chr6	16331258	16332747	1489	744.0	
33372	chr6	16334680	16335076	396	198.0	
33373	chr6	16342319	16342686	367	184.0	
33374	chr6	16404588	16404878	290	145.0	
33375	chr6	16406439	16407079	640	320.0	
33376	chr6	16409607	16410262	655	328.0	
33377	chr6	16413112	16414486	1374	687.0	
33378	chr6	16419869	16421912	2043	1022.0	
33379	chr6	16436427	16438363	1936	968.0	
33380	chr6	16439258	16439373	115	58.0	
33381	chr6	16471453	16471785	332	166.0	
33382	chr6	16473120	16475296	2176	1088.0	
33383	chr6	16481019	16482405	1386	693.0	
33384	chr6	16483092	16484018	926	463.0	
33385	chr6	16486325	16487114	789	394.0	
33386	chr6	16487976	16488861	885	442.0	
33387	chr6	16494781	16495156	375	188.0	
33388	chr6	16503883	16504435	552	276.0	
33389	chr6	16511043	16511444	401	200.0	
33390	chr6	16511974	16512464	490	245.0	
33391	chr6	16514231	16514728	497	248.0	
33392	chr6	16585772	16586631	859	430.0	
33393	chr6	16588150	16588647	497	248.0	
33394	chr6	16591595	16592248	653	326.0	
33395	chr6	16619732	16620133	401	200.0	
33396	chr6	16651611	16652417	806	403.0	
33397	chr6	16654461	16655321	860	430.0	
33398	chr6	16659299	16660258	959	480.0	
33399	chr6	16669079	16670668	1589	794.0	
33400	chr6	16671296	16671549	253	126.0	
33401	chr6	16681197	16682036	839	420.0	
33402	chr6	16683668	16685640	1972	986.0	
33403	chr6	16690794	16691600	806	403.0	
33404	chr6	16694645	16695588	943	472.0	
33405	chr6	16697727	16698523	796	398.0	
33406	chr6	16699101	16701494	2393	1196.0	
33407	chr6	16704025	16705817	1792	896.0	
33408	chr6	16706425	16707874	1449	724.0	
33409	chr6	16711487	16714320	2833	1416.0	
33410	chr6	16723877	16724284	407	204.0	
33411	chr6	16725166	16727147	1981	990.0	
33412	chr6	16727764	16728643	879	440.0	
33413	chr6	16729326	16729837	511	256.0	
33414	chr6	16731142	16732150	1008	504.0	
33415	chr6	16741052	16741513	461	230.0	
33416	chr6	16743666	16743960	294	147.0	
33417	chr6	16747383	16747760	377	188.0	
33418	chr6	16752255	16753012	757	378.0	
33419	chr6	16756940	16757282	342	171.0	
33420	chr6	16758259	16765019	6760	3380.0	
33421	chr6	16766141	16766529	388	194.0	
33422	chr6	16768789	16769775	986	493.0	
33423	chr6	16770693	16771638	945	472.0	
33424	chr6	16801195	16801245	50	25.0	
33425	chr6	16824710	16825665	955	478.0	
33426	chr6	16832263	16832652	389	194.0	
33427	chr6	16836445	16836884	439	220.0	
33428	chr6	16837602	16837968	366	183.0	
33429	chr6	16849248	16849758	510	255.0	
33430	chr6	16851798	16852297	499	250.0	
33431	chr6	16903462	16903989	527	264.0	
33432	chr6	16964822	16965328	506	253.0	
33433	chr6	17015253	17016575	1322	661.0	
33434	chr6	17156102	17156514	412	206.0	
33435	chr6	17580042	17581031	989	494.0	
33436	chr6	17584089	17584847	758	379.0	
33437	chr6	17585839	17586500	661	330.0	
33438	chr6	17589464	17590187	723	362.0	
33439	chr6	17591152	17591979	827	414.0	
33440	chr6	17599653	17601720	2067	1034.0	
33441	chr6	17603303	17603439	136	68.0	
33442	chr6	17633113	17633988	875	438.0	
33443	chr6	17664039	17665071	1032	516.0	
33444	chr6	17673540	17673865	325	162.0	
33445	chr6	17689710	17689972	262	131.0	
33446	chr6	17691911	17692303	392	196.0	
33447	chr6	17700439	17707667	7228	3614.0	
33448	chr6	17714925	17715745	820	410.0	
33449	chr6	17804141	17804611	470	235.0	
33450	chr6	17807480	17807786	306	153.0	
33451	chr6	17815265	17815754	489	244.0	
33452	chr6	17881402	17881920	518	259.0	
33453	chr6	17884511	17885478	967	484.0	
33454	chr6	17892071	17892533	462	231.0	
33455	chr6	17907305	17909260	1955	978.0	
33456	chr6	17910165	17910566	401	200.0	
33457	chr6	17932172	17932962	790	395.0	
33458	chr6	17972767	17972943	176	88.0	
33459	chr6	17980440	17980455	15	8.0	
33460	chr6	17983887	17984400	513	256.0	
33461	chr6	17986588	17988644	2056	1028.0	
33462	chr6	17993163	17994040	877	438.0	
33463	chr6	17998012	17998457	445	222.0	
33464	chr6	18122121	18123208	1087	544.0	
33465	chr6	18148279	18148573	294	147.0	
33466	chr6	18152551	18153756	1205	602.0	
33467	chr6	18154322	18156644	2322	1161.0	
33468	chr6	18166348	18167026	678	339.0	
33469	chr6	18171762	18172324	562	281.0	
33470	chr6	18179944	18180403	459	230.0	
33471	chr6	18186385	18187062	677	338.0	
33472	chr6	18213568	18213765	197	98.0	
33473	chr6	18215214	18215930	716	358.0	
33474	chr6	18245590	18245983	393	196.0	
33475	chr6	18260213	18262041	1828	914.0	
33476	chr6	18262646	18265507	2861	1430.0	
33477	chr6	18269205	18269669	464	232.0	
33478	chr6	18317798	18318273	475	238.0	
33479	chr6	18323945	18324612	667	334.0	
33480	chr6	18327508	18329062	1554	777.0	
33481	chr6	18330169	18331333	1164	582.0	
33482	chr6	18350582	18351213	631	316.0	
33483	chr6	18359474	18359893	419	210.0	
33484	chr6	18386899	18388684	1785	892.0	
33485	chr6	18391082	18391382	300	150.0	
33486	chr6	18400661	18401597	936	468.0	
33487	chr6	18411994	18412734	740	370.0	
33488	chr6	18413528	18413625	97	48.0	
33489	chr6	18432127	18432595	468	234.0	
33490	chr6	18436257	18436790	533	266.0	
33491	chr6	18473682	18474085	403	202.0	
33492	chr6	18477528	18478053	525	262.0	
33493	chr6	18501354	18502188	834	417.0	
33494	chr6	18503546	18504422	876	438.0	
33495	chr6	18596274	18596580	306	153.0	
33496	chr6	19804536	19805114	578	289.0	
33497	chr6	19999830	19999957	127	64.0	
33498	chr6	20023496	20024340	844	422.0	
33499	chr6	20092001	20092465	464	232.0	
33500	chr6	20126717	20127168	451	226.0	
33501	chr6	20168610	20169769	1159	580.0	
33502	chr6	20173627	20174763	1136	568.0	
33503	chr6	20177763	20178101	338	169.0	
33504	chr6	20201868	20202336	468	234.0	
33505	chr6	20204406	20204905	499	250.0	
33506	chr6	20205633	20207473	1840	920.0	
33507	chr6	20211027	20213841	2814	1407.0	
33508	chr6	20238194	20238316	122	61.0	
33509	chr6	20256502	20256940	438	219.0	
33510	chr6	20291443	20292302	859	430.0	
33511	chr6	20319050	20320904	1854	927.0	
33512	chr6	20325911	20326622	711	356.0	
33513	chr6	20335812	20336416	604	302.0	
33514	chr6	20365405	20367375	1970	985.0	
33515	chr6	20377692	20378028	336	168.0	
33516	chr6	20399572	20405160	5588	2794.0	
33517	chr6	20409340	20410448	1108	554.0	
33518	chr6	20411354	20411770	416	208.0	
33519	chr6	20415918	20417047	1129	564.0	
33520	chr6	20417836	20418209	373	186.0	
33521	chr6	20424651	20425219	568	284.0	
33522	chr6	20427835	20428153	318	159.0	
33523	chr6	20444597	20445402	805	402.0	
33524	chr6	20454205	20454572	367	184.0	
33525	chr6	20463415	20463918	503	252.0	
33526	chr6	20474767	20475182	415	208.0	
33527	chr6	20483907	20484803	896	448.0	
33528	chr6	20497717	20498136	419	210.0	
33529	chr6	20528082	20529687	1605	802.0	
33530	chr6	20534063	20535299	1236	618.0	
33531	chr6	20550413	20550811	398	199.0	
33532	chr6	20564189	20564527	338	169.0	
33533	chr6	20708315	20708736	421	210.0	
33534	chr6	20837197	20837603	406	203.0	
33535	chr6	21164843	21165386	543	272.0	
33536	chr6	21438227	21438975	748	374.0	
33537	chr6	21586902	21589836	2934	1467.0	
33538	chr6	21593071	21597357	4286	2143.0	
33539	chr6	21608401	21609026	625	312.0	
33540	chr6	21664605	21665016	411	206.0	
33541	chr6	21665848	21666590	742	371.0	
33542	chr6	21847171	21847416	245	122.0	
33543	chr6	21855591	21857374	1783	892.0	
33544	chr6	21860954	21861161	207	104.0	
33545	chr6	21877064	21877370	306	153.0	
33546	chr6	21914065	21914468	403	202.0	
33547	chr6	21935596	21935981	385	192.0	
33548	chr6	21953847	21954050	203	102.0	
33549	chr6	21970615	21971014	399	200.0	
33550	chr6	21987316	21988147	831	416.0	
33551	chr6	22025075	22026380	1305	652.0	
33552	chr6	22062674	22063577	903	452.0	
33553	chr6	22071744	22071966	222	111.0	
33554	chr6	22073480	22073926	446	223.0	
33555	chr6	22146108	22146410	302	151.0	
33556	chr6	22153685	22154232	547	274.0	
33557	chr6	22302918	22303267	349	174.0	
33558	chr6	22366162	22366750	588	294.0	
33559	chr6	23280706	23280778	72	36.0	
33560	chr6	24228651	24229109	458	229.0	
33561	chr6	24236746	24237189	443	222.0	
33562	chr6	24282958	24284046	1088	544.0	
33563	chr6	24357465	24358492	1027	514.0	
33564	chr6	24359627	24360565	938	469.0	
33565	chr6	24395044	24395427	383	192.0	
33566	chr6	24402517	24403732	1215	608.0	
33567	chr6	24430991	24431447	456	228.0	
33568	chr6	24494286	24495972	1686	843.0	
33569	chr6	24497496	24497525	29	14.0	
33570	chr6	24517663	24518280	617	308.0	
33571	chr6	24520960	24521348	388	194.0	
33572	chr6	24522463	24522556	93	46.0	
33573	chr6	24574846	24575230	384	192.0	
33574	chr6	24581008	24581550	542	271.0	
33575	chr6	24583342	24583841	499	250.0	
33576	chr6	24645463	24646862	1399	700.0	
33577	chr6	24658762	24659412	650	325.0	
33578	chr6	24665980	24669110	3130	1565.0	
33579	chr6	24695496	24696163	667	334.0	
33580	chr6	24701960	24703362	1402	701.0	
33581	chr6	24710765	24711236	471	236.0	
33582	chr6	24712119	24712501	382	191.0	
33583	chr6	24716316	24722219	5903	2952.0	
33584	chr6	24743139	24744323	1184	592.0	
33585	chr6	24744842	24745530	688	344.0	
33586	chr6	24749113	24749739	626	313.0	
33587	chr6	24757569	24758027	458	229.0	
33588	chr6	24766664	24767148	484	242.0	
33589	chr6	24774265	24776593	2328	1164.0	
33590	chr6	24797897	24797925	28	14.0	
33591	chr6	24799208	24799626	418	209.0	
33592	chr6	24802435	24802965	530	265.0	
33593	chr6	24830303	24830622	319	160.0	
33594	chr6	24831442	24831447	5	2.0	
33595	chr6	24833997	24836382	2385	1192.0	
33596	chr6	24837262	24837614	352	176.0	
33597	chr6	24838312	24840593	2281	1140.0	
33598	chr6	24844220	24844435	215	108.0	
33599	chr6	24845547	24846012	465	232.0	
33600	chr6	24855586	24859522	3936	1968.0	
33601	chr6	24860723	24860939	216	108.0	
33602	chr6	24861875	24863000	1125	562.0	
33603	chr6	24867315	24867446	131	66.0	
33604	chr6	24876837	24876851	14	7.0	
33605	chr6	24899653	24902358	2705	1352.0	
33606	chr6	24906404	24906409	5	2.0	
33607	chr6	24907436	24913393	5957	2978.0	
33608	chr6	24918610	24919933	1323	662.0	
33609	chr6	24921100	24921479	379	190.0	
33610	chr6	24922132	24922607	475	238.0	
33611	chr6	24924058	24928349	4291	2146.0	
33612	chr6	24929082	24930009	927	464.0	
33613	chr6	24931841	24934557	2716	1358.0	
33614	chr6	24935069	24938501	3432	1716.0	
33615	chr6	24940266	24940744	478	239.0	
33616	chr6	24948399	24950233	1834	917.0	
33617	chr6	24950762	24952728	1966	983.0	
33618	chr6	24957293	24957526	233	116.0	
33619	chr6	24959346	24959765	419	210.0	
33620	chr6	24960762	24961389	627	314.0	
33621	chr6	24968630	24969288	658	329.0	
33622	chr6	24974102	24975203	1101	550.0	
33623	chr6	24991398	24992499	1101	550.0	
33624	chr6	24996280	24997645	1365	682.0	
33625	chr6	25006101	25007862	1761	880.0	
33626	chr6	25010241	25010497	256	128.0	
33627	chr6	25014961	25015807	846	423.0	
33628	chr6	25017524	25018433	909	454.0	
33629	chr6	25022028	25022439	411	206.0	
33630	chr6	25026974	25028064	1090	545.0	
33631	chr6	25034234	25036814	2580	1290.0	
33632	chr6	25038763	25039517	754	377.0	
33633	chr6	25040684	25043505	2821	1410.0	
33634	chr6	25050237	25050960	723	362.0	
33635	chr6	25053609	25054329	720	360.0	
33636	chr6	25055837	25056777	940	470.0	
33637	chr6	25070377	25071399	1022	511.0	
33638	chr6	25085773	25086173	400	200.0	
33639	chr6	25112195	25112696	501	250.0	
33640	chr6	25136236	25139175	2939	1470.0	
33641	chr6	25147147	25147484	337	168.0	
33642	chr6	25167915	25168322	407	204.0	
33643	chr6	25173821	25174582	761	380.0	
33644	chr6	25223407	25223936	529	264.0	
33645	chr6	25265618	25266120	502	251.0	
33646	chr6	25278518	25281367	2849	1424.0	
33647	chr6	25298695	25298722	27	14.0	
33648	chr6	25301137	25301760	623	312.0	
33649	chr6	25332645	25333010	365	182.0	
33650	chr6	25363438	25363786	348	174.0	
33651	chr6	25364732	25365040	308	154.0	
33652	chr6	25366724	25367766	1042	521.0	
33653	chr6	25369409	25370031	622	311.0	
33654	chr6	25404094	25406222	2128	1064.0	
33655	chr6	25410182	25410600	418	209.0	
33656	chr6	25435482	25435849	367	184.0	
33657	chr6	25446816	25447999	1183	592.0	
33658	chr6	25451982	25452383	401	200.0	
33659	chr6	25463441	25463959	518	259.0	
33660	chr6	25474824	25475138	314	157.0	
33661	chr6	25489969	25490536	567	284.0	
33662	chr6	25497405	25498129	724	362.0	
33663	chr6	25556422	25556813	391	196.0	
33664	chr6	25564923	25565324	401	200.0	
33665	chr6	25602438	25602730	292	146.0	
33666	chr6	25720380	25720867	487	244.0	
33667	chr6	25749823	25750226	403	202.0	
33668	chr6	25788475	25788919	444	222.0	
33669	chr6	25865766	25866540	774	387.0	
33670	chr6	25872759	25873284	525	262.0	
33671	chr6	25875043	25875158	115	58.0	
33672	chr6	25881720	25882686	966	483.0	
33673	chr6	25890443	25890811	368	184.0	
33674	chr6	25942579	25942857	278	139.0	
33675	chr6	25959173	25960515	1342	671.0	
33676	chr6	25961662	25964185	2523	1262.0	
33677	chr6	25991572	25993434	1862	931.0	
33678	chr6	26003069	26003535	466	233.0	
33679	chr6	26017372	26018119	747	374.0	
33680	chr6	26019998	26022770	2772	1386.0	
33681	chr6	26025498	26028024	2526	1263.0	
33682	chr6	26031488	26034631	3143	1572.0	
33683	chr6	26042964	26046059	3095	1548.0	
33684	chr6	26054119	26057319	3200	1600.0	
33685	chr6	26060392	26060698	306	153.0	
33686	chr6	26064431	26065097	666	333.0	
33687	chr6	26065817	26066568	751	376.0	
33688	chr6	26086176	26088288	2112	1056.0	
33689	chr6	26092343	26092944	601	300.0	
33690	chr6	26094257	26094350	93	46.0	
33691	chr6	26097173	26097881	708	354.0	
33692	chr6	26103314	26105058	1744	872.0	
33693	chr6	26122085	26127468	5383	2692.0	
33694	chr6	26131343	26131353	10	5.0	
33695	chr6	26155411	26161158	5747	2874.0	
33696	chr6	26164056	26164360	304	152.0	
33697	chr6	26165983	26166372	389	194.0	
33698	chr6	26170131	26173774	3643	1822.0	
33699	chr6	26175301	26176248	947	474.0	
33700	chr6	26183133	26184579	1446	723.0	
33701	chr6	26187998	26189769	1771	886.0	
33702	chr6	26194837	26200425	5588	2794.0	
33703	chr6	26203947	26206696	2749	1374.0	
33704	chr6	26214529	26218268	3739	1870.0	
33705	chr6	26222767	26225264	2497	1248.0	
33706	chr6	26230377	26231007	630	315.0	
33707	chr6	26232521	26235681	3160	1580.0	
33708	chr6	26239926	26241651	1725	862.0	
33709	chr6	26249290	26253400	4110	2055.0	
33710	chr6	26260111	26261575	1464	732.0	
33711	chr6	26270500	26274660	4160	2080.0	
33712	chr6	26283984	26287130	3146	1573.0	
33713	chr6	26295514	26296025	511	256.0	
33714	chr6	26303713	26305822	2109	1054.0	
33715	chr6	26307829	26308323	494	247.0	
33716	chr6	26309673	26310100	427	214.0	
33717	chr6	26310814	26314215	3401	1700.0	
33718	chr6	26321740	26324195	2455	1228.0	
33719	chr6	26327394	26329012	1618	809.0	
33720	chr6	26329760	26332365	2605	1302.0	
33721	chr6	26336355	26336756	401	200.0	
33722	chr6	26341325	26342684	1359	680.0	
33723	chr6	26358683	26358730	47	24.0	
33724	chr6	26360626	26361456	830	415.0	
33725	chr6	26364016	26365860	1844	922.0	
33726	chr6	26367105	26367575	470	235.0	
33727	chr6	26375461	26375534	73	36.0	
33728	chr6	26376233	26376565	332	166.0	
33729	chr6	26382612	26384134	1522	761.0	
33730	chr6	26385139	26385799	660	330.0	
33731	chr6	26389211	26389734	523	262.0	
33732	chr6	26393177	26393609	432	216.0	
33733	chr6	26397086	26397093	7	4.0	
33734	chr6	26400655	26403333	2678	1339.0	
33735	chr6	26404547	26404948	401	200.0	
33736	chr6	26420380	26422305	1925	962.0	
33737	chr6	26439401	26441237	1836	918.0	
33738	chr6	26441873	26442259	386	193.0	
33739	chr6	26445756	26446428	672	336.0	
33740	chr6	26457231	26459442	2211	1106.0	
33741	chr6	26472670	26475652	2982	1491.0	
33742	chr6	26476808	26477523	715	358.0	
33743	chr6	26478792	26479411	619	310.0	
33744	chr6	26493287	26493641	354	177.0	
33745	chr6	26501406	26502384	978	489.0	
33746	chr6	26520215	26523216	3001	1500.0	
33747	chr6	26525924	26526148	224	112.0	
33748	chr6	26531915	26533659	1744	872.0	
33749	chr6	26536484	26539300	2816	1408.0	
33750	chr6	26540104	26540133	29	14.0	
33751	chr6	26543904	26544356	452	226.0	
33752	chr6	26545558	26546155	597	298.0	
33753	chr6	26550211	26551112	901	450.0	"enhancer	sequence_feature"
33754	chr6	26552851	26557078	4227	2114.0	
33755	chr6	26567793	26570752	2959	1480.0	
33756	chr6	26571379	26573213	1834	917.0	
33757	chr6	26576338	26578028	1690	845.0	
33758	chr6	26595309	26597698	2389	1194.0	
33759	chr6	26607294	26608027	733	366.0	
33760	chr6	26613757	26614601	844	422.0	
33761	chr6	26658917	26660490	1573	786.0	
33762	chr6	26955963	26957286	1323	662.0	
33763	chr6	27019465	27020583	1118	559.0	
33764	chr6	27078639	27079318	679	340.0	
33765	chr6	27096814	27097240	426	213.0	
33766	chr6	27120833	27121306	473	236.0	
33767	chr6	27126701	27127700	999	500.0	
33768	chr6	27129333	27129376	43	22.0	
33769	chr6	27131209	27134801	3592	1796.0	
33770	chr6	27138801	27140293	1492	746.0	
33771	chr6	27144663	27148072	3409	1704.0	
33772	chr6	27154609	27155352	743	372.0	
33773	chr6	27157233	27158578	1345	672.0	
33774	chr6	27161759	27162475	716	358.0	
33775	chr6	27176090	27178916	2826	1413.0	
33776	chr6	27187724	27189295	1571	786.0	
33777	chr6	27206056	27206284	228	114.0	
33778	chr6	27250784	27252324	1540	770.0	
33779	chr6	27312169	27313185	1016	508.0	
33780	chr6	27332776	27333543	767	384.0	
33781	chr6	27374404	27376077	1673	836.0	
33782	chr6	27388356	27389756	1400	700.0	
33783	chr6	27471984	27473939	1955	978.0	
33784	chr6	27478102	27480310	2208	1104.0	
33785	chr6	27495542	27495967	425	212.0	
33786	chr6	27502390	27506371	3981	1990.0	
33787	chr6	27515153	27515210	57	28.0	
33788	chr6	27518332	27519945	1613	806.0	
33789	chr6	27592537	27593097	560	280.0	
33790	chr6	27600843	27601213	370	185.0	
33791	chr6	27601926	27601930	4	2.0	
33792	chr6	27672255	27672710	455	228.0	
33793	chr6	27684334	27685631	1297	648.0	
33794	chr6	27687096	27688835	1739	870.0	
33795	chr6	27693601	27694710	1109	554.0	
33796	chr6	27738173	27738998	825	412.0	
33797	chr6	27751925	27754519	2594	1297.0	
33798	chr6	27755678	27756357	679	340.0	
33799	chr6	27757118	27757888	770	385.0	
33800	chr6	27772166	27773106	940	470.0	
33801	chr6	27773724	27774270	546	273.0	
33802	chr6	27791306	27793148	1842	921.0	
33803	chr6	27795434	27796475	1041	520.0	
33804	chr6	27806701	27809085	2384	1192.0	
33805	chr6	27809650	27811350	1700	850.0	
33806	chr6	27813871	27815709	1838	919.0	
33807	chr6	27819692	27820073	381	190.0	
33808	chr6	27823509	27825422	1913	956.0	
33809	chr6	27830300	27832056	1756	878.0	
33810	chr6	27836399	27840109	3710	1855.0	
33811	chr6	27864159	27868077	3918	1959.0	
33812	chr6	27871200	27874365	3165	1582.0	
33813	chr6	27890000	27896427	6427	3214.0	
33814	chr6	27902121	27903667	1546	773.0	
33815	chr6	28079567	28082082	2515	1258.0	
33816	chr6	28104278	28105734	1456	728.0	
33817	chr6	28123993	28125926	1933	966.0	
33818	chr6	28133950	28138310	4360	2180.0	
33819	chr6	28139928	28140733	805	402.0	
33820	chr6	28141243	28142396	1153	576.0	
33821	chr6	28161427	28162215	788	394.0	
33822	chr6	28207544	28208181	637	318.0	
33823	chr6	28212423	28212853	430	215.0	
33824	chr6	28218413	28219237	824	412.0	
33825	chr6	28224991	28225896	905	452.0	
33826	chr6	28251520	28252894	1374	687.0	
33827	chr6	28253611	28254607	996	498.0	
33828	chr6	28258794	28259544	750	375.0	
33829	chr6	28266655	28267763	1108	554.0	
33830	chr6	28281308	28281998	690	345.0	
33831	chr6	28334645	28337348	2703	1352.0	
33832	chr6	28349505	28350583	1078	539.0	
33833	chr6	28355199	28356746	1547	774.0	
33834	chr6	28368510	28369026	516	258.0	
33835	chr6	28371928	28372193	265	132.0	
33836	chr6	28382943	28383985	1042	521.0	
33837	chr6	28399158	28400346	1188	594.0	
33838	chr6	28442963	28443915	952	476.0	
33839	chr6	28449039	28449480	441	220.0	
33840	chr6	28489238	28490255	1017	508.0	
33841	chr6	28523169	28523587	418	209.0	
33842	chr6	28537426	28537842	416	208.0	
33843	chr6	28542515	28544285	1770	885.0	
33844	chr6	28586947	28587586	639	320.0	
33845	chr6	28589286	28589594	308	154.0	
33846	chr6	28606971	28607074	103	52.0	
33847	chr6	28657994	28658391	397	198.0	
33848	chr6	28684170	28684623	453	226.0	
33849	chr6	28686394	28686867	473	236.0	
33850	chr6	28729050	28729540	490	245.0	
33851	chr6	28837224	28839700	2476	1238.0	
33852	chr6	28848660	28849244	584	292.0	
33853	chr6	28862847	28864644	1797	898.0	
33854	chr6	28865596	28867494	1898	949.0	
33855	chr6	28880807	28881601	794	397.0	
33856	chr6	28883998	28886084	2086	1043.0	
33857	chr6	28895178	28898749	3571	1786.0	
33858	chr6	28900852	28901244	392	196.0	
33859	chr6	28906583	28907760	1177	588.0	
33860	chr6	28917326	28918106	780	390.0	
33861	chr6	28921996	28924762	2766	1383.0	
33862	chr6	28934389	28935134	745	372.0	
33863	chr6	28939620	28942206	2586	1293.0	
33864	chr6	28943313	28945841	2528	1264.0	
33865	chr6	28952988	28954144	1156	578.0	
33866	chr6	28977159	28978268	1109	554.0	
33867	chr6	28980613	28983241	2628	1314.0	
33868	chr6	28985434	28986084	650	325.0	
33869	chr6	28988318	28989238	920	460.0	
33870	chr6	29005200	29005926	726	363.0	
33871	chr6	29011186	29011907	721	360.0	
33872	chr6	29015662	29017557	1895	948.0	
33873	chr6	29516062	29516499	437	218.0	
33874	chr6	29552449	29554092	1643	822.0	
33875	chr6	29589407	29589866	459	230.0	
33876	chr6	29618148	29618459	311	156.0	
33877	chr6	29625073	29629456	4383	2192.0	
33878	chr6	29631559	29634900	3341	1670.0	
33879	chr6	29641537	29642257	720	360.0	
33880	chr6	29647971	29648295	324	162.0	
33881	chr6	29649237	29650817	1580	790.0	
33882	chr6	29651369	29652076	707	354.0	
33883	chr6	29653388	29653875	487	244.0	
33884	chr6	29677282	29677298	16	8.0	
33885	chr6	29680029	29681434	1405	702.0	
33886	chr6	29696755	29696902	147	74.0	
33887	chr6	29702446	29702945	499	250.0	
33888	chr6	29705445	29706262	817	408.0	
33889	chr6	29707136	29707495	359	180.0	
33890	chr6	29708190	29709785	1595	798.0	
33891	chr6	29720842	29721298	456	228.0	
33892	chr6	29721955	29733344	11389	5694.0	
33893	chr6	29734179	29735005	826	413.0	
33894	chr6	29737782	29738626	844	422.0	
33895	chr6	29747927	29750304	2377	1188.0	
33896	chr6	29752082	29753561	1479	740.0	
33897	chr6	29791871	29793574	1703	852.0	
33898	chr6	29813806	29814264	458	229.0	
33899	chr6	29827715	29828810	1095	548.0	
33900	chr6	29834771	29835294	523	262.0	
33901	chr6	29847797	29848632	835	418.0	
33902	chr6	29849969	29850488	519	260.0	
33903	chr6	29870169	29870445	276	138.0	
33904	chr6	29887269	29888905	1636	818.0	
33905	chr6	29917921	29917948	27	14.0	
33906	chr6	29926118	29927690	1572	786.0	
33907	chr6	29940279	29953996	13717	6858.0	
33908	chr6	29958919	29959902	983	492.0	
33909	chr6	29964563	29966713	2150	1075.0	enhancer
33910	chr6	29967461	29968131	670	335.0	
33911	chr6	29974817	29977504	2687	1344.0	
33912	chr6	30006167	30007698	1531	766.0	
33913	chr6	30013239	30013789	550	275.0	
33914	chr6	30033323	30033875	552	276.0	
33915	chr6	30037189	30037571	382	191.0	
33916	chr6	30060268	30063153	2885	1442.0	
33917	chr6	30065960	30067899	1939	970.0	
33918	chr6	30069140	30069335	195	98.0	
33919	chr6	30070515	30072493	1978	989.0	
33920	chr6	30073401	30076328	2927	1464.0	
33921	chr6	30097925	30098269	344	172.0	
33922	chr6	30100577	30104078	3501	1750.0	
33923	chr6	30127926	30127963	37	18.0	
33924	chr6	30129978	30130051	73	36.0	
33925	chr6	30130597	30131623	1026	513.0	
33926	chr6	30163155	30163304	149	74.0	
33927	chr6	30169962	30170434	472	236.0	
33928	chr6	30171702	30172320	618	309.0	
33929	chr6	30200544	30202199	1655	828.0	
33930	chr6	30207059	30207118	59	30.0	
33931	chr6	30210040	30210750	710	355.0	
33932	chr6	30212037	30214965	2928	1464.0	
33933	chr6	30218962	30219770	808	404.0	
33934	chr6	30227688	30228262	574	287.0	
33935	chr6	30234341	30234753	412	206.0	
33936	chr6	30238429	30238856	427	214.0	
33937	chr6	30258179	30260643	2464	1232.0	
33938	chr6	30318154	30318639	485	242.0	
33939	chr6	30322509	30323461	952	476.0	
33940	chr6	30324612	30328001	3389	1694.0	
33941	chr6	30329226	30329939	713	356.0	
33942	chr6	30330655	30331040	385	192.0	
33943	chr6	30341442	30341952	510	255.0	
33944	chr6	30344504	30345885	1381	690.0	
33945	chr6	30357527	30358393	866	433.0	
33946	chr6	30396633	30397486	853	426.0	
33947	chr6	30411370	30412043	673	336.0	
33948	chr6	30444156	30444442	286	143.0	
33949	chr6	30447447	30447501	54	27.0	
33950	chr6	30450345	30454142	3797	1898.0	
33951	chr6	30462078	30462192	114	57.0	
33952	chr6	30463077	30467270	4193	2096.0	
33953	chr6	30480381	30482631	2250	1125.0	
33954	chr6	30483458	30484289	831	416.0	
33955	chr6	30487708	30488070	362	181.0	
33956	chr6	30488887	30498051	9164	4582.0	
33957	chr6	30500502	30501193	691	346.0	
33958	chr6	30503297	30503831	534	267.0	
33959	chr6	30508406	30509975	1569	784.0	
33960	chr6	30514803	30517067	2264	1132.0	
33961	chr6	30518344	30518874	530	265.0	
33962	chr6	30527755	30530411	2656	1328.0	
33963	chr6	30532219	30533942	1723	862.0	
33964	chr6	30541367	30546322	4955	2478.0	
33965	chr6	30546965	30548653	1688	844.0	
33966	chr6	30549328	30550081	753	376.0	
33967	chr6	30550599	30550937	338	169.0	
33968	chr6	30551920	30558202	6282	3141.0	
33969	chr6	30568177	30568740	563	282.0	
33970	chr6	30570332	30573096	2764	1382.0	
33971	chr6	30573650	30574714	1064	532.0	
33972	chr6	30588987	30604084	15097	7548.0	
33973	chr6	30604804	30606445	1641	820.0	
33974	chr6	30607940	30608492	552	276.0	
33975	chr6	30609914	30610699	785	392.0	
33976	chr6	30611530	30618763	7233	3616.0	
33977	chr6	30626225	30627599	1374	687.0	
33978	chr6	30645075	30645356	281	140.0	
33979	chr6	30646382	30648280	1898	949.0	
33980	chr6	30656423	30656988	565	282.0	
33981	chr6	30672258	30673892	1634	817.0	
33982	chr6	30678747	30691470	12723	6362.0	
33983	chr6	30700359	30700806	447	224.0	
33984	chr6	30703811	30704181	370	185.0	
33985	chr6	30711776	30712177	401	200.0	
33986	chr6	30716722	30718138	1416	708.0	
33987	chr6	30719475	30723382	3907	1954.0	
33988	chr6	30730473	30731484	1011	506.0	
33989	chr6	30735580	30745117	9537	4768.0	
33990	chr6	30752274	30752931	657	328.0	
33991	chr6	30755705	30755964	259	130.0	
33992	chr6	30758911	30759448	537	268.0	
33993	chr6	30768931	30770001	1070	535.0	
33994	chr6	30778604	30779502	898	449.0	
33995	chr6	30781351	30782785	1434	717.0	
33996	chr6	30784811	30785806	995	498.0	
33997	chr6	30787810	30789388	1578	789.0	
33998	chr6	30793434	30794355	921	460.0	
33999	chr6	30810878	30811070	192	96.0	
34000	chr6	30813068	30814933	1865	932.0	
34001	chr6	30817018	30817678	660	330.0	
34002	chr6	30818373	30818774	401	200.0	
34003	chr6	30821935	30822335	400	200.0	
34004	chr6	30823315	30823485	170	85.0	
34005	chr6	30828189	30829107	918	459.0	
34006	chr6	30829787	30831104	1317	658.0	
34007	chr6	30834565	30835032	467	234.0	
34008	chr6	30838433	30838770	337	168.0	
34009	chr6	30841638	30842049	411	206.0	
34010	chr6	30877277	30878325	1048	524.0	
34011	chr6	30882655	30886281	3626	1813.0	
34012	chr6	30907457	30908928	1471	736.0	
34013	chr6	30913501	30915912	2411	1206.0	
34014	chr6	30942682	30942963	281	140.0	
34015	chr6	30954948	30956331	1383	692.0	
34016	chr6	30963941	30965171	1230	615.0	
34017	chr6	30969080	30969690	610	305.0	
34018	chr6	30990458	30990797	339	170.0	
34019	chr6	31042691	31043297	606	303.0	
34020	chr6	31058372	31058604	232	116.0	
34021	chr6	31068765	31069351	586	293.0	
34022	chr6	31079546	31080226	680	340.0	
34023	chr6	31084040	31084281	241	120.0	
34024	chr6	31087440	31088000	560	280.0	
34025	chr6	31094228	31095159	931	466.0	
34026	chr6	31097556	31097821	265	132.0	
34027	chr6	31102326	31102798	472	236.0	
34028	chr6	31108925	31109431	506	253.0	
34029	chr6	31114772	31116042	1270	635.0	
34030	chr6	31127817	31128559	742	371.0	
34031	chr6	31137203	31138105	902	451.0	
34032	chr6	31157613	31159754	2141	1070.0	
34033	chr6	31176034	31176102	68	34.0	
34034	chr6	31180236	31181165	929	464.0	
34035	chr6	31186533	31186732	199	100.0	
34036	chr6	31192400	31193379	979	490.0	
34037	chr6	31194326	31194795	469	234.0	
34038	chr6	31196318	31199379	3061	1530.0	
34039	chr6	31202445	31204746	2301	1150.0	
34040	chr6	31215247	31216782	1535	768.0	
34041	chr6	31229158	31229538	380	190.0	
34042	chr6	31259941	31260427	486	243.0	
34043	chr6	31264311	31274460	10149	5074.0	
34044	chr6	31304791	31304970	179	90.0	
34045	chr6	31307671	31309063	1392	696.0	
34046	chr6	31332659	31333568	909	454.0	
34047	chr6	31347227	31359499	12272	6136.0	
34048	chr6	31363891	31364235	344	172.0	
34049	chr6	31366570	31367667	1097	548.0	
34050	chr6	31396726	31397538	812	406.0	
34051	chr6	31399233	31404423	5190	2595.0	
34052	chr6	31407765	31408058	293	146.0	
34053	chr6	31441352	31442236	884	442.0	
34054	chr6	31453177	31453738	561	280.0	
34055	chr6	31462044	31475465	13421	6710.0	
34056	chr6	31476637	31476895	258	129.0	
34057	chr6	31491612	31492408	796	398.0	
34058	chr6	31493661	31498774	5113	2556.0	
34059	chr6	31516198	31516932	734	367.0	
34060	chr6	31528214	31531004	2790	1395.0	
34061	chr6	31538631	31539279	648	324.0	
34062	chr6	31540000	31543089	3089	1544.0	
34063	chr6	31546335	31548107	1772	886.0	
34064	chr6	31551117	31551874	757	378.0	
34065	chr6	31556300	31556705	405	202.0	
34066	chr6	31558068	31560890	2822	1411.0	
34067	chr6	31567336	31569326	1990	995.0	
34068	chr6	31571452	31573503	2051	1026.0	
34069	chr6	31574666	31583153	8487	4244.0	
34070	chr6	31585108	31588748	3640	1820.0	
34071	chr6	31589655	31589953	298	149.0	
34072	chr6	31592162	31593750	1588	794.0	
34073	chr6	31596757	31597447	690	345.0	
34074	chr6	31598314	31599187	873	436.0	
34075	chr6	31614094	31616408	2314	1157.0	
34076	chr6	31619485	31623267	3782	1891.0	
34077	chr6	31627013	31627202	189	94.0	
34078	chr6	31632501	31632744	243	122.0	
34079	chr6	31633396	31633614	218	109.0	
34080	chr6	31634646	31635431	785	392.0	
34081	chr6	31651439	31653718	2279	1140.0	
34082	chr6	31657605	31658641	1036	518.0	
34083	chr6	31659623	31661398	1775	888.0	
34084	chr6	31663566	31666816	3250	1625.0	
34085	chr6	31676409	31676664	255	128.0	
34086	chr6	31680308	31681821	1513	756.0	
34087	chr6	31682997	31683473	476	238.0	
34088	chr6	31689294	31689776	482	241.0	
34089	chr6	31701871	31704010	2139	1070.0	
34090	chr6	31711135	31711612	477	238.0	
34091	chr6	31712272	31712714	442	221.0	
34092	chr6	31726052	31726276	224	112.0	
34093	chr6	31726997	31728296	1299	650.0	
34094	chr6	31728922	31730905	1983	992.0	
34095	chr6	31734302	31741026	6724	3362.0	
34096	chr6	31767712	31767747	35	18.0	
34097	chr6	31768608	31770261	1653	826.0	
34098	chr6	31770939	31771072	133	66.0	
34099	chr6	31771993	31773179	1186	593.0	
34100	chr6	31776584	31777878	1294	647.0	
34101	chr6	31789392	31789816	424	212.0	
34102	chr6	31791283	31791932	649	324.0	
34103	chr6	31794215	31796784	2569	1284.0	
34104	chr6	31797493	31798031	538	269.0	
34105	chr6	31805985	31807345	1360	680.0	
34106	chr6	31813072	31813433	361	180.0	
34107	chr6	31814098	31816130	2032	1016.0	"origin_of_replication	protein_binding_site	origin_of_replication	protein_binding_site"
34108	chr6	31817331	31818545	1214	607.0	
34109	chr6	31821207	31824187	2980	1490.0	
34110	chr6	31826308	31828338	2030	1015.0	
34111	chr6	31829453	31838559	9106	4553.0	
34112	chr6	31841418	31841913	495	248.0	
34113	chr6	31842916	31843396	480	240.0	
34114	chr6	31844533	31844805	272	136.0	
34115	chr6	31845390	31846469	1079	540.0	
34116	chr6	31847144	31853180	6036	3018.0	
34117	chr6	31855159	31864644	9485	4742.0	
34118	chr6	31874580	31874751	171	86.0	
34119	chr6	31888686	31889179	493	246.0	
34120	chr6	31896519	31900430	3911	1956.0	
34121	chr6	31901278	31903216	1938	969.0	
34122	chr6	31907344	31907817	473	236.0	
34123	chr6	31920768	31921269	501	250.0	
34124	chr6	31929398	31929899	501	250.0	
34125	chr6	31945412	31946120	708	354.0	
34126	chr6	31952275	31953049	774	387.0	
34127	chr6	31958218	31959838	1620	810.0	
34128	chr6	31965879	31965881	2	1.0	
34129	chr6	31966863	31974013	7150	3575.0	
34130	chr6	32047892	32048724	832	416.0	
34131	chr6	32087199	32088038	839	420.0	
34132	chr6	32108185	32108680	495	248.0	
34133	chr6	32109398	32109487	89	44.0	
34134	chr6	32113890	32114422	532	266.0	
34135	chr6	32118724	32119427	703	352.0	
34136	chr6	32122829	32123378	549	274.0	
34137	chr6	32127513	32128996	1483	742.0	
34138	chr6	32129649	32130991	1342	671.0	
34139	chr6	32147700	32149703	2003	1002.0	
34140	chr6	32151013	32152491	1478	739.0	
34141	chr6	32153317	32155392	2075	1038.0	
34142	chr6	32173445	32173738	293	146.0	
34143	chr6	32175339	32179268	3929	1964.0	
34144	chr6	32182296	32182508	212	106.0	
34145	chr6	32185590	32186392	802	401.0	
34146	chr6	32186958	32187488	530	265.0	
34147	chr6	32189005	32193902	4897	2448.0	
34148	chr6	32194773	32198084	3311	1656.0	
34149	chr6	32224711	32225095	384	192.0	
34150	chr6	32244820	32245457	637	318.0	
34151	chr6	32252634	32252992	358	179.0	
34152	chr6	32254719	32255936	1217	608.0	
34153	chr6	32271335	32271942	607	304.0	
34154	chr6	32291571	32291915	344	172.0	
34155	chr6	32327037	32327498	461	230.0	
34156	chr6	32413353	32414034	681	340.0	
34157	chr6	32415319	32415911	592	296.0	
34158	chr6	32431982	32432399	417	208.0	
34159	chr6	32436916	32438127	1211	606.0	
34160	chr6	32439111	32440487	1376	688.0	
34161	chr6	32442015	32443640	1625	812.0	
34162	chr6	32444751	32446605	1854	927.0	
34163	chr6	32452503	32452641	138	69.0	
34164	chr6	32472577	32474206	1629	814.0	
34165	chr6	32525833	32526339	506	253.0	
34166	chr6	32529730	32530605	875	438.0	
34167	chr6	32576370	32576385	15	8.0	
34168	chr6	32577518	32577968	450	225.0	
34169	chr6	32578565	32579272	707	354.0	
34170	chr6	32580565	32580862	297	148.0	
34171	chr6	32583707	32584528	821	410.0	
34172	chr6	32585826	32586867	1041	520.0	
34173	chr6	32587765	32590446	2681	1340.0	
34174	chr6	32603798	32605131	1333	666.0	
34175	chr6	32607423	32607989	566	283.0	
34176	chr6	32609295	32610685	1390	695.0	
34177	chr6	32621513	32624162	2649	1324.0	
34178	chr6	32625096	32625408	312	156.0	
34179	chr6	32627881	32628216	335	168.0	
34180	chr6	32634111	32634514	403	202.0	
34181	chr6	32635587	32635846	259	130.0	
34182	chr6	32636862	32637769	907	454.0	
34183	chr6	32638425	32639906	1481	740.0	
34184	chr6	32641818	32643003	1185	592.0	
34185	chr6	32654207	32654235	28	14.0	
34186	chr6	32654927	32655859	932	466.0	
34187	chr6	32656949	32657187	238	119.0	
34188	chr6	32657765	32658994	1229	614.0	
34189	chr6	32659599	32661572	1973	986.0	
34190	chr6	32664170	32667295	3125	1562.0	
34191	chr6	32667936	32669002	1066	533.0	
34192	chr6	32670742	32671150	408	204.0	
34193	chr6	32679360	32680314	954	477.0	
34194	chr6	32685314	32686227	913	456.0	
34195	chr6	32690154	32690650	496	248.0	
34196	chr6	32691963	32692481	518	259.0	
34197	chr6	32700372	32700935	563	282.0	
34198	chr6	32713311	32713412	101	50.0	
34199	chr6	32725030	32725275	245	122.0	
34200	chr6	32760984	32761855	871	436.0	
34201	chr6	32763419	32763795	376	188.0	
34202	chr6	32774402	32774797	395	198.0	
34203	chr6	32785809	32786319	510	255.0	
34204	chr6	32794333	32795152	819	410.0	
34205	chr6	32796672	32797895	1223	612.0	
34206	chr6	32815845	32817365	1520	760.0	
34207	chr6	32837576	32839509	1933	966.0	recombination_feature
34208	chr6	32840331	32841343	1012	506.0	
34209	chr6	32842697	32846776	4079	2040.0	
34210	chr6	32851876	32856119	4243	2122.0	
34211	chr6	32858422	32858802	380	190.0	
34212	chr6	32861268	32861342	74	37.0	
34213	chr6	32866844	32868667	1823	912.0	
34214	chr6	32885606	32886144	538	269.0	
34215	chr6	32893613	32895540	1927	964.0	
34216	chr6	32933501	32934038	537	268.0	
34217	chr6	32935993	32937772	1779	890.0	recombination_feature
34218	chr6	32938497	32938898	401	200.0	
34219	chr6	32940442	32941984	1542	771.0	
34220	chr6	32943792	32945909	2117	1058.0	
34221	chr6	32947741	32948237	496	248.0	
34222	chr6	32949982	32950317	335	168.0	
34223	chr6	32952563	32953884	1321	660.0	
34224	chr6	32954761	32955447	686	343.0	
34225	chr6	32963901	32964256	355	178.0	
34226	chr6	32966687	32988708	22021	11010.0	
34227	chr6	32989216	32990208	992	496.0	
34228	chr6	32991400	32991495	95	48.0	
34229	chr6	32992164	32992473	309	154.0	
34230	chr6	33000012	33000821	809	404.0	
34231	chr6	33004432	33004787	355	178.0	"recombination_feature	recombination_feature"
34232	chr6	33007963	33008131	168	84.0	
34233	chr6	33008776	33009968	1192	596.0	recombination_feature
34234	chr6	33014670	33015410	740	370.0	
34235	chr6	33017876	33019755	1879	940.0	
34236	chr6	33027638	33030307	2669	1334.0	
34237	chr6	33049966	33050408	442	221.0	
34238	chr6	33057210	33058134	924	462.0	
34239	chr6	33061888	33062479	591	296.0	
34240	chr6	33069392	33069524	132	66.0	
34241	chr6	33071731	33074128	2397	1198.0	
34242	chr6	33075180	33076960	1780	890.0	
34243	chr6	33077583	33078394	811	406.0	
34244	chr6	33079000	33083132	4132	2066.0	
34245	chr6	33091737	33092410	673	336.0	
34246	chr6	33111916	33112814	898	449.0	
34247	chr6	33114154	33115624	1470	735.0	
34248	chr6	33118455	33118962	507	254.0	
34249	chr6	33123720	33124121	401	200.0	
34250	chr6	33126075	33126524	449	224.0	
34251	chr6	33132111	33132615	504	252.0	
34252	chr6	33142645	33144907	2262	1131.0	
34253	chr6	33148058	33148452	394	197.0	
34254	chr6	33160649	33162479	1830	915.0	
34255	chr6	33169533	33169574	41	20.0	
34256	chr6	33172617	33173063	446	223.0	
34257	chr6	33183154	33183745	591	296.0	
34258	chr6	33191999	33193656	1657	828.0	
34259	chr6	33197249	33198270	1021	510.0	
34260	chr6	33199142	33201618	2476	1238.0	
34261	chr6	33203833	33206533	2700	1350.0	
34262	chr6	33207375	33209261	1886	943.0	
34263	chr6	33213051	33214289	1238	619.0	
34264	chr6	33215158	33215171	13	6.0	
34265	chr6	33241717	33242117	400	200.0	
34266	chr6	33247855	33250285	2430	1215.0	
34267	chr6	33271016	33273462	2446	1223.0	
34268	chr6	33276394	33280514	4120	2060.0	
34269	chr6	33288475	33290240	1765	882.0	
34270	chr6	33296717	33300474	3757	1878.0	
34271	chr6	33301196	33302393	1197	598.0	
34272	chr6	33303945	33304308	363	182.0	
34273	chr6	33305424	33305451	27	14.0	
34274	chr6	33308470	33308487	17	8.0	
34275	chr6	33311970	33315577	3607	1804.0	
34276	chr6	33316475	33318693	2218	1109.0	
34277	chr6	33321642	33324642	3000	1500.0	
34278	chr6	33343407	33345986	2579	1290.0	
34279	chr6	33373885	33374437	552	276.0	
34280	chr6	33375143	33376602	1459	730.0	
34281	chr6	33390836	33392829	1993	996.0	
34282	chr6	33405600	33405947	347	174.0	
34283	chr6	33407288	33407740	452	226.0	
34284	chr6	33409208	33420348	11140	5570.0	
34285	chr6	33424716	33433642	8926	4463.0	
34286	chr6	33444932	33445886	954	477.0	
34287	chr6	33450188	33450914	726	363.0	
34288	chr6	33453012	33455301	2289	1144.0	
34289	chr6	33481264	33481529	265	132.0	
34290	chr6	33508421	33509511	1090	545.0	
34291	chr6	33511917	33512603	686	343.0	
34292	chr6	33532956	33534018	1062	531.0	
34293	chr6	33548099	33548804	705	352.0	
34294	chr6	33570262	33572497	2235	1118.0	
34295	chr6	33576837	33581018	4181	2090.0	
34296	chr6	33585051	33586516	1465	732.0	
34297	chr6	33589593	33590398	805	402.0	
34298	chr6	33590973	33590983	10	5.0	
34299	chr6	33592350	33593679	1329	664.0	
34300	chr6	33597023	33597273	250	125.0	
34301	chr6	33605067	33605300	233	116.0	
34302	chr6	33607754	33608137	383	192.0	
34303	chr6	33616720	33617645	925	462.0	
34304	chr6	33619141	33623595	4454	2227.0	
34305	chr6	33630038	33630362	324	162.0	
34306	chr6	33632313	33634516	2203	1102.0	
34307	chr6	33645491	33645958	467	234.0	
34308	chr6	33655256	33655336	80	40.0	
34309	chr6	33668799	33669456	657	328.0	
34310	chr6	33672942	33673009	67	34.0	
34311	chr6	33692250	33695365	3115	1558.0	
34312	chr6	33696414	33697590	1176	588.0	
34313	chr6	33700340	33700890	550	275.0	
34314	chr6	33710882	33712401	1519	760.0	
34315	chr6	33740221	33740439	218	109.0	
34316	chr6	33744285	33744853	568	284.0	
34317	chr6	33762131	33762576	445	222.0	
34318	chr6	33768486	33769159	673	336.0	
34319	chr6	33771241	33772282	1041	520.0	
34320	chr6	33787587	33789849	2262	1131.0	
34321	chr6	33815938	33815973	35	18.0	
34322	chr6	33839919	33840632	713	356.0	
34323	chr6	33851885	33852254	369	184.0	
34324	chr6	33856360	33857468	1108	554.0	
34325	chr6	33861046	33861447	401	200.0	
34326	chr6	33886737	33887284	547	274.0	
34327	chr6	33888247	33888510	263	132.0	
34328	chr6	33895312	33895384	72	36.0	
34329	chr6	33904050	33905913	1863	932.0	
34330	chr6	33914493	33915364	871	436.0	
34331	chr6	33924015	33924016	1	0.0	
34332	chr6	33983087	33983424	337	168.0	
34333	chr6	34027383	34028059	676	338.0	
34334	chr6	34044865	34045395	530	265.0	
34335	chr6	34055229	34055659	430	215.0	
34336	chr6	34143928	34144458	530	265.0	
34337	chr6	34145310	34146170	860	430.0	
34338	chr6	34154485	34155375	890	445.0	
34339	chr6	34163549	34164316	767	384.0	
34340	chr6	34181836	34183668	1832	916.0	
34341	chr6	34190059	34190721	662	331.0	
34342	chr6	34195961	34197056	1095	548.0	
34343	chr6	34205431	34205800	369	184.0	
34344	chr6	34219942	34219999	57	28.0	
34345	chr6	34223315	34224862	1547	774.0	
34346	chr6	34227251	34228093	842	421.0	
34347	chr6	34233061	34233425	364	182.0	
34348	chr6	34233984	34238986	5002	2501.0	
34349	chr6	34240032	34240368	336	168.0	
34350	chr6	34242650	34245219	2569	1284.0	
34351	chr6	34246130	34250028	3898	1949.0	
34352	chr6	34259758	34260059	301	150.0	
34353	chr6	34271970	34272466	496	248.0	
34354	chr6	34273161	34273855	694	347.0	
34355	chr6	34284498	34285348	850	425.0	
34356	chr6	34295680	34296117	437	218.0	
34357	chr6	34300285	34300915	630	315.0	
34358	chr6	34315637	34316428	791	396.0	
34359	chr6	34332203	34333326	1123	562.0	
34360	chr6	34344284	34344958	674	337.0	
34361	chr6	34350670	34350990	320	160.0	
34362	chr6	34370156	34370792	636	318.0	
34363	chr6	34373940	34374794	854	427.0	
34364	chr6	34389085	34389484	399	200.0	
34365	chr6	34390856	34394081	3225	1612.0	
34366	chr6	34414999	34415900	901	450.0	
34367	chr6	34425059	34426782	1723	862.0	
34368	chr6	34459841	34460325	484	242.0	
34369	chr6	34465729	34466261	532	266.0	
34370	chr6	34468348	34468788	440	220.0	
34371	chr6	34484808	34485332	524	262.0	
34372	chr6	34486142	34486662	520	260.0	
34373	chr6	34521934	34522293	359	180.0	
34374	chr6	34526775	34527825	1050	525.0	
34375	chr6	34531752	34532172	420	210.0	
34376	chr6	34609441	34610095	654	327.0	
34377	chr6	34655984	34658280	2296	1148.0	
34378	chr6	34663633	34664979	1346	673.0	
34379	chr6	34671467	34675280	3813	1906.0	
34380	chr6	34679830	34680159	329	164.0	
34381	chr6	34681062	34681356	294	147.0	
34382	chr6	34694913	34698240	3327	1664.0	
34383	chr6	34752554	34752808	254	127.0	
34384	chr6	34756362	34758136	1774	887.0	
34385	chr6	34791145	34793516	2371	1186.0	
34386	chr6	34816908	34817284	376	188.0	
34387	chr6	34819169	34819891	722	361.0	
34388	chr6	34834785	34835551	766	383.0	
34389	chr6	34887062	34891077	4015	2008.0	
34390	chr6	34912641	34913218	577	288.0	
34391	chr6	34955517	34955776	259	130.0	
34392	chr6	34986724	34987203	479	240.0	
34393	chr6	35024595	35025148	553	276.0	
34394	chr6	35034298	35035293	995	498.0	
34395	chr6	35044867	35045608	741	370.0	
34396	chr6	35047252	35049217	1965	982.0	
34397	chr6	35049979	35050238	259	130.0	
34398	chr6	35052711	35053017	306	153.0	
34399	chr6	35081313	35081901	588	294.0	
34400	chr6	35139885	35140295	410	205.0	
34401	chr6	35140892	35141586	694	347.0	
34402	chr6	35191691	35192391	700	350.0	
34403	chr6	35193629	35193843	214	107.0	
34404	chr6	35205017	35205484	467	234.0	
34405	chr6	35213895	35214394	499	250.0	
34406	chr6	35218124	35218462	338	169.0	
34407	chr6	35241025	35241763	738	369.0	
34408	chr6	35257121	35257570	449	224.0	
34409	chr6	35258540	35261372	2832	1416.0	
34410	chr6	35263103	35264403	1300	650.0	
34411	chr6	35294263	35294923	660	330.0	
34412	chr6	35296963	35301586	4623	2312.0	
34413	chr6	35302202	35303771	1569	784.0	
34414	chr6	35305083	35305553	470	235.0	
34415	chr6	35310170	35312437	2267	1134.0	
34416	chr6	35312945	35313130	185	92.0	
34417	chr6	35327188	35328231	1043	522.0	
34418	chr6	35331923	35332760	837	418.0	
34419	chr6	35341729	35345633	3904	1952.0	
34420	chr6	35348160	35349089	929	464.0	
34421	chr6	35359515	35359672	157	78.0	
34422	chr6	35360839	35361206	367	184.0	
34423	chr6	35363186	35363814	628	314.0	
34424	chr6	35367999	35368914	915	458.0	
34425	chr6	35369859	35371609	1750	875.0	
34426	chr6	35379305	35379667	362	181.0	
34427	chr6	35388102	35388373	271	136.0	
34428	chr6	35393778	35394465	687	344.0	
34429	chr6	35410899	35411568	669	334.0	
34430	chr6	35415182	35415530	348	174.0	
34431	chr6	35418136	35418401	265	132.0	
34432	chr6	35425908	35426534	626	313.0	
34433	chr6	35449113	35450251	1138	569.0	
34434	chr6	35451416	35453208	1792	896.0	
34435	chr6	35467451	35472730	5279	2640.0	
34436	chr6	35474102	35475915	1813	906.0	
34437	chr6	35487772	35488450	678	339.0	
34438	chr6	35492686	35494731	2045	1022.0	enhancer
34439	chr6	35495354	35498595	3241	1620.0	
34440	chr6	35522449	35524099	1650	825.0	
34441	chr6	35552239	35552748	509	254.0	
34442	chr6	35568987	35569335	348	174.0	
34443	chr6	35583748	35584450	702	351.0	
34444	chr6	35600094	35603150	3056	1528.0	
34445	chr6	35606136	35606587	451	226.0	
34446	chr6	35611228	35611646	418	209.0	
34447	chr6	35616079	35616731	652	326.0	
34448	chr6	35624251	35624983	732	366.0	
34449	chr6	35665698	35665962	264	132.0	
34450	chr6	35668012	35668028	16	8.0	
34451	chr6	35669324	35669794	470	235.0	
34452	chr6	35672897	35674158	1261	630.0	
34453	chr6	35687137	35689902	2765	1382.0	
34454	chr6	35690892	35691988	1096	548.0	
34455	chr6	35710163	35710764	601	300.0	
34456	chr6	35718146	35720865	2719	1360.0	
34457	chr6	35725494	35733361	7867	3934.0	
34458	chr6	35735873	35738150	2277	1138.0	
34459	chr6	35770825	35771177	352	176.0	
34460	chr6	35776530	35776922	392	196.0	
34461	chr6	35805044	35805553	509	254.0	
34462	chr6	35833570	35833968	398	199.0	
34463	chr6	35917805	35918250	445	222.0	
34464	chr6	35919010	35921616	2606	1303.0	
34465	chr6	35952445	35952900	455	228.0	
34466	chr6	36000497	36000775	278	139.0	
34467	chr6	36015204	36015779	575	288.0	
34468	chr6	36018283	36019624	1341	670.0	
34469	chr6	36023979	36024783	804	402.0	
34470	chr6	36027061	36029796	2735	1368.0	
34471	chr6	36032150	36032749	599	300.0	
34472	chr6	36033871	36034353	482	241.0	
34473	chr6	36038105	36038754	649	324.0	
34474	chr6	36075706	36076075	369	184.0	
34475	chr6	36094718	36095810	1092	546.0	
34476	chr6	36099266	36100624	1358	679.0	
34477	chr6	36108858	36109687	829	414.0	
34478	chr6	36114745	36115683	938	469.0	
34479	chr6	36118277	36119175	898	449.0	
34480	chr6	36119885	36121993	2108	1054.0	
34481	chr6	36123106	36124613	1507	754.0	
34482	chr6	36126550	36128428	1878	939.0	
34483	chr6	36129776	36132534	2758	1379.0	
34484	chr6	36141154	36141591	437	218.0	
34485	chr6	36142992	36143428	436	218.0	
34486	chr6	36146753	36147677	924	462.0	
34487	chr6	36169197	36169733	536	268.0	
34488	chr6	36171609	36171971	362	181.0	
34489	chr6	36195400	36198077	2677	1338.0	
34490	chr6	36201769	36201846	77	38.0	
34491	chr6	36203844	36204694	850	425.0	
34492	chr6	36219052	36219494	442	221.0	
34493	chr6	36232159	36232545	386	193.0	
34494	chr6	36235302	36235748	446	223.0	
34495	chr6	36241560	36242204	644	322.0	
34496	chr6	36245318	36245953	635	318.0	
34497	chr6	36246531	36246856	325	162.0	
34498	chr6	36248124	36248685	561	280.0	
34499	chr6	36280432	36281089	657	328.0	
34500	chr6	36287663	36288070	407	204.0	
34501	chr6	36290482	36291833	1351	676.0	
34502	chr6	36296204	36297459	1255	628.0	
34503	chr6	36299996	36300443	447	224.0	
34504	chr6	36302190	36303097	907	454.0	
34505	chr6	36312693	36313360	667	334.0	
34506	chr6	36340535	36341412	877	438.0	
34507	chr6	36360270	36361119	849	424.0	
34508	chr6	36362738	36363240	502	251.0	
34509	chr6	36364845	36365262	417	208.0	
34510	chr6	36369266	36369942	676	338.0	
34511	chr6	36386309	36388462	2153	1076.0	
34512	chr6	36419508	36419510	2	1.0	
34513	chr6	36422714	36424131	1417	708.0	
34514	chr6	36441057	36444522	3465	1732.0	"enhancer	sequence_feature"
34515	chr6	36478163	36478352	189	94.0	
34516	chr6	36484792	36485068	276	138.0	
34517	chr6	36492518	36494372	1854	927.0	
34518	chr6	36526099	36526567	468	234.0	
34519	chr6	36539900	36540714	814	407.0	
34520	chr6	36544081	36548682	4601	2300.0	
34521	chr6	36556264	36557768	1504	752.0	
34522	chr6	36559154	36559171	17	8.0	
34523	chr6	36570283	36570656	373	186.0	
34524	chr6	36576596	36576929	333	166.0	
34525	chr6	36579555	36580290	735	368.0	
34526	chr6	36583467	36583968	501	250.0	
34527	chr6	36592023	36614102	22079	11040.0	
34528	chr6	36614724	36624731	10007	5004.0	
34529	chr6	36627669	36629762	2093	1046.0	
34530	chr6	36644001	36645586	1585	792.0	
34531	chr6	36650734	36651391	657	328.0	
34532	chr6	36660772	36661153	381	190.0	
34533	chr6	36662338	36663568	1230	615.0	
34534	chr6	36667014	36667553	539	270.0	
34535	chr6	36675981	36692845	16864	8432.0	
34536	chr6	36697379	36698569	1190	595.0	
34537	chr6	36699437	36699840	403	202.0	
34538	chr6	36700643	36701916	1273	636.0	
34539	chr6	36724595	36724974	379	190.0	
34540	chr6	36727527	36728288	761	380.0	
34541	chr6	36734770	36736044	1274	637.0	
34542	chr6	36744098	36744183	85	42.0	
34543	chr6	36752357	36754555	2198	1099.0	
34544	chr6	36755169	36759793	4624	2312.0	
34545	chr6	36765868	36766871	1003	502.0	
34546	chr6	36769313	36770549	1236	618.0	
34547	chr6	36779310	36779599	289	144.0	
34548	chr6	36780501	36781308	807	404.0	
34549	chr6	36782631	36783275	644	322.0	
34550	chr6	36827469	36828198	729	364.0	
34551	chr6	36836440	36836455	15	8.0	
34552	chr6	36839270	36840996	1726	863.0	
34553	chr6	36842547	36842990	443	222.0	
34554	chr6	36848650	36849446	796	398.0	
34555	chr6	36850259	36850311	52	26.0	
34556	chr6	36851035	36851542	507	254.0	
34557	chr6	36852749	36853860	1111	556.0	
34558	chr6	36874002	36875683	1681	840.0	
34559	chr6	36885193	36886535	1342	671.0	
34560	chr6	36911904	36913226	1322	661.0	
34561	chr6	36914378	36914666	288	144.0	
34562	chr6	36947919	36948305	386	193.0	
34563	chr6	36954134	36955558	1424	712.0	
34564	chr6	36962617	36964348	1731	866.0	
34565	chr6	36977349	36977800	451	226.0	
34566	chr6	36979271	36979740	469	234.0	
34567	chr6	36983009	36983431	422	211.0	
34568	chr6	36984524	36987299	2775	1388.0	
34569	chr6	37001472	37001846	374	187.0	
34570	chr6	37004281	37008929	4648	2324.0	
34571	chr6	37017704	37019299	1595	798.0	
34572	chr6	37021610	37022460	850	425.0	
34573	chr6	37029154	37029935	781	390.0	
34574	chr6	37033095	37033687	592	296.0	
34575	chr6	37034392	37034759	367	184.0	
34576	chr6	37039429	37040270	841	420.0	
34577	chr6	37047362	37052416	5054	2527.0	
34578	chr6	37059280	37059681	401	200.0	
34579	chr6	37071679	37072949	1270	635.0	
34580	chr6	37083160	37084015	855	428.0	
34581	chr6	37085247	37085475	228	114.0	
34582	chr6	37094359	37094710	351	176.0	
34583	chr6	37099373	37099935	562	281.0	
34584	chr6	37102041	37103973	1932	966.0	
34585	chr6	37130613	37131208	595	298.0	
34586	chr6	37134516	37135181	665	332.0	
34587	chr6	37137244	37137920	676	338.0	
34588	chr6	37155328	37156051	723	362.0	
34589	chr6	37161091	37161646	555	278.0	
34590	chr6	37164469	37164983	514	257.0	
34591	chr6	37168803	37174350	5547	2774.0	
34592	chr6	37175690	37177726	2036	1018.0	
34593	chr6	37182765	37183831	1066	533.0	
34594	chr6	37186017	37186584	567	284.0	
34595	chr6	37187157	37187818	661	330.0	
34596	chr6	37189520	37190499	979	490.0	
34597	chr6	37202255	37202977	722	361.0	
34598	chr6	37205781	37206146	365	182.0	
34599	chr6	37207645	37208619	974	487.0	
34600	chr6	37209265	37210909	1644	822.0	
34601	chr6	37218575	37218971	396	198.0	
34602	chr6	37220913	37223106	2193	1096.0	
34603	chr6	37239830	37240737	907	454.0	
34604	chr6	37244904	37245277	373	186.0	
34605	chr6	37256827	37259727	2900	1450.0	
34606	chr6	37276188	37276484	296	148.0	
34607	chr6	37279681	37280301	620	310.0	
34608	chr6	37289896	37290307	411	206.0	
34609	chr6	37314854	37315249	395	198.0	
34610	chr6	37325544	37326193	649	324.0	
34611	chr6	37353489	37355159	1670	835.0	
34612	chr6	37368928	37369334	406	203.0	
34613	chr6	37381464	37381933	469	234.0	
34614	chr6	37397746	37397952	206	103.0	
34615	chr6	37432480	37434613	2133	1066.0	
34616	chr6	37442437	37443294	857	428.0	
34617	chr6	37483652	37484941	1289	644.0	
34618	chr6	37488507	37488976	469	234.0	
34619	chr6	37489489	37492265	2776	1388.0	
34620	chr6	37498990	37500509	1519	760.0	
34621	chr6	37501732	37504323	2591	1296.0	
34622	chr6	37507726	37508623	897	448.0	
34623	chr6	37514212	37518703	4491	2246.0	
34624	chr6	37535686	37536806	1120	560.0	
34625	chr6	37547403	37548010	607	304.0	
34626	chr6	37553475	37554175	700	350.0	
34627	chr6	37559549	37560647	1098	549.0	
34628	chr6	37561954	37562587	633	316.0	
34629	chr6	37565913	37566835	922	461.0	
34630	chr6	37583173	37583704	531	266.0	
34631	chr6	37620610	37620976	366	183.0	
34632	chr6	37622767	37622783	16	8.0	
34633	chr6	37624967	37625339	372	186.0	
34634	chr6	37630132	37631733	1601	800.0	
34635	chr6	37643973	37644354	381	190.0	
34636	chr6	37648396	37649173	777	388.0	
34637	chr6	37653939	37654363	424	212.0	
34638	chr6	37679835	37680628	793	396.0	
34639	chr6	37691792	37692636	844	422.0	
34640	chr6	37695058	37700144	5086	2543.0	
34641	chr6	37701169	37701508	339	170.0	
34642	chr6	37704996	37706346	1350	675.0	
34643	chr6	37709623	37710058	435	218.0	
34644	chr6	37731854	37732241	387	194.0	
34645	chr6	37783490	37784388	898	449.0	
34646	chr6	37791043	37792057	1014	507.0	
34647	chr6	37802818	37803288	470	235.0	
34648	chr6	37812924	37813201	277	138.0	
34649	chr6	37818228	37821119	2891	1446.0	
34650	chr6	37822597	37823394	797	398.0	
34651	chr6	37826325	37826466	141	70.0	
34652	chr6	37838206	37838650	444	222.0	
34653	chr6	37860390	37860416	26	13.0	
34654	chr6	37865575	37866049	474	237.0	
34655	chr6	37867773	37868629	856	428.0	
34656	chr6	37873864	37874321	457	228.0	
34657	chr6	37881340	37881732	392	196.0	
34658	chr6	37889237	37889244	7	4.0	
34659	chr6	37962513	37963128	615	308.0	
34660	chr6	37982281	37982745	464	232.0	
34661	chr6	37985377	37985773	396	198.0	
34662	chr6	38016906	38017203	297	148.0	
34663	chr6	38154997	38155779	782	391.0	
34664	chr6	38159741	38159958	217	108.0	
34665	chr6	38162570	38162580	10	5.0	
34666	chr6	38443246	38444170	924	462.0	
34667	chr6	38483401	38484089	688	344.0	
34668	chr6	38493929	38494366	437	218.0	
34669	chr6	38508967	38509261	294	147.0	
34670	chr6	38552038	38552632	594	297.0	
34671	chr6	38571736	38572816	1080	540.0	
34672	chr6	38638239	38641252	3013	1506.0	
34673	chr6	38671841	38672326	485	242.0	
34674	chr6	38673714	38674151	437	218.0	
34675	chr6	38688523	38689188	665	332.0	
34676	chr6	38702081	38703718	1637	818.0	
34677	chr6	38713687	38715631	1944	972.0	
34678	chr6	38774947	38775347	400	200.0	
34679	chr6	38872001	38872325	324	162.0	
34680	chr6	38876747	38876748	1	0.0	
34681	chr6	39102335	39102398	63	32.0	
34682	chr6	39111124	39111564	440	220.0	
34683	chr6	39114158	39115840	1682	841.0	
34684	chr6	39143536	39143851	315	158.0	
34685	chr6	39166332	39166876	544	272.0	
34686	chr6	39173247	39173600	353	176.0	
34687	chr6	39197582	39198226	644	322.0	
34688	chr6	39210444	39210848	404	202.0	
34689	chr6	39213217	39213746	529	264.0	
34690	chr6	39218939	39219536	597	298.0	
34691	chr6	39225625	39226887	1262	631.0	
34692	chr6	39227962	39230186	2224	1112.0	
34693	chr6	39282765	39283252	487	244.0	
34694	chr6	39286537	39287067	530	265.0	
34695	chr6	39289383	39289974	591	296.0	
34696	chr6	39300788	39301105	317	158.0	
34697	chr6	39302875	39303625	750	375.0	
34698	chr6	39309889	39310353	464	232.0	
34699	chr6	39330020	39330819	799	400.0	
34700	chr6	39336119	39336500	381	190.0	
34701	chr6	39342938	39343428	490	245.0	
34702	chr6	39347786	39348252	466	233.0	
34703	chr6	39361945	39362415	470	235.0	
34704	chr6	39724735	39725918	1183	592.0	
34705	chr6	39933990	39934779	789	394.0	
34706	chr6	40148836	40149334	498	249.0	
34707	chr6	40436568	40437200	632	316.0	
34708	chr6	40477265	40478371	1106	553.0	
34709	chr6	40505427	40505839	412	206.0	
34710	chr6	40587224	40588252	1028	514.0	
34711	chr6	40719542	40720063	521	260.0	
34712	chr6	40788574	40789583	1009	504.0	
34713	chr6	40804117	40804428	311	156.0	
34714	chr6	40824331	40824642	311	156.0	
34715	chr6	40852714	40853191	477	238.0	
34716	chr6	40999513	41000029	516	258.0	
34717	chr6	41006044	41006592	548	274.0	
34718	chr6	41027410	41029229	1819	910.0	
34719	chr6	41039288	41039712	424	212.0	
34720	chr6	41051425	41052430	1005	502.0	
34721	chr6	41066777	41067427	650	325.0	
34722	chr6	41071407	41074824	3417	1708.0	
34723	chr6	41080601	41081049	448	224.0	
34724	chr6	41100619	41101334	715	358.0	
34725	chr6	41157184	41157860	676	338.0	
34726	chr6	41161816	41162272	456	228.0	
34727	chr6	41167453	41167481	28	14.0	
34728	chr6	41181970	41183340	1370	685.0	
34729	chr6	41185920	41186689	769	384.0	
34730	chr6	41191377	41192149	772	386.0	
34731	chr6	41199413	41202277	2864	1432.0	
34732	chr6	41210201	41210210	9	4.0	
34733	chr6	41222632	41222713	81	40.0	
34734	chr6	41228509	41229352	843	422.0	
34735	chr6	41268626	41275905	7279	3640.0	
34736	chr6	41277238	41279662	2424	1212.0	
34737	chr6	41280408	41281430	1022	511.0	
34738	chr6	41282268	41285111	2843	1422.0	
34739	chr6	41286176	41287436	1260	630.0	
34740	chr6	41288525	41288777	252	126.0	
34741	chr6	41298836	41299598	762	381.0	
34742	chr6	41302503	41303300	797	398.0	
34743	chr6	41306252	41306679	427	214.0	
34744	chr6	41318511	41319641	1130	565.0	
34745	chr6	41332649	41332654	5	2.0	
34746	chr6	41333514	41334927	1413	706.0	
34747	chr6	41344878	41345419	541	270.0	
34748	chr6	41368600	41369500	900	450.0	
34749	chr6	41371393	41372531	1138	569.0	
34750	chr6	41379270	41379745	475	238.0	
34751	chr6	41424392	41425093	701	350.0	
34752	chr6	41426312	41428509	2197	1098.0	
34753	chr6	41429094	41429429	335	168.0	
34754	chr6	41439948	41440520	572	286.0	
34755	chr6	41441578	41442167	589	294.0	
34756	chr6	41442738	41443122	384	192.0	
34757	chr6	41463299	41463698	399	200.0	
34758	chr6	41469926	41470415	489	244.0	
34759	chr6	41505193	41505661	468	234.0	
34760	chr6	41531376	41533833	2457	1228.0	
34761	chr6	41536724	41537434	710	355.0	
34762	chr6	41538554	41539362	808	404.0	
34763	chr6	41545128	41549291	4163	2082.0	
34764	chr6	41560205	41562085	1880	940.0	
34765	chr6	41562704	41562853	149	74.0	
34766	chr6	41591717	41592435	718	359.0	
34767	chr6	41602750	41603516	766	383.0	
34768	chr6	41681922	41684350	2428	1214.0	
34769	chr6	41705667	41708558	2891	1446.0	
34770	chr6	41712729	41713991	1262	631.0	
34771	chr6	41717546	41717786	240	120.0	
34772	chr6	41722976	41724628	1652	826.0	
34773	chr6	41726864	41727560	696	348.0	
34774	chr6	41728399	41729077	678	339.0	
34775	chr6	41730442	41730930	488	244.0	
34776	chr6	41732350	41736409	4059	2030.0	
34777	chr6	41763602	41763888	286	143.0	
34778	chr6	41775840	41776350	510	255.0	
34779	chr6	41777522	41778030	508	254.0	
34780	chr6	41779349	41781752	2403	1202.0	
34781	chr6	41784363	41785125	762	381.0	
34782	chr6	41786012	41788405	2393	1196.0	
34783	chr6	41846684	41847216	532	266.0	
34784	chr6	41871938	41872452	514	257.0	
34785	chr6	41893723	41893748	25	12.0	
34786	chr6	41894275	41896471	2196	1098.0	
34787	chr6	41902086	41902609	523	262.0	
34788	chr6	41920272	41923128	2856	1428.0	
34789	chr6	41930064	41930118	54	27.0	
34790	chr6	41934958	41942842	7884	3942.0	
34791	chr6	41961719	41961839	120	60.0	
34792	chr6	41964648	41964658	10	5.0	
34793	chr6	41967281	41967627	346	173.0	
34794	chr6	41970326	41971048	722	361.0	
34795	chr6	41979816	41980300	484	242.0	
34796	chr6	42007752	42008203	451	226.0	
34797	chr6	42010066	42011023	957	478.0	
34798	chr6	42017192	42017476	284	142.0	
34799	chr6	42022058	42023206	1148	574.0	
34800	chr6	42025096	42029102	4006	2003.0	
34801	chr6	42030856	42031698	842	421.0	
34802	chr6	42039210	42040354	1144	572.0	
34803	chr6	42041489	42042550	1061	530.0	
34804	chr6	42043739	42047386	3647	1824.0	
34805	chr6	42047951	42051373	3422	1711.0	
34806	chr6	42103877	42105435	1558	779.0	
34807	chr6	42136438	42137080	642	321.0	
34808	chr6	42139947	42140591	644	322.0	
34809	chr6	42142294	42143065	771	386.0	
34810	chr6	42166353	42167070	717	358.0	
34811	chr6	42178119	42178359	240	120.0	
34812	chr6	42198103	42198214	111	56.0	
34813	chr6	42214694	42215388	694	347.0	
34814	chr6	42217358	42218392	1034	517.0	
34815	chr6	42260708	42261382	674	337.0	
34816	chr6	42269536	42269955	419	210.0	
34817	chr6	42278047	42279990	1943	972.0	
34818	chr6	42281414	42282108	694	347.0	
34819	chr6	42293393	42294029	636	318.0	
34820	chr6	42294745	42295211	466	233.0	
34821	chr6	42295931	42296038	107	54.0	
34822	chr6	42309725	42310178	453	226.0	
34823	chr6	42315960	42317483	1523	762.0	
34824	chr6	42332848	42334024	1176	588.0	
34825	chr6	42357227	42357950	723	362.0	
34826	chr6	42364018	42365075	1057	528.0	
34827	chr6	42366888	42368685	1797	898.0	
34828	chr6	42369348	42370008	660	330.0	
34829	chr6	42372615	42374817	2202	1101.0	
34830	chr6	42375663	42375971	308	154.0	
34831	chr6	42378092	42378978	886	443.0	
34832	chr6	42381214	42381267	53	26.0	
34833	chr6	42387100	42387822	722	361.0	
34834	chr6	42388748	42388909	161	80.0	
34835	chr6	42389691	42391590	1899	950.0	
34836	chr6	42394957	42395402	445	222.0	
34837	chr6	42402156	42402644	488	244.0	
34838	chr6	42404377	42405056	679	340.0	
34839	chr6	42407364	42407857	493	246.0	
34840	chr6	42409536	42410027	491	246.0	
34841	chr6	42411329	42411745	416	208.0	
34842	chr6	42417364	42418270	906	453.0	
34843	chr6	42428204	42429545	1341	670.0	
34844	chr6	42448704	42449269	565	282.0	
34845	chr6	42449898	42454761	4863	2432.0	
34846	chr6	42514658	42515173	515	258.0	
34847	chr6	42520859	42521428	569	284.0	
34848	chr6	42532009	42532491	482	241.0	
34849	chr6	42545299	42545827	528	264.0	
34850	chr6	42547218	42548456	1238	619.0	
34851	chr6	42554011	42554769	758	379.0	
34852	chr6	42555682	42556344	662	331.0	
34853	chr6	42563300	42566628	3328	1664.0	
34854	chr6	42569138	42570162	1024	512.0	
34855	chr6	42572217	42572996	779	390.0	
34856	chr6	42597984	42597987	3	2.0	
34857	chr6	42661468	42662032	564	282.0	
34858	chr6	42693662	42694249	587	294.0	
34859	chr6	42726137	42727614	1477	738.0	
34860	chr6	42745000	42748120	3120	1560.0	
34861	chr6	42769922	42772565	2643	1322.0	
34862	chr6	42774135	42775826	1691	846.0	
34863	chr6	42777458	42777479	21	10.0	
34864	chr6	42781088	42793082	11994	5997.0	
34865	chr6	42819677	42820342	665	332.0	
34866	chr6	42876998	42877547	549	274.0	
34867	chr6	42878970	42880773	1803	902.0	
34868	chr6	42889893	42891566	1673	836.0	
34869	chr6	42893912	42894398	486	243.0	
34870	chr6	42898633	42899359	726	363.0	
34871	chr6	42901323	42902099	776	388.0	
34872	chr6	42911624	42911850	226	113.0	
34873	chr6	42923578	42924259	681	340.0	
34874	chr6	42928344	42931091	2747	1374.0	
34875	chr6	42932785	42933670	885	442.0	
34876	chr6	42960196	42961187	991	496.0	
34877	chr6	42963805	42964191	386	193.0	
34878	chr6	42971333	42971553	220	110.0	
34879	chr6	42978008	42980262	2254	1127.0	
34880	chr6	42983719	42985535	1816	908.0	
34881	chr6	43009110	43009562	452	226.0	
34882	chr6	43012954	43014841	1887	944.0	
34883	chr6	43016145	43016379	234	117.0	
34884	chr6	43020866	43022433	1567	784.0	
34885	chr6	43053046	43054563	1517	758.0	
34886	chr6	43058707	43060456	1749	874.0	
34887	chr6	43069967	43070413	446	223.0	
34888	chr6	43075981	43077226	1245	622.0	
34889	chr6	43093737	43094240	503	252.0	
34890	chr6	43116380	43116647	267	134.0	
34891	chr6	43142067	43142528	461	230.0	
34892	chr6	43143228	43144267	1039	520.0	
34893	chr6	43170306	43175348	5042	2521.0	
34894	chr6	43180809	43182958	2149	1074.0	
34895	chr6	43185542	43185771	229	114.0	
34896	chr6	43221970	43222008	38	19.0	
34897	chr6	43222588	43226307	3719	1860.0	
34898	chr6	43228594	43230095	1501	750.0	
34899	chr6	43243134	43244052	918	459.0	
34900	chr6	43246507	43248105	1598	799.0	
34901	chr6	43251264	43251454	190	95.0	
34902	chr6	43263212	43263947	735	368.0	
34903	chr6	43269249	43270159	910	455.0	
34904	chr6	43271066	43271492	426	213.0	
34905	chr6	43274948	43276742	1794	897.0	
34906	chr6	43308060	43309267	1207	604.0	
34907	chr6	43310884	43310955	71	36.0	
34908	chr6	43311590	43312145	555	278.0	
34909	chr6	43312665	43313476	811	406.0	
34910	chr6	43331765	43332388	623	312.0	
34911	chr6	43334449	43334895	446	223.0	
34912	chr6	43367397	43370565	3168	1584.0	
34913	chr6	43376785	43376791	6	3.0	
34914	chr6	43383139	43384746	1607	804.0	
34915	chr6	43386491	43386956	465	232.0	
34916	chr6	43391156	43391995	839	420.0	
34917	chr6	43393611	43394095	484	242.0	
34918	chr6	43397786	43398486	700	350.0	
34919	chr6	43426952	43428853	1901	950.0	
34920	chr6	43454199	43456399	2200	1100.0	
34921	chr6	43476728	43478481	1753	876.0	
34922	chr6	43495118	43495756	638	319.0	
34923	chr6	43496628	43497021	393	196.0	
34924	chr6	43506130	43507531	1401	700.0	
34925	chr6	43508338	43511150	2812	1406.0	
34926	chr6	43516210	43517859	1649	824.0	
34927	chr6	43544649	43544656	7	4.0	
34928	chr6	43575068	43576769	1701	850.0	
34929	chr6	43584762	43585327	565	282.0	
34930	chr6	43608222	43609189	967	484.0	
34931	chr6	43626778	43631172	4394	2197.0	
34932	chr6	43635172	43636777	1605	802.0	
34933	chr6	43644743	43646000	1257	628.0	
34934	chr6	43667142	43668806	1664	832.0	
34935	chr6	43683993	43684469	476	238.0	
34936	chr6	43687078	43688393	1315	658.0	
34937	chr6	43701173	43701530	357	178.0	
34938	chr6	43702527	43703286	759	380.0	
34939	chr6	43703951	43704552	601	300.0	
34940	chr6	43705885	43706617	732	366.0	
34941	chr6	43709218	43709682	464	232.0	
34942	chr6	43713718	43714048	330	165.0	
34943	chr6	43714848	43715394	546	273.0	
34944	chr6	43723142	43726023	2881	1440.0	
34945	chr6	43733769	43734519	750	375.0	
34946	chr6	43741009	43741361	352	176.0	
34947	chr6	43758491	43758859	368	184.0	
34948	chr6	43763139	43763825	686	343.0	
34949	chr6	43769191	43772445	3254	1627.0	
34950	chr6	43773029	43773954	925	462.0	
34951	chr6	43774480	43775543	1063	532.0	
34952	chr6	43776342	43776557	215	108.0	
34953	chr6	43783224	43783300	76	38.0	
34954	chr6	43789854	43790534	680	340.0	
34955	chr6	43791781	43792149	368	184.0	
34956	chr6	43796886	43797381	495	248.0	
34957	chr6	43798629	43800363	1734	867.0	
34958	chr6	43803980	43804606	626	313.0	
34959	chr6	43813081	43813622	541	270.0	
34960	chr6	43817143	43817614	471	236.0	
34961	chr6	43824472	43824624	152	76.0	
34962	chr6	43838261	43839096	835	418.0	
34963	chr6	43883967	43884927	960	480.0	
34964	chr6	43917115	43918077	962	481.0	
34965	chr6	43924073	43924761	688	344.0	
34966	chr6	43927764	43928165	401	200.0	
34967	chr6	43951206	43951620	414	207.0	
34968	chr6	43953410	43953612	202	101.0	
34969	chr6	43977312	43978959	1647	824.0	
34970	chr6	43996438	43996574	136	68.0	
34971	chr6	44000191	44003691	3500	1750.0	
34972	chr6	44005140	44005562	422	211.0	
34973	chr6	44010728	44011107	379	190.0	
34974	chr6	44011876	44012656	780	390.0	
34975	chr6	44022357	44022820	463	232.0	
34976	chr6	44034498	44037129	2631	1316.0	
34977	chr6	44052267	44053258	991	496.0	
34978	chr6	44057386	44060955	3569	1784.0	
34979	chr6	44061636	44062250	614	307.0	
34980	chr6	44062769	44063204	435	218.0	
34981	chr6	44064099	44065247	1148	574.0	
34982	chr6	44065989	44066128	139	70.0	
34983	chr6	44072536	44075285	2749	1374.0	
34984	chr6	44076503	44076833	330	165.0	
34985	chr6	44078888	44079798	910	455.0	
34986	chr6	44096481	44097153	672	336.0	
34987	chr6	44100196	44100424	228	114.0	
34988	chr6	44122733	44123819	1086	543.0	
34989	chr6	44126239	44129026	2787	1394.0	
34990	chr6	44151544	44152491	947	474.0	
34991	chr6	44172234	44173351	1117	558.0	
34992	chr6	44176830	44177564	734	367.0	
34993	chr6	44180510	44181416	906	453.0	
34994	chr6	44192507	44192773	266	133.0	
34995	chr6	44216723	44216910	187	94.0	
34996	chr6	44218169	44220049	1880	940.0	
34997	chr6	44221243	44224598	3355	1678.0	
34998	chr6	44226236	44226645	409	204.0	
34999	chr6	44233150	44234785	1635	818.0	
35000	chr6	44237096	44238681	1585	792.0	
35001	chr6	44245457	44271743	26286	13143.0	
35002	chr6	44275655	44276468	813	406.0	
35003	chr6	44279282	44279651	369	184.0	
35004	chr6	44296972	44298011	1039	520.0	
35005	chr6	44304569	44305356	787	394.0	
35006	chr6	44312715	44313953	1238	619.0	
35007	chr6	44333588	44334427	839	420.0	
35008	chr6	44338418	44338999	581	290.0	
35009	chr6	44342423	44342681	258	129.0	
35010	chr6	44356552	44356787	235	118.0	
35011	chr6	44381619	44382324	705	352.0	
35012	chr6	44386703	44388714	2011	1006.0	
35013	chr6	44431115	44431504	389	194.0	
35014	chr6	44456195	44456688	493	246.0	
35015	chr6	44469744	44470214	470	235.0	
35016	chr6	44475614	44476285	671	336.0	
35017	chr6	44527023	44527482	459	230.0	
35018	chr6	44562116	44562215	99	50.0	
35019	chr6	44570024	44570544	520	260.0	
35020	chr6	44593480	44593880	400	200.0	
35021	chr6	44598821	44599018	197	98.0	
35022	chr6	44618448	44618824	376	188.0	
35023	chr6	44623273	44623281	8	4.0	
35024	chr6	44626984	44627815	831	416.0	
35025	chr6	44630407	44630763	356	178.0	
35026	chr6	44642320	44643295	975	488.0	
35027	chr6	44650624	44650659	35	18.0	
35028	chr6	44655167	44656076	909	454.0	
35029	chr6	44668072	44668486	414	207.0	
35030	chr6	44779334	44779875	541	270.0	
35031	chr6	44828821	44829147	326	163.0	
35032	chr6	44925116	44925920	804	402.0	
35033	chr6	44932468	44933887	1419	710.0	
35034	chr6	44976912	44977799	887	444.0	
35035	chr6	45001994	45001996	2	1.0	
35036	chr6	45003325	45003726	401	200.0	
35037	chr6	45031479	45032085	606	303.0	
35038	chr6	45049144	45049682	538	269.0	
35039	chr6	45156022	45156467	445	222.0	
35040	chr6	45293287	45293615	328	164.0	
35041	chr6	45310350	45310952	602	301.0	
35042	chr6	45328003	45328418	415	208.0	"promoter	enhancer	protein_binding_site	protein_binding_site	protein_binding_site	protein_binding_site"
35043	chr6	45376839	45378898	2059	1030.0	
35044	chr6	45419314	45424983	5669	2834.0	"sequence_feature	repeat_region	repeat_region	sequence_feature"
35045	chr6	45428756	45429108	352	176.0	
35046	chr6	45431689	45432056	367	184.0	
35047	chr6	45434039	45434717	678	339.0	
35048	chr6	45436692	45437248	556	278.0	
35049	chr6	45439244	45439359	115	58.0	
35050	chr6	45445360	45446441	1081	540.0	
35051	chr6	45450772	45451255	483	242.0	
35052	chr6	45478191	45478693	502	251.0	
35053	chr6	45486661	45487167	506	253.0	
35054	chr6	45488832	45489250	418	209.0	
35055	chr6	45494774	45496339	1565	782.0	
35056	chr6	45584160	45584454	294	147.0	
35057	chr6	45585938	45587570	1632	816.0	
35058	chr6	45663549	45664247	698	349.0	
35059	chr6	45677215	45678151	936	468.0	
35060	chr6	45681677	45682518	841	420.0	
35061	chr6	45709556	45710965	1409	704.0	
35062	chr6	45712766	45713096	330	165.0	
35063	chr6	45714613	45715153	540	270.0	
35064	chr6	45741411	45742124	713	356.0	
35065	chr6	45830505	45831812	1307	654.0	
35066	chr6	45895620	45895983	363	182.0	
35067	chr6	45922716	45923161	445	222.0	
35068	chr6	45930385	45930850	465	232.0	
35069	chr6	46010935	46012148	1213	606.0	
35070	chr6	46013784	46016216	2432	1216.0	
35071	chr6	46042381	46042757	376	188.0	
35072	chr6	46090103	46090516	413	206.0	
35073	chr6	46119998	46120075	77	38.0	
35074	chr6	46128190	46131074	2884	1442.0	
35075	chr6	46170372	46171629	1257	628.0	
35076	chr6	46174730	46176014	1284	642.0	
35077	chr6	46217696	46218059	363	182.0	
35078	chr6	46220578	46221547	969	484.0	
35079	chr6	46325516	46326067	551	276.0	
35080	chr6	46376367	46377281	914	457.0	
35081	chr6	46491081	46492189	1108	554.0	
35082	chr6	46626327	46626569	242	121.0	
35083	chr6	46652403	46653639	1236	618.0	
35084	chr6	46704601	46705029	428	214.0	
35085	chr6	46715077	46715599	522	261.0	
35086	chr6	46730811	46731398	587	294.0	
35087	chr6	46734837	46735819	982	491.0	
35088	chr6	46770811	46773793	2982	1491.0	
35089	chr6	46781474	46781860	386	193.0	
35090	chr6	46848802	46849351	549	274.0	
35091	chr6	47047443	47047941	498	249.0	
35092	chr6	47097316	47097794	478	239.0	
35093	chr6	47103784	47104334	550	275.0	
35094	chr6	47134362	47135134	772	386.0	
35095	chr6	47161089	47161616	527	264.0	
35096	chr6	47162902	47163113	211	106.0	
35097	chr6	47165962	47166272	310	155.0	
35098	chr6	47170390	47170988	598	299.0	
35099	chr6	47203407	47204052	645	322.0	
35100	chr6	47230580	47231062	482	241.0	
35101	chr6	47235806	47236243	437	218.0	
35102	chr6	47237221	47237439	218	109.0	
35103	chr6	47242118	47243196	1078	539.0	
35104	chr6	47245743	47246104	361	180.0	
35105	chr6	47247053	47247709	656	328.0	
35106	chr6	47308728	47310329	1601	800.0	
35107	chr6	47335399	47336007	608	304.0	
35108	chr6	47343690	47343843	153	76.0	
35109	chr6	47353790	47354397	607	304.0	
35110	chr6	47357911	47358068	157	78.0	
35111	chr6	47360496	47360710	214	107.0	
35112	chr6	47375490	47375625	135	68.0	
35113	chr6	47413682	47415370	1688	844.0	
35114	chr6	47437607	47437990	383	192.0	
35115	chr6	47438988	47439482	494	247.0	
35116	chr6	47455023	47455036	13	6.0	
35117	chr6	47461205	47461646	441	220.0	
35118	chr6	47476897	47479443	2546	1273.0	
35119	chr6	47631208	47632121	913	456.0	
35120	chr6	47656283	47656382	99	50.0	
35121	chr6	47780647	47781155	508	254.0	
35122	chr6	47788021	47788460	439	220.0	
35123	chr6	49409949	49410350	401	200.0	
35124	chr6	49462407	49464112	1705	852.0	
35125	chr6	49532067	49532454	387	194.0	
35126	chr6	49551221	49551560	339	170.0	
35127	chr6	49607087	49607484	397	198.0	
35128	chr6	50816056	50816439	383	192.0	
35129	chr6	51265383	51265970	587	294.0	
35130	chr6	51273103	51273878	775	388.0	
35131	chr6	51283710	51284111	401	200.0	enhancer
35132	chr6	51303289	51303719	430	215.0	
35133	chr6	51534032	51534156	124	62.0	
35134	chr6	52049518	52049645	127	64.0	
35135	chr6	52063451	52064166	715	358.0	
35136	chr6	52156110	52156122	12	6.0	
35137	chr6	52162947	52163298	351	176.0	
35138	chr6	52176513	52177026	513	256.0	
35139	chr6	52231727	52232067	340	170.0	
35140	chr6	52263609	52264167	558	279.0	
35141	chr6	52284039	52285752	1713	856.0	
35142	chr6	52286765	52287588	823	412.0	
35143	chr6	52296492	52297264	772	386.0	
35144	chr6	52304557	52306584	2027	1014.0	
35145	chr6	52307208	52308504	1296	648.0	
35146	chr6	52310842	52311284	442	221.0	
35147	chr6	52317751	52318414	663	332.0	
35148	chr6	52330518	52330876	358	179.0	
35149	chr6	52333667	52334299	632	316.0	
35150	chr6	52341740	52342193	453	226.0	
35151	chr6	52350619	52350753	134	67.0	
35152	chr6	52351946	52353086	1140	570.0	
35153	chr6	52361248	52363514	2266	1133.0	
35154	chr6	52375841	52376267	426	213.0	
35155	chr6	52377551	52378235	684	342.0	
35156	chr6	52389115	52390984	1869	934.0	enhancer
35157	chr6	52392930	52394854	1924	962.0	
35158	chr6	52397544	52398627	1083	542.0	
35159	chr6	52399546	52401044	1498	749.0	
35160	chr6	52407368	52407828	460	230.0	
35161	chr6	52416317	52417155	838	419.0	
35162	chr6	52419564	52421203	1639	820.0	
35163	chr6	52491436	52492192	756	378.0	
35164	chr6	52493914	52493934	20	10.0	
35165	chr6	52497579	52498753	1174	587.0	
35166	chr6	52503821	52505249	1428	714.0	
35167	chr6	52537479	52537560	81	40.0	
35168	chr6	52574038	52577972	3934	1967.0	
35169	chr6	52594929	52595569	640	320.0	
35170	chr6	52596482	52596965	483	242.0	
35171	chr6	52598173	52598636	463	232.0	
35172	chr6	52605790	52606264	474	237.0	
35173	chr6	52651969	52652486	517	258.0	
35174	chr6	52663212	52665102	1890	945.0	
35175	chr6	52667600	52667935	335	168.0	
35176	chr6	52670526	52671716	1190	595.0	
35177	chr6	52684929	52685480	551	276.0	
35178	chr6	52724395	52724869	474	237.0	
35179	chr6	52815475	52815884	409	204.0	
35180	chr6	52839518	52840021	503	252.0	
35181	chr6	52881877	52882787	910	455.0	
35182	chr6	52976451	52977006	555	278.0	
35183	chr6	52984011	52984937	926	463.0	
35184	chr6	52994493	52997315	2822	1411.0	
35185	chr6	53048265	53049087	822	411.0	
35186	chr6	53061066	53062542	1476	738.0	
35187	chr6	53064250	53066546	2296	1148.0	
35188	chr6	53067143	53067517	374	187.0	
35189	chr6	53068087	53068390	303	152.0	
35190	chr6	53070794	53071054	260	130.0	
35191	chr6	53162602	53162983	381	190.0	
35192	chr6	53171753	53172671	918	459.0	
35193	chr6	53179968	53180662	694	347.0	
35194	chr6	53188013	53188900	887	444.0	
35195	chr6	53199086	53199588	502	251.0	
35196	chr6	53231668	53232245	577	288.0	
35197	chr6	53240724	53242433	1709	854.0	
35198	chr6	53244501	53245477	976	488.0	
35199	chr6	53280216	53280594	378	189.0	
35200	chr6	53290542	53291587	1045	522.0	
35201	chr6	53294093	53294456	363	182.0	
35202	chr6	53300482	53301595	1113	556.0	
35203	chr6	53302175	53304084	1909	954.0	
35204	chr6	53306834	53307816	982	491.0	
35205	chr6	53309158	53311578	2420	1210.0	
35206	chr6	53312307	53312863	556	278.0	
35207	chr6	53316197	53316648	451	226.0	
35208	chr6	53320235	53320294	59	30.0	
35209	chr6	53322588	53323438	850	425.0	
35210	chr6	53325373	53327147	1774	887.0	
35211	chr6	53331079	53331253	174	87.0	
35212	chr6	53331811	53333301	1490	745.0	
35213	chr6	53334027	53339861	5834	2917.0	
35214	chr6	53340778	53341141	363	182.0	
35215	chr6	53341832	53342079	247	124.0	
35216	chr6	53342884	53346080	3196	1598.0	
35217	chr6	53346801	53349750	2949	1474.0	
35218	chr6	53358375	53362298	3923	1962.0	
35219	chr6	53410432	53411094	662	331.0	
35220	chr6	53431876	53431931	55	28.0	
35221	chr6	53432458	53433693	1235	618.0	
35222	chr6	53437511	53438030	519	260.0	
35223	chr6	53446173	53446539	366	183.0	
35224	chr6	53458125	53458704	579	290.0	
35225	chr6	53460845	53462130	1285	642.0	
35226	chr6	53464793	53465465	672	336.0	
35227	chr6	53483932	53485101	1169	584.0	
35228	chr6	53492866	53493633	767	384.0	
35229	chr6	53504447	53504970	523	262.0	
35230	chr6	53532303	53532367	64	32.0	
35231	chr6	53533627	53534043	416	208.0	
35232	chr6	53543679	53545709	2030	1015.0	
35233	chr6	53547322	53548858	1536	768.0	
35234	chr6	53551638	53552182	544	272.0	
35235	chr6	53583198	53583280	82	41.0	
35236	chr6	53592958	53593573	615	308.0	
35237	chr6	53623412	53623968	556	278.0	
35238	chr6	53630820	53630893	73	36.0	
35239	chr6	53634403	53634804	401	200.0	
35240	chr6	53646934	53648117	1183	592.0	
35241	chr6	53651073	53652802	1729	864.0	
35242	chr6	53679407	53679790	383	192.0	
35243	chr6	53718819	53719314	495	248.0	
35244	chr6	53725578	53726448	870	435.0	
35245	chr6	53728488	53729049	561	280.0	
35246	chr6	53734977	53736238	1261	630.0	
35247	chr6	53741489	53741833	344	172.0	
35248	chr6	53793364	53796576	3212	1606.0	
35249	chr6	54191363	54191883	520	260.0	
35250	chr6	54198067	54198647	580	290.0	
35251	chr6	55023215	55023616	401	200.0	
35252	chr6	55040099	55040572	473	236.0	
35253	chr6	55047313	55047889	576	288.0	
35254	chr6	56004522	56004711	189	94.0	
35255	chr6	56046571	56047012	441	220.0	
35256	chr6	56100949	56101684	735	368.0	
35257	chr6	56243461	56243989	528	264.0	
35258	chr6	56244828	56245240	412	206.0	
35259	chr6	56359177	56359677	500	250.0	
35260	chr6	56370569	56371432	863	432.0	
35261	chr6	56540219	56540631	412	206.0	
35262	chr6	56541406	56543468	2062	1031.0	
35263	chr6	56570961	56571105	144	72.0	
35264	chr6	56582276	56582574	298	149.0	
35265	chr6	56592912	56594468	1556	778.0	
35266	chr6	56595307	56595902	595	298.0	
35267	chr6	56671942	56672335	393	196.0	
35268	chr6	56692550	56693108	558	279.0	
35269	chr6	56708641	56709433	792	396.0	
35270	chr6	56734407	56734700	293	146.0	
35271	chr6	56742106	56742907	801	400.0	
35272	chr6	56757618	56758042	424	212.0	
35273	chr6	56764128	56764364	236	118.0	
35274	chr6	56842790	56844575	1785	892.0	
35275	chr6	56851521	56852401	880	440.0	
35276	chr6	56890581	56890989	408	204.0	
35277	chr6	56902830	56903271	441	220.0	
35278	chr6	56904547	56905029	482	241.0	
35279	chr6	56954226	56956176	1950	975.0	
35280	chr6	56984305	56984639	334	167.0	
35281	chr6	57021147	57021485	338	169.0	
35282	chr6	57045346	57045629	283	142.0	
35283	chr6	57046130	57047164	1034	517.0	
35284	chr6	57088003	57088209	206	103.0	
35285	chr6	57089364	57090703	1339	670.0	
35286	chr6	57104244	57104769	525	262.0	
35287	chr6	57108605	57109107	502	251.0	
35288	chr6	57171672	57174063	2391	1196.0	
35289	chr6	57221145	57223122	1977	988.0	
35290	chr6	57268065	57268425	360	180.0	
35291	chr6	57316200	57318211	2011	1006.0	
35292	chr6	57324547	57324872	325	162.0	
35293	chr6	57348479	57349000	521	260.0	
35294	chr6	60428977	60429217	240	120.0	
35295	chr6	60434571	60434746	175	88.0	
35296	chr6	60472871	60472873	2	1.0	
35297	chr6	60480083	60480096	13	6.0	
35298	chr6	60532060	60532290	230	115.0	
35299	chr6	57941209	57941397	188	94.0	
35300	chr6	57960949	57961939	990	495.0	
35301	chr6	58447303	58448484	1181	590.0	
35302	chr6	58449757	58453614	3857	1928.0	
35303	chr6	61322764	61323804	1040	520.0	
35304	chr6	62013849	62013971	122	61.0	
35305	chr6	62285423	62286735	1312	656.0	
35306	chr6	62298697	62299132	435	218.0	
35307	chr6	62367685	62367952	267	134.0	
35308	chr6	63307876	63307987	111	56.0	
35309	chr6	63352029	63353515	1486	743.0	
35310	chr6	63355780	63355858	78	39.0	
35311	chr6	63383803	63384309	506	253.0	
35312	chr6	63418685	63419207	522	261.0	
35313	chr6	63441603	63442552	949	474.0	
35314	chr6	63519303	63519532	229	114.0	
35315	chr6	63525319	63525431	112	56.0	
35316	chr6	63571304	63574956	3652	1826.0	
35317	chr6	63582607	63583089	482	241.0	
35318	chr6	63583644	63584767	1123	562.0	
35319	chr6	63585446	63587521	2075	1038.0	
35320	chr6	63597913	63599162	1249	624.0	
35321	chr6	63600177	63600554	377	188.0	
35322	chr6	63609283	63609547	264	132.0	
35323	chr6	63629212	63629435	223	112.0	
35324	chr6	63634745	63637210	2465	1232.0	
35325	chr6	63640138	63640381	243	122.0	
35326	chr6	63643851	63644341	490	245.0	
35327	chr6	63685397	63685985	588	294.0	
35328	chr6	63690409	63690586	177	88.0	
35329	chr6	63764385	63764703	318	159.0	
35330	chr6	63794838	63795095	257	128.0	
35331	chr6	63805604	63807335	1731	866.0	
35332	chr6	63816567	63817012	445	222.0	
35333	chr6	63819743	63820222	479	240.0	
35334	chr6	63904860	63905273	413	206.0	
35335	chr6	64672137	64672535	398	199.0	
35336	chr6	64955429	64955702	273	136.0	
35337	chr6	66628864	66629330	466	233.0	
35338	chr6	68572560	68572896	336	168.0	
35339	chr6	68613835	68614308	473	236.0	
35340	chr6	68628304	68628714	410	205.0	
35341	chr6	68632698	68633026	328	164.0	
35342	chr6	68634346	68636139	1793	896.0	
35343	chr6	68756497	68757152	655	328.0	
35344	chr6	68967845	68968494	649	324.0	
35345	chr6	69784670	69785008	338	169.0	
35346	chr6	69789525	69790055	530	265.0	
35347	chr6	69791169	69791399	230	115.0	
35348	chr6	69793770	69794210	440	220.0	
35349	chr6	69795325	69797748	2423	1212.0	
35350	chr6	69813062	69814123	1061	530.0	
35351	chr6	69814893	69817004	2111	1056.0	
35352	chr6	69835656	69836149	493	246.0	
35353	chr6	69837449	69837656	207	104.0	
35354	chr6	69866253	69868493	2240	1120.0	
35355	chr6	69881276	69882265	989	494.0	
35356	chr6	70369233	70369801	568	284.0	
35357	chr6	70371472	70371914	442	221.0	
35358	chr6	70397068	70397506	438	219.0	
35359	chr6	70409223	70409563	340	170.0	
35360	chr6	70412583	70415667	3084	1542.0	
35361	chr6	70538435	70538755	320	160.0	
35362	chr6	70566254	70567565	1311	656.0	
35363	chr6	70651208	70651804	596	298.0	
35364	chr6	70666647	70669567	2920	1460.0	
35365	chr6	70686498	70686963	465	232.0	
35366	chr6	70706521	70706914	393	196.0	
35367	chr6	70717382	70717816	434	217.0	
35368	chr6	70754039	70754279	240	120.0	
35369	chr6	70857392	70857783	391	196.0	
35370	chr6	70884295	70884794	499	250.0	
35371	chr6	70955416	70957154	1738	869.0	
35372	chr6	71012861	71013225	364	182.0	
35373	chr6	71043921	71044322	401	200.0	
35374	chr6	71091206	71091614	408	204.0	
35375	chr6	71228456	71229178	722	361.0	
35376	chr6	71248163	71248922	759	380.0	
35377	chr6	71249939	71250816	877	438.0	
35378	chr6	71269293	71269395	102	51.0	
35379	chr6	71287009	71290940	3931	1966.0	
35380	chr6	71292072	71292195	123	62.0	
35381	chr6	71324417	71324769	352	176.0	
35382	chr6	71347115	71347481	366	183.0	
35383	chr6	71349345	71349694	349	174.0	
35384	chr6	71366405	71366873	468	234.0	
35385	chr6	71420580	71421124	544	272.0	
35386	chr6	72411965	72412671	706	353.0	
35387	chr6	72580339	72580763	424	212.0	
35388	chr6	72616403	72616809	406	203.0	
35389	chr6	72619650	72623776	4126	2063.0	
35390	chr6	72624517	72624995	478	239.0	
35391	chr6	72733053	72733377	324	162.0	
35392	chr6	72862160	72862544	384	192.0	
35393	chr6	72987268	72987608	340	170.0	
35394	chr6	73129671	73130520	849	424.0	
35395	chr6	73180655	73181457	802	401.0	
35396	chr6	73261948	73263833	1885	942.0	
35397	chr6	73309197	73310830	1633	816.0	
35398	chr6	73314751	73315114	363	182.0	
35399	chr6	73326555	73327030	475	238.0	
35400	chr6	73388462	73389662	1200	600.0	
35401	chr6	73394462	73395404	942	471.0	
35402	chr6	73421844	73423074	1230	615.0	
35403	chr6	73442541	73442699	158	79.0	
35404	chr6	73449329	73453189	3860	1930.0	
35405	chr6	73454662	73455193	531	266.0	
35406	chr6	73455792	73456602	810	405.0	
35407	chr6	73460804	73463284	2480	1240.0	
35408	chr6	73471669	73472350	681	340.0	
35409	chr6	73474497	73474569	72	36.0	
35410	chr6	73494874	73495069	195	98.0	
35411	chr6	73501664	73501790	126	63.0	
35412	chr6	73502655	73524496	21841	10920.0	
35413	chr6	73534128	73534524	396	198.0	
35414	chr6	73560796	73561289	493	246.0	
35415	chr6	73566926	73567464	538	269.0	
35416	chr6	73568246	73568498	252	126.0	
35417	chr6	73579553	73581292	1739	870.0	
35418	chr6	73585046	73586722	1676	838.0	
35419	chr6	73597447	73598292	845	422.0	
35420	chr6	73610328	73610913	585	292.0	
35421	chr6	73645380	73646028	648	324.0	
35422	chr6	73652508	73655583	3075	1538.0	
35423	chr6	73657117	73657677	560	280.0	
35424	chr6	73671924	73672725	801	400.0	
35425	chr6	73675400	73675925	525	262.0	
35426	chr6	73695320	73697328	2008	1004.0	
35427	chr6	73713809	73714617	808	404.0	
35428	chr6	73722638	73723042	404	202.0	
35429	chr6	73725130	73725669	539	270.0	
35430	chr6	73732856	73733889	1033	516.0	
35431	chr6	73739059	73739536	477	238.0	
35432	chr6	73744810	73745211	401	200.0	
35433	chr6	73747102	73747790	688	344.0	
35434	chr6	73854988	73855382	394	197.0	
35435	chr6	74925727	74926065	338	169.0	
35436	chr6	75204476	75209442	4966	2483.0	
35437	chr6	75211105	75211566	461	230.0	
35438	chr6	75230700	75230833	133	66.0	
35439	chr6	75243055	75244626	1571	786.0	
35440	chr6	75266674	75267139	465	232.0	
35441	chr6	75272157	75273468	1311	656.0	
35442	chr6	75278507	75278911	404	202.0	
35443	chr6	75281684	75282072	388	194.0	
35444	chr6	75283307	75285854	2547	1274.0	
35445	chr6	75297161	75297621	460	230.0	
35446	chr6	75300529	75300786	257	128.0	
35447	chr6	75496200	75496878	678	339.0	
35448	chr6	75526461	75526949	488	244.0	
35449	chr6	75563008	75563421	413	206.0	
35450	chr6	75598823	75599178	355	178.0	
35451	chr6	75601219	75604036	2817	1408.0	
35452	chr6	75608506	75609547	1041	520.0	
35453	chr6	75611236	75613833	2597	1298.0	
35454	chr6	75620346	75620732	386	193.0	
35455	chr6	75748364	75750344	1980	990.0	
35456	chr6	75781765	75782206	441	220.0	
35457	chr6	75824229	75824592	363	182.0	
35458	chr6	75893348	75893706	358	179.0	
35459	chr6	75934925	75935239	314	157.0	
35460	chr6	77465866	77466783	917	458.0	
35461	chr6	77650261	77650698	437	218.0	
35462	chr6	78867016	78868188	1172	586.0	
35463	chr6	78909348	78909749	401	200.0	
35464	chr6	78910595	78910996	401	200.0	
35465	chr6	79048645	79049010	365	182.0	
35466	chr6	79064683	79064821	138	69.0	
35467	chr6	79076049	79079298	3249	1624.0	
35468	chr6	79196923	79197322	399	200.0	
35469	chr6	79208808	79209124	316	158.0	
35470	chr6	79233318	79235291	1973	986.0	
35471	chr6	79453762	79453886	124	62.0	
35472	chr6	79536540	79538127	1587	794.0	
35473	chr6	79544834	79545530	696	348.0	
35474	chr6	79570747	79571150	403	202.0	
35475	chr6	79630988	79631830	842	421.0	
35476	chr6	79645962	79646395	433	216.0	
35477	chr6	79666670	79666889	219	110.0	
35478	chr6	79671513	79672056	543	272.0	
35479	chr6	79672840	79673009	169	84.0	
35480	chr6	79702648	79703196	548	274.0	
35481	chr6	79713684	79714039	355	178.0	
35482	chr6	79777592	79778646	1054	527.0	
35483	chr6	79802837	79803360	523	262.0	
35484	chr6	79813835	79814291	456	228.0	
35485	chr6	79862784	79863167	383	192.0	
35486	chr6	79868090	79868591	501	250.0	
35487	chr6	79869491	79870247	756	378.0	
35488	chr6	79873306	79873310	4	2.0	
35489	chr6	79874735	79875231	496	248.0	
35490	chr6	79910515	79910817	302	151.0	
35491	chr6	79913441	79913754	313	156.0	
35492	chr6	79946221	79948381	2160	1080.0	
35493	chr6	79948907	79949790	883	442.0	
35494	chr6	79964407	79965163	756	378.0	
35495	chr6	79984401	79984563	162	81.0	
35496	chr6	80003271	80005246	1975	988.0	
35497	chr6	80029538	80029903	365	182.0	
35498	chr6	80093984	80094489	505	252.0	
35499	chr6	80105971	80107368	1397	698.0	
35500	chr6	80163883	80164266	383	192.0	
35501	chr6	80165162	80165610	448	224.0	
35502	chr6	80214445	80214770	325	162.0	
35503	chr6	80338216	80338669	453	226.0	
35504	chr6	80454078	80454685	607	304.0	
35505	chr6	80605409	80605786	377	188.0	
35506	chr6	80607735	80608136	401	200.0	
35507	chr6	80638651	80639139	488	244.0	
35508	chr6	81744041	81745664	1623	812.0	
35509	chr6	81749756	81754711	4955	2478.0	
35510	chr6	81766302	81767192	890	445.0	
35511	chr6	81772704	81773178	474	237.0	
35512	chr6	81794029	81794258	229	114.0	
35513	chr6	81797547	81798053	506	253.0	
35514	chr6	81808901	81809749	848	424.0	
35515	chr6	81812302	81812919	617	308.0	
35516	chr6	81814400	81815076	676	338.0	
35517	chr6	81818810	81819128	318	159.0	
35518	chr6	81820938	81821459	521	260.0	
35519	chr6	81941144	81941678	534	267.0	
35520	chr6	81962286	81962460	174	87.0	
35521	chr6	81968903	81969440	537	268.0	
35522	chr6	82006149	82006478	329	164.0	
35523	chr6	82067039	82067391	352	176.0	
35524	chr6	82246368	82248765	2397	1198.0	
35525	chr6	82251938	82252333	395	198.0	
35526	chr6	82259382	82259843	461	230.0	
35527	chr6	82270743	82271186	443	222.0	
35528	chr6	82281635	82282046	411	206.0	
35529	chr6	82363480	82365469	1989	994.0	
35530	chr6	83055346	83055833	487	244.0	
35531	chr6	83057720	83058116	396	198.0	
35532	chr6	83065043	83066555	1512	756.0	
35533	chr6	83067149	83068618	1469	734.0	
35534	chr6	83070907	83071491	584	292.0	
35535	chr6	83073852	83073965	113	56.0	
35536	chr6	83086774	83087145	371	186.0	
35537	chr6	83192566	83194617	2051	1026.0	
35538	chr6	83215082	83215611	529	264.0	
35539	chr6	83221896	83222281	385	192.0	
35540	chr6	83308907	83309128	221	110.0	
35541	chr6	83417958	83418238	280	140.0	
35542	chr6	83430415	83431509	1094	547.0	
35543	chr6	83434257	83434875	618	309.0	
35544	chr6	83442842	83443094	252	126.0	
35545	chr6	83444272	83444715	443	222.0	
35546	chr6	83459611	83460167	556	278.0	
35547	chr6	83463854	83464275	421	210.0	
35548	chr6	83467474	83468251	777	388.0	
35549	chr6	83511828	83512742	914	457.0	
35550	chr6	83514848	83515282	434	217.0	
35551	chr6	83536023	83536463	440	220.0	
35552	chr6	83546400	83547125	725	362.0	
35553	chr6	83550489	83550852	363	182.0	
35554	chr6	83590131	83590923	792	396.0	
35555	chr6	83592753	83593202	449	224.0	
35556	chr6	83858943	83861605	2662	1331.0	
35557	chr6	83867310	83868232	922	461.0	
35558	chr6	83884402	83884890	488	244.0	
35559	chr6	84093633	84093954	321	160.0	
35560	chr6	84227022	84228646	1624	812.0	
35561	chr6	85323515	85323806	291	146.0	
35562	chr6	85354975	85355418	443	222.0	
35563	chr6	85449305	85450978	1673	836.0	
35564	chr6	85458234	85458469	235	118.0	
35565	chr6	85460981	85462336	1355	678.0	
35566	chr6	85464254	85465147	893	446.0	
35567	chr6	85465729	85466130	401	200.0	
35568	chr6	85482870	85483530	660	330.0	
35569	chr6	85493388	85493802	414	207.0	
35570	chr6	85537261	85537446	185	92.0	
35571	chr6	85576610	85576634	24	12.0	
35572	chr6	85592692	85595290	2598	1299.0	
35573	chr6	85640863	85645685	4822	2411.0	
35574	chr6	85660288	85660492	204	102.0	
35575	chr6	85669283	85679886	10603	5302.0	
35576	chr6	87066453	87066808	355	178.0	
35577	chr6	87078992	87079416	424	212.0	
35578	chr6	87137201	87137464	263	132.0	
35579	chr6	87139180	87139856	676	338.0	
35580	chr6	87151436	87152967	1531	766.0	
35581	chr6	87154443	87157065	2622	1311.0	
35582	chr6	87174220	87174403	183	92.0	
35583	chr6	87237828	87238232	404	202.0	
35584	chr6	87321789	87323323	1534	767.0	
35585	chr6	87333857	87334115	258	129.0	
35586	chr6	87392956	87393613	657	328.0	
35587	chr6	87396980	87397442	462	231.0	
35588	chr6	87407420	87409081	1661	830.0	
35589	chr6	87436387	87436842	455	228.0	
35590	chr6	87472253	87474051	1798	899.0	
35591	chr6	87482115	87482873	758	379.0	
35592	chr6	87589070	87590870	1800	900.0	
35593	chr6	87600684	87600918	234	117.0	
35594	chr6	87644981	87645600	619	310.0	
35595	chr6	87656850	87657219	369	184.0	
35596	chr6	87670676	87672044	1368	684.0	
35597	chr6	87682307	87682632	325	162.0	
35598	chr6	87691160	87692577	1417	708.0	
35599	chr6	87693279	87694011	732	366.0	
35600	chr6	87695674	87703163	7489	3744.0	
35601	chr6	87705211	87705423	212	106.0	
35602	chr6	87710054	87710518	464	232.0	
35603	chr6	87714363	87714829	466	233.0	
35604	chr6	87716885	87717593	708	354.0	
35605	chr6	87718551	87719729	1178	589.0	
35606	chr6	87723109	87723737	628	314.0	
35607	chr6	87725376	87725994	618	309.0	
35608	chr6	87730313	87730770	457	228.0	
35609	chr6	87731451	87732994	1543	772.0	
35610	chr6	87737201	87737485	284	142.0	
35611	chr6	87738154	87738286	132	66.0	
35612	chr6	87741979	87742741	762	381.0	
35613	chr6	87747556	87748118	562	281.0	
35614	chr6	87754764	87755397	633	316.0	
35615	chr6	87756697	87757567	870	435.0	
35616	chr6	87759239	87759704	465	232.0	
35617	chr6	87767511	87767852	341	170.0	
35618	chr6	87789145	87790105	960	480.0	
35619	chr6	87796433	87797073	640	320.0	
35620	chr6	87799697	87799968	271	136.0	
35621	chr6	87806178	87806288	110	55.0	
35622	chr6	87824859	87826436	1577	788.0	
35623	chr6	87829753	87831315	1562	781.0	
35624	chr6	87831892	87832789	897	448.0	
35625	chr6	87902401	87902799	398	199.0	
35626	chr6	87907522	87907984	462	231.0	
35627	chr6	87922623	87923398	775	388.0	
35628	chr6	87925242	87926106	864	432.0	enhancer
35629	chr6	87929722	87930239	517	258.0	
35630	chr6	87968568	87968912	344	172.0	
35631	chr6	88012949	88013427	478	239.0	
35632	chr6	88141516	88142461	945	472.0	
35633	chr6	88165741	88167166	1425	712.0	
35634	chr6	88177813	88178293	480	240.0	
35635	chr6	88179635	88180012	377	188.0	
35636	chr6	88262522	88262671	149	74.0	
35637	chr6	88380065	88380531	466	233.0	
35638	chr6	88442739	88443934	1195	598.0	
35639	chr6	88449780	88450097	317	158.0	
35640	chr6	88615865	88616746	881	440.0	
35641	chr6	88641392	88641821	429	214.0	
35642	chr6	88780727	88781245	518	259.0	
35643	chr6	88870700	88871115	415	208.0	
35644	chr6	88907295	88907421	126	63.0	
35645	chr6	88923038	88923639	601	300.0	
35646	chr6	88962829	88964427	1598	799.0	
35647	chr6	88982617	88983921	1304	652.0	
35648	chr6	89007733	89008697	964	482.0	
35649	chr6	89009642	89010290	648	324.0	
35650	chr6	89032628	89032879	251	126.0	
35651	chr6	89033437	89036436	2999	1500.0	
35652	chr6	89044696	89045459	763	382.0	
35653	chr6	89051645	89052015	370	185.0	
35654	chr6	89066895	89067376	481	240.0	
35655	chr6	89072892	89073593	701	350.0	
35656	chr6	89078752	89089796	11044	5522.0	
35657	chr6	89090834	89091536	702	351.0	
35658	chr6	89117023	89118313	1290	645.0	
35659	chr6	89122624	89122999	375	188.0	
35660	chr6	89128355	89128825	470	235.0	
35661	chr6	89132078	89132279	201	100.0	
35662	chr6	89145364	89147603	2239	1120.0	
35663	chr6	89175192	89175489	297	148.0	
35664	chr6	89233619	89234202	583	292.0	
35665	chr6	89239300	89239848	548	274.0	
35666	chr6	89242551	89243043	492	246.0	
35667	chr6	89260267	89261135	868	434.0	
35668	chr6	89270915	89271536	621	310.0	
35669	chr6	89281748	89282360	612	306.0	
35670	chr6	89297571	89299142	1571	786.0	
35671	chr6	89308473	89309129	656	328.0	
35672	chr6	89321396	89322142	746	373.0	
35673	chr6	89323449	89324185	736	368.0	
35674	chr6	89344429	89344857	428	214.0	
35675	chr6	89347563	89348312	749	374.0	
35676	chr6	89348921	89353610	4689	2344.0	
35677	chr6	89354138	89354427	289	144.0	
35678	chr6	89357142	89358172	1030	515.0	
35679	chr6	89359590	89359928	338	169.0	
35680	chr6	89360644	89360784	140	70.0	
35681	chr6	89367870	89368534	664	332.0	
35682	chr6	89371790	89372852	1062	531.0	
35683	chr6	89375318	89376179	861	430.0	
35684	chr6	89379117	89379658	541	270.0	
35685	chr6	89401030	89401488	458	229.0	
35686	chr6	89406096	89406501	405	202.0	
35687	chr6	89410471	89413649	3178	1589.0	
35688	chr6	89432598	89434493	1895	948.0	
35689	chr6	89474372	89475044	672	336.0	
35690	chr6	89475630	89476086	456	228.0	
35691	chr6	89595985	89596525	540	270.0	
35692	chr6	89609984	89610511	527	264.0	
35693	chr6	89637879	89639345	1466	733.0	
35694	chr6	89689692	89690224	532	266.0	
35695	chr6	89736900	89737198	298	149.0	
35696	chr6	89792891	89793294	403	202.0	
35697	chr6	89794415	89794630	215	108.0	
35698	chr6	89818511	89820824	2313	1156.0	
35699	chr6	89828603	89830650	2047	1024.0	
35700	chr6	89834788	89835824	1036	518.0	
35701	chr6	89887793	89888023	230	115.0	
35702	chr6	89927809	89928575	766	383.0	
35703	chr6	89940209	89940878	669	334.0	
35704	chr6	89944771	89945222	451	226.0	
35705	chr6	89952073	89953799	1726	863.0	
35706	chr6	89954897	89955013	116	58.0	
35707	chr6	89970598	89970981	383	192.0	
35708	chr6	90000164	90000189	25	12.0	
35709	chr6	90078563	90081815	3252	1626.0	
35710	chr6	90082885	90083190	305	152.0	
35711	chr6	90083782	90084520	738	369.0	
35712	chr6	90085572	90085574	2	1.0	
35713	chr6	90087882	90088508	626	313.0	
35714	chr6	90097847	90098745	898	449.0	
35715	chr6	90101374	90101768	394	197.0	
35716	chr6	90103159	90103890	731	366.0	
35717	chr6	90105523	90107026	1503	752.0	
35718	chr6	90107905	90108369	464	232.0	
35719	chr6	90109079	90109514	435	218.0	
35720	chr6	90110824	90111790	966	483.0	
35721	chr6	90146879	90147492	613	306.0	
35722	chr6	90156799	90157306	507	254.0	
35723	chr6	90160096	90160178	82	41.0	
35724	chr6	90173562	90173872	310	155.0	
35725	chr6	90175711	90176546	835	418.0	
35726	chr6	90177699	90179603	1904	952.0	
35727	chr6	90184447	90185199	752	376.0	
35728	chr6	90186854	90188114	1260	630.0	
35729	chr6	90190756	90191294	538	269.0	
35730	chr6	90197856	90198314	458	229.0	
35731	chr6	90202208	90202446	238	119.0	
35732	chr6	90212316	90212691	375	188.0	
35733	chr6	90214516	90214857	341	170.0	
35734	chr6	90215966	90217071	1105	552.0	
35735	chr6	90217996	90219922	1926	963.0	
35736	chr6	90229679	90229888	209	104.0	
35737	chr6	90232824	90234878	2054	1027.0	
35738	chr6	90238968	90239058	90	45.0	
35739	chr6	90241283	90241726	443	222.0	
35740	chr6	90249447	90249899	452	226.0	
35741	chr6	90251428	90251786	358	179.0	
35742	chr6	90256693	90257340	647	324.0	
35743	chr6	90266649	90267688	1039	520.0	
35744	chr6	90271720	90272441	721	360.0	
35745	chr6	90273119	90275273	2154	1077.0	
35746	chr6	90280801	90281034	233	116.0	
35747	chr6	90281929	90282187	258	129.0	
35748	chr6	90284150	90287322	3172	1586.0	
35749	chr6	90293137	90299077	5940	2970.0	
35750	chr6	90303047	90303531	484	242.0	
35751	chr6	90304336	90304714	378	189.0	
35752	chr6	90315422	90316021	599	300.0	
35753	chr6	90350374	90352176	1802	901.0	
35754	chr6	90368943	90369562	619	310.0	
35755	chr6	90375397	90376402	1005	502.0	
35756	chr6	90383090	90383805	715	358.0	
35757	chr6	90393026	90393801	775	388.0	
35758	chr6	90397734	90398781	1047	524.0	
35759	chr6	90400168	90400333	165	82.0	
35760	chr6	90401901	90403068	1167	584.0	
35761	chr6	90411210	90411958	748	374.0	
35762	chr6	90413307	90414715	1408	704.0	
35763	chr6	90424798	90425932	1134	567.0	
35764	chr6	90458332	90459101	769	384.0	
35765	chr6	90463371	90463861	490	245.0	
35766	chr6	90472733	90473799	1066	533.0	
35767	chr6	90476600	90476950	350	175.0	
35768	chr6	90478889	90479951	1062	531.0	
35769	chr6	90485655	90485939	284	142.0	
35770	chr6	90537584	90538368	784	392.0	
35771	chr6	90544103	90544453	350	175.0	
35772	chr6	90562397	90562811	414	207.0	
35773	chr6	90586278	90587893	1615	808.0	
35774	chr6	90610599	90611673	1074	537.0	
35775	chr6	90940678	90941451	773	386.0	
35776	chr6	91487966	91488440	474	237.0	
35777	chr6	92109953	92110482	529	264.0	
35778	chr6	92116071	92116413	342	171.0	
35779	chr6	92671290	92671952	662	331.0	
35780	chr6	92687296	92687655	359	180.0	
35781	chr6	92688579	92688679	100	50.0	
35782	chr6	93419463	93419938	475	238.0	
35783	chr6	95572089	95572549	460	230.0	
35784	chr6	95574840	95575129	289	144.0	
35785	chr6	95576442	95578546	2104	1052.0	
35786	chr6	96466144	96466592	448	224.0	
35787	chr6	96499472	96500464	992	496.0	
35788	chr6	96519269	96519435	166	83.0	
35789	chr6	96520725	96522930	2205	1102.0	
35790	chr6	96836594	96838180	1586	793.0	
35791	chr6	96885092	96885678	586	293.0	
35792	chr6	96896969	96898935	1966	983.0	
35793	chr6	96917096	96917498	402	201.0	
35794	chr6	96921556	96922439	883	442.0	
35795	chr6	96923332	96925468	2136	1068.0	
35796	chr6	97049447	97050100	653	326.0	
35797	chr6	97059526	97059801	275	138.0	
35798	chr6	97186386	97186824	438	219.0	
35799	chr6	97262637	97263053	416	208.0	
35800	chr6	97282234	97283957	1723	862.0	
35801	chr6	97394107	97394557	450	225.0	
35802	chr6	97497719	97498145	426	213.0	
35803	chr6	97669454	97669484	30	15.0	
35804	chr6	98827893	98827900	7	4.0	enhancer
35805	chr6	98829070	98829302	232	116.0	
35806	chr6	98831179	98831747	568	284.0	
35807	chr6	98832272	98836100	3828	1914.0	
35808	chr6	98842815	98843995	1180	590.0	
35809	chr6	98844829	98846209	1380	690.0	
35810	chr6	98847824	98848892	1068	534.0	
35811	chr6	98946635	98948674	2039	1020.0	
35812	chr6	98949213	98949400	187	94.0	
35813	chr6	99330042	99330649	607	304.0	
35814	chr6	99334600	99334884	284	142.0	
35815	chr6	99393422	99394620	1198	599.0	
35816	chr6	99402515	99402813	298	149.0	
35817	chr6	99417181	99417842	661	330.0	
35818	chr6	99423571	99423877	306	153.0	
35819	chr6	99424391	99426507	2116	1058.0	
35820	chr6	99434721	99435349	628	314.0	
35821	chr6	99484721	99485142	421	210.0	
35822	chr6	99490660	99490889	229	114.0	
35823	chr6	99514600	99516457	1857	928.0	
35824	chr6	99520484	99522113	1629	814.0	
35825	chr6	99567883	99569248	1365	682.0	
35826	chr6	99588403	99589707	1304	652.0	
35827	chr6	99590616	99591851	1235	618.0	
35828	chr6	99592907	99593188	281	140.0	
35829	chr6	99602405	99604193	1788	894.0	
35830	chr6	99604845	99605655	810	405.0	
35831	chr6	99612965	99615024	2059	1030.0	
35832	chr6	99746251	99746739	488	244.0	
35833	chr6	99868079	99868504	425	212.0	
35834	chr6	100001908	100002302	394	197.0	
35835	chr6	100107507	100107724	217	108.0	
35836	chr6	100228495	100229415	920	460.0	
35837	chr6	100258000	100258280	280	140.0	
35838	chr6	100464849	100465173	324	162.0	
35839	chr6	100664303	100665247	944	472.0	
35840	chr6	100796466	100796648	182	91.0	
35841	chr6	100880343	100882269	1926	963.0	
35842	chr6	100913889	100914121	232	116.0	
35843	chr6	101011115	101011610	495	248.0	
35844	chr6	101266073	101266370	297	148.0	
35845	chr6	101760955	101761786	831	416.0	
35846	chr6	101845425	101846064	639	320.0	
35847	chr6	104423531	104423857	326	163.0	
35848	chr6	104525633	104526150	517	258.0	
35849	chr6	104638935	104640134	1199	600.0	
35850	chr6	104671418	104671422	4	2.0	
35851	chr6	104682999	104683480	481	240.0	
35852	chr6	104705011	104705584	573	286.0	
35853	chr6	104771237	104771667	430	215.0	
35854	chr6	104789712	104790300	588	294.0	
35855	chr6	104858765	104860441	1676	838.0	
35856	chr6	104940976	104941797	821	410.0	
35857	chr6	105087556	105087986	430	215.0	
35858	chr6	105136623	105137261	638	319.0	
35859	chr6	105397940	105398354	414	207.0	
35860	chr6	105400464	105400887	423	212.0	
35861	chr6	105402083	105403901	1818	909.0	
35862	chr6	105424118	105424634	516	258.0	
35863	chr6	105431267	105431401	134	67.0	
35864	chr6	105452698	105454318	1620	810.0	
35865	chr6	105455577	105455983	406	203.0	
35866	chr6	105458169	105460093	1924	962.0	
35867	chr6	105482321	105482949	628	314.0	
35868	chr6	105484445	105485164	719	360.0	
35869	chr6	105489105	105489426	321	160.0	
35870	chr6	105553081	105553639	558	279.0	
35871	chr6	105561464	105561856	392	196.0	
35872	chr6	105590983	105591543	560	280.0	
35873	chr6	105599689	105600090	401	200.0	
35874	chr6	105601209	105602244	1035	518.0	
35875	chr6	105644058	105644491	433	216.0	
35876	chr6	105645921	105647087	1166	583.0	
35877	chr6	105648038	105649286	1248	624.0	
35878	chr6	105691091	105691473	382	191.0	
35879	chr6	105692918	105693068	150	75.0	
35880	chr6	105733552	105733869	317	158.0	
35881	chr6	105746295	105746540	245	122.0	
35882	chr6	105748587	105749369	782	391.0	
35883	chr6	105781907	105782380	473	236.0	
35884	chr6	105783357	105784019	662	331.0	
35885	chr6	105785190	105786025	835	418.0	
35886	chr6	105786551	105786821	270	135.0	
35887	chr6	105791584	105792045	461	230.0	
35888	chr6	105793077	105794704	1627	814.0	
35889	chr6	105810449	105810996	547	274.0	
35890	chr6	105832189	105832868	679	340.0	
35891	chr6	105863194	105863860	666	333.0	
35892	chr6	105867201	105868207	1006	503.0	
35893	chr6	105869901	105870472	571	286.0	
35894	chr6	105872123	105872815	692	346.0	
35895	chr6	105879845	105880782	937	468.0	
35896	chr6	105881666	105881689	23	12.0	
35897	chr6	105884103	105884579	476	238.0	
35898	chr6	105886121	105886433	312	156.0	
35899	chr6	105892828	105893433	605	302.0	
35900	chr6	105900099	105900673	574	287.0	
35901	chr6	105908997	105909577	580	290.0	
35902	chr6	105935004	105935859	855	428.0	
35903	chr6	105980917	105981904	987	494.0	
35904	chr6	105985566	105986436	870	435.0	
35905	chr6	105991658	105995637	3979	1990.0	
35906	chr6	106056327	106056818	491	246.0	
35907	chr6	106082738	106083380	642	321.0	
35908	chr6	106084178	106085103	925	462.0	
35909	chr6	106085669	106086788	1119	560.0	
35910	chr6	106087394	106088340	946	473.0	
35911	chr6	106089971	106090622	651	326.0	
35912	chr6	106094141	106094846	705	352.0	
35913	chr6	106097137	106100310	3173	1586.0	
35914	chr6	106100836	106101260	424	212.0	
35915	chr6	106101922	106104444	2522	1261.0	
35916	chr6	106106386	106107005	619	310.0	
35917	chr6	106111691	106113813	2122	1061.0	
35918	chr6	106114435	106115612	1177	588.0	
35919	chr6	106116375	106119183	2808	1404.0	
35920	chr6	106124858	106125274	416	208.0	
35921	chr6	106125891	106126570	679	340.0	
35922	chr6	106141311	106142684	1373	686.0	
35923	chr6	106143628	106144089	461	230.0	
35924	chr6	106149348	106150039	691	346.0	
35925	chr6	106155388	106155839	451	226.0	
35926	chr6	106161385	106161684	299	150.0	
35927	chr6	106163029	106165141	2112	1056.0	
35928	chr6	106186295	106186526	231	116.0	
35929	chr6	106194854	106196152	1298	649.0	
35930	chr6	106197381	106197891	510	255.0	
35931	chr6	106223271	106223760	489	244.0	
35932	chr6	106300983	106301294	311	156.0	
35933	chr6	106324755	106326550	1795	898.0	
35934	chr6	106334938	106335638	700	350.0	
35935	chr6	106339099	106339969	870	435.0	
35936	chr6	106360110	106361724	1614	807.0	
35937	chr6	106444824	106445378	554	277.0	
35938	chr6	106446239	106446669	430	215.0	
35939	chr6	106447810	106448646	836	418.0	
35940	chr6	106449986	106450886	900	450.0	
35941	chr6	106477197	106477480	283	142.0	
35942	chr6	106501781	106502930	1149	574.0	
35943	chr6	106509320	106514678	5358	2679.0	
35944	chr6	106516324	106517159	835	418.0	
35945	chr6	106517741	106518112	371	186.0	
35946	chr6	106518943	106526232	7289	3644.0	
35947	chr6	106533033	106533498	465	232.0	
35948	chr6	106534353	106534967	614	307.0	
35949	chr6	106536922	106538721	1799	900.0	
35950	chr6	106539901	106540453	552	276.0	
35951	chr6	106546222	106547996	1774	887.0	
35952	chr6	106556335	106556789	454	227.0	
35953	chr6	106561347	106562466	1119	560.0	
35954	chr6	106566107	106566982	875	438.0	
35955	chr6	106573164	106573523	359	180.0	
35956	chr6	106608034	106608506	472	236.0	
35957	chr6	106628629	106630246	1617	808.0	
35958	chr6	106637285	106638277	992	496.0	
35959	chr6	106648873	106649311	438	219.0	
35960	chr6	106666590	106667106	516	258.0	
35961	chr6	106702339	106702908	569	284.0	
35962	chr6	106997594	106998039	445	222.0	
35963	chr6	107027537	107029083	1546	773.0	
35964	chr6	107061424	107061825	401	200.0	
35965	chr6	107064652	107065070	418	209.0	
35966	chr6	107109966	107110696	730	365.0	
35967	chr6	107113932	107117008	3076	1538.0	
35968	chr6	107318133	107318509	376	188.0	
35969	chr6	107330171	107330529	358	179.0	
35970	chr6	107458653	107460650	1997	998.0	
35971	chr6	107488122	107491687	3565	1782.0	
35972	chr6	107618536	107619282	746	373.0	
35973	chr6	107634684	107635045	361	180.0	
35974	chr6	107642584	107642929	345	172.0	
35975	chr6	107656944	107658604	1660	830.0	
35976	chr6	107669145	107669464	319	160.0	
35977	chr6	107670717	107671387	670	335.0	
35978	chr6	107674866	107675963	1097	548.0	
35979	chr6	107699674	107699990	316	158.0	
35980	chr6	107704354	107704839	485	242.0	
35981	chr6	107712462	107713709	1247	624.0	
35982	chr6	107715543	107717472	1929	964.0	
35983	chr6	107725997	107727243	1246	623.0	
35984	chr6	107729998	107732577	2579	1290.0	
35985	chr6	107735704	107737833	2129	1064.0	
35986	chr6	107740485	107741911	1426	713.0	
35987	chr6	107785732	107788294	2562	1281.0	
35988	chr6	107793490	107793852	362	181.0	
35989	chr6	107800575	107800895	320	160.0	
35990	chr6	107811557	107812269	712	356.0	
35991	chr6	107816416	107816496	80	40.0	
35992	chr6	107817676	107825281	7605	3802.0	
35993	chr6	107827523	107827975	452	226.0	
35994	chr6	107832598	107832999	401	200.0	
35995	chr6	107847800	107849050	1250	625.0	
35996	chr6	107866903	107867567	664	332.0	
35997	chr6	107894725	107895539	814	407.0	
35998	chr6	107956642	107959098	2456	1228.0	
35999	chr6	108049783	108050267	484	242.0	
36000	chr6	108068522	108069139	617	308.0	
36001	chr6	108073783	108075635	1852	926.0	
36002	chr6	108083228	108083840	612	306.0	
36003	chr6	108113422	108116183	2761	1380.0	
36004	chr6	108116905	108119931	3026	1513.0	
36005	chr6	108132860	108134239	1379	690.0	
36006	chr6	108142206	108142651	445	222.0	
36007	chr6	108157526	108158295	769	384.0	
36008	chr6	108168244	108169881	1637	818.0	
36009	chr6	108174279	108174683	404	202.0	
36010	chr6	108210651	108210659	8	4.0	
36011	chr6	108222496	108222890	394	197.0	
36012	chr6	108250530	108250810	280	140.0	
36013	chr6	108254404	108255039	635	318.0	
36014	chr6	108258826	108262125	3299	1650.0	
36015	chr6	108294192	108295863	1671	836.0	
36016	chr6	108348619	108349127	508	254.0	
36017	chr6	108361517	108361634	117	58.0	
36018	chr6	108453644	108454180	536	268.0	
36019	chr6	108492226	108492255	29	14.0	
36020	chr6	108526673	108527136	463	232.0	
36021	chr6	108541710	108542766	1056	528.0	
36022	chr6	108546422	108547067	645	322.0	
36023	chr6	108557227	108563235	6008	3004.0	
36024	chr6	108564841	108566615	1774	887.0	
36025	chr6	108567895	108569863	1968	984.0	
36026	chr6	108572250	108572398	148	74.0	
36027	chr6	108576593	108577796	1203	602.0	
36028	chr6	108578383	108580257	1874	937.0	
36029	chr6	108580759	108581985	1226	613.0	
36030	chr6	108584038	108584276	238	119.0	
36031	chr6	108587405	108587642	237	118.0	
36032	chr6	108588597	108589914	1317	658.0	
36033	chr6	108592255	108593277	1022	511.0	
36034	chr6	108594247	108594638	391	196.0	
36035	chr6	108596919	108597376	457	228.0	
36036	chr6	108598170	108598584	414	207.0	
36037	chr6	108616591	108617427	836	418.0	
36038	chr6	108619056	108619095	39	20.0	
36039	chr6	108622035	108623329	1294	647.0	
36040	chr6	108630195	108630686	491	246.0	
36041	chr6	108635419	108636185	766	383.0	
36042	chr6	108648242	108648294	52	26.0	
36043	chr6	108650686	108651275	589	294.0	
36044	chr6	108689179	108690087	908	454.0	
36045	chr6	108741910	108742556	646	323.0	
36046	chr6	108779499	108780027	528	264.0	
36047	chr6	108782034	108782921	887	444.0	
36048	chr6	108798378	108799148	770	385.0	
36049	chr6	108801225	108801782	557	278.0	
36050	chr6	108805835	108806249	414	207.0	
36051	chr6	108835142	108835793	651	326.0	
36052	chr6	108837212	108838585	1373	686.0	
36053	chr6	108839457	108839519	62	31.0	
36054	chr6	108841049	108842111	1062	531.0	
36055	chr6	108847735	108849229	1494	747.0	
36056	chr6	108850619	108851518	899	450.0	
36057	chr6	108862693	108863299	606	303.0	
36058	chr6	108865892	108866271	379	190.0	
36059	chr6	108871988	108872689	701	350.0	
36060	chr6	108874320	108875665	1345	672.0	
36061	chr6	108883320	108883335	15	8.0	
36062	chr6	108888753	108889090	337	168.0	
36063	chr6	108893382	108893775	393	196.0	
36064	chr6	108895541	108896768	1227	614.0	
36065	chr6	108900785	108901154	369	184.0	
36066	chr6	108902392	108902915	523	262.0	
36067	chr6	108904666	108905126	460	230.0	
36068	chr6	108914207	108914723	516	258.0	
36069	chr6	108921567	108921851	284	142.0	
36070	chr6	108923912	108924370	458	229.0	
36071	chr6	108942605	108943317	712	356.0	
36072	chr6	108959160	108959578	418	209.0	
36073	chr6	108966285	108967627	1342	671.0	
36074	chr6	108968685	108969151	466	233.0	
36075	chr6	109006041	109006086	45	22.0	
36076	chr6	109006834	109007544	710	355.0	
36077	chr6	109008328	109010509	2181	1090.0	
36078	chr6	109013643	109014101	458	229.0	
36079	chr6	109019897	109020362	465	232.0	
36080	chr6	109036492	109037006	514	257.0	
36081	chr6	109059250	109060223	973	486.0	
36082	chr6	109063000	109063341	341	170.0	
36083	chr6	109069781	109070378	597	298.0	
36084	chr6	109071261	109071716	455	228.0	
36085	chr6	109073094	109073974	880	440.0	
36086	chr6	109082143	109082589	446	223.0	
36087	chr6	109091675	109092053	378	189.0	
36088	chr6	109092584	109092599	15	8.0	
36089	chr6	109093662	109096529	2867	1434.0	
36090	chr6	109117297	109117862	565	282.0	
36091	chr6	109120736	109121343	607	304.0	
36092	chr6	109187759	109188278	519	260.0	
36093	chr6	109235509	109238192	2683	1342.0	
36094	chr6	109239252	109239618	366	183.0	
36095	chr6	109241238	109241756	518	259.0	
36096	chr6	109243564	109244010	446	223.0	
36097	chr6	109282753	109283086	333	166.0	
36098	chr6	109299791	109299822	31	16.0	
36099	chr6	109304323	109304771	448	224.0	
36100	chr6	109308029	109308435	406	203.0	
36101	chr6	109318691	109318715	24	12.0	
36102	chr6	109322699	109323386	687	344.0	
36103	chr6	109325527	109325853	326	163.0	
36104	chr6	109332757	109333167	410	205.0	
36105	chr6	109348139	109348552	413	206.0	
36106	chr6	109349523	109349905	382	191.0	
36107	chr6	109351695	109351752	57	28.0	
36108	chr6	109360421	109361157	736	368.0	
36109	chr6	109362300	109362795	495	248.0	
36110	chr6	109365655	109365963	308	154.0	
36111	chr6	109371097	109371194	97	48.0	
36112	chr6	109372126	109372581	455	228.0	
36113	chr6	109373401	109374611	1210	605.0	
36114	chr6	109379033	109385032	5999	3000.0	
36115	chr6	109390691	109390929	238	119.0	
36116	chr6	109397046	109397547	501	250.0	
36117	chr6	109439977	109444610	4633	2316.0	
36118	chr6	109445378	109446072	694	347.0	
36119	chr6	109447050	109450618	3568	1784.0	
36120	chr6	109453692	109459673	5981	2990.0	
36121	chr6	109472481	109472494	13	6.0	
36122	chr6	109478763	109479239	476	238.0	
36123	chr6	109481783	109484929	3146	1573.0	
36124	chr6	109491078	109491990	912	456.0	
36125	chr6	109493891	109494221	330	165.0	
36126	chr6	109515784	109516208	424	212.0	
36127	chr6	109521076	109521480	404	202.0	
36128	chr6	109526914	109527430	516	258.0	
36129	chr6	109690176	109692058	1882	941.0	
36130	chr6	109693062	109693589	527	264.0	
36131	chr6	109697185	109697814	629	314.0	
36132	chr6	109701711	109702208	497	248.0	
36133	chr6	109702720	109703259	539	270.0	
36134	chr6	109705075	109705725	650	325.0	
36135	chr6	109706467	109707119	652	326.0	
36136	chr6	109740768	109741131	363	182.0	
36137	chr6	109771016	109772710	1694	847.0	
36138	chr6	109873032	109873383	351	176.0	
36139	chr6	109891742	109892581	839	420.0	
36140	chr6	109893366	109894792	1426	713.0	
36141	chr6	109978514	109978920	406	203.0	
36142	chr6	110039170	110040550	1380	690.0	
36143	chr6	110053603	110053996	393	196.0	
36144	chr6	110096798	110097309	511	256.0	
36145	chr6	110101915	110102257	342	171.0	
36146	chr6	110178389	110182146	3757	1878.0	
36147	chr6	110186080	110186167	87	44.0	
36148	chr6	110205822	110206391	569	284.0	
36149	chr6	110233921	110234395	474	237.0	
36150	chr6	110296712	110296767	55	28.0	
36151	chr6	110322722	110323031	309	154.0	
36152	chr6	110357472	110358437	965	482.0	
36153	chr6	110390760	110391283	523	262.0	
36154	chr6	110399489	110400250	761	380.0	
36155	chr6	110415193	110416041	848	424.0	
36156	chr6	110421850	110422100	250	125.0	
36157	chr6	110448841	110448929	88	44.0	
36158	chr6	110475003	110476790	1787	894.0	
36159	chr6	110484244	110484837	593	296.0	
36160	chr6	110485451	110485579	128	64.0	
36161	chr6	110509751	110510335	584	292.0	
36162	chr6	110528010	110528464	454	227.0	
36163	chr6	110537380	110537396	16	8.0	
36164	chr6	110544506	110544684	178	89.0	
36165	chr6	110589772	110590289	517	258.0	
36166	chr6	110613591	110613672	81	40.0	
36167	chr6	110617061	110617520	459	230.0	
36168	chr6	110664661	110665405	744	372.0	
36169	chr6	110682118	110682971	853	426.0	
36170	chr6	110688734	110689724	990	495.0	
36171	chr6	110705596	110705900	304	152.0	
36172	chr6	110738786	110739600	814	407.0	
36173	chr6	110750518	110751162	644	322.0	
36174	chr6	110784280	110784324	44	22.0	
36175	chr6	110813821	110817139	3318	1659.0	
36176	chr6	110820913	110821394	481	240.0	
36177	chr6	110823187	110823446	259	130.0	
36178	chr6	110826056	110827173	1117	558.0	
36179	chr6	110859062	110860090	1028	514.0	
36180	chr6	110866482	110867118	636	318.0	
36181	chr6	110873193	110877969	4776	2388.0	
36182	chr6	110878717	110880355	1638	819.0	
36183	chr6	110881411	110886952	5541	2770.0	
36184	chr6	110887635	110887955	320	160.0	
36185	chr6	110888996	110889111	115	58.0	
36186	chr6	110896120	110905274	9154	4577.0	
36187	chr6	110914168	110914181	13	6.0	
36188	chr6	110917345	110917757	412	206.0	
36189	chr6	110929702	110930465	763	382.0	
36190	chr6	110944402	110945306	904	452.0	
36191	chr6	110949582	110950100	518	259.0	
36192	chr6	110957940	110959648	1708	854.0	
36193	chr6	110979843	110982872	3029	1514.0	
36194	chr6	110999626	110999990	364	182.0	
36195	chr6	111011600	111012104	504	252.0	
36196	chr6	111057254	111057686	432	216.0	
36197	chr6	111075903	111076688	785	392.0	
36198	chr6	111086878	111088915	2037	1018.0	
36199	chr6	111096206	111096696	490	245.0	
36200	chr6	111113556	111114847	1291	646.0	
36201	chr6	111119806	111120374	568	284.0	
36202	chr6	111122470	111122650	180	90.0	
36203	chr6	111210205	111210735	530	265.0	
36204	chr6	111229942	111230743	801	400.0	
36205	chr6	111238438	111238890	452	226.0	
36206	chr6	111258657	111260158	1501	750.0	
36207	chr6	111284370	111284749	379	190.0	
36208	chr6	111353962	111355166	1204	602.0	
36209	chr6	111405949	111406945	996	498.0	
36210	chr6	111410335	111410818	483	242.0	
36211	chr6	111411977	111412667	690	345.0	
36212	chr6	111423196	111423531	335	168.0	
36213	chr6	111427291	111427877	586	293.0	
36214	chr6	111441648	111442454	806	403.0	
36215	chr6	111461826	111462364	538	269.0	
36216	chr6	111462939	111463367	428	214.0	
36217	chr6	111477493	111479757	2264	1132.0	
36218	chr6	111481133	111484905	3772	1886.0	
36219	chr6	111486846	111488378	1532	766.0	
36220	chr6	111522423	111522815	392	196.0	
36221	chr6	111534149	111534728	579	290.0	
36222	chr6	111536819	111537322	503	252.0	
36223	chr6	111566765	111567386	621	310.0	
36224	chr6	111575218	111576627	1409	704.0	
36225	chr6	111587823	111588159	336	168.0	
36226	chr6	111591317	111591826	509	254.0	
36227	chr6	111601962	111602586	624	312.0	
36228	chr6	111604503	111606799	2296	1148.0	
36229	chr6	111624581	111624970	389	194.0	
36230	chr6	111642540	111642922	382	191.0	
36231	chr6	111656544	111656624	80	40.0	
36232	chr6	111657402	111657622	220	110.0	
36233	chr6	111662673	111663982	1309	654.0	
36234	chr6	111666912	111667332	420	210.0	
36235	chr6	111668394	111668795	401	200.0	
36236	chr6	111670096	111670192	96	48.0	
36237	chr6	111672163	111672166	3	2.0	
36238	chr6	111683606	111684354	748	374.0	
36239	chr6	111685319	111685650	331	166.0	
36240	chr6	111692421	111692864	443	222.0	
36241	chr6	111708536	111709012	476	238.0	
36242	chr6	111709612	111712652	3040	1520.0	
36243	chr6	111714218	111715777	1559	780.0	
36244	chr6	111721607	111722800	1193	596.0	
36245	chr6	111724186	111725928	1742	871.0	
36246	chr6	111727879	111727992	113	56.0	
36247	chr6	111729234	111729606	372	186.0	
36248	chr6	111730265	111732507	2242	1121.0	
36249	chr6	111734436	111735638	1202	601.0	
36250	chr6	111737071	111737713	642	321.0	
36251	chr6	111738614	111739601	987	494.0	
36252	chr6	111741546	111742122	576	288.0	
36253	chr6	111742796	111743055	259	130.0	
36254	chr6	111746061	111746398	337	168.0	
36255	chr6	111747103	111748681	1578	789.0	
36256	chr6	111750129	111751901	1772	886.0	
36257	chr6	111753018	111754850	1832	916.0	
36258	chr6	111757199	111763153	5954	2977.0	
36259	chr6	111763768	111766675	2907	1454.0	
36260	chr6	111767500	111768839	1339	670.0	
36261	chr6	111769723	111770735	1012	506.0	
36262	chr6	111772086	111772094	8	4.0	
36263	chr6	111773728	111779492	5764	2882.0	
36264	chr6	111780278	111781744	1466	733.0	
36265	chr6	111782435	111783124	689	344.0	
36266	chr6	111784463	111784805	342	171.0	
36267	chr6	111792205	111792788	583	292.0	
36268	chr6	111793427	111795718	2291	1146.0	
36269	chr6	111799574	111799932	358	179.0	
36270	chr6	111802295	111802440	145	72.0	
36271	chr6	111803156	111806810	3654	1827.0	
36272	chr6	111807855	111808935	1080	540.0	
36273	chr6	111810221	111811257	1036	518.0	
36274	chr6	111811982	111812388	406	203.0	
36275	chr6	111813671	111814088	417	208.0	
36276	chr6	111818384	111819128	744	372.0	
36277	chr6	111822803	111825554	2751	1376.0	
36278	chr6	111827923	111827983	60	30.0	
36279	chr6	111832753	111833684	931	466.0	
36280	chr6	111834298	111835011	713	356.0	
36281	chr6	111836627	111839296	2669	1334.0	
36282	chr6	111840281	111840562	281	140.0	
36283	chr6	111841633	111848112	6479	3240.0	
36284	chr6	111849539	111851254	1715	858.0	
36285	chr6	111852678	111853580	902	451.0	
36286	chr6	111855660	111855851	191	96.0	
36287	chr6	111857523	111858659	1136	568.0	
36288	chr6	111859569	111859946	377	188.0	
36289	chr6	111864691	111865284	593	296.0	
36290	chr6	111866189	111866628	439	220.0	
36291	chr6	111869543	111874585	5042	2521.0	
36292	chr6	111911652	111912053	401	200.0	
36293	chr6	111919007	111919129	122	61.0	
36294	chr6	111922897	111923101	204	102.0	
36295	chr6	111925294	111925653	359	180.0	
36296	chr6	111939883	111940412	529	264.0	
36297	chr6	111941744	111943377	1633	816.0	
36298	chr6	111944593	111944860	267	134.0	
36299	chr6	111952896	111953605	709	354.0	
36300	chr6	111958541	111959151	610	305.0	
36301	chr6	111959754	111960124	370	185.0	
36302	chr6	111970347	111970899	552	276.0	
36303	chr6	111971871	111972124	253	126.0	
36304	chr6	111972723	111974333	1610	805.0	
36305	chr6	111979754	111979998	244	122.0	
36306	chr6	111985096	111985569	473	236.0	
36307	chr6	111989396	111990513	1117	558.0	
36308	chr6	111992660	111993458	798	399.0	
36309	chr6	111996733	111997857	1124	562.0	
36310	chr6	112005152	112005414	262	131.0	
36311	chr6	112007651	112008533	882	441.0	
36312	chr6	112010358	112010959	601	300.0	
36313	chr6	112027654	112028638	984	492.0	
36314	chr6	112029156	112029690	534	267.0	
36315	chr6	112042737	112044304	1567	784.0	
36316	chr6	112086579	112088384	1805	902.0	
36317	chr6	112122760	112123237	477	238.0	
36318	chr6	112163075	112163919	844	422.0	
36319	chr6	112180140	112180462	322	161.0	
36320	chr6	112235947	112236348	401	200.0	
36321	chr6	112285919	112286550	631	316.0	
36322	chr6	112307724	112308046	322	161.0	
36323	chr6	112780536	112780869	333	166.0	
36324	chr6	112879877	112880322	445	222.0	
36325	chr6	113120237	113120545	308	154.0	
36326	chr6	113306512	113306971	459	230.0	
36327	chr6	113382010	113382248	238	119.0	
36328	chr6	113432761	113433901	1140	570.0	
36329	chr6	113446990	113447498	508	254.0	
36330	chr6	113464911	113465406	495	248.0	
36331	chr6	113564676	113565161	485	242.0	
36332	chr6	113600617	113600952	335	168.0	
36333	chr6	113630280	113632856	2576	1288.0	
36334	chr6	113634244	113635597	1353	676.0	
36335	chr6	113641893	113642391	498	249.0	
36336	chr6	113647226	113647576	350	175.0	
36337	chr6	113649199	113649739	540	270.0	
36338	chr6	113653206	113653596	390	195.0	
36339	chr6	113654485	113654681	196	98.0	
36340	chr6	113660620	113660840	220	110.0	
36341	chr6	113671484	113671598	114	57.0	
36342	chr6	113696902	113698056	1154	577.0	
36343	chr6	113719081	113719409	328	164.0	
36344	chr6	113735105	113735860	755	378.0	
36345	chr6	113750224	113750554	330	165.0	
36346	chr6	113758830	113758934	104	52.0	
36347	chr6	113762809	113762901	92	46.0	
36348	chr6	113763777	113764380	603	302.0	
36349	chr6	113774437	113774885	448	224.0	
36350	chr6	113805060	113805634	574	287.0	
36351	chr6	113809475	113810399	924	462.0	
36352	chr6	113818829	113818862	33	16.0	
36353	chr6	113854450	113859736	5286	2643.0	
36354	chr6	113873126	113873649	523	262.0	
36355	chr6	113879437	113879908	471	236.0	
36356	chr6	113909279	113909593	314	157.0	
36357	chr6	113920969	113921061	92	46.0	
36358	chr6	113936090	113936545	455	228.0	
36359	chr6	113969705	113971970	2265	1132.0	
36360	chr6	113979935	113981329	1394	697.0	
36361	chr6	113994843	113995244	401	200.0	
36362	chr6	114989589	114990054	465	232.0	
36363	chr6	116010786	116011162	376	188.0	
36364	chr6	116019520	116019804	284	142.0	
36365	chr6	116087636	116087728	92	46.0	
36366	chr6	116100157	116102083	1926	963.0	
36367	chr6	116102850	116103316	466	233.0	
36368	chr6	116136922	116137378	456	228.0	
36369	chr6	116216971	116217445	474	237.0	
36370	chr6	116218181	116218452	271	136.0	
36371	chr6	116248506	116248854	348	174.0	
36372	chr6	116250473	116254936	4463	2232.0	
36373	chr6	116256131	116256306	175	88.0	
36374	chr6	116257343	116257573	230	115.0	
36375	chr6	116264979	116265960	981	490.0	
36376	chr6	116267938	116269240	1302	651.0	
36377	chr6	116275564	116276527	963	482.0	
36378	chr6	116277136	116281698	4562	2281.0	
36379	chr6	116287601	116288133	532	266.0	
36380	chr6	116298991	116299341	350	175.0	
36381	chr6	116314837	116315304	467	234.0	
36382	chr6	116352481	116352760	279	140.0	
36383	chr6	116363724	116364198	474	237.0	
36384	chr6	116369403	116372023	2620	1310.0	
36385	chr6	116385296	116385828	532	266.0	
36386	chr6	116386496	116387858	1362	681.0	
36387	chr6	116390592	116390998	406	203.0	
36388	chr6	116392102	116393881	1779	890.0	
36389	chr6	116405041	116405527	486	243.0	
36390	chr6	116408516	116408756	240	120.0	
36391	chr6	116409648	116410994	1346	673.0	
36392	chr6	116444078	116444732	654	327.0	
36393	chr6	116446120	116446758	638	319.0	
36394	chr6	116447370	116448303	933	466.0	
36395	chr6	116450720	116451820	1100	550.0	
36396	chr6	116452645	116452874	229	114.0	
36397	chr6	116461386	116462963	1577	788.0	
36398	chr6	116465057	116465813	756	378.0	
36399	chr6	116475103	116476500	1397	698.0	
36400	chr6	116514071	116514540	469	234.0	
36401	chr6	116531924	116532423	499	250.0	
36402	chr6	116536112	116536763	651	326.0	
36403	chr6	116561194	116561890	696	348.0	
36404	chr6	116564896	116565412	516	258.0	
36405	chr6	116568820	116569500	680	340.0	
36406	chr6	116570536	116573017	2481	1240.0	
36407	chr6	116615865	116617249	1384	692.0	
36408	chr6	116629364	116630093	729	364.0	
36409	chr6	116645512	116646012	500	250.0	
36410	chr6	116666987	116669414	2427	1214.0	
36411	chr6	116680372	116683008	2636	1318.0	
36412	chr6	116695334	116695879	545	272.0	
36413	chr6	116697532	116697797	265	132.0	
36414	chr6	117346230	117346489	259	130.0	
36415	chr6	117449722	117450281	559	280.0	
36416	chr6	117451887	117451888	1	0.0	
36417	chr6	117464048	117464198	150	75.0	
36418	chr6	117469310	117469977	667	334.0	
36419	chr6	117478340	117478820	480	240.0	
36420	chr6	117481269	117484053	2784	1392.0	
36421	chr6	117547372	117550132	2760	1380.0	
36422	chr6	117555859	117556331	472	236.0	
36423	chr6	117600259	117600363	104	52.0	
36424	chr6	117601410	117603488	2078	1039.0	
36425	chr6	117605125	117605674	549	274.0	
36426	chr6	117607353	117608157	804	402.0	
36427	chr6	117614033	117614594	561	280.0	
36428	chr6	117616079	117617727	1648	824.0	
36429	chr6	117674705	117676535	1830	915.0	
36430	chr6	117677389	117678709	1320	660.0	
36431	chr6	117681341	117681767	426	213.0	
36432	chr6	117684752	117685043	291	146.0	
36433	chr6	117706795	117707216	421	210.0	
36434	chr6	117771450	117771778	328	164.0	
36435	chr6	117906971	117907375	404	202.0	
36436	chr6	118283752	118284192	440	220.0	
36437	chr6	118551044	118551519	475	238.0	
36438	chr6	118558397	118559403	1006	503.0	
36439	chr6	118565253	118565943	690	345.0	
36440	chr6	118580593	118582089	1496	748.0	
36441	chr6	118618510	118619629	1119	560.0	
36442	chr6	118639280	118639658	378	189.0	
36443	chr6	118650165	118652483	2318	1159.0	
36444	chr6	118656756	118657617	861	430.0	
36445	chr6	118660032	118660660	628	314.0	
36446	chr6	118664345	118665335	990	495.0	
36447	chr6	118705736	118706672	936	468.0	
36448	chr6	118708644	118710952	2308	1154.0	
36449	chr6	118719308	118720677	1369	684.0	
36450	chr6	118724401	118724531	130	65.0	
36451	chr6	118725883	118726491	608	304.0	
36452	chr6	118735339	118735690	351	176.0	
36453	chr6	118745971	118747131	1160	580.0	
36454	chr6	118758155	118759265	1110	555.0	
36455	chr6	118761648	118762145	497	248.0	
36456	chr6	118764767	118765188	421	210.0	
36457	chr6	118768611	118769519	908	454.0	
36458	chr6	118776466	118777372	906	453.0	
36459	chr6	118780308	118781045	737	368.0	
36460	chr6	118787745	118788497	752	376.0	
36461	chr6	118796294	118797096	802	401.0	
36462	chr6	118800228	118801201	973	486.0	
36463	chr6	118808512	118811094	2582	1291.0	
36464	chr6	118813900	118813943	43	22.0	
36465	chr6	118815556	118815707	151	76.0	
36466	chr6	118864578	118865126	548	274.0	
36467	chr6	118881465	118882073	608	304.0	
36468	chr6	118890916	118895622	4706	2353.0	
36469	chr6	118896217	118896939	722	361.0	
36470	chr6	118899897	118901304	1407	704.0	
36471	chr6	118933908	118936373	2465	1232.0	
36472	chr6	119052566	119052785	219	110.0	
36473	chr6	119076077	119079683	3606	1803.0	
36474	chr6	119110482	119111173	691	346.0	
36475	chr6	119112818	119113593	775	388.0	
36476	chr6	119119850	119120474	624	312.0	
36477	chr6	119129289	119129813	524	262.0	
36478	chr6	119137390	119138149	759	380.0	
36479	chr6	119146894	119148880	1986	993.0	
36480	chr6	119158787	119158835	48	24.0	
36481	chr6	119192189	119192625	436	218.0	
36482	chr6	119206286	119206354	68	34.0	
36483	chr6	119267809	119267858	49	24.0	
36484	chr6	119284985	119285227	242	121.0	
36485	chr6	119310361	119311188	827	414.0	
36486	chr6	119312539	119316333	3794	1897.0	
36487	chr6	119321892	119323461	1569	784.0	
36488	chr6	119326203	119326209	6	3.0	
36489	chr6	119329517	119329961	444	222.0	
36490	chr6	119330532	119330823	291	146.0	
36491	chr6	119333653	119334116	463	232.0	
36492	chr6	119334797	119336661	1864	932.0	
36493	chr6	119339769	119341162	1393	696.0	
36494	chr6	119342355	119345141	2786	1393.0	
36495	chr6	119345687	119351313	5626	2813.0	
36496	chr6	119353847	119354166	319	160.0	
36497	chr6	119355100	119355644	544	272.0	
36498	chr6	119442754	119443283	529	264.0	
36499	chr6	119444566	119444994	428	214.0	
36500	chr6	119446078	119446383	305	152.0	
36501	chr6	119449175	119450011	836	418.0	
36502	chr6	119459698	119459769	71	36.0	
36503	chr6	119742184	119742597	413	206.0	
36504	chr6	119856168	119856523	355	178.0	
36505	chr6	119934815	119935171	356	178.0	
36506	chr6	120938789	120939137	348	174.0	
36507	chr6	121055588	121055914	326	163.0	
36508	chr6	121306197	121306360	163	82.0	
36509	chr6	121334031	121335700	1669	834.0	
36510	chr6	121651607	121651727	120	60.0	
36511	chr6	122033586	122033933	347	174.0	
36512	chr6	122322991	122323298	307	154.0	
36513	chr6	122381461	122381974	513	256.0	
36514	chr6	122398828	122400942	2114	1057.0	
36515	chr6	122408609	122409444	835	418.0	
36516	chr6	122469413	122470024	611	306.0	
36517	chr6	122470854	122472502	1648	824.0	
36518	chr6	122476139	122476520	381	190.0	
36519	chr6	122484835	122485226	391	196.0	
36520	chr6	122491862	122492519	657	328.0	
36521	chr6	122495639	122495855	216	108.0	
36522	chr6	122530399	122530909	510	255.0	
36523	chr6	122609661	122611121	1460	730.0	
36524	chr6	122673406	122673932	526	263.0	
36525	chr6	122709963	122710620	657	328.0	
36526	chr6	122712998	122713543	545	272.0	
36527	chr6	122717320	122717725	405	202.0	
36528	chr6	122730784	122731187	403	202.0	
36529	chr6	122744224	122744610	386	193.0	
36530	chr6	122747497	122748023	526	263.0	
36531	chr6	122751306	122751766	460	230.0	
36532	chr6	122752395	122752899	504	252.0	
36533	chr6	122758973	122759485	512	256.0	
36534	chr6	122770646	122771445	799	400.0	
36535	chr6	122788924	122791399	2475	1238.0	
36536	chr6	122839449	122839891	442	221.0	
36537	chr6	122853589	122853916	327	164.0	
36538	chr6	123802509	123803401	892	446.0	
36539	chr6	124819191	124819916	725	362.0	
36540	chr6	124883186	124883190	4	2.0	
36541	chr6	124888872	124889137	265	132.0	
36542	chr6	124961143	124964450	3307	1654.0	
36543	chr6	125066948	125067443	495	248.0	
36544	chr6	125099446	125100202	756	378.0	
36545	chr6	125153480	125154463	983	492.0	
36546	chr6	125192208	125192756	548	274.0	
36547	chr6	125194856	125195346	490	245.0	
36548	chr6	125201971	125202295	324	162.0	
36549	chr6	125258659	125259078	419	210.0	
36550	chr6	125261925	125262285	360	180.0	
36551	chr6	125299214	125300094	880	440.0	
36552	chr6	125300914	125303801	2887	1444.0	
36553	chr6	125310989	125311522	533	266.0	
36554	chr6	125314041	125314569	528	264.0	
36555	chr6	125346863	125347252	389	194.0	
36556	chr6	125598264	125598861	597	298.0	
36557	chr6	125746497	125751842	5345	2672.0	
36558	chr6	125753602	125754055	453	226.0	
36559	chr6	125759119	125759494	375	188.0	
36560	chr6	125769738	125770414	676	338.0	
36561	chr6	125779989	125781960	1971	986.0	
36562	chr6	125789090	125792237	3147	1574.0	
36563	chr6	125793888	125794289	401	200.0	
36564	chr6	125798710	125799382	672	336.0	
36565	chr6	125802796	125803503	707	354.0	
36566	chr6	125804265	125804581	316	158.0	
36567	chr6	125811180	125811770	590	295.0	
36568	chr6	125814592	125814886	294	147.0	
36569	chr6	125826934	125827358	424	212.0	
36570	chr6	125827929	125828775	846	423.0	
36571	chr6	125829359	125829930	571	286.0	
36572	chr6	125831516	125833144	1628	814.0	
36573	chr6	125834412	125835848	1436	718.0	
36574	chr6	125843550	125844059	509	254.0	
36575	chr6	125845589	125845891	302	151.0	
36576	chr6	125858672	125859118	446	223.0	
36577	chr6	125885951	125886440	489	244.0	
36578	chr6	125889340	125889426	86	43.0	
36579	chr6	125904799	125905352	553	276.0	
36580	chr6	125906228	125906877	649	324.0	
36581	chr6	125910654	125911616	962	481.0	
36582	chr6	125918512	125919766	1254	627.0	
36583	chr6	125924279	125924473	194	97.0	
36584	chr6	125927830	125928231	401	200.0	
36585	chr6	125932200	125932256	56	28.0	
36586	chr6	125944431	125944929	498	249.0	
36587	chr6	125953029	125953432	403	202.0	
36588	chr6	125956018	125959474	3456	1728.0	
36589	chr6	125969917	125970012	95	48.0	
36590	chr6	125974197	125974852	655	328.0	
36591	chr6	125985841	125987471	1630	815.0	
36592	chr6	125988523	125989147	624	312.0	
36593	chr6	125995867	125996611	744	372.0	
36594	chr6	126040815	126041184	369	184.0	
36595	chr6	126152274	126152282	8	4.0	
36596	chr6	126170902	126171339	437	218.0	
36597	chr6	126337202	126337920	718	359.0	
36598	chr6	126339553	126340788	1235	618.0	
36599	chr6	127102146	127102793	647	324.0	
36600	chr6	127121311	127121815	504	252.0	
36601	chr6	127186889	127187317	428	214.0	
36602	chr6	127192849	127193340	491	246.0	
36603	chr6	127198464	127199009	545	272.0	
36604	chr6	127204282	127204723	441	220.0	
36605	chr6	127265856	127268713	2857	1428.0	
36606	chr6	127272556	127272998	442	221.0	
36607	chr6	127291182	127291797	615	308.0	
36608	chr6	127302622	127303859	1237	618.0	
36609	chr6	127317262	127317971	709	354.0	
36610	chr6	127332564	127332927	363	182.0	
36611	chr6	127333565	127334124	559	280.0	
36612	chr6	127341420	127344555	3135	1568.0	
36613	chr6	127347056	127348433	1377	688.0	
36614	chr6	127352510	127352911	401	200.0	
36615	chr6	127366210	127366852	642	321.0	
36616	chr6	127404871	127405178	307	154.0	
36617	chr6	127420365	127421091	726	363.0	
36618	chr6	127423907	127424265	358	179.0	
36619	chr6	127457328	127458115	787	394.0	
36620	chr6	127464835	127465319	484	242.0	
36621	chr6	127483863	127484839	976	488.0	
36622	chr6	127514177	127517122	2945	1472.0	
36623	chr6	127518851	127518985	134	67.0	
36624	chr6	127533821	127534058	237	118.0	
36625	chr6	127736879	127737603	724	362.0	
36626	chr6	127748170	127748359	189	94.0	
36627	chr6	127792632	127793025	393	196.0	
36628	chr6	127812982	127813878	896	448.0	
36629	chr6	127855564	127855979	415	208.0	
36630	chr6	127857307	127857400	93	46.0	
36631	chr6	127879775	127879986	211	106.0	
36632	chr6	127880492	127880795	303	152.0	
36633	chr6	127891957	127892152	195	98.0	
36634	chr6	127893827	127893849	22	11.0	
36635	chr6	127900625	127901714	1089	544.0	
36636	chr6	127902865	127903346	481	240.0	
36637	chr6	127907251	127908712	1461	730.0	
36638	chr6	127918201	127919331	1130	565.0	
36639	chr6	127923285	127923469	184	92.0	
36640	chr6	127934121	127935124	1003	502.0	
36641	chr6	127938736	127939124	388	194.0	
36642	chr6	127950637	127952013	1376	688.0	
36643	chr6	127967732	127967965	233	116.0	
36644	chr6	127971344	127973061	1717	858.0	
36645	chr6	127978146	127978658	512	256.0	
36646	chr6	128112641	128112989	348	174.0	
36647	chr6	128134755	128135224	469	234.0	
36648	chr6	128240129	128240287	158	79.0	
36649	chr6	128241253	128241515	262	131.0	
36650	chr6	128259038	128260174	1136	568.0	
36651	chr6	128327906	128328415	509	254.0	
36652	chr6	128478472	128478881	409	204.0	
36653	chr6	128518837	128521273	2436	1218.0	
36654	chr6	129252067	129252508	441	220.0	
36655	chr6	129280619	129281499	880	440.0	
36656	chr6	129370386	129370802	416	208.0	
36657	chr6	129393604	129394073	469	234.0	
36658	chr6	129454384	129454979	595	298.0	
36659	chr6	129490074	129491797	1723	862.0	
36660	chr6	129498732	129499968	1236	618.0	
36661	chr6	129501392	129501774	382	191.0	
36662	chr6	129575202	129575909	707	354.0	
36663	chr6	129598173	129598682	509	254.0	
36664	chr6	129621307	129621649	342	171.0	
36665	chr6	129671632	129673222	1590	795.0	
36666	chr6	129683532	129684608	1076	538.0	
36667	chr6	129685304	129686048	744	372.0	
36668	chr6	129686850	129687863	1013	506.0	
36669	chr6	129709402	129710701	1299	650.0	
36670	chr6	129730453	129730996	543	272.0	
36671	chr6	129735489	129735712	223	112.0	
36672	chr6	129748083	129750734	2651	1326.0	
36673	chr6	129751583	129752444	861	430.0	
36674	chr6	129753366	129753900	534	267.0	
36675	chr6	129766925	129767837	912	456.0	
36676	chr6	129774916	129775564	648	324.0	
36677	chr6	129860580	129861553	973	486.0	
36678	chr6	129875876	129875949	73	36.0	
36679	chr6	129882473	129883083	610	305.0	
36680	chr6	129893804	129894046	242	121.0	
36681	chr6	129894896	129895899	1003	502.0	
36682	chr6	129936474	129936966	492	246.0	
36683	chr6	129989681	129989720	39	20.0	
36684	chr6	130017969	130021699	3730	1865.0	
36685	chr6	130027836	130029766	1930	965.0	
36686	chr6	130033066	130033069	3	2.0	
36687	chr6	130034425	130034709	284	142.0	
36688	chr6	130037183	130037615	432	216.0	
36689	chr6	130106377	130106719	342	171.0	
36690	chr6	130114986	130115386	400	200.0	
36691	chr6	130128402	130128670	268	134.0	
36692	chr6	130131337	130133221	1884	942.0	
36693	chr6	130134616	130134931	315	158.0	
36694	chr6	130138161	130139206	1045	522.0	
36695	chr6	130148210	130148577	367	184.0	
36696	chr6	130183476	130184446	970	485.0	
36697	chr6	130191454	130191463	9	4.0	
36698	chr6	130202885	130203116	231	116.0	
36699	chr6	130215260	130216999	1739	870.0	
36700	chr6	130218031	130218750	719	360.0	
36701	chr6	130222718	130224180	1462	731.0	
36702	chr6	130238979	130239304	325	162.0	
36703	chr6	130259737	130261985	2248	1124.0	
36704	chr6	130282195	130282664	469	234.0	
36705	chr6	130293787	130294193	406	203.0	
36706	chr6	130322427	130323112	685	342.0	
36707	chr6	130365036	130366935	1899	950.0	
36708	chr6	130381702	130382169	467	234.0	
36709	chr6	130396798	130397078	280	140.0	
36710	chr6	130453253	130453646	393	196.0	
36711	chr6	130513398	130514360	962	481.0	
36712	chr6	130575591	130576564	973	486.0	
36713	chr6	130697758	130698360	602	301.0	
36714	chr6	130717720	130717939	219	110.0	
36715	chr6	130776549	130776900	351	176.0	
36716	chr6	130781554	130781960	406	203.0	
36717	chr6	130843484	130843994	510	255.0	
36718	chr6	130848988	130849324	336	168.0	
36719	chr6	130872226	130872668	442	221.0	
36720	chr6	130885283	130885791	508	254.0	
36721	chr6	130893302	130893621	319	160.0	
36722	chr6	130913128	130913516	388	194.0	
36723	chr6	130928507	130928995	488	244.0	
36724	chr6	130931692	130932052	360	180.0	
36725	chr6	131061382	131064190	2808	1404.0	
36726	chr6	131108109	131108488	379	190.0	
36727	chr6	131116747	131117120	373	186.0	
36728	chr6	131117836	131118288	452	226.0	
36729	chr6	131129950	131130240	290	145.0	
36730	chr6	131134973	131136589	1616	808.0	
36731	chr6	131139530	131140278	748	374.0	
36732	chr6	131182873	131183575	702	351.0	
36733	chr6	131197744	131198186	442	221.0	
36734	chr6	131199369	131201153	1784	892.0	
36735	chr6	131250100	131250610	510	255.0	
36736	chr6	131281241	131282090	849	424.0	
36737	chr6	131443579	131444027	448	224.0	
36738	chr6	131459954	131460370	416	208.0	
36739	chr6	131519502	131520231	729	364.0	
36740	chr6	131524520	131525283	763	382.0	
36741	chr6	131531050	131531378	328	164.0	
36742	chr6	131533876	131534551	675	338.0	
36743	chr6	131627437	131628835	1398	699.0	
36744	chr6	131683529	131683937	408	204.0	
36745	chr6	131694847	131695165	318	159.0	
36746	chr6	131807344	131808583	1239	620.0	
36747	chr6	131909623	131910380	757	378.0	
36748	chr6	131915131	131915579	448	224.0	
36749	chr6	131950453	131950897	444	222.0	
36750	chr6	132279468	132280185	717	358.0	
36751	chr6	132286202	132286656	454	227.0	
36752	chr6	132298334	132298692	358	179.0	
36753	chr6	132300362	132300748	386	193.0	
36754	chr6	132352231	132352337	106	53.0	
36755	chr6	132354345	132355223	878	439.0	
36756	chr6	132378726	132379188	462	231.0	
36757	chr6	132401051	132401754	703	352.0	
36758	chr6	132456827	132457124	297	148.0	
36759	chr6	132484084	132484617	533	266.0	
36760	chr6	132489990	132490773	783	392.0	
36761	chr6	132495583	132496020	437	218.0	
36762	chr6	132498505	132499198	693	346.0	
36763	chr6	132499726	132500191	465	232.0	
36764	chr6	132510775	132511620	845	422.0	
36765	chr6	132512323	132514419	2096	1048.0	
36766	chr6	132530308	132530793	485	242.0	
36767	chr6	132587382	132587925	543	272.0	
36768	chr6	132592882	132593210	328	164.0	
36769	chr6	132612377	132612941	564	282.0	
36770	chr6	132614615	132615089	474	237.0	
36771	chr6	132648541	132648590	49	24.0	
36772	chr6	132650988	132651405	417	208.0	
36773	chr6	132669590	132670455	865	432.0	
36774	chr6	132675768	132676203	435	218.0	
36775	chr6	132713313	132714517	1204	602.0	
36776	chr6	132733376	132735334	1958	979.0	
36777	chr6	132736336	132736547	211	106.0	
36778	chr6	132742440	132743004	564	282.0	
36779	chr6	132745975	132746501	526	263.0	
36780	chr6	132748970	132749538	568	284.0	
36781	chr6	132750821	132751690	869	434.0	
36782	chr6	132757591	132758338	747	374.0	
36783	chr6	132763204	132763945	741	370.0	
36784	chr6	132767866	132768650	784	392.0	
36785	chr6	132797847	132799770	1923	962.0	
36786	chr6	132812187	132821584	9397	4698.0	
36787	chr6	132822914	132823574	660	330.0	
36788	chr6	132963085	132963302	217	108.0	
36789	chr6	133062961	133062978	17	8.0	
36790	chr6	133837767	133838173	406	203.0	
36791	chr6	133891321	133891416	95	48.0	
36792	chr6	133916515	133917220	705	352.0	
36793	chr6	133921211	133921688	477	238.0	
36794	chr6	133923876	133924395	519	260.0	
36795	chr6	133951362	133955041	3679	1840.0	
36796	chr6	133957976	133957977	1	0.0	
36797	chr6	133958826	133959312	486	243.0	
36798	chr6	133966858	133967259	401	200.0	
36799	chr6	133969374	133969976	602	301.0	
36800	chr6	133973102	133973843	741	370.0	
36801	chr6	133983236	133983878	642	321.0	
36802	chr6	134021696	134022097	401	200.0	
36803	chr6	134035555	134035593	38	19.0	
36804	chr6	134041161	134041214	53	26.0	
36805	chr6	134051995	134053117	1122	561.0	
36806	chr6	134063759	134064490	731	366.0	
36807	chr6	134093164	134093360	196	98.0	
36808	chr6	134097098	134097537	439	220.0	
36809	chr6	134109445	134109996	551	276.0	
36810	chr6	134111044	134111511	467	234.0	
36811	chr6	134123553	134124310	757	378.0	
36812	chr6	134145734	134146011	277	138.0	
36813	chr6	134156736	134157171	435	218.0	
36814	chr6	134165679	134167224	1545	772.0	
36815	chr6	134167815	134169023	1208	604.0	
36816	chr6	134170003	134170331	328	164.0	
36817	chr6	134170877	134171850	973	486.0	
36818	chr6	134173699	134179068	5369	2684.0	
36819	chr6	134216150	134217029	879	440.0	
36820	chr6	134230094	134230827	733	366.0	
36821	chr6	134233189	134233582	393	196.0	
36822	chr6	134235784	134236688	904	452.0	
36823	chr6	134240384	134241388	1004	502.0	
36824	chr6	134245735	134247965	2230	1115.0	
36825	chr6	134272405	134272748	343	172.0	
36826	chr6	134276809	134277489	680	340.0	
36827	chr6	134288121	134289335	1214	607.0	
36828	chr6	134295587	134296560	973	486.0	
36829	chr6	134317375	134318271	896	448.0	
36830	chr6	134337875	134338183	308	154.0	
36831	chr6	134340561	134340564	3	2.0	
36832	chr6	134345907	134346880	973	486.0	
36833	chr6	134351881	134352369	488	244.0	
36834	chr6	134372599	134373925	1326	663.0	
36835	chr6	134375173	134375745	572	286.0	
36836	chr6	134379180	134379339	159	80.0	
36837	chr6	134380311	134380700	389	194.0	
36838	chr6	134389009	134389594	585	292.0	
36839	chr6	134398422	134398914	492	246.0	
36840	chr6	134412992	134413909	917	458.0	
36841	chr6	134414905	134415117	212	106.0	
36842	chr6	134416419	134416734	315	158.0	
36843	chr6	134420436	134420992	556	278.0	
36844	chr6	134422809	134423327	518	259.0	
36845	chr6	134436044	134437885	1841	920.0	
36846	chr6	134447742	134448406	664	332.0	
36847	chr6	134459048	134459484	436	218.0	
36848	chr6	134510907	134511368	461	230.0	
36849	chr6	134512816	134513315	499	250.0	
36850	chr6	134517304	134518244	940	470.0	
36851	chr6	134519401	134519997	596	298.0	
36852	chr6	134529843	134530483	640	320.0	
36853	chr6	134544702	134545171	469	234.0	
36854	chr6	134593775	134594255	480	240.0	
36855	chr6	134603536	134603914	378	189.0	
36856	chr6	134630568	134631332	764	382.0	
36857	chr6	134632098	134632235	137	68.0	
36858	chr6	134632872	134633603	731	366.0	
36859	chr6	134634928	134635356	428	214.0	
36860	chr6	134640634	134641725	1091	546.0	
36861	chr6	134666180	134666420	240	120.0	
36862	chr6	134707356	134707762	406	203.0	
36863	chr6	134714206	134714419	213	106.0	
36864	chr6	134718692	134719099	407	204.0	
36865	chr6	134720540	134721321	781	390.0	
36866	chr6	134724921	134725283	362	181.0	
36867	chr6	134733765	134734224	459	230.0	
36868	chr6	134738294	134738332	38	19.0	
36869	chr6	134740706	134740712	6	3.0	
36870	chr6	134822824	134823357	533	266.0	
36871	chr6	134873987	134874344	357	178.0	
36872	chr6	134882372	134882870	498	249.0	
36873	chr6	134938948	134939297	349	174.0	
36874	chr6	134940863	134941234	371	186.0	
36875	chr6	135014144	135014892	748	374.0	
36876	chr6	135030107	135030599	492	246.0	
36877	chr6	135044717	135045110	393	196.0	
36878	chr6	135053174	135055667	2493	1246.0	
36879	chr6	135066275	135067296	1021	510.0	
36880	chr6	135086092	135086483	391	196.0	
36881	chr6	135087192	135089657	2465	1232.0	
36882	chr6	135094196	135094949	753	376.0	
36883	chr6	135102752	135103684	932	466.0	
36884	chr6	135115751	135116972	1221	610.0	
36885	chr6	135128246	135129644	1398	699.0	
36886	chr6	135141758	135142066	308	154.0	
36887	chr6	135144897	135145988	1091	546.0	
36888	chr6	135162646	135163825	1179	590.0	
36889	chr6	135176471	135176948	477	238.0	
36890	chr6	135179894	135184473	4579	2290.0	
36891	chr6	135191411	135191814	403	202.0	
36892	chr6	135194989	135195963	974	487.0	
36893	chr6	135209708	135210487	779	390.0	
36894	chr6	135223999	135224454	455	228.0	
36895	chr6	135250199	135250729	530	265.0	
36896	chr6	135280693	135281602	909	454.0	enhancer
36897	chr6	135286892	135287559	667	334.0	
36898	chr6	135306716	135307399	683	342.0	
36899	chr6	135323162	135323563	401	200.0	
36900	chr6	135325701	135326028	327	164.0	
36901	chr6	135423594	135424096	502	251.0	
36902	chr6	135434182	135434458	276	138.0	
36903	chr6	135438904	135439380	476	238.0	
36904	chr6	135440230	135440825	595	298.0	
36905	chr6	135451557	135452086	529	264.0	
36906	chr6	135495452	135495632	180	90.0	
36907	chr6	135496220	135496284	64	32.0	
36908	chr6	135497064	135499086	2022	1011.0	
36909	chr6	135506220	135507086	866	433.0	
36910	chr6	135523118	135523688	570	285.0	
36911	chr6	135525610	135526001	391	196.0	
36912	chr6	135532113	135532753	640	320.0	
36913	chr6	135535861	135536574	713	356.0	
36914	chr6	135537955	135538382	427	214.0	
36915	chr6	135555552	135555994	442	221.0	
36916	chr6	135568269	135568833	564	282.0	
36917	chr6	135586896	135587252	356	178.0	
36918	chr6	135624302	135624954	652	326.0	
36919	chr6	135651924	135652378	454	227.0	
36920	chr6	135675891	135676294	403	202.0	
36921	chr6	135703652	135703854	202	101.0	
36922	chr6	135811632	135812587	955	478.0	
36923	chr6	135819624	135820167	543	272.0	
36924	chr6	135851184	135852360	1176	588.0	
36925	chr6	135876149	135876258	109	54.0	
36926	chr6	135879665	135881122	1457	728.0	
36927	chr6	135909705	135910233	528	264.0	
36928	chr6	135955134	135955443	309	154.0	
36929	chr6	135995403	135995440	37	18.0	
36930	chr6	136007243	136007963	720	360.0	
36931	chr6	136035566	136035614	48	24.0	
36932	chr6	136037521	136037887	366	183.0	
36933	chr6	136051164	136051565	401	200.0	
36934	chr6	136113674	136114232	558	279.0	
36935	chr6	136129499	136129763	264	132.0	
36936	chr6	136215293	136215871	578	289.0	
36937	chr6	136226014	136227064	1050	525.0	
36938	chr6	136228773	136229279	506	253.0	
36939	chr6	136236513	136237232	719	360.0	
36940	chr6	136249528	136251726	2198	1099.0	
36941	chr6	136252315	136253228	913	456.0	
36942	chr6	136271141	136271417	276	138.0	
36943	chr6	136276123	136276469	346	173.0	
36944	chr6	136278373	136278496	123	62.0	
36945	chr6	136282838	136283946	1108	554.0	
36946	chr6	136284513	136291371	6858	3429.0	
36947	chr6	136303621	136303626	5	2.0	
36948	chr6	136316916	136317474	558	279.0	
36949	chr6	136347861	136348262	401	200.0	
36950	chr6	136365687	136366248	561	280.0	
36951	chr6	136403677	136403934	257	128.0	
36952	chr6	136415333	136416018	685	342.0	
36953	chr6	136470054	136470422	368	184.0	
36954	chr6	136525177	136525316	139	70.0	
36955	chr6	136526369	136526839	470	235.0	
36956	chr6	136537697	136538031	334	167.0	
36957	chr6	136549530	136551397	1867	934.0	
36958	chr6	136565846	136566322	476	238.0	
36959	chr6	136582941	136583600	659	330.0	
36960	chr6	136593152	136594716	1564	782.0	
36961	chr6	136607962	136608931	969	484.0	
36962	chr6	136609852	136610787	935	468.0	
36963	chr6	136643908	136644794	886	443.0	
36964	chr6	136647013	136648281	1268	634.0	
36965	chr6	136719639	136720659	1020	510.0	
36966	chr6	136723776	136724212	436	218.0	
36967	chr6	136751266	136754282	3016	1508.0	
36968	chr6	136756278	136757492	1214	607.0	
36969	chr6	136760591	136762919	2328	1164.0	
36970	chr6	136763599	136765426	1827	914.0	
36971	chr6	136767242	136768018	776	388.0	
36972	chr6	136771282	136771819	537	268.0	
36973	chr6	136772634	136773088	454	227.0	
36974	chr6	136774333	136775148	815	408.0	
36975	chr6	136782350	136782775	425	212.0	
36976	chr6	136783441	136786100	2659	1330.0	
36977	chr6	136786682	136787053	371	186.0	
36978	chr6	136787566	136790262	2696	1348.0	
36979	chr6	136790884	136793837	2953	1476.0	
36980	chr6	136821853	136823676	1823	912.0	
36981	chr6	136846054	136846411	357	178.0	
36982	chr6	136859440	136859881	441	220.0	
36983	chr6	136920242	136923983	3741	1870.0	
36984	chr6	136927390	136927441	51	26.0	
36985	chr6	136968077	136968564	487	244.0	
36986	chr6	137033702	137034364	662	331.0	
36987	chr6	137043988	137044978	990	495.0	
36988	chr6	137076450	137076991	541	270.0	
36989	chr6	137094277	137094985	708	354.0	
36990	chr6	137095537	137096061	524	262.0	
36991	chr6	137099941	137100036	95	48.0	
36992	chr6	137102750	137103506	756	378.0	
36993	chr6	137105331	137105744	413	206.0	
36994	chr6	137148341	137149343	1002	501.0	
36995	chr6	137155527	137156441	914	457.0	
36996	chr6	137165215	137166923	1708	854.0	
36997	chr6	137202060	137202461	401	200.0	
36998	chr6	137208813	137208816	3	2.0	
36999	chr6	137211145	137211170	25	12.0	
37000	chr6	137213554	137214217	663	332.0	
37001	chr6	137216360	137220162	3802	1901.0	
37002	chr6	137222370	137222880	510	255.0	
37003	chr6	137223392	137225471	2079	1040.0	
37004	chr6	137228028	137228096	68	34.0	
37005	chr6	137230484	137234970	4486	2243.0	
37006	chr6	137237805	137238105	300	150.0	
37007	chr6	137240015	137240736	721	360.0	
37008	chr6	137246656	137247085	429	214.0	
37009	chr6	137248649	137249167	518	259.0	
37010	chr6	137258004	137258602	598	299.0	
37011	chr6	137261637	137262230	593	296.0	
37012	chr6	137269240	137269977	737	368.0	
37013	chr6	137271243	137272770	1527	764.0	
37014	chr6	137282199	137282708	509	254.0	
37015	chr6	137286939	137287321	382	191.0	
37016	chr6	137291390	137291934	544	272.0	
37017	chr6	137297847	137298350	503	252.0	
37018	chr6	137299718	137300024	306	153.0	
37019	chr6	137307367	137307889	522	261.0	
37020	chr6	137309072	137309820	748	374.0	
37021	chr6	137314061	137315458	1397	698.0	
37022	chr6	137341834	137343260	1426	713.0	
37023	chr6	137351777	137352535	758	379.0	
37024	chr6	137363635	137364177	542	271.0	
37025	chr6	137370731	137371199	468	234.0	
37026	chr6	137388781	137389870	1089	544.0	
37027	chr6	137414999	137416087	1088	544.0	
37028	chr6	137423797	137423849	52	26.0	
37029	chr6	137430966	137431453	487	244.0	
37030	chr6	137487921	137489802	1881	940.0	
37031	chr6	137493146	137494682	1536	768.0	
37032	chr6	137495459	137496074	615	308.0	
37033	chr6	137497223	137498254	1031	516.0	
37034	chr6	137536280	137536766	486	243.0	
37035	chr6	137559411	137560170	759	380.0	
37036	chr6	137571862	137572263	401	200.0	
37037	chr6	137588999	137590056	1057	528.0	
37038	chr6	137621672	137621896	224	112.0	
37039	chr6	137641307	137641913	606	303.0	
37040	chr6	137661603	137662038	435	218.0	
37041	chr6	137666208	137666647	439	220.0	
37042	chr6	137677597	137678227	630	315.0	
37043	chr6	137698404	137699839	1435	718.0	
37044	chr6	137701072	137701595	523	262.0	
37045	chr6	137704943	137706041	1098	549.0	
37046	chr6	137707229	137711086	3857	1928.0	
37047	chr6	137712083	137712196	113	56.0	
37048	chr6	137715192	137718150	2958	1479.0	
37049	chr6	137722568	137723224	656	328.0	
37050	chr6	137724709	137725297	588	294.0	
37051	chr6	137728666	137729214	548	274.0	
37052	chr6	137731927	137732508	581	290.0	
37053	chr6	137734664	137735409	745	372.0	
37054	chr6	137736619	137736689	70	35.0	
37055	chr6	137738246	137738503	257	128.0	
37056	chr6	137754193	137754893	700	350.0	
37057	chr6	137762376	137762880	504	252.0	
37058	chr6	137767954	137768834	880	440.0	
37059	chr6	137773618	137774414	796	398.0	
37060	chr6	137780668	137780794	126	63.0	
37061	chr6	137789998	137791095	1097	548.0	
37062	chr6	137791843	137792828	985	492.0	
37063	chr6	137794612	137794891	279	140.0	
37064	chr6	137795515	137795869	354	177.0	
37065	chr6	137797784	137798185	401	200.0	
37066	chr6	137799542	137800710	1168	584.0	
37067	chr6	137810770	137812356	1586	793.0	
37068	chr6	137815883	137816719	836	418.0	
37069	chr6	137819646	137820400	754	377.0	
37070	chr6	137822146	137823021	875	438.0	
37071	chr6	137823611	137825236	1625	812.0	
37072	chr6	137827885	137828794	909	454.0	
37073	chr6	137830618	137830869	251	126.0	
37074	chr6	137846364	137847562	1198	599.0	
37075	chr6	137864940	137886046	21106	10553.0	
37076	chr6	137886726	137886727	1	0.0	
37077	chr6	137890717	137891886	1169	584.0	
37078	chr6	137892424	137892660	236	118.0	
37079	chr6	137904399	137905577	1178	589.0	
37080	chr6	137910420	137910969	549	274.0	
37081	chr6	137912051	137912122	71	36.0	
37082	chr6	137914623	137915196	573	286.0	
37083	chr6	137921947	137922034	87	44.0	
37084	chr6	137927413	137928774	1361	680.0	
37085	chr6	137939890	137940575	685	342.0	
37086	chr6	137944459	137945398	939	470.0	
37087	chr6	137949930	137950438	508	254.0	
37088	chr6	137951015	137951525	510	255.0	
37089	chr6	137957435	137957916	481	240.0	
37090	chr6	137958619	137959657	1038	519.0	
37091	chr6	137967707	137969481	1774	887.0	
37092	chr6	137970405	137970783	378	189.0	
37093	chr6	137972738	137972815	77	38.0	
37094	chr6	137974831	137976770	1939	970.0	
37095	chr6	137982327	137983011	684	342.0	
37096	chr6	138001742	138002372	630	315.0	
37097	chr6	138004445	138004869	424	212.0	
37098	chr6	138007156	138007283	127	64.0	
37099	chr6	138106814	138108359	1545	772.0	
37100	chr6	138109108	138109821	713	356.0	
37101	chr6	138115605	138116497	892	446.0	
37102	chr6	138160964	138162702	1738	869.0	
37103	chr6	138287238	138287556	318	159.0	
37104	chr6	138372797	138373137	340	170.0	
37105	chr6	138394055	138394553	498	249.0	
37106	chr6	138403031	138405518	2487	1244.0	
37107	chr6	138406436	138406829	393	196.0	
37108	chr6	138410302	138410836	534	267.0	
37109	chr6	138422954	138423249	295	148.0	
37110	chr6	138428886	138429413	527	264.0	
37111	chr6	138431342	138432043	701	350.0	
37112	chr6	138434744	138435368	624	312.0	
37113	chr6	138440983	138441306	323	162.0	
37114	chr6	138455140	138456785	1645	822.0	
37115	chr6	138499170	138499904	734	367.0	
37116	chr6	138509353	138509801	448	224.0	
37117	chr6	138514670	138515298	628	314.0	
37118	chr6	138517515	138518043	528	264.0	
37119	chr6	138521707	138522211	504	252.0	
37120	chr6	138588737	138589439	702	351.0	
37121	chr6	138590824	138591311	487	244.0	
37122	chr6	138592695	138593917	1222	611.0	
37123	chr6	138673209	138673931	722	361.0	
37124	chr6	138691954	138693845	1891	946.0	
37125	chr6	138719826	138719968	142	71.0	
37126	chr6	138765905	138766322	417	208.0	
37127	chr6	138768652	138769435	783	392.0	
37128	chr6	138772725	138774519	1794	897.0	
37129	chr6	138811889	138812239	350	175.0	
37130	chr6	138815970	138816479	509	254.0	
37131	chr6	138818820	138819214	394	197.0	
37132	chr6	138944351	138944782	431	216.0	
37133	chr6	138946802	138947289	487	244.0	
37134	chr6	138953506	138953851	345	172.0	
37135	chr6	138957528	138957840	312	156.0	
37136	chr6	138958348	138958382	34	17.0	
37137	chr6	138970742	138971582	840	420.0	
37138	chr6	138980051	138980736	685	342.0	
37139	chr6	138984176	138984981	805	402.0	
37140	chr6	138986158	138988981	2823	1412.0	
37141	chr6	138992880	138993430	550	275.0	
37142	chr6	139016426	139016972	546	273.0	
37143	chr6	139025373	139025889	516	258.0	
37144	chr6	139027424	139031795	4371	2186.0	
37145	chr6	139033048	139033804	756	378.0	
37146	chr6	139109623	139109858	235	118.0	
37147	chr6	139112858	139114002	1144	572.0	
37148	chr6	139124765	139126705	1940	970.0	
37149	chr6	139131510	139138154	6644	3322.0	
37150	chr6	139138795	139150288	11493	5746.0	
37151	chr6	139151130	139153316	2186	1093.0	
37152	chr6	139154171	139167770	13599	6800.0	
37153	chr6	139169646	139169875	229	114.0	
37154	chr6	139170479	139176907	6428	3214.0	
37155	chr6	139178422	139178823	401	200.0	
37156	chr6	139184192	139184206	14	7.0	
37157	chr6	139186295	139186860	565	282.0	
37158	chr6	139219103	139219843	740	370.0	
37159	chr6	139250466	139251222	756	378.0	
37160	chr6	139262344	139262953	609	304.0	
37161	chr6	139270958	139271489	531	266.0	
37162	chr6	139279461	139280270	809	404.0	
37163	chr6	139290407	139292697	2290	1145.0	
37164	chr6	139295847	139297358	1511	756.0	
37165	chr6	139308208	139309264	1056	528.0	
37166	chr6	139323412	139326085	2673	1336.0	
37167	chr6	139334691	139335500	809	404.0	
37168	chr6	139337736	139339330	1594	797.0	
37169	chr6	139343205	139343452	247	124.0	
37170	chr6	139361140	139361695	555	278.0	
37171	chr6	139363977	139364843	866	433.0	
37172	chr6	139368136	139368259	123	62.0	
37173	chr6	139369438	139370814	1376	688.0	
37174	chr6	139371862	139376435	4573	2286.0	
37175	chr6	139392826	139393211	385	192.0	
37176	chr6	139429691	139430142	451	226.0	
37177	chr6	139433610	139433978	368	184.0	
37178	chr6	139445679	139445970	291	146.0	
37179	chr6	139490353	139490956	603	302.0	
37180	chr6	139530735	139531592	857	428.0	
37181	chr6	139533564	139534988	1424	712.0	
37182	chr6	139540144	139540707	563	282.0	
37183	chr6	139612152	139612214	62	31.0	
37184	chr6	139626264	139627149	885	442.0	
37185	chr6	139648638	139648955	317	158.0	
37186	chr6	139697278	139697434	156	78.0	
37187	chr6	139698834	139698967	133	66.0	
37188	chr6	139736532	139736656	124	62.0	
37189	chr6	139762409	139763202	793	396.0	
37190	chr6	139764037	139765118	1081	540.0	
37191	chr6	139839296	139840262	966	483.0	
37192	chr6	139841584	139842307	723	362.0	
37193	chr6	139846514	139846966	452	226.0	
37194	chr6	139881688	139882267	579	290.0	
37195	chr6	139883788	139884137	349	174.0	
37196	chr6	139903680	139904323	643	322.0	
37197	chr6	139919654	139920601	947	474.0	
37198	chr6	139927341	139927667	326	163.0	
37199	chr6	139940966	139941810	844	422.0	
37200	chr6	140036247	140036596	349	174.0	
37201	chr6	140039348	140039729	381	190.0	
37202	chr6	140044004	140044442	438	219.0	
37203	chr6	140046013	140046398	385	192.0	
37204	chr6	140320283	140321105	822	411.0	
37205	chr6	140809845	140810118	273	136.0	
37206	chr6	141153580	141153900	320	160.0	
37207	chr6	141326453	141326827	374	187.0	
37208	chr6	141464503	141464843	340	170.0	
37209	chr6	141482754	141485195	2441	1220.0	
37210	chr6	141488478	141488880	402	201.0	
37211	chr6	141554122	141554573	451	226.0	
37212	chr6	141562107	141563312	1205	602.0	
37213	chr6	141848420	141848987	567	284.0	
37214	chr6	142045109	142045339	230	115.0	
37215	chr6	142112449	142112823	374	187.0	
37216	chr6	142146628	142147908	1280	640.0	
37217	chr6	142156234	142156878	644	322.0	
37218	chr6	142207317	142207824	507	254.0	
37219	chr6	142232129	142232982	853	426.0	
37220	chr6	142294589	142295151	562	281.0	
37221	chr6	142301427	142302427	1000	500.0	
37222	chr6	142331150	142331500	350	175.0	
37223	chr6	142378183	142378905	722	361.0	
37224	chr6	142380553	142380985	432	216.0	
37225	chr6	142388237	142388626	389	194.0	
37226	chr6	142395393	142396398	1005	502.0	
37227	chr6	142474693	142475157	464	232.0	
37228	chr6	142478120	142478471	351	176.0	
37229	chr6	142482294	142482572	278	139.0	
37230	chr6	142551284	142551756	472	236.0	
37231	chr6	142566553	142567221	668	334.0	
37232	chr6	142569641	142569988	347	174.0	
37233	chr6	142671725	142672228	503	252.0	
37234	chr6	142680371	142680673	302	151.0	
37235	chr6	142686144	142686485	341	170.0	
37236	chr6	142692632	142693495	863	432.0	
37237	chr6	142699900	142700983	1083	542.0	
37238	chr6	142702105	142703289	1184	592.0	
37239	chr6	142704951	142705498	547	274.0	
37240	chr6	142706206	142706604	398	199.0	
37241	chr6	142721262	142721832	570	285.0	
37242	chr6	142728963	142729489	526	263.0	
37243	chr6	142746465	142746923	458	229.0	
37244	chr6	142773802	142774356	554	277.0	
37245	chr6	142784287	142784740	453	226.0	
37246	chr6	142796522	142796975	453	226.0	
37247	chr6	142798284	142798704	420	210.0	
37248	chr6	142811081	142811259	178	89.0	
37249	chr6	142819176	142821079	1903	952.0	
37250	chr6	142822536	142823321	785	392.0	
37251	chr6	142839114	142840083	969	484.0	
37252	chr6	142842234	142847089	4855	2428.0	
37253	chr6	142848448	142848453	5	2.0	
37254	chr6	142850539	142851445	906	453.0	
37255	chr6	142853681	142859116	5435	2718.0	
37256	chr6	142860609	142860621	12	6.0	
37257	chr6	142867848	142868502	654	327.0	
37258	chr6	142871693	142873025	1332	666.0	
37259	chr6	142874603	142875076	473	236.0	
37260	chr6	142878565	142878742	177	88.0	
37261	chr6	142884497	142886105	1608	804.0	
37262	chr6	142886640	142887941	1301	650.0	
37263	chr6	142900506	142901196	690	345.0	
37264	chr6	142902208	142904274	2066	1033.0	
37265	chr6	142906883	142908157	1274	637.0	
37266	chr6	142909702	142910093	391	196.0	
37267	chr6	142912539	142914411	1872	936.0	
37268	chr6	142915002	142915964	962	481.0	
37269	chr6	142925742	142928956	3214	1607.0	
37270	chr6	142929753	142930736	983	492.0	
37271	chr6	142932697	142933375	678	339.0	
37272	chr6	142934613	142936501	1888	944.0	
37273	chr6	142938671	142938838	167	84.0	
37274	chr6	142940572	142941274	702	351.0	
37275	chr6	142942245	142949522	7277	3638.0	
37276	chr6	142952121	142953092	971	486.0	
37277	chr6	142953721	142954212	491	246.0	
37278	chr6	142954759	142955316	557	278.0	
37279	chr6	142960065	142960513	448	224.0	
37280	chr6	142975267	142975853	586	293.0	
37281	chr6	143026997	143027495	498	249.0	
37282	chr6	143038983	143039200	217	108.0	
37283	chr6	143058926	143062461	3535	1768.0	
37284	chr6	143097316	143098722	1406	703.0	
37285	chr6	143232953	143233183	230	115.0	
37286	chr6	143276532	143276570	38	19.0	
37287	chr6	143397006	143398061	1055	528.0	
37288	chr6	143400597	143401149	552	276.0	
37289	chr6	143426991	143427653	662	331.0	
37290	chr6	143449558	143451883	2325	1162.0	
37291	chr6	143510758	143512161	1403	702.0	
37292	chr6	143513323	143513816	493	246.0	
37293	chr6	143516610	143516952	342	171.0	
37294	chr6	143525313	143525709	396	198.0	
37295	chr6	143528058	143528860	802	401.0	
37296	chr6	143534672	143535101	429	214.0	
37297	chr6	143536141	143540291	4150	2075.0	
37298	chr6	143543038	143546526	3488	1744.0	
37299	chr6	143553308	143553560	252	126.0	
37300	chr6	143554959	143555746	787	394.0	
37301	chr6	143556501	143556907	406	203.0	
37302	chr6	143561245	143561265	20	10.0	
37303	chr6	143566823	143567411	588	294.0	
37304	chr6	143569047	143569403	356	178.0	
37305	chr6	143575281	143575798	517	258.0	
37306	chr6	143598289	143598890	601	300.0	
37307	chr6	143614194	143614599	405	202.0	
37308	chr6	143677597	143679109	1512	756.0	
37309	chr6	143695445	143696049	604	302.0	
37310	chr6	143708882	143709293	411	206.0	
37311	chr6	143731826	143732874	1048	524.0	
37312	chr6	143741392	143741917	525	262.0	
37313	chr6	143759614	143760017	403	202.0	
37314	chr6	143807660	143808184	524	262.0	
37315	chr6	143842479	143844385	1906	953.0	
37316	chr6	143845138	143845148	10	5.0	
37317	chr6	143872212	143872517	305	152.0	
37318	chr6	143939970	143940448	478	239.0	
37319	chr6	143942055	143942542	487	244.0	
37320	chr6	143965713	143966701	988	494.0	
37321	chr6	144007729	144008679	950	475.0	
37322	chr6	144013353	144013856	503	252.0	
37323	chr6	144017124	144017599	475	238.0	
37324	chr6	144019882	144020317	435	218.0	
37325	chr6	144035909	144037210	1301	650.0	
37326	chr6	144046733	144047008	275	138.0	
37327	chr6	144049396	144049563	167	84.0	
37328	chr6	144054865	144056038	1173	586.0	
37329	chr6	144062757	144065515	2758	1379.0	
37330	chr6	144066872	144067629	757	378.0	
37331	chr6	144087920	144088105	185	92.0	
37332	chr6	144094598	144096731	2133	1066.0	
37333	chr6	144104829	144105380	551	276.0	
37334	chr6	144123472	144123752	280	140.0	
37335	chr6	144149493	144154470	4977	2488.0	
37336	chr6	144155306	144158509	3203	1602.0	
37337	chr6	144159046	144160945	1899	950.0	
37338	chr6	144161568	144163507	1939	970.0	
37339	chr6	144165714	144166985	1271	636.0	
37340	chr6	144167715	144171079	3364	1682.0	
37341	chr6	144172238	144176329	4091	2046.0	
37342	chr6	144177450	144178486	1036	518.0	
37343	chr6	144179115	144182118	3003	1502.0	
37344	chr6	144190114	144190443	329	164.0	
37345	chr6	144197887	144198337	450	225.0	
37346	chr6	144214991	144217673	2682	1341.0	
37347	chr6	144218417	144219542	1125	562.0	
37348	chr6	144265365	144265762	397	198.0	
37349	chr6	144284218	144287470	3252	1626.0	
37350	chr6	144290612	144290903	291	146.0	
37351	chr6	144298199	144298474	275	138.0	
37352	chr6	144303030	144303383	353	176.0	
37353	chr6	144304349	144304846	497	248.0	
37354	chr6	144305713	144306568	855	428.0	
37355	chr6	144333753	144336371	2618	1309.0	
37356	chr6	144337106	144337131	25	12.0	
37357	chr6	144338921	144339693	772	386.0	
37358	chr6	144340577	144340805	228	114.0	
37359	chr6	144341857	144341965	108	54.0	
37360	chr6	144342850	144345281	2431	1216.0	
37361	chr6	144346861	144347889	1028	514.0	
37362	chr6	144348951	144354812	5861	2930.0	
37363	chr6	144360430	144360846	416	208.0	
37364	chr6	144364280	144365274	994	497.0	
37365	chr6	144395838	144396228	390	195.0	
37366	chr6	144411864	144411926	62	31.0	
37367	chr6	144413534	144413587	53	26.0	
37368	chr6	144419071	144419356	285	142.0	
37369	chr6	144460340	144460915	575	288.0	
37370	chr6	144481797	144482521	724	362.0	
37371	chr6	144500971	144501188	217	108.0	
37372	chr6	144543298	144543641	343	172.0	
37373	chr6	144559915	144560682	767	384.0	
37374	chr6	144566915	144567594	679	340.0	
37375	chr6	144581793	144582237	444	222.0	
37376	chr6	144582769	144583830	1061	530.0	
37377	chr6	144585227	144585613	386	193.0	
37378	chr6	144590405	144591231	826	413.0	
37379	chr6	144608363	144608643	280	140.0	
37380	chr6	144637481	144637973	492	246.0	
37381	chr6	144653806	144654864	1058	529.0	
37382	chr6	144659035	144660172	1137	568.0	
37383	chr6	144662970	144663374	404	202.0	
37384	chr6	144666648	144668072	1424	712.0	
37385	chr6	144675145	144675788	643	322.0	
37386	chr6	144678770	144679257	487	244.0	
37387	chr6	144696067	144696356	289	144.0	
37388	chr6	144722860	144723320	460	230.0	
37389	chr6	144726274	144726310	36	18.0	
37390	chr6	144777535	144777658	123	62.0	
37391	chr6	144820281	144820555	274	137.0	
37392	chr6	144931425	144931800	375	188.0	
37393	chr6	145148249	145148869	620	310.0	
37394	chr6	145372524	145373148	624	312.0	
37395	chr6	145633981	145634410	429	214.0	
37396	chr6	145705479	145706008	529	264.0	
37397	chr6	145734438	145736343	1905	952.0	
37398	chr6	145756015	145756680	665	332.0	
37399	chr6	145813374	145816303	2929	1464.0	
37400	chr6	145820034	145820197	163	82.0	
37401	chr6	145863349	145864403	1054	527.0	
37402	chr6	145865080	145867396	2316	1158.0	
37403	chr6	145875939	145876362	423	212.0	
37404	chr6	145888030	145888414	384	192.0	
37405	chr6	145905141	145905252	111	56.0	
37406	chr6	145963338	145965395	2057	1028.0	
37407	chr6	146028202	146028562	360	180.0	
37408	chr6	146290252	146290748	496	248.0	
37409	chr6	146305266	146305352	86	43.0	
37410	chr6	146357535	146358646	1111	556.0	
37411	chr6	146543003	146547074	4071	2036.0	
37412	chr6	146567989	146568707	718	359.0	
37413	chr6	146582641	146583307	666	333.0	
37414	chr6	146587408	146587837	429	214.0	
37415	chr6	146590512	146590813	301	150.0	
37416	chr6	146593939	146594934	995	498.0	
37417	chr6	146595838	146596578	740	370.0	
37418	chr6	146598687	146599226	539	270.0	
37419	chr6	146700014	146700486	472	236.0	
37420	chr6	146770290	146771499	1209	604.0	
37421	chr6	146784974	146785468	494	247.0	
37422	chr6	146857209	146858241	1032	516.0	
37423	chr6	146876214	146877033	819	410.0	
37424	chr6	146878228	146879383	1155	578.0	
37425	chr6	146887238	146887620	382	191.0	
37426	chr6	146892522	146893088	566	283.0	
37427	chr6	146913782	146915061	1279	640.0	
37428	chr6	146915722	146916137	415	208.0	
37429	chr6	146950252	146950807	555	278.0	
37430	chr6	147109705	147110104	399	200.0	
37431	chr6	147194789	147195825	1036	518.0	
37432	chr6	147201817	147206234	4417	2208.0	
37433	chr6	147222325	147222933	608	304.0	
37434	chr6	147285063	147285459	396	198.0	
37435	chr6	147297857	147298354	497	248.0	
37436	chr6	147321997	147323218	1221	610.0	
37437	chr6	148146723	148146953	230	115.0	
37438	chr6	148203845	148204503	658	329.0	
37439	chr6	148324741	148325262	521	260.0	
37440	chr6	148342382	148343145	763	382.0	
37441	chr6	148363906	148364849	943	472.0	
37442	chr6	148367617	148368112	495	248.0	
37443	chr6	148381574	148381864	290	145.0	
37444	chr6	148383951	148384223	272	136.0	
37445	chr6	148464730	148465138	408	204.0	
37446	chr6	148509746	148510354	608	304.0	
37447	chr6	148520146	148520603	457	228.0	
37448	chr6	148530705	148530770	65	32.0	
37449	chr6	148556405	148556840	435	218.0	
37450	chr6	148557698	148558425	727	364.0	
37451	chr6	148559686	148560456	770	385.0	
37452	chr6	148566218	148567025	807	404.0	
37453	chr6	148578109	148578610	501	250.0	
37454	chr6	148623937	148624484	547	274.0	
37455	chr6	148649042	148649955	913	456.0	
37456	chr6	148656754	148657608	854	427.0	
37457	chr6	148674269	148674723	454	227.0	
37458	chr6	148677464	148678621	1157	578.0	
37459	chr6	148682779	148683646	867	434.0	
37460	chr6	148693788	148694331	543	272.0	
37461	chr6	148700703	148701473	770	385.0	
37462	chr6	148736197	148736209	12	6.0	
37463	chr6	148739620	148740330	710	355.0	
37464	chr6	148746119	148749030	2911	1456.0	
37465	chr6	148757923	148762088	4165	2082.0	
37466	chr6	148770322	148770756	434	217.0	
37467	chr6	148771858	148772392	534	267.0	
37468	chr6	148779002	148779600	598	299.0	
37469	chr6	148780840	148781534	694	347.0	
37470	chr6	148830592	148831439	847	424.0	
37471	chr6	148866939	148867164	225	112.0	
37472	chr6	148947761	148948351	590	295.0	
37473	chr6	148972385	148972925	540	270.0	
37474	chr6	148988044	148988358	314	157.0	
37475	chr6	148999966	149000590	624	312.0	
37476	chr6	149028766	149029304	538	269.0	
37477	chr6	149031272	149031300	28	14.0	
37478	chr6	149031976	149032946	970	485.0	
37479	chr6	149045399	149045709	310	155.0	
37480	chr6	149054322	149054750	428	214.0	
37481	chr6	149060151	149060990	839	420.0	
37482	chr6	149065761	149066824	1063	532.0	
37483	chr6	149079757	149080185	428	214.0	
37484	chr6	149082191	149082743	552	276.0	
37485	chr6	149095025	149095386	361	180.0	
37486	chr6	149111687	149112146	459	230.0	
37487	chr6	149128391	149130137	1746	873.0	
37488	chr6	149139961	149141304	1343	672.0	
37489	chr6	149147918	149148817	899	450.0	
37490	chr6	149169098	149169213	115	58.0	
37491	chr6	149182345	149182470	125	62.0	
37492	chr6	149190194	149190673	479	240.0	
37493	chr6	149210466	149211507	1041	520.0	
37494	chr6	149212792	149213775	983	492.0	
37495	chr6	149217588	149218024	436	218.0	
37496	chr6	149230722	149231148	426	213.0	
37497	chr6	149231708	149232174	466	233.0	
37498	chr6	149232903	149235841	2938	1469.0	
37499	chr6	149246492	149247421	929	464.0	
37500	chr6	149248771	149249472	701	350.0	
37501	chr6	149250188	149250907	719	360.0	
37502	chr6	149257852	149258200	348	174.0	
37503	chr6	149259479	149260290	811	406.0	
37504	chr6	149261455	149261673	218	109.0	
37505	chr6	149264612	149265040	428	214.0	
37506	chr6	149266516	149267169	653	326.0	
37507	chr6	149270656	149272308	1652	826.0	
37508	chr6	149273245	149273792	547	274.0	
37509	chr6	149316421	149321325	4904	2452.0	
37510	chr6	149324590	149324825	235	118.0	
37511	chr6	149342341	149343604	1263	632.0	
37512	chr6	149366182	149366748	566	283.0	
37513	chr6	149405707	149406674	967	484.0	
37514	chr6	149431881	149432468	587	294.0	
37515	chr6	149450669	149451707	1038	519.0	
37516	chr6	149454375	149454794	419	210.0	
37517	chr6	149465531	149466310	779	390.0	
37518	chr6	149468127	149469335	1208	604.0	
37519	chr6	149471994	149472049	55	28.0	
37520	chr6	149473088	149473930	842	421.0	
37521	chr6	149480503	149486061	5558	2779.0	
37522	chr6	149494587	149495930	1343	672.0	
37523	chr6	149508428	149508925	497	248.0	
37524	chr6	149517391	149518123	732	366.0	
37525	chr6	149544242	149546957	2715	1358.0	
37526	chr6	149560609	149561097	488	244.0	
37527	chr6	149565133	149567654	2521	1260.0	
37528	chr6	149628827	149629580	753	376.0	
37529	chr6	149647308	149649456	2148	1074.0	
37530	chr6	149716093	149718964	2871	1436.0	
37531	chr6	149723732	149724280	548	274.0	
37532	chr6	149728064	149728919	855	428.0	
37533	chr6	149729774	149730399	625	312.0	
37534	chr6	149745762	149747052	1290	645.0	
37535	chr6	149748983	149751044	2061	1030.0	
37536	chr6	149753104	149753588	484	242.0	
37537	chr6	149761356	149761941	585	292.0	
37538	chr6	149766414	149766727	313	156.0	
37539	chr6	149834434	149834952	518	259.0	
37540	chr6	149840574	149840986	412	206.0	
37541	chr6	149847555	149847909	354	177.0	
37542	chr6	149851829	149852682	853	426.0	
37543	chr6	149862976	149865406	2430	1215.0	
37544	chr6	149895942	149896365	423	212.0	
37545	chr6	149922266	149923903	1637	818.0	
37546	chr6	149924412	149924418	6	3.0	
37547	chr6	149925034	149926819	1785	892.0	
37548	chr6	149929456	149929712	256	128.0	
37549	chr6	149933916	149935177	1261	630.0	
37550	chr6	149937467	149943630	6163	3082.0	
37551	chr6	149948271	149948361	90	45.0	
37552	chr6	149953965	149956058	2093	1046.0	
37553	chr6	149961582	149966005	4423	2212.0	
37554	chr6	149974826	149975280	454	227.0	
37555	chr6	149988684	149989028	344	172.0	
37556	chr6	149989734	149991899	2165	1082.0	
37557	chr6	150001235	150001984	749	374.0	
37558	chr6	150003983	150007603	3620	1810.0	
37559	chr6	150014121	150014146	25	12.0	
37560	chr6	150015143	150015828	685	342.0	
37561	chr6	150016431	150017519	1088	544.0	
37562	chr6	150025450	150025939	489	244.0	
37563	chr6	150029871	150030084	213	106.0	
37564	chr6	150033183	150033710	527	264.0	
37565	chr6	150037697	150037748	51	26.0	
37566	chr6	150059989	150060259	270	135.0	
37567	chr6	150068105	150069784	1679	840.0	
37568	chr6	150070493	150072612	2119	1060.0	
37569	chr6	150079411	150081095	1684	842.0	
37570	chr6	150142313	150143557	1244	622.0	
37571	chr6	150145710	150146270	560	280.0	
37572	chr6	150157130	150157474	344	172.0	
37573	chr6	150167783	150168389	606	303.0	
37574	chr6	150185006	150185227	221	110.0	
37575	chr6	150263980	150264453	473	236.0	
37576	chr6	150310476	150311961	1485	742.0	
37577	chr6	150335100	150335501	401	200.0	
37578	chr6	150395419	150395825	406	203.0	
37579	chr6	150417772	150419501	1729	864.0	
37580	chr6	150491295	150491792	497	248.0	
37581	chr6	150574444	150574890	446	223.0	
37582	chr6	150598850	150601325	2475	1238.0	
37583	chr6	150622708	150623773	1065	532.0	enhancer
37584	chr6	150631465	150634337	2872	1436.0	
37585	chr6	150641309	150641804	495	248.0	
37586	chr6	150683265	150683675	410	205.0	
37587	chr6	150684664	150685137	473	236.0	
37588	chr6	150685882	150686307	425	212.0	
37589	chr6	150690265	150690550	285	142.0	
37590	chr6	150691414	150691883	469	234.0	
37591	chr6	150702622	150703694	1072	536.0	
37592	chr6	150720685	150721200	515	258.0	
37593	chr6	150815075	150815536	461	230.0	
37594	chr6	150817780	150818189	409	204.0	
37595	chr6	150861703	150862202	499	250.0	
37596	chr6	150865150	150867205	2055	1028.0	
37597	chr6	150891831	150892323	492	246.0	
37598	chr6	150895061	150895346	285	142.0	
37599	chr6	150925322	150925537	215	108.0	
37600	chr6	150927105	150927566	461	230.0	
37601	chr6	150981231	150981404	173	86.0	
37602	chr6	150987439	150987923	484	242.0	
37603	chr6	151004376	151005040	664	332.0	
37604	chr6	151005980	151006698	718	359.0	
37605	chr6	151014304	151014776	472	236.0	
37606	chr6	151029887	151030456	569	284.0	
37607	chr6	151036417	151036437	20	10.0	
37608	chr6	151037245	151037807	562	281.0	
37609	chr6	151040674	151041543	869	434.0	
37610	chr6	151059548	151060145	597	298.0	
37611	chr6	151324049	151326138	2089	1044.0	
37612	chr6	151334802	151335244	442	221.0	
37613	chr6	151352620	151353429	809	404.0	
37614	chr6	151372064	151375299	3235	1618.0	
37615	chr6	151376459	151376864	405	202.0	
37616	chr6	151379856	151381313	1457	728.0	
37617	chr6	151381991	151382026	35	18.0	
37618	chr6	151384986	151385601	615	308.0	
37619	chr6	151388804	151392908	4104	2052.0	
37620	chr6	151406023	151406458	435	218.0	
37621	chr6	151412891	151414227	1336	668.0	
37622	chr6	151440925	151441326	401	200.0	
37623	chr6	151451516	151453433	1917	958.0	
37624	chr6	151475648	151476506	858	429.0	
37625	chr6	151481633	151483054	1421	710.0	
37626	chr6	151493475	151495014	1539	770.0	
37627	chr6	151497891	151498790	899	450.0	
37628	chr6	151499725	151500126	401	200.0	
37629	chr6	151502519	151502890	371	186.0	
37630	chr6	151512424	151512843	419	210.0	
37631	chr6	151675667	151676154	487	244.0	
37632	chr6	151690240	151691778	1538	769.0	
37633	chr6	151702111	151702120	9	4.0	
37634	chr6	151723325	151723365	40	20.0	
37635	chr6	151763951	151764702	751	376.0	
37636	chr6	151765412	151765862	450	225.0	
37637	chr6	151807169	151808527	1358	679.0	
37638	chr6	151822445	151822881	436	218.0	
37639	chr6	151948235	151948838	603	302.0	
37640	chr6	151958341	151958669	328	164.0	
37641	chr6	152094957	152095680	723	362.0	
37642	chr6	152100049	152100735	686	343.0	
37643	chr6	152112628	152112629	1	0.0	
37644	chr6	152124437	152124829	392	196.0	
37645	chr6	152152048	152152249	201	100.0	
37646	chr6	152170529	152171828	1299	650.0	
37647	chr6	152182899	152186822	3923	1962.0	
37648	chr6	152206533	152206809	276	138.0	
37649	chr6	152233167	152233460	293	146.0	
37650	chr6	152268238	152268571	333	166.0	
37651	chr6	152299345	152299575	230	115.0	
37652	chr6	152300651	152300714	63	32.0	
37653	chr6	152301267	152302761	1494	747.0	
37654	chr6	152309625	152310894	1269	634.0	
37655	chr6	152329671	152330025	354	177.0	
37656	chr6	152338338	152338988	650	325.0	
37657	chr6	152356687	152357041	354	177.0	
37658	chr6	152552557	152553025	468	234.0	
37659	chr6	152565951	152566696	745	372.0	
37660	chr6	152575461	152576178	717	358.0	
37661	chr6	152587375	152587950	575	288.0	
37662	chr6	152625196	152625598	402	201.0	
37663	chr6	152631288	152631409	121	60.0	
37664	chr6	152634621	152637532	2911	1456.0	
37665	chr6	152640530	152640906	376	188.0	
37666	chr6	152642908	152643442	534	267.0	
37667	chr6	152863830	152864279	449	224.0	
37668	chr6	152897785	152898253	468	234.0	
37669	chr6	152948142	152948588	446	223.0	
37670	chr6	152953147	152953471	324	162.0	
37671	chr6	152975062	152975931	869	434.0	
37672	chr6	152982319	152984978	2659	1330.0	
37673	chr6	153001864	153003956	2092	1046.0	
37674	chr6	153024155	153024859	704	352.0	
37675	chr6	153032305	153032541	236	118.0	
37676	chr6	153073865	153074185	320	160.0	
37677	chr6	153090559	153090622	63	32.0	
37678	chr6	153092308	153093178	870	435.0	
37679	chr6	153099719	153100060	341	170.0	
37680	chr6	153118555	153119018	463	232.0	
37681	chr6	153129742	153132078	2336	1168.0	
37682	chr6	153135634	153136117	483	242.0	
37683	chr6	153312711	153312993	282	141.0	
37684	chr6	153512038	153512488	450	225.0	
37685	chr6	153947900	153948191	291	146.0	
37686	chr6	153957319	153957876	557	278.0	
37687	chr6	154012797	154013250	453	226.0	
37688	chr6	154039453	154039713	260	130.0	
37689	chr6	154125975	154126813	838	419.0	
37690	chr6	154138714	154140581	1867	934.0	
37691	chr6	154154362	154154849	487	244.0	
37692	chr6	154155965	154157966	2001	1000.0	
37693	chr6	154161680	154162155	475	238.0	
37694	chr6	154165391	154166508	1117	558.0	
37695	chr6	154167175	154167529	354	177.0	
37696	chr6	154169451	154170499	1048	524.0	
37697	chr6	154229510	154230349	839	420.0	
37698	chr6	154230963	154232700	1737	868.0	
37699	chr6	154233743	154234784	1041	520.0	
37700	chr6	154239344	154239813	469	234.0	
37701	chr6	154241029	154241506	477	238.0	
37702	chr6	154243035	154244904	1869	934.0	
37703	chr6	154245410	154248531	3121	1560.0	
37704	chr6	154249306	154250892	1586	793.0	
37705	chr6	154252680	154253292	612	306.0	
37706	chr6	154256904	154258763	1859	930.0	
37707	chr6	154267837	154268133	296	148.0	
37708	chr6	154276818	154278156	1338	669.0	
37709	chr6	154302025	154302730	705	352.0	
37710	chr6	154306591	154307119	528	264.0	
37711	chr6	154337383	154337881	498	249.0	
37712	chr6	154341367	154341871	504	252.0	
37713	chr6	154352891	154353314	423	212.0	
37714	chr6	154354709	154357288	2579	1290.0	
37715	chr6	154359088	154359720	632	316.0	
37716	chr6	154367306	154368585	1279	640.0	
37717	chr6	154370520	154371717	1197	598.0	
37718	chr6	154380847	154381049	202	101.0	
37719	chr6	154413992	154414477	485	242.0	
37720	chr6	154432831	154433203	372	186.0	
37721	chr6	154478389	154478532	143	72.0	
37722	chr6	154510575	154510911	336	168.0	
37723	chr6	154606359	154606946	587	294.0	
37724	chr6	154675410	154676406	996	498.0	
37725	chr6	154683862	154684656	794	397.0	
37726	chr6	154714104	154714575	471	236.0	
37727	chr6	154732630	154735041	2411	1206.0	
37728	chr6	154735782	154735932	150	75.0	
37729	chr6	154736592	154736995	403	202.0	
37730	chr6	154754236	154754556	320	160.0	
37731	chr6	154805250	154805713	463	232.0	
37732	chr6	154815237	154815619	382	191.0	
37733	chr6	154921473	154921853	380	190.0	
37734	chr6	154928318	154928740	422	211.0	
37735	chr6	154951009	154952272	1263	632.0	
37736	chr6	155050301	155050745	444	222.0	
37737	chr6	155093451	155093867	416	208.0	
37738	chr6	155143024	155143657	633	316.0	
37739	chr6	155170987	155171977	990	495.0	
37740	chr6	155174629	155175187	558	279.0	
37741	chr6	155177359	155177765	406	203.0	
37742	chr6	155189063	155189373	310	155.0	
37743	chr6	155221015	155221590	575	288.0	
37744	chr6	155222546	155222750	204	102.0	
37745	chr6	155223648	155224781	1133	566.0	
37746	chr6	155248374	155248768	394	197.0	
37747	chr6	155268111	155268498	387	194.0	
37748	chr6	155306988	155307003	15	8.0	
37749	chr6	155313530	155315765	2235	1118.0	
37750	chr6	155319600	155320347	747	374.0	
37751	chr6	155327411	155327997	586	293.0	
37752	chr6	155417471	155419072	1601	800.0	
37753	chr6	155528946	155529581	635	318.0	
37754	chr6	155974107	155974298	191	96.0	
37755	chr6	156059980	156060393	413	206.0	
37756	chr6	156163307	156163788	481	240.0	
37757	chr6	156379003	156379065	62	31.0	
37758	chr6	156395155	156397216	2061	1030.0	
37759	chr6	156423817	156424155	338	169.0	
37760	chr6	156557466	156558006	540	270.0	
37761	chr6	156564141	156564843	702	351.0	
37762	chr6	156636162	156636528	366	183.0	
37763	chr6	156647391	156648272	881	440.0	
37764	chr6	156651004	156651912	908	454.0	
37765	chr6	156686084	156688436	2352	1176.0	
37766	chr6	156689585	156690117	532	266.0	
37767	chr6	156697098	156699501	2403	1202.0	
37768	chr6	156719399	156721224	1825	912.0	
37769	chr6	156727767	156728081	314	157.0	
37770	chr6	156752539	156753133	594	297.0	
37771	chr6	156768168	156768617	449	224.0	
37772	chr6	156776319	156783131	6812	3406.0	
37773	chr6	156791161	156791671	510	255.0	
37774	chr6	156794908	156795239	331	166.0	
37775	chr6	156807043	156807466	423	212.0	
37776	chr6	156808988	156809485	497	248.0	
37777	chr6	156816468	156817579	1111	556.0	
37778	chr6	156822746	156822762	16	8.0	
37779	chr6	156839181	156839543	362	181.0	
37780	chr6	156840322	156841007	685	342.0	
37781	chr6	156842891	156843079	188	94.0	
37782	chr6	156852234	156852456	222	111.0	
37783	chr6	156862883	156863281	398	199.0	
37784	chr6	156866174	156866556	382	191.0	
37785	chr6	156883604	156883823	219	110.0	
37786	chr6	156886370	156886813	443	222.0	
37787	chr6	156912408	156912875	467	234.0	
37788	chr6	156916180	156916885	705	352.0	
37789	chr6	156953437	156954005	568	284.0	
37790	chr6	156963630	156964421	791	396.0	
37791	chr6	156974903	156974985	82	41.0	
37792	chr6	156976163	156976879	716	358.0	
37793	chr6	156984383	156984754	371	186.0	
37794	chr6	156988198	156988947	749	374.0	
37795	chr6	157018993	157022702	3709	1854.0	
37796	chr6	157033281	157035045	1764	882.0	
37797	chr6	157036419	157036828	409	204.0	
37798	chr6	157049105	157049629	524	262.0	
37799	chr6	157054287	157055296	1009	504.0	
37800	chr6	157068766	157069085	319	160.0	
37801	chr6	157099833	157100733	900	450.0	
37802	chr6	157129156	157129629	473	236.0	
37803	chr6	157143227	157143915	688	344.0	
37804	chr6	157146793	157147393	600	300.0	
37805	chr6	157184147	157184697	550	275.0	
37806	chr6	157220870	157223477	2607	1304.0	
37807	chr6	157224236	157224539	303	152.0	
37808	chr6	157227651	157228285	634	317.0	
37809	chr6	157235269	157236889	1620	810.0	
37810	chr6	157258883	157259468	585	292.0	
37811	chr6	157273122	157275627	2505	1252.0	
37812	chr6	157304792	157305632	840	420.0	
37813	chr6	157312828	157313083	255	128.0	
37814	chr6	157314642	157315355	713	356.0	
37815	chr6	157316863	157317814	951	476.0	
37816	chr6	157322803	157324457	1654	827.0	
37817	chr6	157334950	157335310	360	180.0	
37818	chr6	157369420	157370103	683	342.0	
37819	chr6	157376991	157377159	168	84.0	
37820	chr6	157379546	157382758	3212	1606.0	
37821	chr6	157393987	157394054	67	34.0	
37822	chr6	157460843	157461912	1069	534.0	
37823	chr6	157486675	157487025	350	175.0	
37824	chr6	157510526	157511388	862	431.0	
37825	chr6	157514946	157515420	474	237.0	
37826	chr6	157520968	157522023	1055	528.0	
37827	chr6	157527347	157527866	519	260.0	
37828	chr6	157535312	157536537	1225	612.0	
37829	chr6	157538104	157538603	499	250.0	
37830	chr6	157539340	157539786	446	223.0	
37831	chr6	157548908	157551134	2226	1113.0	
37832	chr6	157556769	157556955	186	93.0	
37833	chr6	157557535	157557832	297	148.0	
37834	chr6	157561419	157562424	1005	502.0	
37835	chr6	157563696	157564170	474	237.0	
37836	chr6	157569544	157569909	365	182.0	
37837	chr6	157585357	157585665	308	154.0	
37838	chr6	157592535	157592898	363	182.0	
37839	chr6	157597620	157598101	481	240.0	
37840	chr6	157607254	157607666	412	206.0	
37841	chr6	157615358	157615595	237	118.0	
37842	chr6	157647668	157647832	164	82.0	
37843	chr6	157667102	157667865	763	382.0	
37844	chr6	157754496	157754523	27	14.0	
37845	chr6	157755627	157757916	2289	1144.0	
37846	chr6	157760885	157765298	4413	2206.0	
37847	chr6	157768130	157769547	1417	708.0	
37848	chr6	157774047	157774468	421	210.0	
37849	chr6	157814658	157815415	757	378.0	
37850	chr6	157822304	157824802	2498	1249.0	
37851	chr6	157830422	157830822	400	200.0	
37852	chr6	157832463	157832789	326	163.0	
37853	chr6	157833531	157834446	915	458.0	
37854	chr6	157841394	157841860	466	233.0	
37855	chr6	157846152	157846668	516	258.0	
37856	chr6	157849508	157849673	165	82.0	
37857	chr6	157860324	157860879	555	278.0	
37858	chr6	157873659	157874348	689	344.0	
37859	chr6	157877426	157877916	490	245.0	
37860	chr6	157884607	157886113	1506	753.0	
37861	chr6	157891546	157892659	1113	556.0	
37862	chr6	157893187	157893681	494	247.0	
37863	chr6	157908734	157908992	258	129.0	
37864	chr6	157947041	157947583	542	271.0	
37865	chr6	157962632	157963028	396	198.0	
37866	chr6	157979359	157983968	4609	2304.0	
37867	chr6	157984590	157985034	444	222.0	
37868	chr6	157989856	157991123	1267	634.0	
37869	chr6	158004249	158004650	401	200.0	
37870	chr6	158008735	158009897	1162	581.0	
37871	chr6	158025858	158027567	1709	854.0	
37872	chr6	158029869	158030168	299	150.0	
37873	chr6	158030965	158032348	1383	692.0	
37874	chr6	158057057	158058444	1387	694.0	
37875	chr6	158060332	158060869	537	268.0	
37876	chr6	158071922	158072633	711	356.0	
37877	chr6	158081326	158082066	740	370.0	
37878	chr6	158082699	158083185	486	243.0	
37879	chr6	158086225	158087802	1577	788.0	
37880	chr6	158131935	158132308	373	186.0	
37881	chr6	158158110	158158484	374	187.0	
37882	chr6	158167079	158169193	2114	1057.0	
37883	chr6	158213911	158214772	861	430.0	
37884	chr6	158219075	158219799	724	362.0	
37885	chr6	158220588	158221315	727	364.0	
37886	chr6	158231343	158233832	2489	1244.0	
37887	chr6	158242471	158243010	539	270.0	
37888	chr6	158256241	158256540	299	150.0	
37889	chr6	158270881	158271674	793	396.0	
37890	chr6	158283310	158284858	1548	774.0	
37891	chr6	158289819	158291163	1344	672.0	
37892	chr6	158313912	158314559	647	324.0	
37893	chr6	158323318	158323329	11	6.0	
37894	chr6	158439336	158439634	298	149.0	
37895	chr6	158518111	158518935	824	412.0	
37896	chr6	158535789	158537690	1901	950.0	
37897	chr6	158559379	158562510	3131	1566.0	
37898	chr6	158563373	158565669	2296	1148.0	
37899	chr6	158567430	158568688	1258	629.0	
37900	chr6	158569921	158570397	476	238.0	
37901	chr6	158571901	158572435	534	267.0	
37902	chr6	158595224	158595615	391	196.0	
37903	chr6	158605221	158605693	472	236.0	
37904	chr6	158626784	158627143	359	180.0	
37905	chr6	158629409	158629638	229	114.0	
37906	chr6	158632104	158632781	677	338.0	
37907	chr6	158634589	158636046	1457	728.0	
37908	chr6	158640547	158640716	169	84.0	
37909	chr6	158642325	158646084	3759	1880.0	
37910	chr6	158648828	158650335	1507	754.0	
37911	chr6	158652629	158655968	3339	1670.0	
37912	chr6	158660160	158661320	1160	580.0	
37913	chr6	158662815	158663432	617	308.0	
37914	chr6	158666489	158667967	1478	739.0	
37915	chr6	158686335	158688052	1717	858.0	
37916	chr6	158691096	158691814	718	359.0	
37917	chr6	158703760	158704993	1233	616.0	
37918	chr6	158707879	158708244	365	182.0	
37919	chr6	158715503	158716661	1158	579.0	
37920	chr6	158717202	158718755	1553	776.0	
37921	chr6	158720162	158721454	1292	646.0	
37922	chr6	158737841	158738078	237	118.0	
37923	chr6	158759046	158761302	2256	1128.0	
37924	chr6	158762963	158765984	3021	1510.0	
37925	chr6	158766525	158778746	12221	6110.0	
37926	chr6	158779657	158787866	8209	4104.0	
37927	chr6	158788750	158804729	15979	7990.0	
37928	chr6	158805643	158810777	5134	2567.0	
37929	chr6	158811525	158820801	9276	4638.0	
37930	chr6	158821544	158821672	128	64.0	
37931	chr6	158822558	158823119	561	280.0	
37932	chr6	158826802	158827636	834	417.0	
37933	chr6	158835477	158835940	463	232.0	
37934	chr6	158843693	158844420	727	364.0	
37935	chr6	158846871	158847280	409	204.0	
37936	chr6	158848448	158848815	367	184.0	
37937	chr6	158849473	158851108	1635	818.0	
37938	chr6	158852377	158855159	2782	1391.0	
37939	chr6	158865996	158866100	104	52.0	
37940	chr6	158867230	158870813	3583	1792.0	
37941	chr6	158909986	158912452	2466	1233.0	
37942	chr6	158917435	158918302	867	434.0	
37943	chr6	158921131	158921456	325	162.0	
37944	chr6	158938703	158940041	1338	669.0	
37945	chr6	158958780	158959146	366	183.0	
37946	chr6	158972242	158972782	540	270.0	
37947	chr6	158995314	158995752	438	219.0	
37948	chr6	158996800	158997338	538	269.0	
37949	chr6	158998917	159000691	1774	887.0	
37950	chr6	159008493	159009490	997	498.0	
37951	chr6	159013209	159013759	550	275.0	
37952	chr6	159023936	159024209	273	136.0	
37953	chr6	159031318	159034296	2978	1489.0	
37954	chr6	159034897	159046250	11353	5676.0	
37955	chr6	159053631	159054435	804	402.0	
37956	chr6	159055014	159057086	2072	1036.0	
37957	chr6	159061826	159064855	3029	1514.0	
37958	chr6	159068900	159069269	369	184.0	
37959	chr6	159077154	159077483	329	164.0	
37960	chr6	159080151	159080715	564	282.0	
37961	chr6	159084590	159084768	178	89.0	
37962	chr6	159092501	159093109	608	304.0	
37963	chr6	159093612	159095237	1625	812.0	
37964	chr6	159098275	159100802	2527	1264.0	
37965	chr6	159103682	159105368	1686	843.0	
37966	chr6	159106303	159108394	2091	1046.0	
37967	chr6	159109469	159110430	961	480.0	
37968	chr6	159113843	159114822	979	490.0	
37969	chr6	159116146	159118130	1984	992.0	
37970	chr6	159118872	159120437	1565	782.0	
37971	chr6	159121281	159121841	560	280.0	
37972	chr6	159126956	159127550	594	297.0	
37973	chr6	159134601	159135336	735	368.0	
37974	chr6	159151057	159151696	639	320.0	
37975	chr6	159168757	159170178	1421	710.0	
37976	chr6	159174201	159174710	509	254.0	
37977	chr6	159190892	159191042	150	75.0	
37978	chr6	159252891	159253282	391	196.0	
37979	chr6	159654493	159654909	416	208.0	
37980	chr6	159676421	159694836	18415	9208.0	
37981	chr6	159700439	159700803	364	182.0	
37982	chr6	159701339	159701981	642	321.0	
37983	chr6	159715106	159715578	472	236.0	
37984	chr6	159716108	159717206	1098	549.0	
37985	chr6	159720535	159721109	574	287.0	
37986	chr6	159726137	159730142	4005	2002.0	
37987	chr6	159733400	159734201	801	400.0	
37988	chr6	159737082	159737310	228	114.0	
37989	chr6	159737949	159737973	24	12.0	
37990	chr6	159739398	159739655	257	128.0	
37991	chr6	159755104	159755495	391	196.0	
37992	chr6	159758222	159758959	737	368.0	
37993	chr6	159759791	159763331	3540	1770.0	
37994	chr6	159788101	159791636	3535	1768.0	
37995	chr6	159819777	159820661	884	442.0	
37996	chr6	159829617	159829900	283	142.0	
37997	chr6	159842568	159843015	447	224.0	
37998	chr6	159852842	159853260	418	209.0	
37999	chr6	159862074	159862572	498	249.0	
38000	chr6	159863215	159863673	458	229.0	
38001	chr6	159908582	159908926	344	172.0	
38002	chr6	159929657	159930334	677	338.0	
38003	chr6	159941580	159942199	619	310.0	
38004	chr6	159943270	159944431	1161	580.0	
38005	chr6	159952966	159953806	840	420.0	
38006	chr6	159958948	159960438	1490	745.0	
38007	chr6	159961455	159961990	535	268.0	
38008	chr6	159966297	159966822	525	262.0	
38009	chr6	159968258	159970571	2313	1156.0	
38010	chr6	159973744	159974883	1139	570.0	
38011	chr6	159976702	159977698	996	498.0	
38012	chr6	159978241	159984686	6445	3222.0	
38013	chr6	159985320	159985617	297	148.0	
38014	chr6	159989067	159990671	1604	802.0	
38015	chr6	159997014	159997285	271	136.0	
38016	chr6	159999475	159999520	45	22.0	
38017	chr6	160003995	160004545	550	275.0	
38018	chr6	160005905	160006539	634	317.0	
38019	chr6	160014144	160014885	741	370.0	
38020	chr6	160015715	160016895	1180	590.0	
38021	chr6	160028440	160028855	415	208.0	
38022	chr6	160030298	160030425	127	64.0	
38023	chr6	160068923	160069788	865	432.0	
38024	chr6	160100638	160101524	886	443.0	
38025	chr6	160103300	160103711	411	206.0	
38026	chr6	160138135	160138651	516	258.0	
38027	chr6	160398963	160399075	112	56.0	
38028	chr6	160455697	160456699	1002	501.0	
38029	chr6	160462366	160463274	908	454.0	
38030	chr6	160519601	160521086	1485	742.0	
38031	chr6	160533987	160534646	659	330.0	
38032	chr6	160733125	160733189	64	32.0	
38033	chr6	160767327	160767701	374	187.0	
38034	chr6	160930632	160931388	756	378.0	
38035	chr6	160986775	160987303	528	264.0	
38036	chr6	160990948	160993201	2253	1126.0	
38037	chr6	160996199	160996636	437	218.0	
38038	chr6	161001719	161001765	46	23.0	
38039	chr6	161013674	161014104	430	215.0	
38040	chr6	161076032	161077028	996	498.0	
38041	chr6	161079615	161080759	1144	572.0	
38042	chr6	161108326	161109522	1196	598.0	
38043	chr6	161111212	161111671	459	230.0	
38044	chr6	161117013	161118096	1083	542.0	
38045	chr6	161136204	161136736	532	266.0	
38046	chr6	161153118	161153290	172	86.0	
38047	chr6	161170115	161170877	762	381.0	
38048	chr6	161186525	161186810	285	142.0	
38049	chr6	161199883	161200212	329	164.0	
38050	chr6	161226003	161227276	1273	636.0	
38051	chr6	161229171	161229506	335	168.0	
38052	chr6	161241855	161243929	2074	1037.0	
38053	chr6	161255873	161256798	925	462.0	
38054	chr6	161258572	161258901	329	164.0	
38055	chr6	161259477	161260095	618	309.0	
38056	chr6	161260611	161262606	1995	998.0	
38057	chr6	161264211	161264467	256	128.0	
38058	chr6	161265864	161266483	619	310.0	
38059	chr6	161269303	161270385	1082	541.0	
38060	chr6	161271127	161271784	657	328.0	
38061	chr6	161272922	161275286	2364	1182.0	
38062	chr6	161351803	161352206	403	202.0	
38063	chr6	161353299	161353691	392	196.0	
38064	chr6	161355577	161357345	1768	884.0	
38065	chr6	161359230	161359893	663	332.0	
38066	chr6	161360574	161360922	348	174.0	
38067	chr6	161366314	161367039	725	362.0	
38068	chr6	161369012	161369878	866	433.0	
38069	chr6	161370625	161371312	687	344.0	
38070	chr6	161373674	161374500	826	413.0	
38071	chr6	161375064	161376065	1001	500.0	
38072	chr6	161393736	161394554	818	409.0	
38073	chr6	161418406	161418736	330	165.0	
38074	chr6	161922881	161923183	302	151.0	
38075	chr6	162099536	162100241	705	352.0	
38076	chr6	162119290	162119858	568	284.0	
38077	chr6	162140363	162140873	510	255.0	
38078	chr6	162150906	162151314	408	204.0	
38079	chr6	162157138	162157543	405	202.0	
38080	chr6	162173555	162173792	237	118.0	
38081	chr6	162179305	162179692	387	194.0	
38082	chr6	162181054	162182269	1215	608.0	
38083	chr6	162184187	162185017	830	415.0	
38084	chr6	162706368	162706502	134	67.0	
38085	chr6	162712764	162712940	176	88.0	
38086	chr6	162726941	162728751	1810	905.0	
38087	chr6	162733459	162733881	422	211.0	
38088	chr6	163122312	163122814	502	251.0	
38089	chr6	163170258	163170716	458	229.0	
38090	chr6	163181190	163181562	372	186.0	
38091	chr6	163250325	163250441	116	58.0	
38092	chr6	163335778	163336137	359	180.0	
38093	chr6	163344395	163344761	366	183.0	
38094	chr6	163352296	163352634	338	169.0	
38095	chr6	163353980	163356910	2930	1465.0	
38096	chr6	163384478	163384858	380	190.0	
38097	chr6	163390853	163391000	147	74.0	
38098	chr6	163398641	163399316	675	338.0	
38099	chr6	163404498	163406607	2109	1054.0	
38100	chr6	163412187	163417951	5764	2882.0	
38101	chr6	163419755	163419977	222	111.0	
38102	chr6	163422952	163423676	724	362.0	
38103	chr6	163424422	163424440	18	9.0	
38104	chr6	163427817	163428279	462	231.0	
38105	chr6	163438539	163439369	830	415.0	
38106	chr6	163444001	163444371	370	185.0	
38107	chr6	163457570	163460978	3408	1704.0	
38108	chr6	163461704	163462158	454	227.0	
38109	chr6	163469522	163469914	392	196.0	
38110	chr6	163485558	163485699	141	70.0	
38111	chr6	163487710	163488005	295	148.0	
38112	chr6	163533486	163533892	406	203.0	
38113	chr6	163554623	163555093	470	235.0	
38114	chr6	163585739	163586477	738	369.0	
38115	chr6	163587748	163588077	329	164.0	
38116	chr6	163661072	163661777	705	352.0	
38117	chr6	163667331	163668548	1217	608.0	
38118	chr6	163696169	163696733	564	282.0	
38119	chr6	163698217	163698358	141	70.0	
38120	chr6	163704409	163704462	53	26.0	
38121	chr6	163707654	163708387	733	366.0	
38122	chr6	163709769	163710133	364	182.0	
38123	chr6	163710646	163711103	457	228.0	
38124	chr6	163711772	163713330	1558	779.0	
38125	chr6	163716638	163717137	499	250.0	
38126	chr6	163750521	163751589	1068	534.0	
38127	chr6	163754818	163755333	515	258.0	
38128	chr6	163755924	163756872	948	474.0	
38129	chr6	163782620	163783009	389	194.0	
38130	chr6	163860870	163860883	13	6.0	
38131	chr6	163883910	163884434	524	262.0	
38132	chr6	163956511	163957073	562	281.0	
38133	chr6	163984476	163984980	504	252.0	
38134	chr6	163988216	163988711	495	248.0	
38135	chr6	164039875	164040486	611	306.0	
38136	chr6	164086096	164086635	539	270.0	
38137	chr6	164097972	164098222	250	125.0	
38138	chr6	164108504	164109949	1445	722.0	
38139	chr6	164927530	164927953	423	212.0	
38140	chr6	165850444	165850790	346	173.0	
38141	chr6	165884846	165885295	449	224.0	
38142	chr6	166106118	166106345	227	114.0	
38143	chr6	166195375	166195930	555	278.0	
38144	chr6	166202237	166202669	432	216.0	
38145	chr6	166235132	166235613	481	240.0	
38146	chr6	166236660	166237122	462	231.0	
38147	chr6	166244042	166245119	1077	538.0	
38148	chr6	166253092	166254392	1300	650.0	
38149	chr6	166257873	166260065	2192	1096.0	
38150	chr6	166262821	166263097	276	138.0	
38151	chr6	166275565	166276324	759	380.0	
38152	chr6	166286692	166287408	716	358.0	
38153	chr6	166306970	166308751	1781	890.0	
38154	chr6	166313184	166313707	523	262.0	
38155	chr6	166325448	166325785	337	168.0	
38156	chr6	166333512	166334656	1144	572.0	
38157	chr6	166336994	166337011	17	8.0	
38158	chr6	166338563	166339421	858	429.0	
38159	chr6	166340171	166343606	3435	1718.0	
38160	chr6	166346998	166347384	386	193.0	
38161	chr6	166351915	166352445	530	265.0	
38162	chr6	166381348	166384373	3025	1512.0	
38163	chr6	166400574	166401271	697	348.0	
38164	chr6	166411363	166412272	909	454.0	
38165	chr6	166415292	166416119	827	414.0	
38166	chr6	166416829	166417966	1137	568.0	
38167	chr6	166418653	166420654	2001	1000.0	
38168	chr6	166435433	166436143	710	355.0	
38169	chr6	166487647	166488901	1254	627.0	
38170	chr6	166512497	166513016	519	260.0	
38171	chr6	166540814	166542317	1503	752.0	
38172	chr6	166556900	166557324	424	212.0	
38173	chr6	166584185	166584395	210	105.0	
38174	chr6	166586680	166589500	2820	1410.0	
38175	chr6	166598550	166598735	185	92.0	
38176	chr6	166599277	166599700	423	212.0	
38177	chr6	166603104	166603451	347	174.0	
38178	chr6	166624347	166624724	377	188.0	
38179	chr6	166626079	166628896	2817	1408.0	
38180	chr6	166640330	166640697	367	184.0	
38181	chr6	166656893	166657881	988	494.0	
38182	chr6	166662722	166663062	340	170.0	
38183	chr6	166750962	166751607	645	322.0	
38184	chr6	166760329	166760686	357	178.0	
38185	chr6	166775111	166775624	513	256.0	
38186	chr6	166786676	166787126	450	225.0	
38187	chr6	166830125	166830668	543	272.0	
38188	chr6	166862110	166863237	1127	564.0	
38189	chr6	166907422	166907833	411	206.0	
38190	chr6	166908882	166908890	8	4.0	
38191	chr6	166936444	166936765	321	160.0	
38192	chr6	166942759	166943215	456	228.0	
38193	chr6	166949279	166953417	4138	2069.0	
38194	chr6	166954775	166960314	5539	2770.0	
38195	chr6	166969345	166970091	746	373.0	
38196	chr6	166973732	166973853	121	60.0	
38197	chr6	166989433	166990157	724	362.0	
38198	chr6	166997466	167000159	2693	1346.0	
38199	chr6	167000909	167000960	51	26.0	
38200	chr6	167041188	167041796	608	304.0	
38201	chr6	167047045	167048167	1122	561.0	
38202	chr6	167056284	167056802	518	259.0	
38203	chr6	167079677	167080460	783	392.0	
38204	chr6	167089916	167095824	5908	2954.0	
38205	chr6	167098725	167099256	531	266.0	
38206	chr6	167103071	167103937	866	433.0	
38207	chr6	167111629	167112007	378	189.0	
38208	chr6	167112509	167115231	2722	1361.0	
38209	chr6	167118533	167123000	4467	2234.0	
38210	chr6	167125436	167125763	327	164.0	
38211	chr6	167129945	167130584	639	320.0	
38212	chr6	167140683	167140888	205	102.0	
38213	chr6	167142093	167142601	508	254.0	
38214	chr6	167151078	167151554	476	238.0	
38215	chr6	167152822	167154065	1243	622.0	
38216	chr6	167157787	167158249	462	231.0	
38217	chr6	167350083	167352150	2067	1034.0	
38218	chr6	167699065	167700078	1013	506.0	
38219	chr6	167706174	167706715	541	270.0	
38220	chr6	167825329	167828141	2812	1406.0	
38221	chr6	167833382	167833458	76	38.0	
38222	chr6	168370245	168370646	401	200.0	
38223	chr6	168877699	168878453	754	377.0	
38224	chr6	168883979	168885225	1246	623.0	
38225	chr6	168894944	168895700	756	378.0	
38226	chr6	168905566	168906386	820	410.0	
38227	chr6	168956824	168957285	461	230.0	
38228	chr6	168968115	168968634	519	260.0	
38229	chr6	169212786	169215551	2765	1382.0	
38230	chr6	169289885	169290420	535	268.0	
38231	chr6	169292183	169293028	845	422.0	
38232	chr6	169530516	169530915	399	200.0	
38233	chr6	169556772	169557214	442	221.0	
38234	chr6	169583807	169584529	722	361.0	
38235	chr6	169589195	169590358	1163	582.0	
38236	chr6	169654245	169655549	1304	652.0	
38237	chr6	169669899	169670252	353	176.0	
38238	chr6	169700211	169703311	3100	1550.0	
38239	chr6	169720240	169720658	418	209.0	
38240	chr6	169722500	169725696	3196	1598.0	
38241	chr6	169750899	169752637	1738	869.0	
38242	chr6	169789709	169791030	1321	660.0	
38243	chr6	169803420	169804045	625	312.0	
38244	chr6	169805246	169805968	722	361.0	
38245	chr6	169806516	169807809	1293	646.0	
38246	chr6	169831560	169832054	494	247.0	
38247	chr6	169868177	169868968	791	396.0	
38248	chr6	170036904	170037178	274	137.0	
38249	chr6	170046713	170047343	630	315.0	
38250	chr6	170048191	170050283	2092	1046.0	
38251	chr6	170085725	170090333	4608	2304.0	
38252	chr6	170144481	170144960	479	240.0	
38253	chr6	170145764	170145870	106	53.0	
38254	chr6	170146608	170148797	2189	1094.0	
38255	chr6	170151930	170152798	868	434.0	
38256	chr6	170162824	170162831	7	4.0	
38257	chr6	170177198	170177972	774	387.0	
38258	chr6	170184382	170184781	399	200.0	
38259	chr6	170225469	170225676	207	104.0	
38260	chr6	170266123	170266447	324	162.0	
38261	chr6	170271452	170272793	1341	670.0	
38262	chr6	170278367	170279065	698	349.0	
38263	chr6	170280210	170281028	818	409.0	
38264	chr6	170288797	170297644	8847	4424.0	
38265	chr6	170305820	170308152	2332	1166.0	
38266	chr6	170374930	170375394	464	232.0	
38267	chr6	170378402	170378936	534	267.0	
38268	chr6	170438263	170438903	640	320.0	enhancer
38269	chr6	170443925	170444633	708	354.0	
38270	chr6	170459396	170460499	1103	552.0	
38271	chr6	170462176	170462730	554	277.0	
38272	chr6	170464254	170465099	845	422.0	
38273	chr6	170476125	170476840	715	358.0	
38274	chr6	170516828	170517440	612	306.0	
38275	chr6	170529756	170530278	522	261.0	
38276	chr6	170552496	170555027	2531	1266.0	
38277	chr6	170583720	170585512	1792	896.0	
38278	chr7	31068	31469	401	200.0	
38279	chr7	61184	61513	329	164.0	
38280	chr7	63536	64396	860	430.0	
38281	chr7	89333	89731	398	199.0	
38282	chr7	90408	90770	362	181.0	
38283	chr7	112745	113371	626	313.0	
38284	chr7	115104	116044	940	470.0	
38285	chr7	118888	119938	1050	525.0	
38286	chr7	128168	128572	404	202.0	
38287	chr7	129474	130056	582	291.0	
38288	chr7	143916	144434	518	259.0	
38289	chr7	148751	151257	2506	1253.0	
38290	chr7	166335	167682	1347	674.0	
38291	chr7	191639	193981	2342	1171.0	
38292	chr7	209827	210333	506	253.0	
38293	chr7	213728	213947	219	110.0	
38294	chr7	263922	265279	1357	678.0	
38295	chr7	321820	322806	986	493.0	
38296	chr7	332522	333289	767	384.0	
38297	chr7	337267	337566	299	150.0	
38298	chr7	349058	349405	347	174.0	
38299	chr7	351117	352656	1539	770.0	
38300	chr7	359849	360734	885	442.0	
38301	chr7	362118	364185	2067	1034.0	
38302	chr7	366202	366603	401	200.0	
38303	chr7	379724	380382	658	329.0	
38304	chr7	381576	382173	597	298.0	
38305	chr7	467350	469546	2196	1098.0	
38306	chr7	472448	472682	234	117.0	
38307	chr7	517116	517505	389	194.0	
38308	chr7	518691	520784	2093	1046.0	
38309	chr7	521398	522971	1573	786.0	
38310	chr7	583091	584878	1787	894.0	
38311	chr7	585476	585511	35	18.0	
38312	chr7	593146	594284	1138	569.0	
38313	chr7	595501	596064	563	282.0	
38314	chr7	601178	605502	4324	2162.0	
38315	chr7	608077	608445	368	184.0	
38316	chr7	609316	609707	391	196.0	
38317	chr7	610385	611282	897	448.0	
38318	chr7	616088	616607	519	260.0	
38319	chr7	617609	619385	1776	888.0	
38320	chr7	636368	636856	488	244.0	
38321	chr7	651314	651626	312	156.0	
38322	chr7	712248	712736	488	244.0	
38323	chr7	726040	727920	1880	940.0	
38324	chr7	767847	768590	743	372.0	
38325	chr7	774228	774945	717	358.0	
38326	chr7	786357	787001	644	322.0	
38327	chr7	799763	800116	353	176.0	
38328	chr7	812414	813896	1482	741.0	
38329	chr7	815260	818684	3424	1712.0	
38330	chr7	831650	833015	1365	682.0	
38331	chr7	873074	873944	870	435.0	
38332	chr7	875619	878466	2847	1424.0	
38333	chr7	888251	888253	2	1.0	
38334	chr7	888830	889289	459	230.0	
38335	chr7	891207	891340	133	66.0	
38336	chr7	892444	892813	369	184.0	
38337	chr7	893592	893971	379	190.0	
38338	chr7	895419	895935	516	258.0	
38339	chr7	897840	897892	52	26.0	
38340	chr7	899094	899354	260	130.0	
38341	chr7	901094	902200	1106	553.0	
38342	chr7	906606	911181	4575	2288.0	
38343	chr7	913030	913368	338	169.0	
38344	chr7	914156	915156	1000	500.0	
38345	chr7	920749	926360	5611	2806.0	
38346	chr7	927076	927101	25	12.0	
38347	chr7	928319	932260	3941	1970.0	
38348	chr7	936417	937000	583	292.0	
38349	chr7	940818	941380	562	281.0	
38350	chr7	949333	950924	1591	796.0	
38351	chr7	952277	955983	3706	1853.0	
38352	chr7	957568	958628	1060	530.0	
38353	chr7	963122	966411	3289	1644.0	
38354	chr7	968814	969150	336	168.0	
38355	chr7	974033	976223	2190	1095.0	
38356	chr7	977211	977402	191	96.0	
38357	chr7	986192	986418	226	113.0	
38358	chr7	988523	988712	189	94.0	
38359	chr7	992717	993905	1188	594.0	
38360	chr7	1003955	1004452	497	248.0	
38361	chr7	1010975	1012099	1124	562.0	
38362	chr7	1022860	1024941	2081	1040.0	enhancer
38363	chr7	1026866	1030259	3393	1696.0	
38364	chr7	1033327	1034069	742	371.0	
38365	chr7	1041975	1042905	930	465.0	
38366	chr7	1043582	1045325	1743	872.0	
38367	chr7	1046528	1047205	677	338.0	
38368	chr7	1049136	1049232	96	48.0	
38369	chr7	1054884	1056657	1773	886.0	
38370	chr7	1058993	1061141	2148	1074.0	
38371	chr7	1062110	1062898	788	394.0	
38372	chr7	1065355	1066355	1000	500.0	
38373	chr7	1086444	1087499	1055	528.0	
38374	chr7	1090694	1091368	674	337.0	
38375	chr7	1103086	1103918	832	416.0	
38376	chr7	1136749	1139011	2262	1131.0	
38377	chr7	1140368	1140913	545	272.0	
38378	chr7	1144142	1144617	475	238.0	
38379	chr7	1151655	1152303	648	324.0	
38380	chr7	1156765	1157211	446	223.0	
38381	chr7	1159228	1161095	1867	934.0	
38382	chr7	1169540	1170511	971	486.0	
38383	chr7	1176003	1177512	1509	754.0	
38384	chr7	1182991	1183414	423	212.0	
38385	chr7	1192157	1192680	523	262.0	
38386	chr7	1193791	1194202	411	206.0	
38387	chr7	1225461	1225884	423	212.0	enhancer
38388	chr7	1247691	1248175	484	242.0	
38389	chr7	1290105	1290954	849	424.0	
38390	chr7	1369012	1369507	495	248.0	
38391	chr7	1412432	1413542	1110	555.0	
38392	chr7	1417158	1417969	811	406.0	
38393	chr7	1418588	1418925	337	168.0	
38394	chr7	1432060	1433097	1037	518.0	
38395	chr7	1446718	1447669	951	476.0	
38396	chr7	1458453	1463388	4935	2468.0	
38397	chr7	1466697	1467158	461	230.0	
38398	chr7	1468487	1468490	3	2.0	
38399	chr7	1473740	1475010	1270	635.0	
38400	chr7	1475836	1476417	581	290.0	
38401	chr7	1503767	1504942	1175	588.0	
38402	chr7	1505606	1507551	1945	972.0	
38403	chr7	1510753	1511572	819	410.0	
38404	chr7	1512537	1514158	1621	810.0	
38405	chr7	1521618	1521721	103	52.0	
38406	chr7	1526410	1526617	207	104.0	
38407	chr7	1529713	1534883	5170	2585.0	
38408	chr7	1535703	1536210	507	254.0	
38409	chr7	1536929	1537407	478	239.0	
38410	chr7	1537934	1539745	1811	906.0	
38411	chr7	1540887	1542113	1226	613.0	
38412	chr7	1543131	1549377	6246	3123.0	
38413	chr7	1550316	1550769	453	226.0	
38414	chr7	1554393	1554589	196	98.0	
38415	chr7	1555759	1556713	954	477.0	
38416	chr7	1558200	1558601	401	200.0	
38417	chr7	1568665	1571566	2901	1450.0	
38418	chr7	1579387	1580090	703	352.0	
38419	chr7	1591906	1592840	934	467.0	
38420	chr7	1593465	1593647	182	91.0	
38421	chr7	1663152	1663647	495	248.0	
38422	chr7	1664572	1668002	3430	1715.0	
38423	chr7	1741962	1743427	1465	732.0	
38424	chr7	1812362	1812747	385	192.0	
38425	chr7	1824502	1825012	510	255.0	
38426	chr7	1854528	1854857	329	164.0	
38427	chr7	1875363	1875630	267	134.0	
38428	chr7	1915959	1916761	802	401.0	
38429	chr7	1919444	1921081	1637	818.0	
38430	chr7	1921979	1922708	729	364.0	
38431	chr7	1925860	1927392	1532	766.0	
38432	chr7	1938660	1942127	3467	1734.0	
38433	chr7	1943440	1944607	1167	584.0	
38434	chr7	1951024	1951766	742	371.0	
38435	chr7	1961742	1962428	686	343.0	
38436	chr7	1979980	1980654	674	337.0	
38437	chr7	1986434	1987264	830	415.0	
38438	chr7	2018351	2020617	2266	1133.0	
38439	chr7	2023937	2024761	824	412.0	
38440	chr7	2031030	2031891	861	430.0	
38441	chr7	2037231	2038677	1446	723.0	
38442	chr7	2040752	2041652	900	450.0	
38443	chr7	2049604	2050792	1188	594.0	
38444	chr7	2063628	2064202	574	287.0	
38445	chr7	2066370	2066918	548	274.0	
38446	chr7	2072024	2072415	391	196.0	
38447	chr7	2076410	2077196	786	393.0	
38448	chr7	2079563	2080182	619	310.0	
38449	chr7	2084472	2085195	723	362.0	
38450	chr7	2087783	2088117	334	167.0	
38451	chr7	2096950	2097411	461	230.0	
38452	chr7	2099354	2100734	1380	690.0	
38453	chr7	2101899	2103032	1133	566.0	
38454	chr7	2103871	2104728	857	428.0	
38455	chr7	2110188	2110684	496	248.0	
38456	chr7	2112574	2112897	323	162.0	
38457	chr7	2115652	2116102	450	225.0	
38458	chr7	2119854	2120820	966	483.0	
38459	chr7	2138274	2138820	546	273.0	
38460	chr7	2160247	2160423	176	88.0	
38461	chr7	2165811	2166065	254	127.0	
38462	chr7	2203878	2204208	330	165.0	
38463	chr7	2209442	2209887	445	222.0	
38464	chr7	2231956	2233569	1613	806.0	
38465	chr7	2237036	2237870	834	417.0	
38466	chr7	2241623	2243550	1927	964.0	
38467	chr7	2244377	2245147	770	385.0	
38468	chr7	2246296	2247557	1261	630.0	
38469	chr7	2248970	2249697	727	364.0	
38470	chr7	2252377	2252784	407	204.0	
38471	chr7	2258949	2259547	598	299.0	
38472	chr7	2261487	2262347	860	430.0	
38473	chr7	2299038	2300370	1332	666.0	
38474	chr7	2307595	2308223	628	314.0	
38475	chr7	2312495	2312946	451	226.0	
38476	chr7	2313609	2315315	1706	853.0	
38477	chr7	2325205	2325607	402	201.0	
38478	chr7	2347736	2348463	727	364.0	
38479	chr7	2353506	2355915	2409	1204.0	
38480	chr7	2362598	2363034	436	218.0	
38481	chr7	2364844	2365191	347	174.0	
38482	chr7	2384668	2384720	52	26.0	
38483	chr7	2390402	2390906	504	252.0	
38484	chr7	2393217	2393761	544	272.0	
38485	chr7	2399689	2400557	868	434.0	
38486	chr7	2402701	2407474	4773	2386.0	
38487	chr7	2408565	2408842	277	138.0	
38488	chr7	2409477	2410870	1393	696.0	
38489	chr7	2412494	2412499	5	2.0	
38490	chr7	2413335	2413957	622	311.0	
38491	chr7	2417727	2418705	978	489.0	
38492	chr7	2431380	2431901	521	260.0	
38493	chr7	2451143	2452617	1474	737.0	
38494	chr7	2457897	2458524	627	314.0	
38495	chr7	2468832	2469794	962	481.0	
38496	chr7	2477178	2478561	1383	692.0	
38497	chr7	2507790	2512978	5188	2594.0	enhancer
38498	chr7	2515556	2515636	80	40.0	
38499	chr7	2516931	2516991	60	30.0	
38500	chr7	2517909	2532823	14914	7457.0	
38501	chr7	2535246	2535730	484	242.0	
38502	chr7	2537782	2546241	8459	4230.0	
38503	chr7	2547272	2547439	167	84.0	
38504	chr7	2554201	2556332	2131	1066.0	
38505	chr7	2558420	2560373	1953	976.0	
38506	chr7	2566955	2568289	1334	667.0	
38507	chr7	2602564	2602634	70	35.0	
38508	chr7	2607199	2607935	736	368.0	
38509	chr7	2608517	2609560	1043	522.0	
38510	chr7	2612459	2612736	277	138.0	
38511	chr7	2614172	2614704	532	266.0	
38512	chr7	2622120	2622498	378	189.0	
38513	chr7	2623213	2623780	567	284.0	
38514	chr7	2631059	2634664	3605	1802.0	
38515	chr7	2636205	2636242	37	18.0	
38516	chr7	2637098	2638395	1297	648.0	
38517	chr7	2640795	2642131	1336	668.0	
38518	chr7	2643459	2643686	227	114.0	
38519	chr7	2644266	2645922	1656	828.0	
38520	chr7	2647337	2648113	776	388.0	
38521	chr7	2658702	2658812	110	55.0	
38522	chr7	2661143	2661182	39	20.0	
38523	chr7	2663116	2663328	212	106.0	
38524	chr7	2664769	2665177	408	204.0	
38525	chr7	2666252	2666638	386	193.0	
38526	chr7	2670669	2671534	865	432.0	
38527	chr7	2680703	2681323	620	310.0	
38528	chr7	2688564	2690301	1737	868.0	
38529	chr7	2690991	2691854	863	432.0	
38530	chr7	2693635	2694407	772	386.0	
38531	chr7	2698578	2699682	1104	552.0	
38532	chr7	2709230	2711666	2436	1218.0	
38533	chr7	2713349	2713833	484	242.0	
38534	chr7	2715258	2716398	1140	570.0	
38535	chr7	2717291	2717963	672	336.0	
38536	chr7	2718721	2719413	692	346.0	
38537	chr7	2720778	2721321	543	272.0	
38538	chr7	2728340	2729181	841	420.0	
38539	chr7	2733089	2735630	2541	1270.0	
38540	chr7	2737801	2738678	877	438.0	
38541	chr7	2757426	2758800	1374	687.0	
38542	chr7	2760006	2761150	1144	572.0	
38543	chr7	2762730	2762955	225	112.0	
38544	chr7	2771535	2771560	25	12.0	
38545	chr7	2772613	2773741	1128	564.0	
38546	chr7	2774590	2775334	744	372.0	
38547	chr7	2792270	2793537	1267	634.0	
38548	chr7	2796728	2796879	151	76.0	
38549	chr7	2808706	2809224	518	259.0	
38550	chr7	2811685	2811862	177	88.0	
38551	chr7	2820566	2822432	1866	933.0	
38552	chr7	2838871	2839389	518	259.0	
38553	chr7	2843331	2845312	1981	990.0	
38554	chr7	2850022	2850873	851	426.0	
38555	chr7	2851406	2851875	469	234.0	
38556	chr7	2856964	2857134	170	85.0	
38557	chr7	2862913	2865629	2716	1358.0	
38558	chr7	2870029	2871215	1186	593.0	
38559	chr7	2878866	2879298	432	216.0	
38560	chr7	2886905	2887429	524	262.0	
38561	chr7	2893600	2895168	1568	784.0	
38562	chr7	2902504	2904209	1705	852.0	
38563	chr7	2905670	2905684	14	7.0	
38564	chr7	2906348	2906544	196	98.0	
38565	chr7	2908306	2908432	126	63.0	
38566	chr7	2941141	2941728	587	294.0	
38567	chr7	2944764	2945201	437	218.0	
38568	chr7	2950539	2951852	1313	656.0	
38569	chr7	2953922	2955186	1264	632.0	
38570	chr7	2956589	2957300	711	356.0	
38571	chr7	2962793	2963331	538	269.0	
38572	chr7	2978055	2981142	3087	1544.0	
38573	chr7	2982672	2983473	801	400.0	
38574	chr7	3010181	3010572	391	196.0	
38575	chr7	3028189	3028357	168	84.0	
38576	chr7	3037315	3037636	321	160.0	
38577	chr7	3041302	3044554	3252	1626.0	
38578	chr7	3062804	3063682	878	439.0	
38579	chr7	3065175	3066224	1049	524.0	
38580	chr7	3067171	3067866	695	348.0	
38581	chr7	3068556	3070446	1890	945.0	
38582	chr7	3089481	3089869	388	194.0	
38583	chr7	3091843	3093211	1368	684.0	
38584	chr7	3094033	3095748	1715	858.0	
38585	chr7	3103488	3104512	1024	512.0	
38586	chr7	3106324	3108031	1707	854.0	
38587	chr7	3112541	3113299	758	379.0	
38588	chr7	3116910	3118298	1388	694.0	
38589	chr7	3119445	3119884	439	220.0	
38590	chr7	3120391	3121147	756	378.0	
38591	chr7	3147102	3147158	56	28.0	
38592	chr7	3154826	3155330	504	252.0	
38593	chr7	3200517	3200824	307	154.0	
38594	chr7	3202018	3202525	507	254.0	
38595	chr7	3300237	3302817	2580	1290.0	
38596	chr7	3461796	3462408	612	306.0	
38597	chr7	3464882	3465314	432	216.0	
38598	chr7	3597038	3597709	671	336.0	
38599	chr7	3897381	3897820	439	220.0	
38600	chr7	4204630	4205344	714	357.0	
38601	chr7	4610746	4611355	609	304.0	
38602	chr7	4612947	4613675	728	364.0	
38603	chr7	4631846	4632000	154	77.0	
38604	chr7	4641208	4642912	1704	852.0	
38605	chr7	4681588	4685093	3505	1752.0	
38606	chr7	4705388	4705735	347	174.0	
38607	chr7	4706299	4707109	810	405.0	
38608	chr7	4712537	4713833	1296	648.0	
38609	chr7	4714955	4716094	1139	570.0	
38610	chr7	4724566	4726954	2388	1194.0	
38611	chr7	4733780	4734595	815	408.0	
38612	chr7	4738630	4740121	1491	746.0	
38613	chr7	4744272	4746857	2585	1292.0	
38614	chr7	4748377	4748699	322	161.0	
38615	chr7	4753412	4754512	1100	550.0	
38616	chr7	4774487	4776605	2118	1059.0	
38617	chr7	4789925	4789955	30	15.0	
38618	chr7	4791467	4793182	1715	858.0	
38619	chr7	4798023	4798879	856	428.0	
38620	chr7	4800592	4800594	2	1.0	
38621	chr7	4809051	4809742	691	346.0	
38622	chr7	4830065	4830518	453	226.0	
38623	chr7	4849723	4849727	4	2.0	
38624	chr7	4861526	4862200	674	337.0	
38625	chr7	4872568	4873024	456	228.0	
38626	chr7	4882943	4884328	1385	692.0	
38627	chr7	4973388	4975080	1692	846.0	
38628	chr7	5045250	5046807	1557	778.0	
38629	chr7	5071839	5072352	513	256.0	
38630	chr7	5085325	5085884	559	280.0	
38631	chr7	5129510	5129836	326	163.0	
38632	chr7	5131344	5132097	753	376.0	
38633	chr7	5142860	5145055	2195	1098.0	
38634	chr7	5174505	5174905	400	200.0	
38635	chr7	5189554	5191932	2378	1189.0	
38636	chr7	5218053	5219681	1628	814.0	
38637	chr7	5229622	5230977	1355	678.0	
38638	chr7	5231667	5232751	1084	542.0	
38639	chr7	5235090	5235565	475	238.0	
38640	chr7	5236989	5237956	967	484.0	
38641	chr7	5239954	5241476	1522	761.0	
38642	chr7	5267841	5268071	230	115.0	
38643	chr7	5282581	5283649	1068	534.0	
38644	chr7	5295950	5297586	1636	818.0	
38645	chr7	5303398	5303412	14	7.0	
38646	chr7	5327603	5328070	467	234.0	
38647	chr7	5331229	5331858	629	314.0	
38648	chr7	5354536	5355286	750	375.0	
38649	chr7	5363750	5363873	123	62.0	
38650	chr7	5365927	5366581	654	327.0	
38651	chr7	5375978	5376355	377	188.0	
38652	chr7	5396214	5398287	2073	1036.0	
38653	chr7	5412797	5413395	598	299.0	
38654	chr7	5418512	5430307	11795	5898.0	
38655	chr7	5441776	5442534	758	379.0	
38656	chr7	5450501	5451317	816	408.0	
38657	chr7	5455923	5456166	243	122.0	
38658	chr7	5457698	5458117	419	210.0	
38659	chr7	5477658	5478853	1195	598.0	
38660	chr7	5486409	5488871	2462	1231.0	
38661	chr7	5492017	5492655	638	319.0	
38662	chr7	5494533	5495921	1388	694.0	
38663	chr7	5497223	5497797	574	287.0	
38664	chr7	5502682	5503235	553	276.0	
38665	chr7	5506086	5506547	461	230.0	
38666	chr7	5512287	5514802	2515	1258.0	
38667	chr7	5517101	5533794	16693	8346.0	
38668	chr7	5538268	5539383	1115	558.0	
38669	chr7	5549289	5549690	401	200.0	
38670	chr7	5554479	5559688	5209	2604.0	
38671	chr7	5561785	5564193	2408	1204.0	
38672	chr7	5564851	5565105	254	127.0	
38673	chr7	5569085	5571094	2009	1004.0	
38674	chr7	5574289	5575053	764	382.0	
38675	chr7	5590058	5590349	291	146.0	
38676	chr7	5591260	5596762	5502	2751.0	
38677	chr7	5598554	5599511	957	478.0	
38678	chr7	5603319	5604308	989	494.0	
38679	chr7	5605791	5605964	173	86.0	
38680	chr7	5606835	5610085	3250	1625.0	
38681	chr7	5611215	5611512	297	148.0	
38682	chr7	5612562	5612875	313	156.0	
38683	chr7	5630004	5631195	1191	596.0	
38684	chr7	5641811	5642475	664	332.0	
38685	chr7	5643177	5643799	622	311.0	
38686	chr7	5656285	5656291	6	3.0	
38687	chr7	5661838	5662511	673	336.0	
38688	chr7	5665264	5665828	564	282.0	
38689	chr7	5667694	5668156	462	231.0	
38690	chr7	5670052	5671179	1127	564.0	
38691	chr7	5677694	5678660	966	483.0	
38692	chr7	5679799	5680798	999	500.0	
38693	chr7	5682136	5683624	1488	744.0	
38694	chr7	5687960	5691023	3063	1532.0	
38695	chr7	5692102	5696664	4562	2281.0	
38696	chr7	5697918	5698096	178	89.0	
38697	chr7	5699616	5701990	2374	1187.0	
38698	chr7	5704300	5705063	763	382.0	
38699	chr7	5724120	5724645	525	262.0	
38700	chr7	5758899	5759411	512	256.0	
38701	chr7	5773786	5774029	243	122.0	
38702	chr7	5776613	5777648	1035	518.0	
38703	chr7	5780587	5782328	1741	870.0	
38704	chr7	5797902	5797918	16	8.0	
38705	chr7	5820483	5821173	690	345.0	
38706	chr7	5822360	5824942	2582	1291.0	
38707	chr7	5827568	5828195	627	314.0	
38708	chr7	5833682	5834833	1151	576.0	
38709	chr7	5835841	5836581	740	370.0	
38710	chr7	5856388	5856924	536	268.0	
38711	chr7	5858343	5859097	754	377.0	
38712	chr7	5865563	5865869	306	153.0	
38713	chr7	5898236	5899588	1352	676.0	
38714	chr7	5983902	5984393	491	246.0	
38715	chr7	5997130	5997775	645	322.0	
38716	chr7	6008499	6010023	1524	762.0	
38717	chr7	6025961	6027461	1500	750.0	
38718	chr7	6032349	6032493	144	72.0	
38719	chr7	6058389	6059787	1398	699.0	
38720	chr7	6071423	6071607	184	92.0	
38721	chr7	6074995	6075379	384	192.0	
38722	chr7	6078561	6078917	356	178.0	
38723	chr7	6080424	6082045	1621	810.0	
38724	chr7	6103214	6107061	3847	1924.0	
38725	chr7	6139370	6139876	506	253.0	
38726	chr7	6175555	6176078	523	262.0	
38727	chr7	6218283	6219501	1218	609.0	
38728	chr7	6221116	6222275	1159	580.0	
38729	chr7	6228834	6229334	500	250.0	
38730	chr7	6232128	6233118	990	495.0	
38731	chr7	6234356	6234717	361	180.0	
38732	chr7	6240578	6242210	1632	816.0	
38733	chr7	6248626	6248795	169	84.0	
38734	chr7	6250333	6250609	276	138.0	
38735	chr7	6256681	6257242	561	280.0	
38736	chr7	6258858	6259104	246	123.0	
38737	chr7	6270769	6273347	2578	1289.0	
38738	chr7	6317907	6318292	385	192.0	
38739	chr7	6322907	6323421	514	257.0	
38740	chr7	6348211	6351067	2856	1428.0	
38741	chr7	6352316	6352612	296	148.0	
38742	chr7	6356186	6356668	482	241.0	
38743	chr7	6360873	6361327	454	227.0	
38744	chr7	6367771	6368261	490	245.0	
38745	chr7	6373037	6376431	3394	1697.0	
38746	chr7	6378263	6378695	432	216.0	
38747	chr7	6382406	6384459	2053	1026.0	
38748	chr7	6385260	6386205	945	472.0	
38749	chr7	6393164	6393961	797	398.0	
38750	chr7	6395850	6396764	914	457.0	
38751	chr7	6400748	6400913	165	82.0	
38752	chr7	6422046	6425502	3456	1728.0	
38753	chr7	6430266	6430567	301	150.0	
38754	chr7	6433599	6434529	930	465.0	
38755	chr7	6435185	6437716	2531	1266.0	
38756	chr7	6438620	6438714	94	47.0	
38757	chr7	6442092	6442530	438	219.0	
38758	chr7	6446747	6449621	2874	1437.0	
38759	chr7	6479041	6479461	420	210.0	
38760	chr7	6482912	6484851	1939	970.0	
38761	chr7	6503018	6505305	2287	1144.0	
38762	chr7	6516254	6517128	874	437.0	
38763	chr7	6526299	6527083	784	392.0	
38764	chr7	6530664	6531730	1066	533.0	
38765	chr7	6534114	6534410	296	148.0	
38766	chr7	6536396	6536840	444	222.0	
38767	chr7	6558857	6559259	402	201.0	
38768	chr7	6574494	6574882	388	194.0	
38769	chr7	6576398	6578737	2339	1170.0	
38770	chr7	6579419	6579895	476	238.0	
38771	chr7	6589334	6591138	1804	902.0	
38772	chr7	6602002	6602853	851	426.0	
38773	chr7	6614930	6616390	1460	730.0	
38774	chr7	6621284	6621539	255	128.0	
38775	chr7	6623752	6624412	660	330.0	
38776	chr7	6634753	6635747	994	497.0	
38777	chr7	6636377	6638818	2441	1220.0	
38778	chr7	6639655	6640720	1065	532.0	
38779	chr7	6663673	6664522	849	424.0	
38780	chr7	6705830	6707569	1739	870.0	
38781	chr7	6724927	6725644	717	358.0	
38782	chr7	6729089	6730697	1608	804.0	
38783	chr7	6826066	6826707	641	320.0	
38784	chr7	6854750	6855542	792	396.0	
38785	chr7	6857625	6858192	567	284.0	
38786	chr7	6990966	6991751	785	392.0	
38787	chr7	7051213	7051540	327	164.0	
38788	chr7	7099596	7099936	340	170.0	
38789	chr7	7103135	7103799	664	332.0	
38790	chr7	7122680	7123386	706	353.0	
38791	chr7	7125881	7126448	567	284.0	
38792	chr7	7136435	7136713	278	139.0	
38793	chr7	7156800	7158170	1370	685.0	
38794	chr7	7159185	7160110	925	462.0	
38795	chr7	7176328	7176890	562	281.0	
38796	chr7	7181082	7184113	3031	1516.0	
38797	chr7	7193089	7193595	506	253.0	
38798	chr7	7201348	7202203	855	428.0	
38799	chr7	7203840	7204391	551	276.0	
38800	chr7	7237236	7237605	369	184.0	
38801	chr7	7243009	7243297	288	144.0	
38802	chr7	7251338	7252272	934	467.0	
38803	chr7	7257846	7260560	2714	1357.0	
38804	chr7	7321877	7322008	131	66.0	
38805	chr7	7416143	7416768	625	312.0	
38806	chr7	7417831	7418217	386	193.0	
38807	chr7	7424373	7424983	610	305.0	
38808	chr7	7541359	7541826	467	234.0	
38809	chr7	7564346	7565081	735	368.0	
38810	chr7	7566145	7570671	4526	2263.0	
38811	chr7	7577743	7578349	606	303.0	
38812	chr7	7595495	7595804	309	154.0	
38813	chr7	7639377	7641761	2384	1192.0	
38814	chr7	7653628	7653920	292	146.0	
38815	chr7	7679888	7680332	444	222.0	
38816	chr7	7681383	7681929	546	273.0	
38817	chr7	7719318	7719634	316	158.0	
38818	chr7	7761133	7762907	1774	887.0	
38819	chr7	7764649	7765081	432	216.0	
38820	chr7	7782965	7783382	417	208.0	
38821	chr7	7815999	7816649	650	325.0	
38822	chr7	7818020	7818061	41	20.0	
38823	chr7	7857238	7857364	126	63.0	
38824	chr7	7867834	7868731	897	448.0	
38825	chr7	7920427	7920951	524	262.0	
38826	chr7	7934126	7934596	470	235.0	
38827	chr7	7942735	7942936	201	100.0	
38828	chr7	7944236	7945468	1232	616.0	
38829	chr7	7966658	7966970	312	156.0	
38830	chr7	7967564	7972559	4995	2498.0	
38831	chr7	7976659	7977203	544	272.0	
38832	chr7	7979831	7980204	373	186.0	
38833	chr7	7989491	7990311	820	410.0	
38834	chr7	8015012	8015581	569	284.0	
38835	chr7	8035239	8036370	1131	566.0	
38836	chr7	8105718	8106048	330	165.0	
38837	chr7	8115589	8115986	397	198.0	
38838	chr7	8125224	8126781	1557	778.0	
38839	chr7	8128648	8129713	1065	532.0	
38840	chr7	8131715	8132865	1150	575.0	
38841	chr7	8133996	8134820	824	412.0	
38842	chr7	8143540	8143909	369	184.0	
38843	chr7	8149092	8149727	635	318.0	
38844	chr7	8152368	8153178	810	405.0	
38845	chr7	8175110	8175271	161	80.0	
38846	chr7	8175808	8177643	1835	918.0	
38847	chr7	8185837	8186419	582	291.0	
38848	chr7	8190299	8190803	504	252.0	
38849	chr7	8198081	8198808	727	364.0	
38850	chr7	8217220	8217884	664	332.0	
38851	chr7	8261209	8262555	1346	673.0	
38852	chr7	8295980	8296508	528	264.0	
38853	chr7	8442801	8443177	376	188.0	
38854	chr7	10643595	10643925	330	165.0	
38855	chr7	10646188	10646745	557	278.0	
38856	chr7	10888760	10889698	938	469.0	
38857	chr7	10939268	10941544	2276	1138.0	
38858	chr7	10972750	10974968	2218	1109.0	
38859	chr7	11171023	11171214	191	96.0	
38860	chr7	11212053	11212512	459	230.0	
38861	chr7	11221965	11222351	386	193.0	
38862	chr7	11343846	11344171	325	162.0	
38863	chr7	11430201	11430540	339	170.0	
38864	chr7	11458760	11459147	387	194.0	
38865	chr7	11478451	11479245	794	397.0	
38866	chr7	11492346	11492707	361	180.0	
38867	chr7	11557642	11558011	369	184.0	
38868	chr7	12067404	12067958	554	277.0	
38869	chr7	12111496	12112110	614	307.0	
38870	chr7	12170221	12170890	669	334.0	
38871	chr7	12210280	12212335	2055	1028.0	
38872	chr7	12222816	12223382	566	283.0	
38873	chr7	12239829	12240222	393	196.0	
38874	chr7	12244196	12244293	97	48.0	
38875	chr7	12257173	12258414	1241	620.0	
38876	chr7	12322555	12322579	24	12.0	
38877	chr7	12389070	12389493	423	212.0	
38878	chr7	12403465	12404172	707	354.0	
38879	chr7	12458555	12458874	319	160.0	
38880	chr7	12539779	12539976	197	98.0	
38881	chr7	12570198	12571067	869	434.0	
38882	chr7	12573191	12573546	355	178.0	
38883	chr7	12583076	12583636	560	280.0	
38884	chr7	12584822	12585536	714	357.0	
38885	chr7	12623907	12624218	311	156.0	
38886	chr7	12635630	12636304	674	337.0	
38887	chr7	12638005	12639322	1317	658.0	
38888	chr7	12643531	12644147	616	308.0	
38889	chr7	12670655	12671432	777	388.0	
38890	chr7	12674785	12675517	732	366.0	
38891	chr7	12683612	12684097	485	242.0	
38892	chr7	12684805	12688244	3439	1720.0	
38893	chr7	12712266	12712588	322	161.0	
38894	chr7	12715451	12716082	631	316.0	
38895	chr7	12719481	12720444	963	482.0	
38896	chr7	12731317	12731603	286	143.0	
38897	chr7	13057496	13058092	596	298.0	
38898	chr7	13104135	13104581	446	223.0	
38899	chr7	13262920	13263319	399	200.0	
38900	chr7	13849748	13850841	1093	546.0	
38901	chr7	13908662	13909071	409	204.0	
38902	chr7	13910865	13911331	466	233.0	
38903	chr7	13989055	13991991	2936	1468.0	
38904	chr7	14009983	14010391	408	204.0	
38905	chr7	14446839	14447155	316	158.0	
38906	chr7	14457826	14458174	348	174.0	
38907	chr7	14690107	14690209	102	51.0	
38908	chr7	14691644	14691779	135	68.0	
38909	chr7	16055599	16055913	314	157.0	
38910	chr7	16071275	16071630	355	178.0	
38911	chr7	16223915	16224322	407	204.0	
38912	chr7	16346270	16346837	567	284.0	
38913	chr7	16404614	16405077	463	232.0	
38914	chr7	16420089	16422050	1961	980.0	
38915	chr7	16432101	16432583	482	241.0	
38916	chr7	16563065	16565332	2267	1134.0	
38917	chr7	16644181	16648916	4735	2368.0	
38918	chr7	16657919	16658153	234	117.0	
38919	chr7	16661004	16661319	315	158.0	
38920	chr7	16667889	16668572	683	342.0	
38921	chr7	16685081	16685339	258	129.0	
38922	chr7	16753280	16755181	1901	950.0	
38923	chr7	16758956	16759414	458	229.0	
38924	chr7	16813260	16813539	279	140.0	
38925	chr7	16816728	16817231	503	252.0	
38926	chr7	16850640	16852264	1624	812.0	
38927	chr7	16891591	16891688	97	48.0	
38928	chr7	16926236	16926712	476	238.0	
38929	chr7	16929095	16929680	585	292.0	
38930	chr7	16933765	16934404	639	320.0	
38931	chr7	16945029	16945057	28	14.0	
38932	chr7	16975676	16976122	446	223.0	
38933	chr7	16982526	16983034	508	254.0	
38934	chr7	16989868	16990151	283	142.0	
38935	chr7	16999792	17000257	465	232.0	
38936	chr7	17005321	17005457	136	68.0	
38937	chr7	17009004	17010102	1098	549.0	
38938	chr7	17010678	17011019	341	170.0	
38939	chr7	17027498	17028396	898	449.0	
38940	chr7	17029113	17029616	503	252.0	
38941	chr7	17030483	17030992	509	254.0	
38942	chr7	17041211	17041823	612	306.0	
38943	chr7	17042938	17043330	392	196.0	
38944	chr7	17044883	17045279	396	198.0	
38945	chr7	17058536	17058998	462	231.0	
38946	chr7	17120798	17121096	298	149.0	
38947	chr7	17122893	17123540	647	324.0	
38948	chr7	17139005	17139696	691	346.0	
38949	chr7	17142247	17143490	1243	622.0	
38950	chr7	17144290	17144829	539	270.0	
38951	chr7	17150044	17150467	423	212.0	
38952	chr7	17152602	17153899	1297	648.0	
38953	chr7	17185634	17186092	458	229.0	
38954	chr7	17227739	17228124	385	192.0	
38955	chr7	17233768	17235415	1647	824.0	
38956	chr7	17297117	17300419	3302	1651.0	
38957	chr7	17301479	17302138	659	330.0	
38958	chr7	17302674	17303168	494	247.0	
38959	chr7	17304886	17305478	592	296.0	
38960	chr7	17306522	17308251	1729	864.0	
38961	chr7	17316434	17316479	45	22.0	
38962	chr7	17339747	17339933	186	93.0	
38963	chr7	17369769	17370629	860	430.0	
38964	chr7	17401810	17402301	491	246.0	
38965	chr7	17406714	17407110	396	198.0	
38966	chr7	17408265	17408989	724	362.0	
38967	chr7	17533118	17533467	349	174.0	
38968	chr7	17633052	17633533	481	240.0	
38969	chr7	17640842	17640851	9	4.0	
38970	chr7	17679934	17681221	1287	644.0	
38971	chr7	17690025	17690516	491	246.0	
38972	chr7	17706775	17707075	300	150.0	
38973	chr7	17769766	17771267	1501	750.0	
38974	chr7	17772870	17773713	843	422.0	
38975	chr7	17861213	17861487	274	137.0	
38976	chr7	17934142	17935314	1172	586.0	
38977	chr7	17937882	17937894	12	6.0	
38978	chr7	17938883	17941576	2693	1346.0	
38979	chr7	17946581	17946999	418	209.0	
38980	chr7	17952417	17952798	381	190.0	
38981	chr7	17983437	17984080	643	322.0	
38982	chr7	18064236	18064659	423	212.0	
38983	chr7	18086265	18087141	876	438.0	
38984	chr7	18144127	18144633	506	253.0	
38985	chr7	18177717	18178756	1039	520.0	
38986	chr7	18189676	18189903	227	114.0	
38987	chr7	18215491	18215791	300	150.0	
38988	chr7	18221541	18222314	773	386.0	
38989	chr7	18225036	18225486	450	225.0	
38990	chr7	18288656	18288721	65	32.0	
38991	chr7	18289906	18291473	1567	784.0	
38992	chr7	18294374	18294833	459	230.0	
38993	chr7	18296009	18296407	398	199.0	
38994	chr7	18302189	18302351	162	81.0	
38995	chr7	18317102	18317880	778	389.0	
38996	chr7	18320923	18321383	460	230.0	
38997	chr7	18337444	18337446	2	1.0	
38998	chr7	18345619	18346069	450	225.0	
38999	chr7	18352323	18352717	394	197.0	
39000	chr7	18355967	18356608	641	320.0	
39001	chr7	18387373	18388631	1258	629.0	
39002	chr7	18390169	18390917	748	374.0	
39003	chr7	18401757	18402168	411	206.0	
39004	chr7	18495424	18496404	980	490.0	
39005	chr7	18508452	18509360	908	454.0	
39006	chr7	18520411	18520830	419	210.0	
39007	chr7	18522008	18522284	276	138.0	
39008	chr7	18530535	18530630	95	48.0	
39009	chr7	18552337	18553283	946	473.0	
39010	chr7	18566751	18567328	577	288.0	
39011	chr7	18590268	18590583	315	158.0	
39012	chr7	18638608	18639470	862	431.0	
39013	chr7	18647600	18648033	433	216.0	
39014	chr7	18655915	18656367	452	226.0	
39015	chr7	18666009	18666565	556	278.0	
39016	chr7	19707347	19707441	94	47.0	
39017	chr7	19708099	19709805	1706	853.0	
39018	chr7	19713605	19714319	714	357.0	
39019	chr7	19754737	19754813	76	38.0	
39020	chr7	20021739	20022210	471	236.0	
39021	chr7	20083819	20084174	355	178.0	
39022	chr7	20113302	20113860	558	279.0	
39023	chr7	20114381	20115005	624	312.0	
39024	chr7	20150796	20151303	507	254.0	
39025	chr7	20152023	20152382	359	180.0	
39026	chr7	20172731	20173070	339	170.0	
39027	chr7	20187799	20188242	443	222.0	
39028	chr7	20199214	20201830	2616	1308.0	
39029	chr7	20217160	20217906	746	373.0	
39030	chr7	20219315	20221438	2123	1062.0	
39031	chr7	20230231	20230295	64	32.0	
39032	chr7	20238619	20239302	683	342.0	
39033	chr7	20299908	20300274	366	183.0	
39034	chr7	20301535	20302003	468	234.0	
39035	chr7	20329510	20331943	2433	1216.0	
39036	chr7	20395030	20395585	555	278.0	
39037	chr7	20411998	20412384	386	193.0	
39038	chr7	20417188	20417737	549	274.0	
39039	chr7	20438499	20439122	623	312.0	
39040	chr7	20450480	20450929	449	224.0	
39041	chr7	20458578	20458899	321	160.0	
39042	chr7	20466339	20467119	780	390.0	
39043	chr7	20468425	20468911	486	243.0	
39044	chr7	20470611	20471208	597	298.0	
39045	chr7	20474390	20474531	141	70.0	
39046	chr7	20484485	20484759	274	137.0	
39047	chr7	20507945	20508692	747	374.0	
39048	chr7	20598470	20599149	679	340.0	
39049	chr7	20777910	20778381	471	236.0	
39050	chr7	20783606	20784284	678	339.0	
39051	chr7	20786766	20787319	553	276.0	
39052	chr7	20797586	20798727	1141	570.0	
39053	chr7	21254022	21254482	460	230.0	
39054	chr7	21256415	21256614	199	100.0	
39055	chr7	21261678	21262188	510	255.0	
39056	chr7	21338643	21339372	729	364.0	
39057	chr7	21352356	21354184	1828	914.0	
39058	chr7	21355064	21356202	1138	569.0	
39059	chr7	21358495	21359080	585	292.0	
39060	chr7	21383208	21384384	1176	588.0	
39061	chr7	21412436	21413188	752	376.0	
39062	chr7	21426320	21428905	2585	1292.0	
39063	chr7	21430031	21430666	635	318.0	
39064	chr7	21462131	21462439	308	154.0	
39065	chr7	21507578	21508048	470	235.0	
39066	chr7	21542787	21543587	800	400.0	
39067	chr7	21553953	21554441	488	244.0	
39068	chr7	21580061	21580618	557	278.0	
39069	chr7	21897965	21899166	1201	600.0	
39070	chr7	21939028	21939452	424	212.0	
39071	chr7	21941704	21942279	575	288.0	
39072	chr7	21944548	21946494	1946	973.0	
39073	chr7	21966111	21966699	588	294.0	
39074	chr7	21967693	21968018	325	162.0	
39075	chr7	22001322	22001793	471	236.0	
39076	chr7	22082556	22084023	1467	734.0	
39077	chr7	22103606	22104108	502	251.0	
39078	chr7	22109959	22110708	749	374.0	
39079	chr7	22147249	22147271	22	11.0	
39080	chr7	22174218	22174570	352	176.0	
39081	chr7	22357006	22357385	379	190.0	
39082	chr7	22402341	22402641	300	150.0	
39083	chr7	22445400	22445774	374	187.0	
39084	chr7	22447891	22447968	77	38.0	
39085	chr7	22452220	22452604	384	192.0	
39086	chr7	22481555	22482132	577	288.0	
39087	chr7	22488786	22489323	537	268.0	
39088	chr7	22499772	22500531	759	380.0	
39089	chr7	22523977	22524375	398	199.0	
39090	chr7	22550129	22550520	391	196.0	
39091	chr7	22551838	22552106	268	134.0	
39092	chr7	22559762	22560476	714	357.0	
39093	chr7	22563216	22563895	679	340.0	
39094	chr7	22564939	22565983	1044	522.0	
39095	chr7	22569733	22570396	663	332.0	
39096	chr7	22571716	22572221	505	252.0	
39097	chr7	22575091	22575681	590	295.0	
39098	chr7	22577524	22578460	936	468.0	
39099	chr7	22587249	22587826	577	288.0	
39100	chr7	22588341	22588585	244	122.0	
39101	chr7	22601070	22601336	266	133.0	
39102	chr7	22661868	22663734	1866	933.0	
39103	chr7	22675447	22676395	948	474.0	
39104	chr7	22677724	22678143	419	210.0	
39105	chr7	22694605	22695026	421	210.0	
39106	chr7	22698157	22698727	570	285.0	
39107	chr7	22700711	22701065	354	177.0	
39108	chr7	22709891	22710029	138	69.0	
39109	chr7	22713019	22713338	319	160.0	
39110	chr7	22722558	22724087	1529	764.0	
39111	chr7	22726294	22727614	1320	660.0	
39112	chr7	22728459	22728834	375	188.0	
39113	chr7	22765681	22765934	253	126.0	
39114	chr7	22782564	22783032	468	234.0	
39115	chr7	22821462	22823591	2129	1064.0	
39116	chr7	22827683	22827941	258	129.0	
39117	chr7	22831672	22832015	343	172.0	
39118	chr7	22853376	22855477	2101	1050.0	
39119	chr7	22860733	22861099	366	183.0	
39120	chr7	22871996	22872764	768	384.0	
39121	chr7	22885828	22886327	499	250.0	
39122	chr7	23010950	23011655	705	352.0	
39123	chr7	23012789	23014842	2053	1026.0	
39124	chr7	23017252	23017725	473	236.0	
39125	chr7	23019934	23021519	1585	792.0	
39126	chr7	23055541	23056073	532	266.0	
39127	chr7	23085941	23086426	485	242.0	
39128	chr7	23105055	23107215	2160	1080.0	
39129	chr7	23175933	23176475	542	271.0	
39130	chr7	23181183	23182992	1809	904.0	
39131	chr7	23183649	23184008	359	180.0	
39132	chr7	23184946	23185358	412	206.0	
39133	chr7	23205828	23206518	690	345.0	
39134	chr7	23207028	23208683	1655	828.0	
39135	chr7	23210487	23210912	425	212.0	
39136	chr7	23215934	23216504	570	285.0	
39137	chr7	23234784	23235002	218	109.0	
39138	chr7	23242235	23242706	471	236.0	
39139	chr7	23247466	23248556	1090	545.0	
39140	chr7	23261769	23262269	500	250.0	
39141	chr7	23272781	23273725	944	472.0	
39142	chr7	23277138	23277831	693	346.0	
39143	chr7	23289587	23290126	539	270.0	
39144	chr7	23295243	23295434	191	96.0	
39145	chr7	23298599	23300278	1679	840.0	
39146	chr7	23345977	23348075	2098	1049.0	
39147	chr7	23357691	23357741	50	25.0	
39148	chr7	23368049	23368692	643	322.0	
39149	chr7	23373118	23374017	899	450.0	
39150	chr7	23410305	23411047	742	371.0	
39151	chr7	23462894	23463148	254	127.0	
39152	chr7	23465446	23465785	339	170.0	
39153	chr7	23467606	23471748	4142	2071.0	
39154	chr7	23473619	23474992	1373	686.0	
39155	chr7	23490103	23491365	1262	631.0	
39156	chr7	23500039	23500041	2	1.0	
39157	chr7	23501334	23503384	2050	1025.0	
39158	chr7	23506067	23507434	1367	684.0	
39159	chr7	23508927	23508968	41	20.0	
39160	chr7	23509582	23510597	1015	508.0	
39161	chr7	23512159	23512697	538	269.0	
39162	chr7	23513575	23513936	361	180.0	
39163	chr7	23514488	23515240	752	376.0	
39164	chr7	23517548	23518578	1030	515.0	
39165	chr7	23520552	23520961	409	204.0	
39166	chr7	23523508	23526640	3132	1566.0	
39167	chr7	23528131	23528447	316	158.0	
39168	chr7	23529311	23532812	3501	1750.0	
39169	chr7	23539370	23540055	685	342.0	
39170	chr7	23544349	23545457	1108	554.0	
39171	chr7	23546661	23547613	952	476.0	
39172	chr7	23570520	23571221	701	350.0	
39173	chr7	23595047	23595600	553	276.0	
39174	chr7	23596856	23598696	1840	920.0	
39175	chr7	23679609	23681276	1667	834.0	
39176	chr7	23696866	23697442	576	288.0	
39177	chr7	23712380	23712816	436	218.0	
39178	chr7	23894528	23894737	209	104.0	
39179	chr7	24200000	24200397	397	198.0	
39180	chr7	24227512	24227999	487	244.0	
39181	chr7	24283883	24284402	519	260.0	
39182	chr7	24290164	24290669	505	252.0	
39183	chr7	24402017	24402346	329	164.0	
39184	chr7	24406260	24406466	206	103.0	
39185	chr7	24441672	24442660	988	494.0	
39186	chr7	24560904	24561031	127	64.0	
39187	chr7	24571437	24574816	3379	1690.0	
39188	chr7	24576146	24576642	496	248.0	
39189	chr7	24587629	24588324	695	348.0	
39190	chr7	24595555	24596368	813	406.0	
39191	chr7	24653632	24653702	70	35.0	
39192	chr7	24665657	24666058	401	200.0	
39193	chr7	24718832	24719559	727	364.0	
39194	chr7	24755947	24758050	2103	1052.0	
39195	chr7	24778824	24779606	782	391.0	
39196	chr7	24780900	24781575	675	338.0	
39197	chr7	24786206	24787504	1298	649.0	
39198	chr7	24812246	24812946	700	350.0	
39199	chr7	24820005	24822207	2202	1101.0	
39200	chr7	24826123	24827360	1237	618.0	
39201	chr7	24831146	24832926	1780	890.0	
39202	chr7	24833556	24834664	1108	554.0	
39203	chr7	24835949	24836545	596	298.0	
39204	chr7	24871805	24872150	345	172.0	
39205	chr7	24877895	24878388	493	246.0	
39206	chr7	24896008	24896486	478	239.0	
39207	chr7	24898716	24899117	401	200.0	
39208	chr7	24907322	24908353	1031	516.0	
39209	chr7	24910501	24911738	1237	618.0	
39210	chr7	24913226	24913467	241	120.0	
39211	chr7	24924584	24924585	1	0.0	
39212	chr7	24939376	24939813	437	218.0	
39213	chr7	24948852	24948935	83	42.0	
39214	chr7	24963003	24963830	827	414.0	
39215	chr7	24965677	24967175	1498	749.0	
39216	chr7	24971379	24971984	605	302.0	
39217	chr7	24977059	24977167	108	54.0	
39218	chr7	24978736	24982467	3731	1866.0	
39219	chr7	25028348	25029384	1036	518.0	
39220	chr7	25069779	25070462	683	342.0	
39221	chr7	25087764	25088302	538	269.0	
39222	chr7	25093142	25094834	1692	846.0	
39223	chr7	25098330	25098852	522	261.0	
39224	chr7	25103410	25103413	3	2.0	
39225	chr7	25109490	25109573	83	42.0	
39226	chr7	25110596	25122935	12339	6170.0	
39227	chr7	25123774	25126243	2469	1234.0	
39228	chr7	25159955	25160404	449	224.0	
39229	chr7	25179535	25181143	1608	804.0	
39230	chr7	25259541	25260122	581	290.0	
39231	chr7	25261004	25261492	488	244.0	
39232	chr7	25389516	25389904	388	194.0	
39233	chr7	25496309	25497105	796	398.0	enhancer
39234	chr7	25565826	25566314	488	244.0	
39235	chr7	25568894	25569182	288	144.0	
39236	chr7	25620129	25620691	562	281.0	
39237	chr7	25625595	25625635	40	20.0	
39238	chr7	25851579	25852847	1268	634.0	
39239	chr7	25854545	25855263	718	359.0	
39240	chr7	25856549	25857597	1048	524.0	
39241	chr7	25860552	25860916	364	182.0	
39242	chr7	25862012	25863022	1010	505.0	
39243	chr7	25892757	25893600	843	422.0	
39244	chr7	25894130	25895979	1849	924.0	
39245	chr7	25949719	25952153	2434	1217.0	
39246	chr7	25967404	25969050	1646	823.0	
39247	chr7	25994850	25994956	106	53.0	
39248	chr7	26051045	26051270	225	112.0	
39249	chr7	26061555	26062424	869	434.0	
39250	chr7	26078818	26079435	617	308.0	
39251	chr7	26089393	26089958	565	282.0	
39252	chr7	26090587	26091389	802	401.0	
39253	chr7	26097045	26097992	947	474.0	
39254	chr7	26100257	26102080	1823	912.0	
39255	chr7	26103481	26104029	548	274.0	
39256	chr7	26105177	26105552	375	188.0	
39257	chr7	26117477	26117494	17	8.0	
39258	chr7	26139478	26139966	488	244.0	
39259	chr7	26141023	26141517	494	247.0	
39260	chr7	26151159	26157295	6136	3068.0	
39261	chr7	26166258	26167890	1632	816.0	
39262	chr7	26169062	26169674	612	306.0	
39263	chr7	26171110	26171489	379	190.0	
39264	chr7	26173993	26174703	710	355.0	
39265	chr7	26177187	26203103	25916	12958.0	
39266	chr7	26204165	26205048	883	442.0	
39267	chr7	26216159	26216424	265	132.0	
39268	chr7	26277921	26280123	2202	1101.0	
39269	chr7	26285053	26285421	368	184.0	
39270	chr7	26288081	26288557	476	238.0	
39271	chr7	26291338	26294776	3438	1719.0	
39272	chr7	26298635	26298794	159	80.0	
39273	chr7	26304861	26306188	1327	664.0	
39274	chr7	26306816	26307708	892	446.0	
39275	chr7	26314119	26315071	952	476.0	
39276	chr7	26319642	26319985	343	172.0	
39277	chr7	26329526	26330479	953	476.0	
39278	chr7	26335270	26336495	1225	612.0	
39279	chr7	26337476	26337502	26	13.0	
39280	chr7	26360522	26361072	550	275.0	
39281	chr7	26364976	26365550	574	287.0	
39282	chr7	26369470	26370327	857	428.0	
39283	chr7	26375846	26377642	1796	898.0	
39284	chr7	26381489	26381865	376	188.0	
39285	chr7	26388211	26388701	490	245.0	
39286	chr7	26397853	26399646	1793	896.0	
39287	chr7	26500754	26501101	347	174.0	
39288	chr7	26664720	26665481	761	380.0	
39289	chr7	26667446	26667971	525	262.0	
39290	chr7	26681780	26682201	421	210.0	
39291	chr7	26686293	26686778	485	242.0	
39292	chr7	26688939	26689288	349	174.0	enhancer
39293	chr7	26709245	26709553	308	154.0	
39294	chr7	26729321	26730244	923	462.0	
39295	chr7	26853779	26854130	351	176.0	
39296	chr7	26856575	26856578	3	2.0	
39297	chr7	26857387	26859015	1628	814.0	
39298	chr7	26863156	26865423	2267	1134.0	
39299	chr7	26910197	26910675	478	239.0	
39300	chr7	26912297	26912789	492	246.0	
39301	chr7	27031314	27032291	977	488.0	
39302	chr7	27047173	27047180	7	4.0	
39303	chr7	27079431	27080045	614	307.0	
39304	chr7	27087976	27088452	476	238.0	
39305	chr7	27095011	27097645	2634	1317.0	
39306	chr7	27098600	27098641	41	20.0	
39307	chr7	27101919	27103152	1233	616.0	
39308	chr7	27129899	27131588	1689	844.0	
39309	chr7	27134536	27134641	105	52.0	
39310	chr7	27143319	27144125	806	403.0	
39311	chr7	27147135	27148958	1823	912.0	
39312	chr7	27150218	27152945	2727	1364.0	
39313	chr7	27154936	27159283	4347	2174.0	
39314	chr7	27159968	27162179	2211	1106.0	
39315	chr7	27163993	27167406	3413	1706.0	recombination_feature
39316	chr7	27168327	27170306	1979	990.0	recombination_feature
39317	chr7	27171445	27174810	3365	1682.0	
39318	chr7	27179640	27180350	710	355.0	
39319	chr7	27183081	27186430	3349	1674.0	recombination_feature
39320	chr7	27187724	27190047	2323	1162.0	
39321	chr7	27191757	27193646	1889	944.0	
39322	chr7	27196129	27196673	544	272.0	
39323	chr7	27198384	27202551	4167	2084.0	recombination_feature
39324	chr7	27203630	27203670	40	20.0	
39325	chr7	27204702	27205633	931	466.0	
39326	chr7	27210249	27210952	703	352.0	
39327	chr7	27213146	27213761	615	308.0	
39328	chr7	27220382	27220609	227	114.0	
39329	chr7	27235331	27235915	584	292.0	
39330	chr7	27239543	27239657	114	57.0	
39331	chr7	27242662	27242670	8	4.0	
39332	chr7	27249124	27249380	256	128.0	enhancer
39333	chr7	27324296	27324608	312	156.0	
39334	chr7	27339345	27340178	833	416.0	
39335	chr7	27359205	27360173	968	484.0	
39336	chr7	27372610	27373066	456	228.0	
39337	chr7	27576393	27576681	288	144.0	
39338	chr7	27661846	27664037	2191	1096.0	
39339	chr7	27693872	27694093	221	110.0	
39340	chr7	27697690	27698626	936	468.0	
39341	chr7	27713162	27713689	527	264.0	
39342	chr7	27739266	27741555	2289	1144.0	
39343	chr7	27745057	27745448	391	196.0	
39344	chr7	27784337	27784876	539	270.0	
39345	chr7	27834613	27834718	105	52.0	
39346	chr7	27840238	27840710	472	236.0	
39347	chr7	27860781	27861184	403	202.0	
39348	chr7	27895493	27895990	497	248.0	
39349	chr7	27898842	27900079	1237	618.0	
39350	chr7	27900865	27901843	978	489.0	
39351	chr7	27921108	27921622	514	257.0	
39352	chr7	27966318	27966756	438	219.0	
39353	chr7	27972154	27972760	606	303.0	
39354	chr7	28020262	28020932	670	335.0	
39355	chr7	28037307	28037606	299	150.0	
39356	chr7	28054673	28054949	276	138.0	
39357	chr7	28062096	28063098	1002	501.0	
39358	chr7	28078054	28078737	683	342.0	enhancer
39359	chr7	28081023	28081339	316	158.0	
39360	chr7	28082276	28082501	225	112.0	
39361	chr7	28083356	28084293	937	468.0	
39362	chr7	28086196	28086607	411	206.0	
39363	chr7	28087995	28088607	612	306.0	
39364	chr7	28089121	28089367	246	123.0	
39365	chr7	28093589	28094027	438	219.0	
39366	chr7	28095293	28095546	253	126.0	
39367	chr7	28096575	28097094	519	260.0	
39368	chr7	28112792	28113368	576	288.0	
39369	chr7	28120089	28120692	603	302.0	
39370	chr7	28126401	28126856	455	228.0	
39371	chr7	28142568	28143044	476	238.0	
39372	chr7	28150032	28150091	59	30.0	
39373	chr7	28151787	28152708	921	460.0	
39374	chr7	28154870	28156211	1341	670.0	
39375	chr7	28157824	28158450	626	313.0	
39376	chr7	28165229	28165685	456	228.0	
39377	chr7	28168374	28168823	449	224.0	
39378	chr7	28176208	28176526	318	159.0	
39379	chr7	28178804	28181419	2615	1308.0	
39380	chr7	28182526	28182597	71	36.0	
39381	chr7	28189979	28190374	395	198.0	
39382	chr7	28191758	28192133	375	188.0	
39383	chr7	28193130	28193703	573	286.0	
39384	chr7	28195903	28196607	704	352.0	
39385	chr7	28200538	28201032	494	247.0	
39386	chr7	28203721	28204324	603	302.0	
39387	chr7	28207484	28208131	647	324.0	
39388	chr7	28237208	28237696	488	244.0	
39389	chr7	28239394	28240928	1534	767.0	
39390	chr7	28245620	28245868	248	124.0	
39391	chr7	28259091	28259147	56	28.0	
39392	chr7	28269911	28270434	523	262.0	
39393	chr7	28272321	28272866	545	272.0	
39394	chr7	28297124	28297255	131	66.0	
39395	chr7	28297835	28298453	618	309.0	
39396	chr7	28329909	28330789	880	440.0	
39397	chr7	28389458	28389810	352	176.0	
39398	chr7	28405730	28405973	243	122.0	
39399	chr7	28407654	28408012	358	179.0	
39400	chr7	28408567	28410028	1461	730.0	
39401	chr7	28410748	28411683	935	468.0	
39402	chr7	28423915	28424270	355	178.0	
39403	chr7	28509356	28509443	87	44.0	
39404	chr7	28628159	28628255	96	48.0	
39405	chr7	28669288	28669851	563	282.0	
39406	chr7	28684491	28686866	2375	1188.0	
39407	chr7	28687622	28688019	397	198.0	
39408	chr7	28749237	28749537	300	150.0	
39409	chr7	28782399	28782763	364	182.0	
39410	chr7	28800000	28800670	670	335.0	
39411	chr7	28809079	28809554	475	238.0	
39412	chr7	28815883	28816211	328	164.0	
39413	chr7	28853715	28854634	919	460.0	
39414	chr7	28879294	28879390	96	48.0	
39415	chr7	28921708	28923390	1682	841.0	
39416	chr7	28926652	28927472	820	410.0	
39417	chr7	28955594	28957809	2215	1108.0	
39418	chr7	28958494	28958725	231	116.0	
39419	chr7	28984766	28984904	138	69.0	
39420	chr7	28986672	28987378	706	353.0	
39421	chr7	29035357	29035763	406	203.0	
39422	chr7	29038409	29038695	286	143.0	
39423	chr7	29084766	29085274	508	254.0	
39424	chr7	29088280	29088577	297	148.0	
39425	chr7	29091203	29092121	918	459.0	
39426	chr7	29102505	29103214	709	354.0	
39427	chr7	29106319	29106844	525	262.0	
39428	chr7	29109864	29110526	662	331.0	
39429	chr7	29113552	29114608	1056	528.0	
39430	chr7	29130069	29130491	422	211.0	
39431	chr7	29135776	29136295	519	260.0	
39432	chr7	29139738	29140223	485	242.0	
39433	chr7	29140857	29141268	411	206.0	
39434	chr7	29142209	29143142	933	466.0	
39435	chr7	29145925	29147657	1732	866.0	
39436	chr7	29149030	29149423	393	196.0	
39437	chr7	29156804	29157328	524	262.0	
39438	chr7	29177978	29178708	730	365.0	
39439	chr7	29189660	29190167	507	254.0	
39440	chr7	29193989	29197549	3560	1780.0	
39441	chr7	29202377	29203249	872	436.0	
39442	chr7	29207415	29207774	359	180.0	
39443	chr7	29239664	29240015	351	176.0	
39444	chr7	29243873	29244821	948	474.0	
39445	chr7	29256118	29256275	157	78.0	
39446	chr7	29270942	29271369	427	214.0	
39447	chr7	29282817	29283231	414	207.0	
39448	chr7	29285198	29285860	662	331.0	
39449	chr7	29288943	29289506	563	282.0	
39450	chr7	29319706	29320467	761	380.0	
39451	chr7	29337191	29338248	1057	528.0	
39452	chr7	29343202	29343770	568	284.0	
39453	chr7	29345622	29345951	329	164.0	
39454	chr7	29351995	29352397	402	201.0	
39455	chr7	29408688	29409190	502	251.0	
39456	chr7	29557991	29558398	407	204.0	
39457	chr7	29564655	29565162	507	254.0	
39458	chr7	29589051	29589560	509	254.0	
39459	chr7	29684432	29685974	1542	771.0	
39460	chr7	29859250	29860207	957	478.0	
39461	chr7	29865923	29866982	1059	530.0	
39462	chr7	29878289	29878469	180	90.0	
39463	chr7	29921404	29921865	461	230.0	
39464	chr7	29946809	29947230	421	210.0	
39465	chr7	29953723	29954100	377	188.0	
39466	chr7	29956014	29956575	561	280.0	
39467	chr7	29976970	29977345	375	188.0	
39468	chr7	29985328	29986253	925	462.0	
39469	chr7	29987815	29990372	2557	1278.0	
39470	chr7	30026122	30030109	3987	1994.0	
39471	chr7	30061820	30062945	1125	562.0	
39472	chr7	30133960	30136703	2743	1372.0	
39473	chr7	30148777	30149666	889	444.0	
39474	chr7	30157105	30157660	555	278.0	
39475	chr7	30159130	30160542	1412	706.0	
39476	chr7	30162241	30165085	2844	1422.0	
39477	chr7	30169256	30169295	39	20.0	
39478	chr7	30170738	30171265	527	264.0	
39479	chr7	30176576	30177248	672	336.0	
39480	chr7	30178784	30179502	718	359.0	
39481	chr7	30184770	30185633	863	432.0	
39482	chr7	30188409	30188444	35	18.0	
39483	chr7	30201379	30201600	221	110.0	
39484	chr7	30223926	30225139	1213	606.0	
39485	chr7	30225731	30226687	956	478.0	
39486	chr7	30237059	30237893	834	417.0	
39487	chr7	30238917	30239522	605	302.0	
39488	chr7	30249205	30249811	606	303.0	
39489	chr7	30252849	30253283	434	217.0	
39490	chr7	30270933	30271322	389	194.0	
39491	chr7	30276047	30276560	513	256.0	
39492	chr7	30278352	30278424	72	36.0	
39493	chr7	30279547	30279549	2	1.0	
39494	chr7	30283639	30286603	2964	1482.0	
39495	chr7	30290542	30290579	37	18.0	
39496	chr7	30296431	30296755	324	162.0	
39497	chr7	30307022	30307220	198	99.0	
39498	chr7	30319375	30319388	13	6.0	
39499	chr7	30321493	30323451	1958	979.0	
39500	chr7	30329619	30331241	1622	811.0	
39501	chr7	30347504	30348883	1379	690.0	
39502	chr7	30351469	30351603	134	67.0	
39503	chr7	30352276	30352591	315	158.0	
39504	chr7	30389820	30390194	374	187.0	
39505	chr7	30411266	30411370	104	52.0	
39506	chr7	30412990	30413474	484	242.0	
39507	chr7	30426771	30426989	218	109.0	
39508	chr7	30427652	30427872	220	110.0	
39509	chr7	30428601	30429536	935	468.0	
39510	chr7	30430404	30431186	782	391.0	
39511	chr7	30432969	30433417	448	224.0	
39512	chr7	30434206	30434889	683	342.0	
39513	chr7	30437541	30438055	514	257.0	
39514	chr7	30445528	30446632	1104	552.0	
39515	chr7	30462210	30462484	274	137.0	
39516	chr7	30463454	30463705	251	126.0	
39517	chr7	30464366	30464788	422	211.0	
39518	chr7	30468064	30468465	401	200.0	
39519	chr7	30471363	30471407	44	22.0	
39520	chr7	30477817	30480135	2318	1159.0	
39521	chr7	30502851	30505685	2834	1417.0	
39522	chr7	30510087	30510537	450	225.0	
39523	chr7	30520323	30521168	845	422.0	
39524	chr7	30548733	30549171	438	219.0	
39525	chr7	30550977	30551430	453	226.0	
39526	chr7	30564054	30564886	832	416.0	
39527	chr7	30585636	30585941	305	152.0	
39528	chr7	30593610	30596520	2910	1455.0	
39529	chr7	30681925	30682967	1042	521.0	
39530	chr7	30702199	30702600	401	200.0	
39531	chr7	30726448	30728046	1598	799.0	
39532	chr7	30738016	30738860	844	422.0	
39533	chr7	30740228	30741190	962	481.0	
39534	chr7	30770878	30772488	1610	805.0	
39535	chr7	30800915	30801086	171	86.0	
39536	chr7	30938750	30939077	327	164.0	
39537	chr7	30974731	30975169	438	219.0	
39538	chr7	30983540	30984014	474	237.0	
39539	chr7	31000247	31000250	3	2.0	
39540	chr7	31023893	31024277	384	192.0	
39541	chr7	31122574	31122985	411	206.0	
39542	chr7	31134483	31134848	365	182.0	
39543	chr7	31443383	31443754	371	186.0	
39544	chr7	31478781	31479073	292	146.0	
39545	chr7	31488661	31488923	262	131.0	
39546	chr7	31640229	31640997	768	384.0	
39547	chr7	31647406	31647988	582	291.0	
39548	chr7	31648841	31649467	626	313.0	
39549	chr7	31664795	31665358	563	282.0	
39550	chr7	31668814	31669230	416	208.0	
39551	chr7	31688198	31689374	1176	588.0	
39552	chr7	31695938	31696623	685	342.0	
39553	chr7	31736359	31736770	411	206.0	
39554	chr7	31744274	31744662	388	194.0	
39555	chr7	31782398	31782841	443	222.0	
39556	chr7	31805390	31805801	411	206.0	
39557	chr7	31811489	31812651	1162	581.0	
39558	chr7	31833819	31833849	30	15.0	
39559	chr7	31857156	31857640	484	242.0	
39560	chr7	31875414	31875787	373	186.0	
39561	chr7	31883618	31884343	725	362.0	
39562	chr7	31888151	31888329	178	89.0	
39563	chr7	31889991	31891206	1215	608.0	
39564	chr7	32427706	32428064	358	179.0	
39565	chr7	32479645	32479955	310	155.0	
39566	chr7	32489759	32491412	1653	826.0	
39567	chr7	32494686	32496646	1960	980.0	
39568	chr7	32500753	32501462	709	354.0	
39569	chr7	32506534	32506623	89	44.0	
39570	chr7	32516145	32516170	25	12.0	
39571	chr7	32638738	32639261	523	262.0	
39572	chr7	32691860	32692801	941	470.0	
39573	chr7	32727944	32729240	1296	648.0	
39574	chr7	32800449	32800901	452	226.0	
39575	chr7	32846361	32847166	805	402.0	
39576	chr7	32865108	32865906	798	399.0	
39577	chr7	32868386	32868503	117	58.0	
39578	chr7	32872821	32872931	110	55.0	
39579	chr7	32875154	32875305	151	76.0	
39580	chr7	32878042	32878094	52	26.0	
39581	chr7	32879562	32879928	366	183.0	
39582	chr7	32881580	32881943	363	182.0	
39583	chr7	32885766	32886103	337	168.0	
39584	chr7	32887151	32887236	85	42.0	
39585	chr7	32888621	32893643	5022	2511.0	
39586	chr7	32904958	32906329	1371	686.0	
39587	chr7	32942027	32943664	1637	818.0	
39588	chr7	32957056	32958053	997	498.0	
39589	chr7	32964641	32964976	335	168.0	
39590	chr7	33039280	33041589	2309	1154.0	
39591	chr7	33050085	33051168	1083	542.0	
39592	chr7	33054039	33054722	683	342.0	
39593	chr7	33061619	33063682	2063	1032.0	
39594	chr7	33099581	33099889	308	154.0	
39595	chr7	33107259	33110284	3025	1512.0	
39596	chr7	33128670	33130591	1921	960.0	
39597	chr7	33185744	33186047	303	152.0	
39598	chr7	33191308	33191715	407	204.0	
39599	chr7	33195278	33195605	327	164.0	
39600	chr7	33459502	33459589	87	44.0	
39601	chr7	33639931	33640135	204	102.0	
39602	chr7	33707363	33707972	609	304.0	
39603	chr7	33738451	33738943	492	246.0	
39604	chr7	33895248	33895696	448	224.0	
39605	chr7	33904215	33904305	90	45.0	
39606	chr7	33904859	33905164	305	152.0	
39607	chr7	33932855	33933249	394	197.0	
39608	chr7	34718858	34718968	110	55.0	
39609	chr7	34928141	34928296	155	78.0	
39610	chr7	34991831	34992847	1016	508.0	
39611	chr7	35035532	35038517	2985	1492.0	
39612	chr7	35073461	35073755	294	147.0	
39613	chr7	35253762	35254460	698	349.0	
39614	chr7	35379511	35379898	387	194.0	
39615	chr7	35380518	35381306	788	394.0	
39616	chr7	35384797	35384991	194	97.0	
39617	chr7	35424802	35425314	512	256.0	
39618	chr7	35520148	35520636	488	244.0	
39619	chr7	35530736	35530995	259	130.0	
39620	chr7	35533875	35534318	443	222.0	
39621	chr7	35536972	35538036	1064	532.0	
39622	chr7	35557097	35557566	469	234.0	
39623	chr7	35571553	35572234	681	340.0	
39624	chr7	35576001	35576451	450	225.0	
39625	chr7	35624342	35625174	832	416.0	
39626	chr7	35646459	35646476	17	8.0	
39627	chr7	35647137	35647454	317	158.0	
39628	chr7	35650627	35650898	271	136.0	
39629	chr7	35652140	35652555	415	208.0	
39630	chr7	35657962	35658492	530	265.0	
39631	chr7	35676221	35676617	396	198.0	
39632	chr7	35680456	35682118	1662	831.0	
39633	chr7	35687210	35687698	488	244.0	
39634	chr7	35688444	35688664	220	110.0	
39635	chr7	35690357	35696464	6107	3054.0	
39636	chr7	35697489	35697584	95	48.0	
39637	chr7	35709353	35709963	610	305.0	
39638	chr7	35722606	35723476	870	435.0	
39639	chr7	35724896	35725852	956	478.0	
39640	chr7	35727582	35728049	467	234.0	
39641	chr7	35728911	35731001	2090	1045.0	
39642	chr7	35799923	35803102	3179	1590.0	
39643	chr7	35805718	35807595	1877	938.0	
39644	chr7	35906211	35907019	808	404.0	
39645	chr7	35916903	35917414	511	256.0	
39646	chr7	35919839	35919939	100	50.0	
39647	chr7	35971349	35971786	437	218.0	
39648	chr7	35975805	35976326	521	260.0	
39649	chr7	35985103	35985610	507	254.0	
39650	chr7	36057610	36057620	10	5.0	
39651	chr7	36115491	36116035	544	272.0	
39652	chr7	36118928	36120335	1407	704.0	
39653	chr7	36152229	36154268	2039	1020.0	
39654	chr7	36164941	36165682	741	370.0	
39655	chr7	36175723	36176513	790	395.0	
39656	chr7	36190637	36192614	1977	988.0	
39657	chr7	36207557	36209602	2045	1022.0	
39658	chr7	36261271	36261725	454	227.0	
39659	chr7	36263954	36264703	749	374.0	
39660	chr7	36265468	36266208	740	370.0	
39661	chr7	36272890	36273272	382	191.0	
39662	chr7	36280760	36281272	512	256.0	
39663	chr7	36283117	36285041	1924	962.0	
39664	chr7	36285668	36288432	2764	1382.0	
39665	chr7	36291319	36292328	1009	504.0	
39666	chr7	36312478	36312955	477	238.0	
39667	chr7	36318991	36319439	448	224.0	
39668	chr7	36366521	36367907	1386	693.0	
39669	chr7	36378859	36378935	76	38.0	
39670	chr7	36387718	36387722	4	2.0	
39671	chr7	36388504	36391087	2583	1292.0	
39672	chr7	36391699	36392172	473	236.0	
39673	chr7	36487704	36488166	462	231.0	
39674	chr7	36504809	36505082	273	136.0	
39675	chr7	36505798	36506197	399	200.0	
39676	chr7	36506717	36507720	1003	502.0	
39677	chr7	36513609	36517076	3467	1734.0	
39678	chr7	36561935	36561961	26	13.0	
39679	chr7	36565940	36566413	473	236.0	
39680	chr7	36570457	36571285	828	414.0	
39681	chr7	36591598	36592022	424	212.0	
39682	chr7	36599940	36600612	672	336.0	
39683	chr7	36601169	36601415	246	123.0	
39684	chr7	36607273	36607277	4	2.0	
39685	chr7	36620365	36620661	296	148.0	
39686	chr7	36623284	36623602	318	159.0	
39687	chr7	36625293	36625753	460	230.0	
39688	chr7	36639706	36640538	832	416.0	
39689	chr7	36657103	36657549	446	223.0	
39690	chr7	36670617	36671284	667	334.0	
39691	chr7	36677846	36679067	1221	610.0	
39692	chr7	36686446	36686964	518	259.0	
39693	chr7	36692496	36692940	444	222.0	
39694	chr7	36708838	36709217	379	190.0	
39695	chr7	36717298	36717756	458	229.0	
39696	chr7	36720805	36721681	876	438.0	
39697	chr7	36722848	36725041	2193	1096.0	
39698	chr7	36726269	36727609	1340	670.0	
39699	chr7	36736259	36737923	1664	832.0	
39700	chr7	36742702	36743761	1059	530.0	
39701	chr7	36746248	36746753	505	252.0	
39702	chr7	36748223	36748624	401	200.0	
39703	chr7	36749137	36750067	930	465.0	
39704	chr7	36765563	36766060	497	248.0	
39705	chr7	36775209	36776160	951	476.0	
39706	chr7	36776678	36778263	1585	792.0	
39707	chr7	36780745	36781642	897	448.0	
39708	chr7	36784559	36785725	1166	583.0	
39709	chr7	36787729	36789429	1700	850.0	
39710	chr7	36802505	36802758	253	126.0	
39711	chr7	36863882	36865475	1593	796.0	
39712	chr7	36871873	36872353	480	240.0	
39713	chr7	36938269	36938307	38	19.0	
39714	chr7	36949582	36950219	637	318.0	
39715	chr7	36951233	36951540	307	154.0	
39716	chr7	36958413	36958664	251	126.0	
39717	chr7	36967295	36967696	401	200.0	
39718	chr7	36969308	36969823	515	258.0	
39719	chr7	36972125	36972693	568	284.0	
39720	chr7	36984261	36984337	76	38.0	
39721	chr7	36984962	36985213	251	126.0	
39722	chr7	36986948	36987548	600	300.0	
39723	chr7	37031878	37032405	527	264.0	
39724	chr7	37092236	37093084	848	424.0	
39725	chr7	37181884	37182608	724	362.0	
39726	chr7	37198777	37199302	525	262.0	
39727	chr7	37201502	37202016	514	257.0	
39728	chr7	37208209	37209019	810	405.0	
39729	chr7	37234824	37235196	372	186.0	
39730	chr7	37247846	37248337	491	246.0	
39731	chr7	37250534	37250979	445	222.0	
39732	chr7	37259271	37259933	662	331.0	
39733	chr7	37265010	37265611	601	300.0	
39734	chr7	37284671	37285348	677	338.0	
39735	chr7	37286101	37286443	342	171.0	
39736	chr7	37290837	37291061	224	112.0	
39737	chr7	37310183	37311918	1735	868.0	
39738	chr7	37315496	37316600	1104	552.0	
39739	chr7	37318537	37319062	525	262.0	
39740	chr7	37320814	37321145	331	166.0	
39741	chr7	37336013	37336906	893	446.0	
39742	chr7	37337574	37337818	244	122.0	
39743	chr7	37341011	37341434	423	212.0	
39744	chr7	37342147	37343729	1582	791.0	
39745	chr7	37344955	37345550	595	298.0	
39746	chr7	37349943	37350401	458	229.0	
39747	chr7	37352768	37355247	2479	1240.0	
39748	chr7	37363220	37364134	914	457.0	
39749	chr7	37365460	37365590	130	65.0	
39750	chr7	37385622	37386350	728	364.0	
39751	chr7	37390100	37390529	429	214.0	
39752	chr7	37391698	37392650	952	476.0	
39753	chr7	37406284	37406658	374	187.0	
39754	chr7	37408259	37409896	1637	818.0	
39755	chr7	37410790	37411260	470	235.0	
39756	chr7	37419711	37419843	132	66.0	
39757	chr7	37425011	37426057	1046	523.0	
39758	chr7	37432452	37433544	1092	546.0	
39759	chr7	37440612	37441882	1270	635.0	
39760	chr7	37444961	37450065	5104	2552.0	
39761	chr7	37462139	37462542	403	202.0	
39762	chr7	37479928	37480670	742	371.0	
39763	chr7	37488399	37488703	304	152.0	
39764	chr7	37495611	37495977	366	183.0	
39765	chr7	37510094	37510433	339	170.0	
39766	chr7	37645307	37645901	594	297.0	
39767	chr7	37656664	37658255	1591	796.0	
39768	chr7	37663553	37664165	612	306.0	
39769	chr7	37666284	37666902	618	309.0	
39770	chr7	37669892	37670186	294	147.0	
39771	chr7	37671924	37672160	236	118.0	
39772	chr7	37674268	37675206	938	469.0	
39773	chr7	37683141	37684060	919	460.0	
39774	chr7	37685140	37685376	236	118.0	
39775	chr7	37686591	37687084	493	246.0	
39776	chr7	37690158	37690669	511	256.0	
39777	chr7	37694054	37694871	817	408.0	
39778	chr7	37706763	37707234	471	236.0	
39779	chr7	37714655	37714984	329	164.0	
39780	chr7	37728628	37729307	679	340.0	
39781	chr7	37731979	37732773	794	397.0	
39782	chr7	37757585	37757675	90	45.0	
39783	chr7	37765323	37766566	1243	622.0	
39784	chr7	37786646	37787666	1020	510.0	
39785	chr7	37832170	37832659	489	244.0	
39786	chr7	37833306	37833946	640	320.0	
39787	chr7	37901454	37901559	105	52.0	
39788	chr7	37916247	37917493	1246	623.0	
39789	chr7	37920395	37921686	1291	646.0	
39790	chr7	37987781	37988067	286	143.0	
39791	chr7	38105818	38106340	522	261.0	
39792	chr7	38107373	38108050	677	338.0	
39793	chr7	38169858	38170271	413	206.0	
39794	chr7	38171722	38172479	757	378.0	
39795	chr7	38177535	38180254	2719	1360.0	
39796	chr7	38186628	38186824	196	98.0	
39797	chr7	38192176	38192345	169	84.0	
39798	chr7	38215446	38218106	2660	1330.0	
39799	chr7	38218740	38219198	458	229.0	
39800	chr7	38220378	38220949	571	286.0	
39801	chr7	38222390	38223642	1252	626.0	
39802	chr7	38231976	38234321	2345	1172.0	
39803	chr7	38234912	38235125	213	106.0	
39804	chr7	38235634	38235900	266	133.0	
39805	chr7	38242780	38243769	989	494.0	
39806	chr7	38245604	38246005	401	200.0	
39807	chr7	38256564	38257641	1077	538.0	
39808	chr7	38259239	38259242	3	2.0	
39809	chr7	38261621	38261851	230	115.0	
39810	chr7	38273455	38273530	75	38.0	
39811	chr7	38274210	38274910	700	350.0	
39812	chr7	38276379	38276975	596	298.0	
39813	chr7	38280685	38281204	519	260.0	
39814	chr7	38284707	38285122	415	208.0	
39815	chr7	38294955	38295282	327	164.0	
39816	chr7	38299390	38300621	1231	616.0	"sequence_feature	sequence_feature"
39817	chr7	38303881	38308137	4256	2128.0	
39818	chr7	38309235	38311982	2747	1374.0	
39819	chr7	38312622	38313276	654	327.0	
39820	chr7	38316887	38319258	2371	1186.0	"sequence_feature	sequence_feature"
39821	chr7	38319829	38320542	713	356.0	
39822	chr7	38327595	38328018	423	212.0	
39823	chr7	38330028	38331784	1756	878.0	"sequence_feature	sequence_feature"
39824	chr7	38334555	38336407	1852	926.0	"sequence_feature	sequence_feature"
39825	chr7	38337954	38338192	238	119.0	
39826	chr7	38340244	38341858	1614	807.0	"sequence_feature	sequence_feature"
39827	chr7	38344759	38346193	1434	717.0	"sequence_feature	sequence_feature"
39828	chr7	38349086	38350525	1439	720.0	"sequence_feature	sequence_feature"
39829	chr7	38353446	38354719	1273	636.0	"sequence_feature	sequence_feature"
39830	chr7	38358087	38359731	1644	822.0	"sequence_feature	sequence_feature"
39831	chr7	38360781	38361146	365	182.0	
39832	chr7	38362321	38363900	1579	790.0	"sequence_feature	sequence_feature"
39833	chr7	38367072	38368753	1681	840.0	"sequence_feature	sequence_feature"
39834	chr7	38369658	38370496	838	419.0	
39835	chr7	38374356	38374850	494	247.0	
39836	chr7	38393855	38395516	1661	830.0	
39837	chr7	38396091	38396309	218	109.0	
39838	chr7	38398687	38399154	467	234.0	
39839	chr7	38413872	38414207	335	168.0	
39840	chr7	38425099	38425961	862	431.0	
39841	chr7	38433811	38434286	475	238.0	
39842	chr7	38463258	38464128	870	435.0	
39843	chr7	38656948	38657392	444	222.0	
39844	chr7	38658915	38659259	344	172.0	
39845	chr7	38660016	38660939	923	462.0	
39846	chr7	38671859	38672634	775	388.0	
39847	chr7	38673650	38674862	1212	606.0	
39848	chr7	38685892	38686292	400	200.0	
39849	chr7	38744670	38745071	401	200.0	
39850	chr7	38796929	38797221	292	146.0	
39851	chr7	38855461	38855717	256	128.0	
39852	chr7	38907063	38907506	443	222.0	
39853	chr7	38908514	38909653	1139	570.0	
39854	chr7	38929687	38929933	246	123.0	
39855	chr7	38932520	38932922	402	201.0	
39856	chr7	39070187	39070606	419	210.0	
39857	chr7	39414251	39414846	595	298.0	
39858	chr7	39433717	39433872	155	78.0	
39859	chr7	39453763	39454102	339	170.0	
39860	chr7	39464979	39465338	359	180.0	
39861	chr7	39519859	39520333	474	237.0	
39862	chr7	39565843	39567093	1250	625.0	
39863	chr7	39580141	39580911	770	385.0	
39864	chr7	39589571	39590236	665	332.0	
39865	chr7	39609160	39610102	942	471.0	
39866	chr7	39621648	39624963	3315	1658.0	
39867	chr7	39633790	39634623	833	416.0	
39868	chr7	39698714	39699205	491	246.0	
39869	chr7	39700860	39701368	508	254.0	
39870	chr7	39727529	39728092	563	282.0	
39871	chr7	39732483	39736254	3771	1886.0	
39872	chr7	39742152	39742696	544	272.0	
39873	chr7	39745942	39746599	657	328.0	
39874	chr7	39833184	39833634	450	225.0	
39875	chr7	39896328	39896894	566	283.0	
39876	chr7	39948252	39953166	4914	2457.0	
39877	chr7	39956964	39957360	396	198.0	
39878	chr7	39967422	39967757	335	168.0	
39879	chr7	39971936	39972227	291	146.0	
39880	chr7	39978120	39979967	1847	924.0	
39881	chr7	39985321	39986026	705	352.0	
39882	chr7	39987645	39988159	514	257.0	
39883	chr7	40012635	40013601	966	483.0	
39884	chr7	40015734	40016172	438	219.0	
39885	chr7	40022504	40022646	142	71.0	
39886	chr7	40049106	40049730	624	312.0	
39887	chr7	40052250	40052941	691	346.0	
39888	chr7	40077826	40078215	389	194.0	
39889	chr7	40133801	40135600	1799	900.0	
39890	chr7	40232607	40232660	53	26.0	
39891	chr7	40268647	40269438	791	396.0	
39892	chr7	40329571	40329940	369	184.0	
39893	chr7	40419777	40420141	364	182.0	
39894	chr7	40551508	40552591	1083	542.0	
39895	chr7	40582616	40582849	233	116.0	
39896	chr7	40599881	40600209	328	164.0	
39897	chr7	40604807	40605229	422	211.0	
39898	chr7	41003096	41003175	79	40.0	
39899	chr7	41010294	41010773	479	240.0	
39900	chr7	41459220	41460380	1160	580.0	
39901	chr7	41478198	41478648	450	225.0	
39902	chr7	41567036	41567759	723	362.0	
39903	chr7	41584681	41585204	523	262.0	
39904	chr7	41592275	41592637	362	181.0	
39905	chr7	41693363	41693716	353	176.0	
39906	chr7	41696437	41696831	394	197.0	
39907	chr7	41699517	41699953	436	218.0	
39908	chr7	41700748	41700770	22	11.0	
39909	chr7	41704723	41705977	1254	627.0	
39910	chr7	41731469	41733188	1719	860.0	
39911	chr7	41777754	41778790	1036	518.0	
39912	chr7	41779752	41780787	1035	518.0	
39913	chr7	41786928	41787269	341	170.0	
39914	chr7	41810167	41810679	512	256.0	
39915	chr7	41837855	41838299	444	222.0	
39916	chr7	41847693	41847997	304	152.0	
39917	chr7	41861601	41862102	501	250.0	
39918	chr7	41869065	41870956	1891	946.0	
39919	chr7	41880165	41880537	372	186.0	
39920	chr7	41881280	41883071	1791	896.0	
39921	chr7	41886254	41886710	456	228.0	
39922	chr7	41887311	41887991	680	340.0	
39923	chr7	41888999	41889493	494	247.0	
39924	chr7	41892628	41892643	15	8.0	
39925	chr7	41940513	41941397	884	442.0	
39926	chr7	41942772	41943535	763	382.0	
39927	chr7	42227603	42228274	671	336.0	
39928	chr7	42236428	42238279	1851	926.0	
39929	chr7	42876416	42876859	443	222.0	
39930	chr7	42877704	42878674	970	485.0	
39931	chr7	42887792	42889547	1755	878.0	
39932	chr7	42911190	42912759	1569	784.0	
39933	chr7	42914718	42914978	260	130.0	
39934	chr7	42931179	42933542	2363	1182.0	
39935	chr7	42941032	42941698	666	333.0	
39936	chr7	42945985	42946319	334	167.0	
39937	chr7	43108405	43108751	346	173.0	
39938	chr7	43164492	43165208	716	358.0	
39939	chr7	43261273	43261658	385	192.0	
39940	chr7	43439761	43440214	453	226.0	
39941	chr7	43455038	43455386	348	174.0	
39942	chr7	43554307	43554355	48	24.0	
39943	chr7	43572310	43573151	841	420.0	
39944	chr7	43582336	43587682	5346	2673.0	
39945	chr7	43588618	43589611	993	496.0	
39946	chr7	43590857	43591922	1065	532.0	
39947	chr7	43592766	43593420	654	327.0	
39948	chr7	43593965	43595335	1370	685.0	
39949	chr7	43598395	43598635	240	120.0	
39950	chr7	43600087	43600194	107	54.0	
39951	chr7	43601709	43602030	321	160.0	
39952	chr7	43603556	43603773	217	108.0	
39953	chr7	43605572	43605961	389	194.0	
39954	chr7	43607803	43608194	391	196.0	
39955	chr7	43609632	43609764	132	66.0	
39956	chr7	43611928	43613673	1745	872.0	
39957	chr7	43615525	43615968	443	222.0	
39958	chr7	43617489	43618682	1193	596.0	
39959	chr7	43619239	43619258	19	10.0	
39960	chr7	43619946	43619957	11	6.0	
39961	chr7	43620639	43623013	2374	1187.0	
39962	chr7	43624904	43626558	1654	827.0	
39963	chr7	43629952	43629968	16	8.0	
39964	chr7	43631417	43631989	572	286.0	
39965	chr7	43634519	43634622	103	52.0	
39966	chr7	43637051	43637966	915	458.0	
39967	chr7	43642857	43644236	1379	690.0	
39968	chr7	43645803	43646076	273	136.0	
39969	chr7	43646781	43652068	5287	2644.0	
39970	chr7	43658726	43659009	283	142.0	
39971	chr7	43669131	43670101	970	485.0	
39972	chr7	43699556	43700421	865	432.0	
39973	chr7	43721181	43721651	470	235.0	
39974	chr7	43728763	43730183	1420	710.0	
39975	chr7	43734826	43735032	206	103.0	
39976	chr7	43747682	43748119	437	218.0	
39977	chr7	43750934	43751247	313	156.0	
39978	chr7	43753380	43753877	497	248.0	
39979	chr7	43757979	43759702	1723	862.0	
39980	chr7	43762058	43762704	646	323.0	
39981	chr7	43764001	43765470	1469	734.0	
39982	chr7	43769486	43769563	77	38.0	
39983	chr7	43781944	43782502	558	279.0	
39984	chr7	43784828	43784829	1	0.0	
39985	chr7	43791615	43792301	686	343.0	
39986	chr7	43808265	43808932	667	334.0	
39987	chr7	43810568	43810954	386	193.0	
39988	chr7	43834250	43835443	1193	596.0	
39989	chr7	43838439	43839540	1101	550.0	
39990	chr7	43868524	43870509	1985	992.0	
39991	chr7	43876031	43876724	693	346.0	
39992	chr7	43892319	43892581	262	131.0	
39993	chr7	43905308	43907160	1852	926.0	
39994	chr7	43925707	43927280	1573	786.0	
39995	chr7	43931475	43931601	126	63.0	
39996	chr7	43985810	43986423	613	306.0	
39997	chr7	44018597	44020781	2184	1092.0	
39998	chr7	44036325	44036828	503	252.0	
39999	chr7	44038804	44041156	2352	1176.0	
40000	chr7	44043991	44047590	3599	1800.0	
40001	chr7	44058431	44060020	1589	794.0	
40002	chr7	44064286	44064296	10	5.0	
40003	chr7	44064916	44066780	1864	932.0	
40004	chr7	44071116	44071524	408	204.0	
40005	chr7	44072215	44075523	3308	1654.0	
40006	chr7	44076534	44076796	262	131.0	
40007	chr7	44077724	44077997	273	136.0	
40008	chr7	44080750	44083302	2552	1276.0	
40009	chr7	44085639	44085795	156	78.0	
40010	chr7	44097238	44097824	586	293.0	
40011	chr7	44103875	44105885	2010	1005.0	
40012	chr7	44123022	44124377	1355	678.0	
40013	chr7	44145240	44146867	1627	814.0	
40014	chr7	44196339	44196793	454	227.0	
40015	chr7	44200588	44201632	1044	522.0	
40016	chr7	44214460	44214471	11	6.0	
40017	chr7	44240710	44241606	896	448.0	
40018	chr7	44244304	44244666	362	181.0	
40019	chr7	44257574	44258569	995	498.0	
40020	chr7	44309663	44310110	447	224.0	
40021	chr7	44338505	44339029	524	262.0	
40022	chr7	44377881	44378408	527	264.0	
40023	chr7	44449456	44449649	193	96.0	
40024	chr7	44460194	44461844	1650	825.0	
40025	chr7	44477070	44477947	877	438.0	
40026	chr7	44489539	44491404	1865	932.0	
40027	chr7	44508713	44508808	95	48.0	
40028	chr7	44534535	44534963	428	214.0	
40029	chr7	44565257	44566717	1460	730.0	
40030	chr7	44573279	44574824	1545	772.0	
40031	chr7	44581265	44583200	1935	968.0	
40032	chr7	44587862	44588702	840	420.0	
40033	chr7	44605109	44607812	2703	1352.0	
40034	chr7	44609119	44609687	568	284.0	
40035	chr7	44614994	44615819	825	412.0	
40036	chr7	44617424	44617617	193	96.0	
40037	chr7	44618728	44619143	415	208.0	
40038	chr7	44621025	44621855	830	415.0	
40039	chr7	44622506	44624617	2111	1056.0	
40040	chr7	44626105	44626792	687	344.0	
40041	chr7	44629288	44636346	7058	3529.0	
40042	chr7	44637611	44640247	2636	1318.0	"enhancer	sequence_feature"
40043	chr7	44678907	44679068	161	80.0	
40044	chr7	44712399	44712403	4	2.0	
40045	chr7	44727362	44727707	345	172.0	
40046	chr7	44735295	44735957	662	331.0	
40047	chr7	44747658	44751664	4006	2003.0	
40048	chr7	44768117	44770457	2340	1170.0	
40049	chr7	44786952	44787371	419	210.0	
40050	chr7	44795666	44799056	3390	1695.0	
40051	chr7	44801857	44802824	967	484.0	
40052	chr7	44805936	44806386	450	225.0	
40053	chr7	44822621	44823012	391	196.0	
40054	chr7	44824900	44825547	647	324.0	
40055	chr7	44841583	44842224	641	320.0	
40056	chr7	44845518	44849305	3787	1894.0	
40057	chr7	44856537	44857599	1062	531.0	
40058	chr7	44880316	44881989	1673	836.0	
40059	chr7	44884144	44886668	2524	1262.0	
40060	chr7	44887211	44887837	626	313.0	
40061	chr7	44891144	44891955	811	406.0	
40062	chr7	44897333	44897637	304	152.0	
40063	chr7	44914993	44915482	489	244.0	
40064	chr7	44921639	44922695	1056	528.0	
40065	chr7	44955037	44955226	189	94.0	
40066	chr7	44958901	44960637	1736	868.0	
40067	chr7	44961749	44965266	3517	1758.0	
40068	chr7	44967522	44967632	110	55.0	
40069	chr7	44973677	44974394	717	358.0	
40070	chr7	44975754	44975814	60	30.0	
40071	chr7	44976527	44982933	6406	3203.0	
40072	chr7	44983620	44987393	3773	1886.0	
40073	chr7	44995082	44996305	1223	612.0	
40074	chr7	44998465	45002094	3629	1814.0	
40075	chr7	45007824	45008195	371	186.0	
40076	chr7	45013353	45013904	551	276.0	
40077	chr7	45021655	45022024	369	184.0	
40078	chr7	45026573	45029403	2830	1415.0	
40079	chr7	45033174	45033685	511	256.0	
40080	chr7	45036003	45037202	1199	600.0	
40081	chr7	45062014	45062115	101	50.0	
40082	chr7	45074709	45075112	403	202.0	
40083	chr7	45078369	45078695	326	163.0	
40084	chr7	45079804	45081865	2061	1030.0	
40085	chr7	45082706	45083107	401	200.0	
40086	chr7	45086894	45086941	47	24.0	
40087	chr7	45088255	45090056	1801	900.0	
40088	chr7	45110053	45112569	2516	1258.0	
40089	chr7	45122925	45123809	884	442.0	
40090	chr7	45135726	45136755	1029	514.0	
40091	chr7	45154529	45155068	539	270.0	
40092	chr7	45157593	45157834	241	120.0	
40093	chr7	45160329	45160744	415	208.0	
40094	chr7	45171873	45172187	314	157.0	
40095	chr7	45192395	45193227	832	416.0	
40096	chr7	45204127	45204465	338	169.0	
40097	chr7	45259949	45260445	496	248.0	
40098	chr7	45402873	45403251	378	189.0	
40099	chr7	45768065	45769719	1654	827.0	
40100	chr7	45854264	45854668	404	202.0	
40101	chr7	45917530	45918029	499	250.0	
40102	chr7	45920459	45923631	3172	1586.0	
40103	chr7	45940076	45941100	1024	512.0	
40104	chr7	47088771	47089145	374	187.0	
40105	chr7	47102443	47102779	336	168.0	
40106	chr7	47147404	47147472	68	34.0	
40107	chr7	47149411	47149903	492	246.0	
40108	chr7	47180415	47180541	126	63.0	
40109	chr7	47186174	47186789	615	308.0	
40110	chr7	47192002	47192395	393	196.0	
40111	chr7	47225768	47226254	486	243.0	
40112	chr7	47253447	47254872	1425	712.0	
40113	chr7	47266220	47266655	435	218.0	
40114	chr7	47291567	47291939	372	186.0	
40115	chr7	47391075	47391176	101	50.0	
40116	chr7	47453529	47454088	559	280.0	
40117	chr7	47473771	47474270	499	250.0	
40118	chr7	47474989	47475834	845	422.0	
40119	chr7	47481106	47482553	1447	724.0	
40120	chr7	47494374	47495380	1006	503.0	
40121	chr7	47496083	47496229	146	73.0	
40122	chr7	47497174	47498011	837	418.0	
40123	chr7	47503285	47503694	409	204.0	
40124	chr7	47520534	47520729	195	98.0	
40125	chr7	47543762	47543770	8	4.0	
40126	chr7	47568429	47568988	559	280.0	
40127	chr7	47571032	47572121	1089	544.0	
40128	chr7	47574079	47575391	1312	656.0	
40129	chr7	47575966	47577788	1822	911.0	
40130	chr7	47578855	47578862	7	4.0	
40131	chr7	47580903	47582450	1547	774.0	
40132	chr7	47583400	47583697	297	148.0	
40133	chr7	47586159	47587754	1595	798.0	
40134	chr7	47600788	47601951	1163	582.0	
40135	chr7	47632368	47632700	332	166.0	
40136	chr7	47647267	47647734	467	234.0	
40137	chr7	47669314	47671392	2078	1039.0	
40138	chr7	47672186	47672685	499	250.0	
40139	chr7	47677824	47677846	22	11.0	
40140	chr7	47715315	47715334	19	10.0	
40141	chr7	47725283	47725792	509	254.0	
40142	chr7	47806486	47807538	1052	526.0	
40143	chr7	47813610	47813976	366	183.0	
40144	chr7	47819343	47819710	367	184.0	
40145	chr7	47937357	47937742	385	192.0	
40146	chr7	47938299	47938529	230	115.0	
40147	chr7	47941237	47941893	656	328.0	
40148	chr7	47945174	47945641	467	234.0	
40149	chr7	47968794	47971293	2499	1250.0	
40150	chr7	47978820	47980039	1219	610.0	
40151	chr7	47991295	47992654	1359	680.0	
40152	chr7	48011583	48011974	391	196.0	
40153	chr7	48034983	48036650	1667	834.0	
40154	chr7	48045239	48045587	348	174.0	
40155	chr7	48046388	48046876	488	244.0	
40156	chr7	48049797	48050308	511	256.0	
40157	chr7	48059026	48059355	329	164.0	
40158	chr7	48079841	48079879	38	19.0	
40159	chr7	48083458	48083734	276	138.0	
40160	chr7	48084618	48086106	1488	744.0	
40161	chr7	48086696	48090665	3969	1984.0	
40162	chr7	48091656	48092488	832	416.0	
40163	chr7	48094676	48098888	4212	2106.0	
40164	chr7	48101871	48102467	596	298.0	
40165	chr7	48108166	48108215	49	24.0	
40166	chr7	48108961	48111111	2150	1075.0	
40167	chr7	48154770	48155166	396	198.0	
40168	chr7	48299823	48299934	111	56.0	
40169	chr7	48350589	48350839	250	125.0	
40170	chr7	48388917	48391380	2463	1232.0	
40171	chr7	48459179	48459509	330	165.0	
40172	chr7	48515180	48515504	324	162.0	
40173	chr7	48691838	48692197	359	180.0	
40174	chr7	48964091	48964428	337	168.0	
40175	chr7	48976330	48976508	178	89.0	
40176	chr7	49001625	49001909	284	142.0	
40177	chr7	49580745	49581218	473	236.0	
40178	chr7	49852965	49852967	2	1.0	
40179	chr7	50068037	50070291	2254	1127.0	
40180	chr7	50092411	50093583	1172	586.0	
40181	chr7	50119828	50120156	328	164.0	
40182	chr7	50121291	50121605	314	157.0	
40183	chr7	50142294	50142962	668	334.0	
40184	chr7	50148174	50148824	650	325.0	
40185	chr7	50156731	50157077	346	173.0	
40186	chr7	50164555	50165312	757	378.0	
40187	chr7	50167393	50167976	583	292.0	
40188	chr7	50181129	50181480	351	176.0	
40189	chr7	50182651	50183218	567	284.0	
40190	chr7	50185120	50185620	500	250.0	
40191	chr7	50204553	50208531	3978	1989.0	
40192	chr7	50210925	50210939	14	7.0	
40193	chr7	50212519	50214577	2058	1029.0	
40194	chr7	50216695	50216863	168	84.0	
40195	chr7	50217732	50218315	583	292.0	
40196	chr7	50220181	50221529	1348	674.0	
40197	chr7	50226325	50227023	698	349.0	
40198	chr7	50227613	50228354	741	370.0	
40199	chr7	50261594	50263356	1762	881.0	
40200	chr7	50264619	50268684	4065	2032.0	
40201	chr7	50269299	50269407	108	54.0	
40202	chr7	50270389	50270880	491	246.0	
40203	chr7	50274353	50274782	429	214.0	
40204	chr7	50276430	50276831	401	200.0	
40205	chr7	50281378	50283758	2380	1190.0	
40206	chr7	50284273	50284746	473	236.0	
40207	chr7	50285263	50285781	518	259.0	
40208	chr7	50300347	50300719	372	186.0	
40209	chr7	50302490	50302594	104	52.0	
40210	chr7	50303174	50310778	7604	3802.0	
40211	chr7	50311968	50319698	7730	3865.0	enhancer
40212	chr7	50321260	50322666	1406	703.0	
40213	chr7	50329491	50331035	1544	772.0	
40214	chr7	50343492	50343893	401	200.0	
40215	chr7	50345715	50349132	3417	1708.0	
40216	chr7	50349912	50354421	4509	2254.0	
40217	chr7	50355840	50361270	5430	2715.0	
40218	chr7	50362012	50365731	3719	1860.0	
40219	chr7	50366304	50369921	3617	1808.0	
40220	chr7	50371183	50372339	1156	578.0	
40221	chr7	50372911	50373379	468	234.0	
40222	chr7	50374441	50374707	266	133.0	
40223	chr7	50379176	50379661	485	242.0	
40224	chr7	50380464	50380510	46	23.0	
40225	chr7	50392980	50394713	1733	866.0	
40226	chr7	50396730	50397762	1032	516.0	
40227	chr7	50404340	50406237	1897	948.0	
40228	chr7	50406744	50407789	1045	522.0	
40229	chr7	50409586	50411933	2347	1174.0	
40230	chr7	50412872	50413873	1001	500.0	
40231	chr7	50415838	50418631	2793	1396.0	
40232	chr7	50436104	50436575	471	236.0	
40233	chr7	50449417	50451210	1793	896.0	
40234	chr7	50455735	50455783	48	24.0	
40235	chr7	50467679	50468485	806	403.0	
40236	chr7	50534839	50535317	478	239.0	
40237	chr7	50595530	50595543	13	6.0	
40238	chr7	50598501	50598882	381	190.0	
40239	chr7	50608119	50608662	543	272.0	
40240	chr7	50610349	50611250	901	450.0	
40241	chr7	50614801	50614973	172	86.0	
40242	chr7	50632664	50633370	706	353.0	
40243	chr7	50659746	50660896	1150	575.0	
40244	chr7	50661422	50662796	1374	687.0	
40245	chr7	50664593	50664794	201	100.0	
40246	chr7	50679208	50679681	473	236.0	
40247	chr7	50681691	50681999	308	154.0	
40248	chr7	50696896	50697081	185	92.0	
40249	chr7	50739539	50740587	1048	524.0	
40250	chr7	50781260	50783146	1886	943.0	
40251	chr7	50792607	50793981	1374	687.0	
40252	chr7	51160987	51161468	481	240.0	
40253	chr7	51162683	51163141	458	229.0	
40254	chr7	51244856	51244920	64	32.0	
40255	chr7	51467681	51468022	341	170.0	
40256	chr7	52274152	52274895	743	372.0	
40257	chr7	54398040	54398195	155	78.0	
40258	chr7	54758322	54760138	1816	908.0	
40259	chr7	54773705	54774685	980	490.0	
40260	chr7	54788631	54788979	348	174.0	
40261	chr7	54823605	54824294	689	344.0	
40262	chr7	54831631	54831936	305	152.0	
40263	chr7	54839563	54839990	427	214.0	
40264	chr7	55073810	55074666	856	428.0	
40265	chr7	55086558	55087041	483	242.0	
40266	chr7	55254534	55256149	1615	808.0	
40267	chr7	55279837	55280540	703	352.0	
40268	chr7	55308773	55310359	1586	793.0	
40269	chr7	55364948	55367202	2254	1127.0	
40270	chr7	55415086	55415607	521	260.0	
40271	chr7	55433168	55433581	413	206.0	
40272	chr7	55439927	55439939	12	6.0	
40273	chr7	55469095	55469885	790	395.0	
40274	chr7	55475134	55476255	1121	560.0	
40275	chr7	55498111	55498592	481	240.0	
40276	chr7	55506007	55506583	576	288.0	
40277	chr7	55509211	55509749	538	269.0	
40278	chr7	55517362	55517543	181	90.0	
40279	chr7	55526666	55527197	531	266.0	
40280	chr7	55532961	55535635	2674	1337.0	
40281	chr7	55536744	55538052	1308	654.0	
40282	chr7	55538682	55538731	49	24.0	
40283	chr7	55546779	55547298	519	260.0	
40284	chr7	55549546	55549831	285	142.0	
40285	chr7	55552563	55553121	558	279.0	
40286	chr7	55557653	55558246	593	296.0	
40287	chr7	55561798	55562113	315	158.0	
40288	chr7	55565656	55566090	434	217.0	
40289	chr7	55567543	55567581	38	19.0	
40290	chr7	55568666	55574552	5886	2943.0	
40291	chr7	55593475	55594366	891	446.0	
40292	chr7	55597889	55598290	401	200.0	
40293	chr7	55641137	55641829	692	346.0	
40294	chr7	55886820	55888156	1336	668.0	"repeat_region	sequence_feature"
40295	chr7	55904697	55904717	20	10.0	
40296	chr7	55951227	55952683	1456	728.0	
40297	chr7	55963886	55965568	1682	841.0	
40298	chr7	56000027	56000697	670	335.0	
40299	chr7	56004596	56005282	686	343.0	
40300	chr7	56033517	56034820	1303	652.0	
40301	chr7	56050310	56052608	2298	1149.0	
40302	chr7	56063621	56065522	1901	950.0	
40303	chr7	56073788	56074914	1126	563.0	
40304	chr7	56092213	56092331	118	59.0	
40305	chr7	56092922	56093354	432	216.0	
40306	chr7	56098745	56099097	352	176.0	
40307	chr7	56105394	56108140	2746	1373.0	
40308	chr7	57489547	57489973	426	213.0	
40309	chr7	61096385	61096535	150	75.0	
40310	chr7	62506834	62510962	4128	2064.0	
40311	chr7	62512731	62513048	317	158.0	
40312	chr7	62522426	62522559	133	66.0	
40313	chr7	62525675	62526043	368	184.0	
40314	chr7	63899579	63901602	2023	1012.0	
40315	chr7	63925154	63927454	2300	1150.0	
40316	chr7	64045155	64045891	736	368.0	
40317	chr7	64304586	64305818	1232	616.0	
40318	chr7	64306442	64308287	1845	922.0	
40319	chr7	64313255	64315234	1979	990.0	
40320	chr7	64463541	64464128	587	294.0	
40321	chr7	64562201	64563494	1293	646.0	
40322	chr7	64569055	64570545	1490	745.0	
40323	chr7	64619078	64619460	382	191.0	
40324	chr7	64630675	64630786	111	56.0	
40325	chr7	64665715	64667717	2002	1001.0	
40326	chr7	64668870	64669135	265	132.0	
40327	chr7	64686587	64686947	360	180.0	
40328	chr7	64774473	64774640	167	84.0	
40329	chr7	64793821	64795249	1428	714.0	
40330	chr7	64877265	64878228	963	482.0	
40331	chr7	64887974	64889659	1685	842.0	
40332	chr7	64902615	64904150	1535	768.0	
40333	chr7	64951173	64951645	472	236.0	
40334	chr7	64999232	65000023	791	396.0	
40335	chr7	65005997	65007544	1547	774.0	
40336	chr7	65035749	65036969	1220	610.0	
40337	chr7	65037544	65039349	1805	902.0	
40338	chr7	65080600	65081839	1239	620.0	
40339	chr7	65216360	65216823	463	232.0	
40340	chr7	65239609	65240256	647	324.0	
40341	chr7	65251786	65252771	985	492.0	
40342	chr7	65269074	65269764	690	345.0	
40343	chr7	65307703	65308156	453	226.0	
40344	chr7	65338400	65338670	270	135.0	
40345	chr7	65372439	65372643	204	102.0	
40346	chr7	65373399	65374727	1328	664.0	
40347	chr7	65376031	65376166	135	68.0	
40348	chr7	65383655	65383656	1	0.0	
40349	chr7	65387919	65388199	280	140.0	
40350	chr7	65462769	65463047	278	139.0	
40351	chr7	65475449	65476274	825	412.0	
40352	chr7	65489533	65489691	158	79.0	
40353	chr7	65508882	65510309	1427	714.0	
40354	chr7	65722215	65722756	541	270.0	
40355	chr7	65731816	65731824	8	4.0	
40356	chr7	65750266	65752088	1822	911.0	
40357	chr7	65770120	65771473	1353	676.0	
40358	chr7	65871355	65871907	552	276.0	
40359	chr7	65872499	65874301	1802	901.0	
40360	chr7	65892114	65892603	489	244.0	
40361	chr7	65980265	65982889	2624	1312.0	
40362	chr7	66030842	66031345	503	252.0	
40363	chr7	66033470	66034122	652	326.0	
40364	chr7	66043805	66044749	944	472.0	
40365	chr7	66075088	66077158	2070	1035.0	
40366	chr7	66089250	66089408	158	79.0	
40367	chr7	66092452	66092769	317	158.0	
40368	chr7	66095143	66095532	389	194.0	
40369	chr7	66099453	66100583	1130	565.0	
40370	chr7	66114092	66115851	1759	880.0	
40371	chr7	66117227	66117235	8	4.0	
40372	chr7	66125055	66126435	1380	690.0	
40373	chr7	66148085	66149061	976	488.0	
40374	chr7	66204346	66206126	1780	890.0	
40375	chr7	66206875	66207946	1071	536.0	
40376	chr7	66212768	66213153	385	192.0	
40377	chr7	66255007	66255442	435	218.0	
40378	chr7	66281840	66282158	318	159.0	
40379	chr7	66296125	66296476	351	176.0	
40380	chr7	66297678	66298022	344	172.0	
40381	chr7	66348834	66349335	501	250.0	
40382	chr7	66413068	66414301	1233	616.0	
40383	chr7	66492311	66494522	2211	1106.0	
40384	chr7	66496839	66497251	412	206.0	
40385	chr7	66505927	66506826	899	450.0	
40386	chr7	66522540	66522956	416	208.0	
40387	chr7	66557327	66559061	1734	867.0	
40388	chr7	66583627	66584124	497	248.0	
40389	chr7	66589905	66590620	715	358.0	
40390	chr7	66591308	66593175	1867	934.0	
40391	chr7	66627091	66632895	5804	2902.0	
40392	chr7	66636064	66636323	259	130.0	
40393	chr7	66642284	66642460	176	88.0	
40394	chr7	66653154	66655581	2427	1214.0	
40395	chr7	66662512	66662870	358	179.0	
40396	chr7	66665745	66665757	12	6.0	
40397	chr7	66678915	66680226	1311	656.0	
40398	chr7	66681059	66683377	2318	1159.0	
40399	chr7	66684340	66685386	1046	523.0	
40400	chr7	66686039	66686399	360	180.0	
40401	chr7	66692503	66693668	1165	582.0	
40402	chr7	66694662	66694784	122	61.0	
40403	chr7	66695322	66695671	349	174.0	
40404	chr7	66696640	66699233	2593	1296.0	
40405	chr7	66720644	66720883	239	120.0	
40406	chr7	66732504	66732576	72	36.0	
40407	chr7	66736336	66736703	367	184.0	
40408	chr7	66737762	66738909	1147	574.0	
40409	chr7	66739426	66743841	4415	2208.0	
40410	chr7	66745824	66746214	390	195.0	
40411	chr7	66748850	66749930	1080	540.0	
40412	chr7	66750660	66751069	409	204.0	
40413	chr7	66751712	66751767	55	28.0	
40414	chr7	66754134	66754496	362	181.0	
40415	chr7	66755057	66755400	343	172.0	
40416	chr7	66758375	66760202	1827	914.0	
40417	chr7	66761349	66761381	32	16.0	
40418	chr7	66762503	66762674	171	86.0	
40419	chr7	66763985	66764301	316	158.0	
40420	chr7	66767603	66767825	222	111.0	
40421	chr7	66768923	66770536	1613	806.0	
40422	chr7	66776418	66776446	28	14.0	
40423	chr7	66790114	66790629	515	258.0	
40424	chr7	66813053	66813509	456	228.0	
40425	chr7	66817126	66817721	595	298.0	
40426	chr7	66825517	66825987	470	235.0	
40427	chr7	66836936	66837433	497	248.0	
40428	chr7	66843132	66846403	3271	1636.0	
40429	chr7	66847927	66848960	1033	516.0	
40430	chr7	66877554	66877867	313	156.0	
40431	chr7	66894875	66895123	248	124.0	
40432	chr7	66920533	66922860	2327	1164.0	
40433	chr7	66936444	66936768	324	162.0	
40434	chr7	66984375	66984382	7	4.0	
40435	chr7	66985755	66986074	319	160.0	
40436	chr7	66994299	66997411	3112	1556.0	
40437	chr7	67000654	67001038	384	192.0	
40438	chr7	67128637	67129675	1038	519.0	
40439	chr7	67163184	67163762	578	289.0	
40440	chr7	67191649	67192112	463	232.0	
40441	chr7	67301123	67301395	272	136.0	
40442	chr7	67301904	67303603	1699	850.0	
40443	chr7	67306347	67306634	287	144.0	
40444	chr7	67371775	67372213	438	219.0	
40445	chr7	67378184	67378552	368	184.0	
40446	chr7	69182581	69182982	401	200.0	
40447	chr7	69184288	69184850	562	281.0	
40448	chr7	69198921	69199579	658	329.0	
40449	chr7	69208846	69209269	423	212.0	
40450	chr7	69246811	69247224	413	206.0	
40451	chr7	69256325	69257270	945	472.0	
40452	chr7	69261505	69261932	427	214.0	
40453	chr7	69373721	69374059	338	169.0	
40454	chr7	69412551	69413015	464	232.0	
40455	chr7	69430658	69430712	54	27.0	
40456	chr7	69493847	69494433	586	293.0	
40457	chr7	69596617	69600581	3964	1982.0	
40458	chr7	69603807	69604438	631	316.0	
40459	chr7	69646827	69646974	147	74.0	
40460	chr7	69650966	69651688	722	361.0	
40461	chr7	69654145	69654833	688	344.0	
40462	chr7	69671119	69671560	441	220.0	
40463	chr7	69696016	69696473	457	228.0	
40464	chr7	69739946	69740292	346	173.0	
40465	chr7	69824082	69825123	1041	520.0	
40466	chr7	69827664	69827858	194	97.0	
40467	chr7	69953587	69953959	372	186.0	
40468	chr7	70060419	70060653	234	117.0	
40469	chr7	70177647	70178163	516	258.0	
40470	chr7	70178755	70179093	338	169.0	
40471	chr7	70238398	70238423	25	12.0	enhancer
40472	chr7	70316807	70317039	232	116.0	
40473	chr7	70334891	70335238	347	174.0	
40474	chr7	70354733	70355119	386	193.0	
40475	chr7	70595692	70596432	740	370.0	
40476	chr7	70614476	70614520	44	22.0	
40477	chr7	70645935	70646165	230	115.0	
40478	chr7	70647497	70648994	1497	748.0	
40479	chr7	70649972	70650298	326	163.0	
40480	chr7	70659270	70661128	1858	929.0	
40481	chr7	70669771	70670505	734	367.0	
40482	chr7	70679562	70680161	599	300.0	
40483	chr7	70681729	70682385	656	328.0	
40484	chr7	70692637	70696647	4010	2005.0	
40485	chr7	70698133	70698661	528	264.0	
40486	chr7	70716351	70716826	475	238.0	
40487	chr7	70736683	70737083	400	200.0	
40488	chr7	70764055	70765109	1054	527.0	
40489	chr7	70778555	70779754	1199	600.0	
40490	chr7	70787751	70788923	1172	586.0	
40491	chr7	70829113	70829566	453	226.0	
40492	chr7	71733451	71733618	167	84.0	
40493	chr7	72035215	72035708	493	246.0	
40494	chr7	72053282	72053665	383	192.0	
40495	chr7	72058720	72058872	152	76.0	
40496	chr7	72403536	72404208	672	336.0	
40497	chr7	72405264	72406028	764	382.0	
40498	chr7	72805468	72807148	1680	840.0	
40499	chr7	72810420	72810797	377	188.0	
40500	chr7	72818670	72819310	640	320.0	
40501	chr7	72827548	72830767	3219	1610.0	
40502	chr7	72878853	72880418	1565	782.0	
40503	chr7	72914980	72915495	515	258.0	
40504	chr7	72924338	72926009	1671	836.0	
40505	chr7	72937102	72937809	707	354.0	
40506	chr7	73005530	73006129	599	300.0	
40507	chr7	73235006	73236362	1356	678.0	recombination_feature
40508	chr7	73237355	73237649	294	147.0	recombination_feature
40509	chr7	73292123	73292365	242	121.0	
40510	chr7	73308162	73309183	1021	510.0	
40511	chr7	73323879	73324750	871	436.0	
40512	chr7	73341924	73342179	255	128.0	
40513	chr7	73357823	73358680	857	428.0	
40514	chr7	73367609	73368062	453	226.0	
40515	chr7	73382903	73383318	415	208.0	
40516	chr7	73399296	73399886	590	295.0	
40517	chr7	73433235	73434533	1298	649.0	
40518	chr7	73438715	73438753	38	19.0	
40519	chr7	73451578	73452248	670	335.0	
40520	chr7	73519797	73523302	3505	1752.0	
40521	chr7	73525407	73525963	556	278.0	
40522	chr7	73527212	73527674	462	231.0	
40523	chr7	73555684	73558352	2668	1334.0	
40524	chr7	73565898	73566793	895	448.0	
40525	chr7	73577584	73579523	1939	970.0	
40526	chr7	73581258	73582710	1452	726.0	
40527	chr7	73587358	73588422	1064	532.0	
40528	chr7	73590901	73591319	418	209.0	
40529	chr7	73594127	73594804	677	338.0	
40530	chr7	73600682	73601280	598	299.0	
40531	chr7	73606772	73607777	1005	502.0	
40532	chr7	73623634	73624876	1242	621.0	
40533	chr7	73629260	73629619	359	180.0	
40534	chr7	73636174	73636781	607	304.0	
40535	chr7	73647658	73648458	800	400.0	
40536	chr7	73665019	73665414	395	198.0	
40537	chr7	73666291	73666355	64	32.0	
40538	chr7	73667248	73668905	1657	828.0	
40539	chr7	73682603	73684351	1748	874.0	
40540	chr7	73689760	73690032	272	136.0	
40541	chr7	73694006	73694266	260	130.0	
40542	chr7	73698622	73702562	3940	1970.0	
40543	chr7	73703105	73704861	1756	878.0	
40544	chr7	73706338	73707705	1367	684.0	
40545	chr7	73717476	73720372	2896	1448.0	
40546	chr7	73725426	73726398	972	486.0	
40547	chr7	73731722	73732117	395	198.0	
40548	chr7	73734425	73735532	1107	554.0	
40549	chr7	73736880	73739733	2853	1426.0	
40550	chr7	73811652	73812122	470	235.0	
40551	chr7	73826462	73827236	774	387.0	
40552	chr7	73828121	73828481	360	180.0	
40553	chr7	73841824	73843110	1286	643.0	
40554	chr7	73845639	73846362	723	362.0	
40555	chr7	73850733	73851905	1172	586.0	
40556	chr7	73855383	73856214	831	416.0	
40557	chr7	73866188	73866482	294	147.0	
40558	chr7	73909120	73909807	687	344.0	
40559	chr7	73978964	73979469	505	252.0	
40560	chr7	74002567	74003152	585	292.0	
40561	chr7	74003787	74003876	89	44.0	
40562	chr7	74026747	74027290	543	272.0	
40563	chr7	74057979	74058189	210	105.0	
40564	chr7	74061667	74063171	1504	752.0	
40565	chr7	74067481	74068604	1123	562.0	
40566	chr7	74082993	74085356	2363	1182.0	
40567	chr7	74092340	74095408	3068	1534.0	
40568	chr7	74100787	74101761	974	487.0	
40569	chr7	74129449	74129599	150	75.0	
40570	chr7	74134072	74134765	693	346.0	
40571	chr7	74172292	74172294	2	1.0	
40572	chr7	74173126	74175541	2415	1208.0	
40573	chr7	74176653	74176656	3	2.0	
40574	chr7	74178818	74178849	31	16.0	
40575	chr7	74179381	74179899	518	259.0	
40576	chr7	74182591	74184646	2055	1028.0	
40577	chr7	74195060	74195475	415	208.0	
40578	chr7	74197570	74198112	542	271.0	
40579	chr7	74201146	74201335	189	94.0	
40580	chr7	74202772	74203821	1049	524.0	
40581	chr7	74204636	74204970	334	167.0	
40582	chr7	74206304	74207239	935	468.0	
40583	chr7	74209214	74211720	2506	1253.0	
40584	chr7	74212661	74213081	420	210.0	
40585	chr7	74216380	74216776	396	198.0	
40586	chr7	74217327	74218337	1010	505.0	
40587	chr7	74225397	74225747	350	175.0	
40588	chr7	74226448	74227226	778	389.0	
40589	chr7	74229269	74231779	2510	1255.0	
40590	chr7	74241700	74242263	563	282.0	
40591	chr7	74253771	74255479	1708	854.0	
40592	chr7	74256637	74257019	382	191.0	
40593	chr7	74269629	74270464	835	418.0	
40594	chr7	74271842	74273080	1238	619.0	
40595	chr7	74275307	74275647	340	170.0	
40596	chr7	74284701	74285237	536	268.0	
40597	chr7	74288381	74292090	3709	1854.0	
40598	chr7	74306245	74307294	1049	524.0	
40599	chr7	74401035	74401693	658	329.0	
40600	chr7	74417313	74417961	648	324.0	
40601	chr7	74449815	74450495	680	340.0	
40602	chr7	74452090	74454605	2515	1258.0	"enhancer	sequence_feature"
40603	chr7	74477873	74478563	690	345.0	
40604	chr7	74480279	74481312	1033	516.0	
40605	chr7	74482668	74483017	349	174.0	
40606	chr7	74545249	74545508	259	130.0	
40607	chr7	74553842	74554056	214	107.0	
40608	chr7	74566694	74567150	456	228.0	
40609	chr7	74569434	74569958	524	262.0	
40610	chr7	74606095	74607058	963	482.0	
40611	chr7	74610120	74610895	775	388.0	
40612	chr7	74617341	74618034	693	346.0	
40613	chr7	74625435	74625762	327	164.0	
40614	chr7	74631576	74632013	437	218.0	
40615	chr7	74642060	74642276	216	108.0	
40616	chr7	74643124	74643876	752	376.0	
40617	chr7	74649906	74651000	1094	547.0	
40618	chr7	74655730	74661602	5872	2936.0	
40619	chr7	74662436	74662758	322	161.0	
40620	chr7	74665622	74665947	325	162.0	
40621	chr7	74743946	74744071	125	62.0	"recombination_feature	recombination_feature"
40622	chr7	74758387	74758648	261	130.0	recombination_feature
40623	chr7	74788364	74789118	754	377.0	recombination_feature
40624	chr7	74790618	74790642	24	12.0	recombination_feature
40625	chr7	74850678	74851368	690	345.0	recombination_feature
40626	chr7	74866155	74866616	461	230.0	recombination_feature
40627	chr7	74890019	74891183	1164	582.0	
40628	chr7	75072682	75074498	1816	908.0	
40629	chr7	75077528	75078559	1031	516.0	recombination_feature
40630	chr7	75082379	75082776	397	198.0	recombination_feature
40631	chr7	75092641	75093586	945	472.0	recombination_feature
40632	chr7	75154944	75155088	144	72.0	
40633	chr7	75156228	75157587	1359	680.0	
40634	chr7	74964408	74965177	769	384.0	
40635	chr7	75427425	75428606	1181	590.0	
40636	chr7	75442053	75442960	907	454.0	recombination_feature
40637	chr7	75485489	75486803	1314	657.0	
40638	chr7	75527147	75528777	1630	815.0	
40639	chr7	75534856	75535424	568	284.0	
40640	chr7	75569526	75570273	747	374.0	
40641	chr7	75603829	75604937	1108	554.0	
40642	chr7	75609398	75609637	239	120.0	
40643	chr7	75614295	75615346	1051	526.0	
40644	chr7	75617307	75618596	1289	644.0	
40645	chr7	75621038	75621591	553	276.0	
40646	chr7	75623354	75624866	1512	756.0	
40647	chr7	75638381	75640025	1644	822.0	
40648	chr7	75642604	75643351	747	374.0	
40649	chr7	75662766	75663333	567	284.0	
40650	chr7	75670716	75671687	971	486.0	
40651	chr7	75674678	75675047	369	184.0	
40652	chr7	75688245	75688546	301	150.0	
40653	chr7	75711872	75711875	3	2.0	
40654	chr7	75727529	75728799	1270	635.0	
40655	chr7	75729741	75730444	703	352.0	
40656	chr7	75738081	75742046	3965	1982.0	
40657	chr7	75761761	75762899	1138	569.0	
40658	chr7	75776302	75777158	856	428.0	
40659	chr7	75795913	75796405	492	246.0	
40660	chr7	75813758	75814073	315	158.0	
40661	chr7	75819685	75820199	514	257.0	
40662	chr7	75842645	75843462	817	408.0	
40663	chr7	75847567	75848235	668	334.0	
40664	chr7	75850127	75850686	559	280.0	
40665	chr7	75854274	75854592	318	159.0	
40666	chr7	75856295	75857108	813	406.0	
40667	chr7	75861467	75862161	694	347.0	
40668	chr7	75866210	75867461	1251	626.0	
40669	chr7	75872105	75872796	691	346.0	
40670	chr7	75876160	75877018	858	429.0	
40671	chr7	75878095	75880579	2484	1242.0	
40672	chr7	75905703	75906615	912	456.0	
40673	chr7	75909766	75909829	63	32.0	
40674	chr7	75914126	75916701	2575	1288.0	
40675	chr7	75918583	75919026	443	222.0	
40676	chr7	75920512	75920859	347	174.0	
40677	chr7	75921784	75921832	48	24.0	
40678	chr7	75924804	75925963	1159	580.0	
40679	chr7	75928402	75929230	828	414.0	
40680	chr7	75934745	75935137	392	196.0	
40681	chr7	75937879	75938641	762	381.0	
40682	chr7	75945292	75946210	918	459.0	
40683	chr7	75950016	75950706	690	345.0	
40684	chr7	75951321	75952134	813	406.0	
40685	chr7	75953462	75954534	1072	536.0	
40686	chr7	75967371	75968042	671	336.0	
40687	chr7	75971648	75972753	1105	552.0	
40688	chr7	75989426	75989528	102	51.0	
40689	chr7	75993387	75995376	1989	994.0	
40690	chr7	75996761	75997897	1136	568.0	
40691	chr7	76008294	76009721	1427	714.0	
40692	chr7	76019913	76020589	676	338.0	
40693	chr7	76022906	76023444	538	269.0	
40694	chr7	76047186	76049057	1871	936.0	
40695	chr7	76051824	76052270	446	223.0	
40696	chr7	76069119	76069566	447	224.0	
40697	chr7	76133384	76134242	858	429.0	
40698	chr7	76153476	76153959	483	242.0	
40699	chr7	76155702	76156451	749	374.0	
40700	chr7	76166065	76167364	1299	650.0	
40701	chr7	76177855	76178939	1084	542.0	
40702	chr7	76201522	76202650	1128	564.0	
40703	chr7	76234996	76235633	637	318.0	
40704	chr7	76259793	76260829	1036	518.0	
40705	chr7	76262888	76263356	468	234.0	
40706	chr7	76267150	76267768	618	309.0	
40707	chr7	76278688	76278927	239	120.0	
40708	chr7	76281251	76283162	1911	956.0	
40709	chr7	76290233	76290368	135	68.0	
40710	chr7	76291305	76292601	1296	648.0	
40711	chr7	76294552	76295289	737	368.0	
40712	chr7	76301934	76305057	3123	1562.0	
40713	chr7	76313825	76314919	1094	547.0	
40714	chr7	76317312	76319500	2188	1094.0	
40715	chr7	76322808	76322816	8	4.0	
40716	chr7	76327875	76328044	169	84.0	
40717	chr7	76332108	76332328	220	110.0	
40718	chr7	76333148	76334005	857	428.0	
40719	chr7	76338386	76338744	358	179.0	
40720	chr7	76340772	76341203	431	216.0	
40721	chr7	76342260	76342585	325	162.0	
40722	chr7	76343239	76343731	492	246.0	
40723	chr7	76346640	76347164	524	262.0	
40724	chr7	76348198	76348608	410	205.0	
40725	chr7	76351778	76352091	313	156.0	
40726	chr7	76357370	76360626	3256	1628.0	
40727	chr7	76364020	76365199	1179	590.0	
40728	chr7	76373233	76373564	331	166.0	
40729	chr7	76379326	76380843	1517	758.0	
40730	chr7	76388970	76389369	399	200.0	
40731	chr7	76392552	76394654	2102	1051.0	
40732	chr7	76397028	76398276	1248	624.0	
40733	chr7	76402972	76404546	1574	787.0	
40734	chr7	76418881	76420293	1412	706.0	
40735	chr7	76437857	76438296	439	220.0	
40736	chr7	76443904	76444127	223	112.0	
40737	chr7	76445548	76446035	487	244.0	
40738	chr7	76461708	76462092	384	192.0	
40739	chr7	76486643	76487090	447	224.0	
40740	chr7	76507680	76508537	857	428.0	
40741	chr7	76510044	76510413	369	184.0	
40742	chr7	76515867	76516326	459	230.0	
40743	chr7	76548741	76550229	1488	744.0	
40744	chr7	76592718	76593062	344	172.0	
40745	chr7	76605935	76606531	596	298.0	
40746	chr7	76607930	76608267	337	168.0	
40747	chr7	76626596	76627446	850	425.0	recombination_feature
40748	chr7	76997348	76999215	1867	934.0	
40749	chr7	77112810	77113001	191	96.0	
40750	chr7	77121707	77123040	1333	666.0	
40751	chr7	77128534	77129192	658	329.0	
40752	chr7	77152455	77152568	113	56.0	
40753	chr7	77155017	77155265	248	124.0	
40754	chr7	77157302	77157989	687	344.0	
40755	chr7	77188764	77189668	904	452.0	
40756	chr7	77192856	77193518	662	331.0	
40757	chr7	77199218	77200965	1747	874.0	
40758	chr7	77202649	77202819	170	85.0	
40759	chr7	77222066	77222515	449	224.0	
40760	chr7	77238254	77239867	1613	806.0	
40761	chr7	77246270	77246272	2	1.0	
40762	chr7	77247132	77247661	529	264.0	
40763	chr7	77269861	77269947	86	43.0	
40764	chr7	77276074	77276551	477	238.0	
40765	chr7	77316611	77317107	496	248.0	
40766	chr7	77326445	77328734	2289	1144.0	
40767	chr7	77330194	77330955	761	380.0	
40768	chr7	77331785	77332336	551	276.0	
40769	chr7	77336105	77336772	667	334.0	
40770	chr7	77338097	77339413	1316	658.0	
40771	chr7	77351278	77352556	1278	639.0	
40772	chr7	77353155	77353215	60	30.0	
40773	chr7	77354031	77354960	929	464.0	
40774	chr7	77390696	77391674	978	489.0	
40775	chr7	77399787	77400349	562	281.0	
40776	chr7	77408000	77408278	278	139.0	
40777	chr7	77409815	77410821	1006	503.0	
40778	chr7	77412880	77417116	4236	2118.0	
40779	chr7	77421017	77421489	472	236.0	
40780	chr7	77426925	77429544	2619	1310.0	
40781	chr7	77433904	77434359	455	228.0	
40782	chr7	77439568	77439977	409	204.0	
40783	chr7	77453446	77453864	418	209.0	
40784	chr7	77463487	77464129	642	321.0	
40785	chr7	77466358	77466820	462	231.0	
40786	chr7	77467402	77467966	564	282.0	
40787	chr7	77473290	77473915	625	312.0	
40788	chr7	77480243	77480448	205	102.0	
40789	chr7	77481652	77482423	771	386.0	
40790	chr7	77500594	77501519	925	462.0	
40791	chr7	77521805	77522422	617	308.0	
40792	chr7	77531026	77531460	434	217.0	
40793	chr7	77536225	77539160	2935	1468.0	
40794	chr7	77539800	77540321	521	260.0	
40795	chr7	77542334	77542882	548	274.0	
40796	chr7	77544077	77544393	316	158.0	
40797	chr7	77548079	77548863	784	392.0	
40798	chr7	77560836	77561703	867	434.0	
40799	chr7	77565869	77566398	529	264.0	
40800	chr7	77569844	77570789	945	472.0	
40801	chr7	77571799	77572273	474	237.0	
40802	chr7	77651540	77651953	413	206.0	
40803	chr7	77657744	77658263	519	260.0	
40804	chr7	77685138	77685720	582	291.0	
40805	chr7	77687386	77688101	715	358.0	
40806	chr7	77695605	77699440	3835	1918.0	
40807	chr7	77722889	77723076	187	94.0	
40808	chr7	77724792	77725005	213	106.0	
40809	chr7	77726532	77726878	346	173.0	
40810	chr7	77728310	77728705	395	198.0	
40811	chr7	77751973	77752521	548	274.0	
40812	chr7	77757636	77757921	285	142.0	
40813	chr7	77759070	77759772	702	351.0	
40814	chr7	77784696	77784747	51	26.0	
40815	chr7	77797299	77800533	3234	1617.0	
40816	chr7	77802978	77803599	621	310.0	
40817	chr7	77824160	77825562	1402	701.0	
40818	chr7	77834148	77834988	840	420.0	
40819	chr7	77906059	77906934	875	438.0	
40820	chr7	77990114	77990173	59	30.0	
40821	chr7	78019120	78020962	1842	921.0	
40822	chr7	78040124	78040654	530	265.0	
40823	chr7	79452190	79452514	324	162.0	
40824	chr7	79778906	79779775	869	434.0	
40825	chr7	79976774	79976791	17	8.0	
40826	chr7	80019164	80019598	434	217.0	
40827	chr7	80107317	80107694	377	188.0	
40828	chr7	80128933	80129306	373	186.0	
40829	chr7	80134297	80136031	1734	867.0	
40830	chr7	80428425	80428863	438	219.0	
40831	chr7	80439946	80440884	938	469.0	
40832	chr7	80443026	80443870	844	422.0	
40833	chr7	80450710	80450948	238	119.0	
40834	chr7	80538358	80538663	305	152.0	
40835	chr7	80618030	80618721	691	346.0	
40836	chr7	80619748	80620181	433	216.0	
40837	chr7	80632121	80632384	263	132.0	
40838	chr7	80634410	80634896	486	243.0	
40839	chr7	80636247	80636341	94	47.0	
40840	chr7	80638095	80639014	919	460.0	
40841	chr7	80642793	80643979	1186	593.0	
40842	chr7	80659466	80659830	364	182.0	
40843	chr7	80680152	80681593	1441	720.0	
40844	chr7	80699054	80700120	1066	533.0	
40845	chr7	80707960	80709105	1145	572.0	
40846	chr7	80721696	80723190	1494	747.0	
40847	chr7	80770542	80771175	633	316.0	
40848	chr7	80829981	80830447	466	233.0	
40849	chr7	80858577	80858825	248	124.0	
40850	chr7	80883335	80884020	685	342.0	
40851	chr7	80918306	80920271	1965	982.0	
40852	chr7	80934378	80934661	283	142.0	
40853	chr7	80942217	80942515	298	149.0	
40854	chr7	80967080	80967483	403	202.0	
40855	chr7	81140661	81141656	995	498.0	
40856	chr7	81470015	81470367	352	176.0	
40857	chr7	81487354	81488103	749	374.0	
40858	chr7	81499653	81500004	351	176.0	
40859	chr7	81769043	81770955	1912	956.0	
40860	chr7	81781360	81781659	299	150.0	
40861	chr7	81810409	81811147	738	369.0	
40862	chr7	81840179	81840368	189	94.0	
40863	chr7	81845583	81847064	1481	740.0	
40864	chr7	81956531	81956932	401	200.0	
40865	chr7	81990558	81990793	235	118.0	
40866	chr7	82572225	82572628	403	202.0	
40867	chr7	82595826	82596269	443	222.0	
40868	chr7	82615425	82616767	1342	671.0	
40869	chr7	82677509	82677940	431	216.0	
40870	chr7	82678719	82678932	213	106.0	
40871	chr7	83162607	83163117	510	255.0	
40872	chr7	83908653	83908842	189	94.0	
40873	chr7	83936061	83936806	745	372.0	
40874	chr7	83976257	83976628	371	186.0	
40875	chr7	84092166	84092474	308	154.0	
40876	chr7	84194634	84195354	720	360.0	
40877	chr7	84237489	84237949	460	230.0	
40878	chr7	84243026	84243412	386	193.0	
40879	chr7	84248192	84250024	1832	916.0	
40880	chr7	84372680	84373090	410	205.0	
40881	chr7	85186636	85187237	601	300.0	
40882	chr7	85290330	85290607	277	138.0	
40883	chr7	85554268	85554542	274	137.0	
40884	chr7	85573847	85574257	410	205.0	
40885	chr7	85711963	85712317	354	177.0	
40886	chr7	85720609	85721011	402	201.0	
40887	chr7	86926597	86927096	499	250.0	
40888	chr7	86929752	86930083	331	166.0	
40889	chr7	86939144	86939633	489	244.0	
40890	chr7	86978547	86979490	943	472.0	
40891	chr7	87039706	87040090	384	192.0	
40892	chr7	87058677	87060427	1750	875.0	
40893	chr7	87144466	87144495	29	14.0	
40894	chr7	87148354	87148753	399	200.0	
40895	chr7	87151654	87153821	2167	1084.0	
40896	chr7	87199251	87199386	135	68.0	
40897	chr7	87200286	87200729	443	222.0	
40898	chr7	87208643	87208734	91	46.0	
40899	chr7	87212310	87213450	1140	570.0	
40900	chr7	87216111	87221380	5269	2634.0	
40901	chr7	87226498	87226915	417	208.0	
40902	chr7	87236682	87237315	633	316.0	
40903	chr7	87312033	87312741	708	354.0	
40904	chr7	87318877	87319639	762	381.0	
40905	chr7	87341627	87341630	3	2.0	
40906	chr7	87344735	87346333	1598	799.0	
40907	chr7	87369206	87369609	403	202.0	
40908	chr7	87416624	87417138	514	257.0	
40909	chr7	87446006	87446053	47	24.0	
40910	chr7	87474265	87476306	2041	1020.0	
40911	chr7	87499061	87499202	141	70.0	
40912	chr7	87564253	87564626	373	186.0	
40913	chr7	87589734	87591029	1295	648.0	
40914	chr7	87598375	87601296	2921	1460.0	
40915	chr7	87627332	87629636	2304	1152.0	
40916	chr7	87797765	87798230	465	232.0	
40917	chr7	87852275	87852746	471	236.0	
40918	chr7	87858171	87858532	361	180.0	
40919	chr7	87863424	87863475	51	26.0	
40920	chr7	87873704	87877818	4114	2057.0	"origin_of_replication	origin_of_replication	region	origin_of_replication"
40921	chr7	87886851	87887282	431	216.0	
40922	chr7	87933451	87935398	1947	974.0	
40923	chr7	88111487	88111524	37	18.0	
40924	chr7	88132879	88133031	152	76.0	
40925	chr7	88165780	88166053	273	136.0	
40926	chr7	88217630	88221262	3632	1816.0	
40927	chr7	88224672	88224966	294	147.0	
40928	chr7	88226894	88227293	399	200.0	
40929	chr7	88243233	88243749	516	258.0	
40930	chr7	88264855	88265313	458	229.0	
40931	chr7	88268763	88269339	576	288.0	
40932	chr7	88278776	88279344	568	284.0	
40933	chr7	88306594	88307262	668	334.0	
40934	chr7	88313885	88314629	744	372.0	
40935	chr7	88315587	88315826	239	120.0	
40936	chr7	88316470	88316821	351	176.0	
40937	chr7	88317412	88317881	469	234.0	
40938	chr7	88322016	88322645	629	314.0	
40939	chr7	88328729	88329156	427	214.0	
40940	chr7	88345273	88345591	318	159.0	
40941	chr7	88354968	88355398	430	215.0	
40942	chr7	88357308	88357658	350	175.0	
40943	chr7	88358233	88358601	368	184.0	
40944	chr7	88395618	88396721	1103	552.0	
40945	chr7	89002888	89003366	478	239.0	
40946	chr7	89607791	89608190	399	200.0	
40947	chr7	89622998	89623399	401	200.0	
40948	chr7	90152712	90153025	313	156.0	
40949	chr7	90153978	90154942	964	482.0	
40950	chr7	90178863	90179397	534	267.0	
40951	chr7	90211568	90211992	424	212.0	
40952	chr7	90244510	90245980	1470	735.0	
40953	chr7	90298206	90298480	274	137.0	
40954	chr7	90335186	90335250	64	32.0	
40955	chr7	90345398	90348149	2751	1376.0	
40956	chr7	90402816	90404556	1740	870.0	
40957	chr7	90427714	90428170	456	228.0	
40958	chr7	90455351	90455840	489	244.0	
40959	chr7	90461321	90461680	359	180.0	
40960	chr7	90462978	90463857	879	440.0	
40961	chr7	90530283	90530696	413	206.0	
40962	chr7	90536408	90537188	780	390.0	
40963	chr7	90568063	90568742	679	340.0	
40964	chr7	90579195	90579789	594	297.0	
40965	chr7	90582107	90582590	483	242.0	
40966	chr7	90595539	90597689	2150	1075.0	
40967	chr7	90599899	90600753	854	427.0	
40968	chr7	90612925	90613649	724	362.0	
40969	chr7	90620851	90622093	1242	621.0	
40970	chr7	90624436	90624837	401	200.0	
40971	chr7	90629241	90629763	522	261.0	
40972	chr7	90689314	90689614	300	150.0	
40973	chr7	90708760	90710318	1558	779.0	
40974	chr7	90737174	90737765	591	296.0	
40975	chr7	90772409	90772815	406	203.0	
40976	chr7	91050570	91051192	622	311.0	
40977	chr7	91082887	91083188	301	150.0	
40978	chr7	91085146	91085633	487	244.0	
40979	chr7	91089334	91089819	485	242.0	
40980	chr7	91140945	91141572	627	314.0	
40981	chr7	91164897	91165913	1016	508.0	
40982	chr7	91240595	91240673	78	39.0	
40983	chr7	91263566	91265789	2223	1112.0	
40984	chr7	91288228	91288668	440	220.0	
40985	chr7	91299997	91300938	941	470.0	
40986	chr7	91308293	91308619	326	163.0	
40987	chr7	91326794	91327858	1064	532.0	
40988	chr7	91345529	91345797	268	134.0	
40989	chr7	91373091	91373572	481	240.0	
40990	chr7	91496234	91496709	475	238.0	
40991	chr7	91636140	91636482	342	171.0	
40992	chr7	91829964	91830401	437	218.0	
40993	chr7	91848176	91848588	412	206.0	
40994	chr7	91852420	91852497	77	38.0	
40995	chr7	91880090	91881413	1323	662.0	
40996	chr7	91910263	91910391	128	64.0	
40997	chr7	91939800	91942589	2789	1394.0	
40998	chr7	91945246	91947000	1754	877.0	
40999	chr7	91953678	91954014	336	168.0	
41000	chr7	92058079	92058393	314	157.0	
41001	chr7	92061225	92061265	40	20.0	
41002	chr7	92095398	92095631	233	116.0	
41003	chr7	92133195	92135521	2326	1163.0	
41004	chr7	92178701	92179778	1077	538.0	
41005	chr7	92244775	92247266	2491	1246.0	
41006	chr7	92248128	92248314	186	93.0	
41007	chr7	92313013	92313511	498	249.0	
41008	chr7	92379273	92379625	352	176.0	
41009	chr7	92404000	92404509	509	254.0	
41010	chr7	92423428	92426022	2594	1297.0	
41011	chr7	92446770	92449140	2370	1185.0	
41012	chr7	92461517	92462014	497	248.0	
41013	chr7	92527280	92529440	2160	1080.0	
41014	chr7	92574357	92574715	358	179.0	
41015	chr7	92584824	92585391	567	284.0	
41016	chr7	92588552	92591054	2502	1251.0	
41017	chr7	92609897	92610335	438	219.0	
41018	chr7	92620898	92621868	970	485.0	
41019	chr7	92633117	92635837	2720	1360.0	
41020	chr7	92639392	92640368	976	488.0	
41021	chr7	92641794	92642602	808	404.0	
41022	chr7	92645539	92645841	302	151.0	
41023	chr7	92664060	92665014	954	477.0	
41024	chr7	92683004	92683362	358	179.0	
41025	chr7	92684991	92685648	657	328.0	
41026	chr7	92691471	92692142	671	336.0	
41027	chr7	92695861	92696262	401	200.0	
41028	chr7	92717667	92719107	1440	720.0	
41029	chr7	92723920	92724459	539	270.0	
41030	chr7	92731345	92733014	1669	834.0	
41031	chr7	92755060	92755670	610	305.0	
41032	chr7	92757392	92757998	606	303.0	
41033	chr7	92798821	92799159	338	169.0	
41034	chr7	92809442	92810602	1160	580.0	
41035	chr7	92813346	92814121	775	388.0	
41036	chr7	92830464	92831120	656	328.0	
41037	chr7	92831929	92837678	5749	2874.0	
41038	chr7	92864035	92864530	495	248.0	
41039	chr7	92880231	92880594	363	182.0	
41040	chr7	92904123	92904927	804	402.0	
41041	chr7	93055566	93056043	477	238.0	
41042	chr7	93092926	93093104	178	89.0	
41043	chr7	93117052	93118708	1656	828.0	
41044	chr7	93145306	93145778	472	236.0	
41045	chr7	93146443	93148839	2396	1198.0	
41046	chr7	93150290	93151225	935	468.0	
41047	chr7	93165362	93165915	553	276.0	
41048	chr7	93196257	93196894	637	318.0	
41049	chr7	93202890	93203131	241	120.0	
41050	chr7	93228009	93228908	899	450.0	
41051	chr7	93231218	93233058	1840	920.0	
41052	chr7	93245513	93246389	876	438.0	
41053	chr7	93442727	93443103	376	188.0	
41054	chr7	93559896	93560353	457	228.0	
41055	chr7	93921734	93922249	515	258.0	
41056	chr7	94003556	94005241	1685	842.0	
41057	chr7	94022659	94022894	235	118.0	
41058	chr7	94043197	94043774	577	288.0	
41059	chr7	94049731	94050564	833	416.0	
41060	chr7	94052388	94052851	463	232.0	
41061	chr7	94057042	94057202	160	80.0	
41062	chr7	94059775	94060062	287	144.0	
41063	chr7	94064909	94065049	140	70.0	
41064	chr7	94087631	94088918	1287	644.0	
41065	chr7	94160632	94161402	770	385.0	
41066	chr7	94170933	94171180	247	124.0	
41067	chr7	94394324	94395858	1534	767.0	
41068	chr7	94435972	94436431	459	230.0	
41069	chr7	94509151	94511322	2171	1086.0	
41070	chr7	94620678	94621147	469	234.0	
41071	chr7	94655250	94658882	3632	1816.0	
41072	chr7	95330554	95331177	623	312.0	
41073	chr7	95396145	95396664	519	260.0	
41074	chr7	95434395	95435701	1306	653.0	
41075	chr7	95476926	95477381	455	228.0	
41076	chr7	95501566	95501648	82	41.0	
41077	chr7	95511644	95512367	723	362.0	
41078	chr7	95527410	95527855	445	222.0	
41079	chr7	95545026	95545357	331	166.0	
41080	chr7	95595950	95597243	1293	646.0	
41081	chr7	95608269	95609364	1095	548.0	enhancer
41082	chr7	95686094	95686495	401	200.0	
41083	chr7	95690286	95690927	641	320.0	
41084	chr7	95772352	95772856	504	252.0	
41085	chr7	95886728	95887012	284	142.0	
41086	chr7	95916609	95916965	356	178.0	
41087	chr7	96075406	96076214	808	404.0	enhancer
41088	chr7	96285392	96286377	985	492.0	
41089	chr7	96287191	96287607	416	208.0	
41090	chr7	96306372	96306977	605	302.0	
41091	chr7	96311957	96312400	443	222.0	
41092	chr7	96320574	96322666	2092	1046.0	
41093	chr7	96326546	96327292	746	373.0	
41094	chr7	96414967	96414993	26	13.0	
41095	chr7	96685625	96685692	67	34.0	
41096	chr7	96709075	96710343	1268	634.0	
41097	chr7	96837392	96838122	730	365.0	
41098	chr7	97005279	97006728	1449	724.0	
41099	chr7	97026246	97028065	1819	910.0	
41100	chr7	97104585	97105152	567	284.0	
41101	chr7	97116173	97118667	2494	1247.0	
41102	chr7	97174189	97174753	564	282.0	
41103	chr7	97179427	97179901	474	237.0	
41104	chr7	97835519	97835948	429	214.0	
41105	chr7	97871569	97873044	1475	738.0	
41106	chr7	97928026	97928879	853	426.0	
41107	chr7	97971368	97972830	1462	731.0	
41108	chr7	98021476	98022087	611	306.0	
41109	chr7	98051056	98051585	529	264.0	
41110	chr7	98106113	98107850	1737	868.0	
41111	chr7	98125706	98126347	641	320.0	
41112	chr7	98131438	98132536	1098	549.0	
41113	chr7	98133050	98135031	1981	990.0	
41114	chr7	98137446	98138293	847	424.0	
41115	chr7	98162786	98163268	482	241.0	
41116	chr7	98166074	98166550	476	238.0	
41117	chr7	98168346	98169034	688	344.0	
41118	chr7	98186806	98187445	639	320.0	
41119	chr7	98200364	98200685	321	160.0	
41120	chr7	98202303	98203627	1324	662.0	
41121	chr7	98210626	98212087	1461	730.0	
41122	chr7	98212776	98212913	137	68.0	
41123	chr7	98218095	98218611	516	258.0	
41124	chr7	98241332	98241793	461	230.0	
41125	chr7	98245547	98246187	640	320.0	
41126	chr7	98248762	98249680	918	459.0	
41127	chr7	98250514	98252973	2459	1230.0	
41128	chr7	98255128	98255607	479	240.0	
41129	chr7	98266835	98267260	425	212.0	
41130	chr7	98273829	98274356	527	264.0	
41131	chr7	98276119	98276839	720	360.0	
41132	chr7	98280376	98286783	6407	3204.0	
41133	chr7	98287946	98288440	494	247.0	
41134	chr7	98294777	98295254	477	238.0	
41135	chr7	98314429	98315680	1251	626.0	
41136	chr7	98400405	98401715	1310	655.0	
41137	chr7	98420958	98421380	422	211.0	
41138	chr7	98433280	98433707	427	214.0	
41139	chr7	98514153	98515232	1079	540.0	
41140	chr7	98515850	98515993	143	72.0	
41141	chr7	98641730	98642399	669	334.0	
41142	chr7	98733188	98733338	150	75.0	
41143	chr7	98745737	98746090	353	176.0	
41144	chr7	98801793	98802896	1103	552.0	
41145	chr7	98841667	98842178	511	256.0	
41146	chr7	98869495	98870845	1350	675.0	
41147	chr7	98872262	98872738	476	238.0	
41148	chr7	98877785	98880494	2709	1354.0	
41149	chr7	98930628	98931358	730	365.0	
41150	chr7	98985475	98985478	3	2.0	
41151	chr7	98989185	98989555	370	185.0	
41152	chr7	99005707	99006038	331	166.0	
41153	chr7	99040291	99040972	681	340.0	
41154	chr7	99109075	99109417	342	171.0	
41155	chr7	99112093	99112390	297	148.0	
41156	chr7	99118617	99119067	450	225.0	
41157	chr7	99120407	99120985	578	289.0	
41158	chr7	99141125	99145013	3888	1944.0	
41159	chr7	99248242	99249167	925	462.0	
41160	chr7	99274217	99274267	50	25.0	
41161	chr7	99312674	99313601	927	464.0	
41162	chr7	99325170	99327123	1953	976.0	
41163	chr7	99330381	99331053	672	336.0	
41164	chr7	99365450	99365999	549	274.0	
41165	chr7	99372915	99377873	4958	2479.0	
41166	chr7	99378623	99382131	3508	1754.0	
41167	chr7	99384454	99384842	388	194.0	
41168	chr7	99385445	99385885	440	220.0	
41169	chr7	99386655	99387518	863	432.0	
41170	chr7	99392294	99394361	2067	1034.0	
41171	chr7	99399192	99400182	990	495.0	
41172	chr7	99400904	99401034	130	65.0	
41173	chr7	99404619	99405305	686	343.0	
41174	chr7	99406498	99410242	3744	1872.0	
41175	chr7	99415439	99415930	491	246.0	
41176	chr7	99420190	99420372	182	91.0	
41177	chr7	99429069	99429091	22	11.0	
41178	chr7	99438173	99439844	1671	836.0	
41179	chr7	99459074	99459487	413	206.0	
41180	chr7	99465362	99466964	1602	801.0	
41181	chr7	99471183	99473723	2540	1270.0	
41182	chr7	99478672	99479531	859	430.0	
41183	chr7	99489417	99489527	110	55.0	
41184	chr7	99490602	99491189	587	294.0	
41185	chr7	99492399	99492649	250	125.0	
41186	chr7	99497772	99500961	3189	1594.0	
41187	chr7	99503982	99505846	1864	932.0	
41188	chr7	99551317	99552735	1418	709.0	
41189	chr7	99555052	99555342	290	145.0	
41190	chr7	99557372	99559682	2310	1155.0	
41191	chr7	99562883	99563241	358	179.0	
41192	chr7	99579842	99581000	1158	579.0	
41193	chr7	99616122	99617750	1628	814.0	
41194	chr7	99623232	99625197	1965	982.0	
41195	chr7	99740956	99741155	199	100.0	
41196	chr7	99788831	99788909	78	39.0	promoter
41197	chr7	99897947	99898042	95	48.0	
41198	chr7	99913051	99913612	561	280.0	
41199	chr7	99918737	99920234	1497	748.0	
41200	chr7	99929199	99929899	700	350.0	
41201	chr7	99944066	99944374	308	154.0	
41202	chr7	99953509	99954103	594	297.0	
41203	chr7	99979695	99980345	650	325.0	
41204	chr7	99990765	99991455	690	345.0	
41205	chr7	99994123	99994585	462	231.0	
41206	chr7	99997207	99998231	1024	512.0	
41207	chr7	100012902	100012932	30	15.0	
41208	chr7	100013458	100013473	15	8.0	
41209	chr7	100014936	100016879	1943	972.0	
41210	chr7	100026177	100026303	126	63.0	
41211	chr7	100044679	100045090	411	206.0	
41212	chr7	100049214	100050532	1318	659.0	
41213	chr7	100053200	100053663	463	232.0	
41214	chr7	100080928	100083287	2359	1180.0	
41215	chr7	100086118	100086565	447	224.0	
41216	chr7	100088339	100089743	1404	702.0	
41217	chr7	100091753	100091782	29	14.0	
41218	chr7	100095648	100095989	341	170.0	
41219	chr7	100100023	100102653	2630	1315.0	
41220	chr7	100118727	100120939	2212	1106.0	
41221	chr7	100125959	100128619	2660	1330.0	
41222	chr7	100130695	100131408	713	356.0	
41223	chr7	100132411	100133214	803	402.0	
41224	chr7	100141181	100141948	767	384.0	
41225	chr7	100148003	100149989	1986	993.0	
41226	chr7	100152168	100152876	708	354.0	
41227	chr7	100156190	100159658	3468	1734.0	
41228	chr7	100162999	100163770	771	386.0	
41229	chr7	100166134	100169972	3838	1919.0	
41230	chr7	100170975	100172307	1332	666.0	
41231	chr7	100173918	100174264	346	173.0	
41232	chr7	100175668	100178303	2635	1318.0	
41233	chr7	100180499	100181133	634	317.0	
41234	chr7	100182652	100183052	400	200.0	
41235	chr7	100189968	100190522	554	277.0	
41236	chr7	100192474	100192854	380	190.0	
41237	chr7	100196191	100196267	76	38.0	
41238	chr7	100199923	100200585	662	331.0	
41239	chr7	100208808	100209454	646	323.0	
41240	chr7	100211081	100212070	989	494.0	
41241	chr7	100216875	100218406	1531	766.0	
41242	chr7	100219053	100223882	4829	2414.0	
41243	chr7	100231347	100231511	164	82.0	
41244	chr7	100243378	100243881	503	252.0	
41245	chr7	100271202	100272839	1637	818.0	
41246	chr7	100317684	100318644	960	480.0	
41247	chr7	100334433	100336858	2425	1212.0	
41248	chr7	100344147	100345722	1575	788.0	
41249	chr7	100351567	100354299	2732	1366.0	
41250	chr7	100358486	100358863	377	188.0	
41251	chr7	100365210	100370079	4869	2434.0	
41252	chr7	100371764	100374950	3186	1593.0	
41253	chr7	100378393	100378440	47	24.0	
41254	chr7	100379345	100380605	1260	630.0	
41255	chr7	100382372	100383260	888	444.0	
41256	chr7	100384587	100385073	486	243.0	
41257	chr7	100393269	100393872	603	302.0	
41258	chr7	100396336	100397645	1309	654.0	
41259	chr7	100407309	100408178	869	434.0	
41260	chr7	100413310	100413628	318	159.0	
41261	chr7	100427664	100438138	10474	5237.0	
41262	chr7	100439412	100439447	35	18.0	
41263	chr7	100440539	100445506	4967	2484.0	
41264	chr7	100447472	100448330	858	429.0	
41265	chr7	100450035	100451545	1510	755.0	
41266	chr7	100454522	100455085	563	282.0	
41267	chr7	100456654	100456727	73	36.0	
41268	chr7	100465717	100466273	556	278.0	
41269	chr7	100469010	100470313	1303	652.0	
41270	chr7	100472771	100473335	564	282.0	
41271	chr7	100475585	100479839	4254	2127.0	
41272	chr7	100482828	100484898	2070	1035.0	
41273	chr7	100489779	100490233	454	227.0	
41274	chr7	100493315	100494102	787	394.0	
41275	chr7	100515970	100516821	851	426.0	
41276	chr7	100521878	100522329	451	226.0	
41277	chr7	100538284	100540297	2013	1006.0	
41278	chr7	100544654	100548358	3704	1852.0	
41279	chr7	100549723	100550854	1131	566.0	
41280	chr7	100556611	100556933	322	161.0	
41281	chr7	100559480	100560414	934	467.0	
41282	chr7	100563631	100564671	1040	520.0	
41283	chr7	100566875	100574857	7982	3991.0	
41284	chr7	100582953	100587456	4503	2252.0	
41285	chr7	100588423	100588889	466	233.0	
41286	chr7	100603429	100606225	2796	1398.0	
41287	chr7	100607137	100607527	390	195.0	
41288	chr7	100611380	100614151	2771	1386.0	
41289	chr7	100626091	100627432	1341	670.0	
41290	chr7	100629282	100629714	432	216.0	
41291	chr7	100632799	100634296	1497	748.0	
41292	chr7	100642531	100642979	448	224.0	
41293	chr7	100655989	100656778	789	394.0	
41294	chr7	100672729	100678830	6101	3050.0	
41295	chr7	100679433	100683190	3757	1878.0	
41296	chr7	100684571	100684840	269	134.0	
41297	chr7	100691390	100692451	1061	530.0	
41298	chr7	100693147	100696009	2862	1431.0	
41299	chr7	100704988	100706875	1887	944.0	
41300	chr7	100725167	100725720	553	276.0	
41301	chr7	100745178	100745719	541	270.0	
41302	chr7	100799172	100799906	734	367.0	
41303	chr7	100803255	100804081	826	413.0	
41304	chr7	100813796	100814541	745	372.0	
41305	chr7	100825805	100826255	450	225.0	
41306	chr7	100826979	100828879	1900	950.0	
41307	chr7	100836966	100837902	936	468.0	
41308	chr7	100851743	100853992	2249	1124.0	
41309	chr7	100865637	100868880	3243	1622.0	
41310	chr7	100874225	100876020	1795	898.0	
41311	chr7	100876722	100877042	320	160.0	
41312	chr7	100884511	100885579	1068	534.0	
41313	chr7	100886944	100891367	4423	2212.0	
41314	chr7	100894343	100897740	3397	1698.0	
41315	chr7	100910295	100911118	823	412.0	
41316	chr7	100912666	100912954	288	144.0	
41317	chr7	100915009	100915535	526	263.0	
41318	chr7	100916483	100917032	549	274.0	
41319	chr7	100991730	100992055	325	162.0	
41320	chr7	101016552	101017951	1399	700.0	
41321	chr7	101018555	101019141	586	293.0	
41322	chr7	101058380	101059813	1433	716.0	
41323	chr7	101077171	101078198	1027	514.0	
41324	chr7	101084787	101086305	1518	759.0	
41325	chr7	101094826	101095205	379	190.0	
41326	chr7	101099951	101100734	783	392.0	
41327	chr7	101108052	101108772	720	360.0	
41328	chr7	101122099	101122802	703	352.0	
41329	chr7	101124614	101125064	450	225.0	
41330	chr7	101126041	101127349	1308	654.0	
41331	chr7	101128323	101128403	80	40.0	
41332	chr7	101134587	101134669	82	41.0	
41333	chr7	101137115	101138982	1867	934.0	
41334	chr7	101143729	101144631	902	451.0	
41335	chr7	101146965	101147364	399	200.0	
41336	chr7	101153710	101155622	1912	956.0	
41337	chr7	101162666	101166284	3618	1809.0	
41338	chr7	101166941	101167013	72	36.0	
41339	chr7	101168147	101174787	6640	3320.0	
41340	chr7	101179040	101179531	491	246.0	
41341	chr7	101180251	101180575	324	162.0	
41342	chr7	101182428	101182871	443	222.0	
41343	chr7	101186856	101187407	551	276.0	
41344	chr7	101192275	101193171	896	448.0	
41345	chr7	101201728	101202315	587	294.0	
41346	chr7	101203691	101204757	1066	533.0	
41347	chr7	101216428	101218776	2348	1174.0	
41348	chr7	101237943	101238050	107	54.0	
41349	chr7	101240948	101241341	393	196.0	
41350	chr7	101243760	101245707	1947	974.0	
41351	chr7	101251664	101253137	1473	736.0	
41352	chr7	101282574	101283454	880	440.0	
41353	chr7	101287033	101287487	454	227.0	
41354	chr7	101290363	101290838	475	238.0	
41355	chr7	101303459	101303707	248	124.0	
41356	chr7	101308069	101308683	614	307.0	
41357	chr7	101315231	101315669	438	219.0	
41358	chr7	101321150	101322439	1289	644.0	
41359	chr7	101352532	101352592	60	30.0	
41360	chr7	101362942	101364355	1413	706.0	
41361	chr7	101370820	101371154	334	167.0	
41362	chr7	101390879	101391288	409	204.0	
41363	chr7	101411161	101411995	834	417.0	
41364	chr7	101538782	101539213	431	216.0	
41365	chr7	101542746	101543265	519	260.0	
41366	chr7	101602361	101602859	498	249.0	
41367	chr7	101688015	101689074	1059	530.0	
41368	chr7	101717063	101718787	1724	862.0	
41369	chr7	101726648	101726913	265	132.0	
41370	chr7	101728787	101729804	1017	508.0	
41371	chr7	101733399	101734260	861	430.0	
41372	chr7	101740908	101741606	698	349.0	
41373	chr7	101743100	101744138	1038	519.0	
41374	chr7	101746326	101746692	366	183.0	
41375	chr7	101754449	101754977	528	264.0	
41376	chr7	101784357	101784757	400	200.0	
41377	chr7	101794357	101794682	325	162.0	
41378	chr7	101796595	101797424	829	414.0	
41379	chr7	101803924	101804474	550	275.0	
41380	chr7	101813818	101818254	4436	2218.0	
41381	chr7	101819246	101819251	5	2.0	
41382	chr7	101823118	101823929	811	406.0	
41383	chr7	101855920	101857844	1924	962.0	
41384	chr7	101882037	101883396	1359	680.0	
41385	chr7	101884990	101885224	234	117.0	
41386	chr7	101891997	101892830	833	416.0	
41387	chr7	101904701	101905223	522	261.0	
41388	chr7	101912073	101912518	445	222.0	
41389	chr7	101952929	101953868	939	470.0	
41390	chr7	101990659	101991468	809	404.0	
41391	chr7	102028513	102028601	88	44.0	
41392	chr7	102044898	102046502	1604	802.0	
41393	chr7	102061677	102062764	1087	544.0	
41394	chr7	102064353	102065256	903	452.0	
41395	chr7	102121970	102122462	492	246.0	
41396	chr7	102132106	102132978	872	436.0	
41397	chr7	102134437	102134826	389	194.0	
41398	chr7	102140699	102141751	1052	526.0	
41399	chr7	102146977	102147454	477	238.0	
41400	chr7	102236709	102237051	342	171.0	
41401	chr7	102272113	102272651	538	269.0	
41402	chr7	102279345	102280220	875	438.0	
41403	chr7	102284040	102289705	5665	2832.0	
41404	chr7	102291574	102291929	355	178.0	
41405	chr7	102303652	102303866	214	107.0	
41406	chr7	102305483	102307718	2235	1118.0	
41407	chr7	102363221	102364655	1434	717.0	
41408	chr7	102390513	102391334	821	410.0	
41409	chr7	102395330	102397293	1963	982.0	
41410	chr7	102404147	102405182	1035	518.0	
41411	chr7	102408426	102408940	514	257.0	
41412	chr7	102412283	102413121	838	419.0	
41413	chr7	102415193	102417570	2377	1188.0	
41414	chr7	102420773	102421567	794	397.0	
41415	chr7	102424547	102427512	2965	1482.0	
41416	chr7	102430587	102434950	4363	2182.0	
41417	chr7	102441520	102442289	769	384.0	
41418	chr7	102443390	102443749	359	180.0	
41419	chr7	102445132	102445343	211	106.0	
41420	chr7	102450139	102450712	573	286.0	
41421	chr7	102464176	102466145	1969	984.0	
41422	chr7	102470497	102470763	266	133.0	
41423	chr7	102478494	102479362	868	434.0	
41424	chr7	102479937	102480464	527	264.0	
41425	chr7	102490559	102490906	347	174.0	
41426	chr7	102512360	102513330	970	485.0	
41427	chr7	102517612	102517943	331	166.0	
41428	chr7	102572077	102573076	999	500.0	
41429	chr7	102611900	102612303	403	202.0	
41430	chr7	102616516	102617551	1035	518.0	
41431	chr7	102713271	102713763	492	246.0	
41432	chr7	102718555	102718634	79	40.0	
41433	chr7	102748264	102749632	1368	684.0	
41434	chr7	102812301	102812302	1	0.0	
41435	chr7	102890500	102890921	421	210.0	
41436	chr7	102892721	102892947	226	113.0	
41437	chr7	102898214	102898949	735	368.0	
41438	chr7	102953561	102953756	195	98.0	
41439	chr7	102978260	102978660	400	200.0	
41440	chr7	102988964	102989161	197	98.0	
41441	chr7	102991024	102991996	972	486.0	
41442	chr7	103009856	103010181	325	162.0	
41443	chr7	103061890	103062291	401	200.0	
41444	chr7	103065647	103066071	424	212.0	
41445	chr7	103073915	103076043	2128	1064.0	
41446	chr7	103076720	103077197	477	238.0	
41447	chr7	103078167	103078718	551	276.0	
41448	chr7	103148536	103150148	1612	806.0	
41449	chr7	103155350	103156239	889	444.0	
41450	chr7	103279296	103281304	2008	1004.0	
41451	chr7	103296738	103298204	1466	733.0	
41452	chr7	103336816	103337096	280	140.0	
41453	chr7	103343576	103345303	1727	864.0	
41454	chr7	103347091	103348884	1793	896.0	
41455	chr7	103349800	103349945	145	72.0	
41456	chr7	103406797	103407317	520	260.0	
41457	chr7	103445985	103446082	97	48.0	
41458	chr7	104207036	104208714	1678	839.0	
41459	chr7	104231380	104231848	468	234.0	
41460	chr7	104848385	104848820	435	218.0	
41461	chr7	104883589	104884470	881	440.0	
41462	chr7	104895561	104895861	300	150.0	
41463	chr7	104897078	104897488	410	205.0	
41464	chr7	104918500	104919052	552	276.0	
41465	chr7	104922671	104923509	838	419.0	
41466	chr7	104933196	104933995	799	400.0	
41467	chr7	104940327	104947014	6687	3344.0	
41468	chr7	104951510	104952119	609	304.0	
41469	chr7	104953293	104953317	24	12.0	
41470	chr7	104955486	104955600	114	57.0	
41471	chr7	104956904	104957753	849	424.0	
41472	chr7	104960659	104962279	1620	810.0	
41473	chr7	104963758	104964059	301	150.0	
41474	chr7	104973671	104974496	825	412.0	
41475	chr7	104980928	104981796	868	434.0	
41476	chr7	104982541	104985232	2691	1346.0	
41477	chr7	104986646	104987094	448	224.0	
41478	chr7	105003058	105004431	1373	686.0	
41479	chr7	105006266	105018329	12063	6032.0	
41480	chr7	105019886	105025089	5203	2602.0	
41481	chr7	105026161	105027498	1337	668.0	
41482	chr7	105028016	105028771	755	378.0	
41483	chr7	105030018	105030062	44	22.0	
41484	chr7	105032917	105032938	21	10.0	
41485	chr7	105033817	105034636	819	410.0	
41486	chr7	105036177	105036732	555	278.0	
41487	chr7	105041124	105041597	473	236.0	
41488	chr7	105044789	105045042	253	126.0	
41489	chr7	105060690	105060720	30	15.0	
41490	chr7	105067967	105068050	83	42.0	
41491	chr7	105099195	105099238	43	22.0	
41492	chr7	105112030	105112920	890	445.0	
41493	chr7	105152898	105153299	401	200.0	
41494	chr7	105191290	105192017	727	364.0	
41495	chr7	105193146	105193533	387	194.0	
41496	chr7	105205538	105206009	471	236.0	
41497	chr7	105210721	105211369	648	324.0	
41498	chr7	105213543	105214125	582	291.0	
41499	chr7	105225151	105225648	497	248.0	
41500	chr7	105257455	105257581	126	63.0	
41501	chr7	105267307	105267601	294	147.0	
41502	chr7	105268135	105269719	1584	792.0	
41503	chr7	105298314	105298807	493	246.0	
41504	chr7	105300514	105301078	564	282.0	
41505	chr7	105325254	105325593	339	170.0	
41506	chr7	105345738	105347108	1370	685.0	
41507	chr7	105351593	105353087	1494	747.0	
41508	chr7	105353726	105354768	1042	521.0	
41509	chr7	105355321	105356013	692	346.0	
41510	chr7	105387604	105389747	2143	1072.0	
41511	chr7	105392147	105392472	325	162.0	
41512	chr7	105401560	105402041	481	240.0	
41513	chr7	105429636	105430106	470	235.0	
41514	chr7	105448349	105448562	213	106.0	
41515	chr7	105487930	105488319	389	194.0	
41516	chr7	105521165	105522986	1821	910.0	
41517	chr7	105524814	105525278	464	232.0	
41518	chr7	105531145	105532965	1820	910.0	
41519	chr7	105581157	105581817	660	330.0	
41520	chr7	105589354	105589883	529	264.0	
41521	chr7	105652288	105652778	490	245.0	
41522	chr7	105656842	105657554	712	356.0	
41523	chr7	105674013	105674919	906	453.0	
41524	chr7	105675662	105679593	3931	1966.0	
41525	chr7	105690755	105692702	1947	974.0	
41526	chr7	105707894	105708318	424	212.0	
41527	chr7	105718589	105719055	466	233.0	
41528	chr7	105760212	105761265	1053	526.0	
41529	chr7	105765103	105765472	369	184.0	
41530	chr7	105806354	105807497	1143	572.0	
41531	chr7	105808857	105809857	1000	500.0	
41532	chr7	105848794	105850096	1302	651.0	
41533	chr7	105857475	105858053	578	289.0	
41534	chr7	105875161	105877697	2536	1268.0	
41535	chr7	105878234	105879779	1545	772.0	
41536	chr7	105890575	105890589	14	7.0	
41537	chr7	105924714	105925347	633	316.0	
41538	chr7	106009124	106010220	1096	548.0	
41539	chr7	106012422	106012476	54	27.0	
41540	chr7	106021688	106024332	2644	1322.0	
41541	chr7	106041059	106041561	502	251.0	
41542	chr7	106042504	106043257	753	376.0	
41543	chr7	106056825	106058819	1994	997.0	
41544	chr7	106059472	106059937	465	232.0	
41545	chr7	106061478	106061878	400	200.0	
41546	chr7	106071145	106072335	1190	595.0	
41547	chr7	106076532	106076681	149	74.0	
41548	chr7	106089671	106090057	386	193.0	
41549	chr7	106109084	106113234	4150	2075.0	
41550	chr7	106114728	106115220	492	246.0	
41551	chr7	106126317	106126875	558	279.0	
41552	chr7	106153598	106154291	693	346.0	
41553	chr7	106155980	106156442	462	231.0	
41554	chr7	106166672	106167141	469	234.0	
41555	chr7	106176536	106177345	809	404.0	
41556	chr7	106244171	106244358	187	94.0	
41557	chr7	106246906	106249915	3009	1504.0	
41558	chr7	106250911	106271455	20544	10272.0	
41559	chr7	106272709	106286520	13811	6906.0	
41560	chr7	106287537	106287812	275	138.0	
41561	chr7	106289945	106290245	300	150.0	
41562	chr7	106293433	106293445	12	6.0	
41563	chr7	106304564	106304924	360	180.0	
41564	chr7	106313605	106314552	947	474.0	
41565	chr7	106344290	106347980	3690	1845.0	
41566	chr7	106357732	106358011	279	140.0	
41567	chr7	106365123	106365988	865	432.0	
41568	chr7	106366960	106368024	1064	532.0	
41569	chr7	106371483	106372007	524	262.0	
41570	chr7	106417971	106418759	788	394.0	
41571	chr7	106420712	106422052	1340	670.0	
41572	chr7	106424386	106425827	1441	720.0	
41573	chr7	106462371	106462823	452	226.0	
41574	chr7	106501975	106502457	482	241.0	
41575	chr7	106542434	106542941	507	254.0	
41576	chr7	106552607	106553433	826	413.0	
41577	chr7	106568735	106569109	374	187.0	
41578	chr7	106598282	106599398	1116	558.0	
41579	chr7	106604447	106604941	494	247.0	
41580	chr7	106645003	106645380	377	188.0	
41581	chr7	106657350	106657790	440	220.0	
41582	chr7	106659645	106662583	2938	1469.0	
41583	chr7	106679110	106679875	765	382.0	
41584	chr7	106704270	106704801	531	266.0	
41585	chr7	106717780	106718825	1045	522.0	
41586	chr7	106720582	106720983	401	200.0	
41587	chr7	106722084	106722551	467	234.0	
41588	chr7	106729946	106730303	357	178.0	
41589	chr7	106730908	106731628	720	360.0	
41590	chr7	106736444	106737337	893	446.0	
41591	chr7	106757910	106758169	259	130.0	
41592	chr7	106767918	106768811	893	446.0	
41593	chr7	106792980	106793440	460	230.0	
41594	chr7	106811929	106812343	414	207.0	
41595	chr7	106858620	106859508	888	444.0	
41596	chr7	106862495	106863853	1358	679.0	
41597	chr7	106864534	106866045	1511	756.0	
41598	chr7	106866558	106867421	863	432.0	
41599	chr7	106870946	106872648	1702	851.0	
41600	chr7	106874095	106874433	338	169.0	
41601	chr7	106895133	106895687	554	277.0	
41602	chr7	106901787	106902320	533	266.0	
41603	chr7	106947187	106947657	470	235.0	
41604	chr7	106952713	106953464	751	376.0	
41605	chr7	106957700	106958244	544	272.0	
41606	chr7	107027205	107028397	1192	596.0	
41607	chr7	107037690	107038631	941	470.0	
41608	chr7	107041215	107041600	385	192.0	
41609	chr7	107044065	107045812	1747	874.0	
41610	chr7	107077130	107077568	438	219.0	
41611	chr7	107103269	107103916	647	324.0	
41612	chr7	107105009	107105214	205	102.0	
41613	chr7	107125958	107127176	1218	609.0	
41614	chr7	107147394	107147919	525	262.0	
41615	chr7	107150361	107150865	504	252.0	
41616	chr7	107167480	107172224	4744	2372.0	
41617	chr7	107172992	107173073	81	40.0	
41618	chr7	107173827	107174476	649	324.0	
41619	chr7	107175147	107176190	1043	522.0	
41620	chr7	107179558	107179895	337	168.0	
41621	chr7	107180431	107180932	501	250.0	
41622	chr7	107194079	107194145	66	33.0	
41623	chr7	107194931	107195328	397	198.0	
41624	chr7	107201825	107202295	470	235.0	
41625	chr7	107204946	107205013	67	34.0	
41626	chr7	107207856	107207863	7	4.0	
41627	chr7	107463078	107463561	483	242.0	
41628	chr7	107506580	107507201	621	310.0	
41629	chr7	107560421	107561913	1492	746.0	
41630	chr7	107563077	107564904	1827	914.0	
41631	chr7	107579123	107580955	1832	916.0	
41632	chr7	107622422	107622926	504	252.0	
41633	chr7	107628651	107629075	424	212.0	
41634	chr7	107638531	107639081	550	275.0	
41635	chr7	107659811	107659990	179	90.0	
41636	chr7	107660612	107662145	1533	766.0	
41637	chr7	107725114	107725532	418	209.0	
41638	chr7	107742690	107744992	2302	1151.0	
41639	chr7	107856885	107857710	825	412.0	
41640	chr7	107874441	107876115	1674	837.0	
41641	chr7	107879295	107879870	575	288.0	
41642	chr7	107890354	107892474	2120	1060.0	
41643	chr7	107899018	107899355	337	168.0	
41644	chr7	107907704	107908399	695	348.0	
41645	chr7	107914873	107915206	333	166.0	
41646	chr7	108135548	108136460	912	456.0	
41647	chr7	108146172	108146573	401	200.0	
41648	chr7	108181060	108181452	392	196.0	
41649	chr7	108294718	108294939	221	110.0	
41650	chr7	108415158	108416906	1748	874.0	
41651	chr7	108452707	108453154	447	224.0	
41652	chr7	108454655	108457120	2465	1232.0	
41653	chr7	108460005	108460346	341	170.0	
41654	chr7	108463588	108464038	450	225.0	
41655	chr7	108468915	108469390	475	238.0	
41656	chr7	108497057	108497604	547	274.0	
41657	chr7	108503276	108504043	767	384.0	
41658	chr7	108515624	108516171	547	274.0	
41659	chr7	108517720	108517727	7	4.0	
41660	chr7	108523201	108523756	555	278.0	
41661	chr7	108524590	108527254	2664	1332.0	
41662	chr7	108535224	108535587	363	182.0	
41663	chr7	108551804	108552285	481	240.0	
41664	chr7	108568735	108571411	2676	1338.0	
41665	chr7	108575372	108575383	11	6.0	
41666	chr7	108577020	108577281	261	130.0	
41667	chr7	108579114	108579652	538	269.0	
41668	chr7	108580350	108580497	147	74.0	
41669	chr7	108613152	108613509	357	178.0	
41670	chr7	110977421	110977574	153	76.0	
41671	chr7	111009741	111009935	194	97.0	
41672	chr7	111012904	111013844	940	470.0	
41673	chr7	111024937	111025476	539	270.0	
41674	chr7	111029746	111029861	115	58.0	
41675	chr7	111083227	111083931	704	352.0	
41676	chr7	111089811	111090239	428	214.0	
41677	chr7	111090787	111091341	554	277.0	
41678	chr7	111098601	111099070	469	234.0	
41679	chr7	111137748	111138693	945	472.0	
41680	chr7	111532007	111532375	368	184.0	
41681	chr7	111560925	111563163	2238	1119.0	
41682	chr7	111735630	111736065	435	218.0	
41683	chr7	111741690	111742177	487	244.0	
41684	chr7	111752166	111752591	425	212.0	
41685	chr7	111987005	111988139	1134	567.0	
41686	chr7	112080259	112082632	2373	1186.0	
41687	chr7	112084059	112085107	1048	524.0	
41688	chr7	112089501	112090029	528	264.0	
41689	chr7	112103199	112103584	385	192.0	
41690	chr7	112112736	112113315	579	290.0	
41691	chr7	112124287	112124784	497	248.0	
41692	chr7	112159242	112159785	543	272.0	
41693	chr7	112202961	112203072	111	56.0	
41694	chr7	112203913	112207670	3757	1878.0	
41695	chr7	112272884	112273316	432	216.0	
41696	chr7	112390858	112392575	1717	858.0	
41697	chr7	112398580	112398688	108	54.0	
41698	chr7	112414934	112415276	342	171.0	
41699	chr7	112421718	112423260	1542	771.0	
41700	chr7	112445384	112445491	107	54.0	
41701	chr7	112449270	112456038	6768	3384.0	
41702	chr7	112458842	112460817	1975	988.0	
41703	chr7	112461938	112463041	1103	552.0	
41704	chr7	112464592	112466646	2054	1027.0	
41705	chr7	112467451	112468945	1494	747.0	
41706	chr7	112469510	112474450	4940	2470.0	
41707	chr7	112474977	112475369	392	196.0	
41708	chr7	112475940	112482659	6719	3360.0	
41709	chr7	112483567	112485209	1642	821.0	
41710	chr7	112486697	112486828	131	66.0	
41711	chr7	112487419	112487739	320	160.0	
41712	chr7	112489679	112490346	667	334.0	
41713	chr7	112492165	112492731	566	283.0	
41714	chr7	112495767	112496258	491	246.0	
41715	chr7	112497556	112497587	31	16.0	
41716	chr7	112503650	112503816	166	83.0	
41717	chr7	112509834	112510871	1037	518.0	
41718	chr7	112550431	112550863	432	216.0	
41719	chr7	112789375	112791068	1693	846.0	
41720	chr7	112798476	112799606	1130	565.0	
41721	chr7	112866516	112866782	266	133.0	
41722	chr7	112869119	112869597	478	239.0	
41723	chr7	112882515	112882906	391	196.0	
41724	chr7	112887400	112887523	123	62.0	
41725	chr7	112898624	112899134	510	255.0	
41726	chr7	112930654	112931278	624	312.0	
41727	chr7	112938629	112941038	2409	1204.0	
41728	chr7	113071452	113071879	427	214.0	
41729	chr7	113086416	113086843	427	214.0	
41730	chr7	113087611	113088012	401	200.0	
41731	chr7	113116984	113119297	2313	1156.0	
41732	chr7	113120981	113120982	1	0.0	
41733	chr7	113143952	113144367	415	208.0	
41734	chr7	113421625	113422160	535	268.0	
41735	chr7	113710343	113710645	302	151.0	
41736	chr7	113774489	113774539	50	25.0	
41737	chr7	114026539	114026680	141	70.0	
41738	chr7	114047975	114048702	727	364.0	
41739	chr7	114051718	114052583	865	432.0	
41740	chr7	114081937	114082292	355	178.0	
41741	chr7	114084248	114087652	3404	1702.0	
41742	chr7	114865528	114865998	470	235.0	
41743	chr7	114916246	114917239	993	496.0	
41744	chr7	114918607	114920129	1522	761.0	
41745	chr7	114921450	114924723	3273	1636.0	
41746	chr7	114925432	114925695	263	132.0	
41747	chr7	114928313	114928706	393	196.0	
41748	chr7	114929636	114929784	148	74.0	
41749	chr7	114930723	114932131	1408	704.0	
41750	chr7	114932966	114934444	1478	739.0	
41751	chr7	114939731	114940090	359	180.0	
41752	chr7	114942494	114942954	460	230.0	
41753	chr7	114957459	114957800	341	170.0	
41754	chr7	114970118	114970768	650	325.0	
41755	chr7	114981272	114982089	817	408.0	
41756	chr7	114997744	114997861	117	58.0	
41757	chr7	115008337	115010369	2032	1016.0	
41758	chr7	115019822	115020634	812	406.0	
41759	chr7	115023256	115023641	385	192.0	
41760	chr7	115060389	115060949	560	280.0	
41761	chr7	115066140	115066360	220	110.0	
41762	chr7	115136122	115136372	250	125.0	
41763	chr7	115145455	115145866	411	206.0	
41764	chr7	115183569	115183888	319	160.0	
41765	chr7	115229348	115230039	691	346.0	
41766	chr7	115231177	115231514	337	168.0	
41767	chr7	115410368	115411487	1119	560.0	
41768	chr7	115435191	115435479	288	144.0	
41769	chr7	115476743	115477740	997	498.0	
41770	chr7	115505142	115505559	417	208.0	
41771	chr7	115910567	115910957	390	195.0	
41772	chr7	115940670	115940770	100	50.0	
41773	chr7	115965845	115966235	390	195.0	
41774	chr7	115980275	115980340	65	32.0	
41775	chr7	116025050	116025907	857	428.0	
41776	chr7	116027840	116028110	270	135.0	
41777	chr7	116030546	116031164	618	309.0	
41778	chr7	116087333	116087647	314	157.0	
41779	chr7	116095396	116095795	399	200.0	
41780	chr7	116097380	116097791	411	206.0	
41781	chr7	116138145	116138633	488	244.0	
41782	chr7	116142578	116143248	670	335.0	
41783	chr7	116162248	116162607	359	180.0	
41784	chr7	116165585	116166548	963	482.0	
41785	chr7	116167120	116167633	513	256.0	
41786	chr7	116173013	116173472	459	230.0	
41787	chr7	116180126	116180808	682	341.0	
41788	chr7	116209435	116215926	6491	3246.0	
41789	chr7	116218141	116218684	543	272.0	
41790	chr7	116219283	116219666	383	192.0	
41791	chr7	116223460	116225250	1790	895.0	
41792	chr7	116229180	116231105	1925	962.0	
41793	chr7	116231829	116232233	404	202.0	
41794	chr7	116233095	116233185	90	45.0	
41795	chr7	116234818	116235190	372	186.0	
41796	chr7	116235774	116236496	722	361.0	
41797	chr7	116250013	116250337	324	162.0	
41798	chr7	116258646	116259120	474	237.0	
41799	chr7	116499231	116500989	1758	879.0	
41800	chr7	116511382	116512613	1231	616.0	
41801	chr7	116524470	116527045	2575	1288.0	
41802	chr7	116530379	116530489	110	55.0	
41803	chr7	116573602	116573844	242	121.0	
41804	chr7	116583651	116584101	450	225.0	
41805	chr7	116588202	116589424	1222	611.0	
41806	chr7	116591622	116592757	1135	568.0	
41807	chr7	116610100	116610501	401	200.0	
41808	chr7	116621604	116621995	391	196.0	
41809	chr7	116630850	116631365	515	258.0	
41810	chr7	116633502	116633895	393	196.0	
41811	chr7	116671695	116672700	1005	502.0	
41812	chr7	116683839	116684094	255	128.0	
41813	chr7	116692912	116693371	459	230.0	
41814	chr7	116786692	116787329	637	318.0	
41815	chr7	116802659	116803233	574	287.0	
41816	chr7	116809655	116810101	446	223.0	
41817	chr7	116812901	116813161	260	130.0	
41818	chr7	116842614	116842651	37	18.0	
41819	chr7	116843235	116844712	1477	738.0	
41820	chr7	116859213	116859962	749	374.0	
41821	chr7	116861794	116863917	2123	1062.0	
41822	chr7	116865438	116865827	389	194.0	
41823	chr7	116871271	116871461	190	95.0	
41824	chr7	116874504	116874574	70	35.0	
41825	chr7	116902872	116902986	114	57.0	
41826	chr7	116930168	116931085	917	458.0	
41827	chr7	116952851	116954709	1858	929.0	
41828	chr7	116955723	116956534	811	406.0	
41829	chr7	116962237	116962646	409	204.0	
41830	chr7	116970108	116970762	654	327.0	
41831	chr7	116984774	116985250	476	238.0	
41832	chr7	117007297	117007589	292	146.0	
41833	chr7	117009176	117009633	457	228.0	
41834	chr7	117011809	117012809	1000	500.0	
41835	chr7	117014668	117015093	425	212.0	
41836	chr7	117066714	117066942	228	114.0	
41837	chr7	117072790	117073048	258	129.0	
41838	chr7	117092375	117092453	78	39.0	
41839	chr7	117110385	117111063	678	339.0	
41840	chr7	117119409	117119890	481	240.0	
41841	chr7	117124610	117125121	511	256.0	
41842	chr7	117127520	117127993	473	236.0	
41843	chr7	117134781	117135528	747	374.0	
41844	chr7	117139173	117139620	447	224.0	
41845	chr7	117146107	117146895	788	394.0	
41846	chr7	117212965	117213379	414	207.0	
41847	chr7	117773477	117774147	670	335.0	
41848	chr7	117775863	117776208	345	172.0	
41849	chr7	117791936	117792894	958	479.0	
41850	chr7	117873270	117873581	311	156.0	
41851	chr7	118153545	118153960	415	208.0	
41852	chr7	118183153	118184978	1825	912.0	
41853	chr7	118195776	118196287	511	256.0	
41854	chr7	118214033	118215018	985	492.0	
41855	chr7	118288379	118288401	22	11.0	
41856	chr7	118311394	118311981	587	294.0	
41857	chr7	119270000	119270307	307	154.0	
41858	chr7	120791975	120792417	442	221.0	
41859	chr7	120805844	120806302	458	229.0	
41860	chr7	120856807	120858261	1454	727.0	
41861	chr7	120927728	120928041	313	156.0	
41862	chr7	120941292	120941508	216	108.0	
41863	chr7	120949788	120952203	2415	1208.0	
41864	chr7	120987379	120989970	2591	1296.0	
41865	chr7	120994963	120997383	2420	1210.0	
41866	chr7	120997955	120998324	369	184.0	
41867	chr7	120999996	121000272	276	138.0	
41868	chr7	121018929	121019456	527	264.0	
41869	chr7	121020575	121021159	584	292.0	
41870	chr7	121023231	121023638	407	204.0	
41871	chr7	121081280	121081797	517	258.0	
41872	chr7	121107875	121108342	467	234.0	
41873	chr7	121138173	121138776	603	302.0	
41874	chr7	121179126	121179238	112	56.0	
41875	chr7	121180388	121180905	517	258.0	
41876	chr7	121314345	121314599	254	127.0	
41877	chr7	121328693	121330791	2098	1049.0	
41878	chr7	121360542	121360989	447	224.0	
41879	chr7	121366767	121367230	463	232.0	
41880	chr7	121369656	121369731	75	38.0	
41881	chr7	121372563	121373074	511	256.0	
41882	chr7	121385621	121386214	593	296.0	
41883	chr7	121395368	121396932	1564	782.0	
41884	chr7	121438104	121438951	847	424.0	
41885	chr7	121440887	121441561	674	337.0	
41886	chr7	121442780	121443298	518	259.0	
41887	chr7	121510292	121510683	391	196.0	
41888	chr7	121519959	121520591	632	316.0	
41889	chr7	121530160	121531289	1129	564.0	
41890	chr7	121547460	121547957	497	248.0	
41891	chr7	122092923	122093348	425	212.0	
41892	chr7	122143144	122145004	1860	930.0	
41893	chr7	123494173	123494598	425	212.0	
41894	chr7	123532780	123535670	2890	1445.0	
41895	chr7	123537044	123537457	413	206.0	
41896	chr7	123557096	123558606	1510	755.0	
41897	chr7	123569429	123569813	384	192.0	
41898	chr7	123580848	123581180	332	166.0	
41899	chr7	123624586	123624987	401	200.0	
41900	chr7	123682665	123683022	357	178.0	
41901	chr7	123701505	123701887	382	191.0	
41902	chr7	123719275	123719634	359	180.0	
41903	chr7	123746173	123746270	97	48.0	
41904	chr7	123746994	123749977	2983	1492.0	
41905	chr7	123770281	123771118	837	418.0	
41906	chr7	123784525	123784530	5	2.0	
41907	chr7	123865479	123865963	484	242.0	
41908	chr7	123867122	123867667	545	272.0	
41909	chr7	123872250	123872645	395	198.0	
41910	chr7	124856343	124856671	328	164.0	
41911	chr7	124929045	124931823	2778	1389.0	
41912	chr7	126700921	126701498	577	288.0	
41913	chr7	127251389	127254379	2990	1495.0	
41914	chr7	127322316	127322856	540	270.0	
41915	chr7	127347384	127348392	1008	504.0	
41916	chr7	127380570	127380891	321	160.0	
41917	chr7	127383308	127383627	319	160.0	
41918	chr7	127391185	127394051	2866	1433.0	
41919	chr7	127395316	127395521	205	102.0	
41920	chr7	127396073	127396748	675	338.0	
41921	chr7	127404595	127404833	238	119.0	
41922	chr7	127407994	127408286	292	146.0	
41923	chr7	127413329	127414804	1475	738.0	
41924	chr7	127417449	127417723	274	137.0	
41925	chr7	127447136	127447845	709	354.0	
41926	chr7	127451266	127451590	324	162.0	
41927	chr7	127514509	127514898	389	194.0	
41928	chr7	127583799	127586268	2469	1234.0	
41929	chr7	127587573	127590341	2768	1384.0	
41930	chr7	127593857	127595030	1173	586.0	
41931	chr7	127629282	127629644	362	181.0	
41932	chr7	127650849	127653056	2207	1104.0	
41933	chr7	127654484	127655431	947	474.0	
41934	chr7	127659013	127659230	217	108.0	
41935	chr7	127667957	127668681	724	362.0	
41936	chr7	127685595	127686134	539	270.0	
41937	chr7	127708668	127709162	494	247.0	
41938	chr7	127751377	127751723	346	173.0	
41939	chr7	127761192	127761595	403	202.0	
41940	chr7	127766919	127767357	438	219.0	
41941	chr7	127782099	127783452	1353	676.0	
41942	chr7	127791745	127792093	348	174.0	
41943	chr7	127792696	127794019	1323	662.0	
41944	chr7	127819999	127820858	859	430.0	
41945	chr7	127833647	127833997	350	175.0	
41946	chr7	127845028	127845118	90	45.0	
41947	chr7	127856540	127857320	780	390.0	
41948	chr7	127865545	127865768	223	112.0	
41949	chr7	127870289	127870948	659	330.0	
41950	chr7	127876459	127876533	74	37.0	
41951	chr7	127953636	127954078	442	221.0	
41952	chr7	128000129	128000486	357	178.0	
41953	chr7	128001021	128001055	34	17.0	
41954	chr7	128003212	128004188	976	488.0	
41955	chr7	128020265	128020286	21	10.0	
41956	chr7	128025757	128026281	524	262.0	
41957	chr7	128030834	128032918	2084	1042.0	
41958	chr7	128059045	128059604	559	280.0	
41959	chr7	128102624	128102692	68	34.0	
41960	chr7	128103508	128104839	1331	666.0	
41961	chr7	128108373	128109857	1484	742.0	
41962	chr7	128112305	128113221	916	458.0	
41963	chr7	128121575	128122997	1422	711.0	
41964	chr7	128129272	128129621	349	174.0	
41965	chr7	128135206	128137739	2533	1266.0	
41966	chr7	128151625	128151961	336	168.0	
41967	chr7	128166740	128168918	2178	1089.0	
41968	chr7	128201230	128201626	396	198.0	
41969	chr7	128208412	128208894	482	241.0	
41970	chr7	128209653	128210388	735	368.0	
41971	chr7	128216896	128217946	1050	525.0	
41972	chr7	128221835	128222301	466	233.0	
41973	chr7	128222820	128223196	376	188.0	
41974	chr7	128227376	128227742	366	183.0	
41975	chr7	128236671	128237560	889	444.0	
41976	chr7	128247713	128248144	431	216.0	
41977	chr7	128271930	128272273	343	172.0	
41978	chr7	128320111	128321179	1068	534.0	
41979	chr7	128321935	128322486	551	276.0	
41980	chr7	128343210	128344277	1067	534.0	
41981	chr7	128347530	128348014	484	242.0	
41982	chr7	128351265	128352659	1394	697.0	
41983	chr7	128358232	128358628	396	198.0	
41984	chr7	128360500	128362475	1975	988.0	
41985	chr7	128381137	128381652	515	258.0	
41986	chr7	128387457	128388484	1027	514.0	
41987	chr7	128398475	128399164	689	344.0	
41988	chr7	128403663	128404098	435	218.0	
41989	chr7	128404700	128410892	6192	3096.0	
41990	chr7	128422692	128423979	1287	644.0	
41991	chr7	128425714	128426405	691	346.0	
41992	chr7	128427198	128427755	557	278.0	
41993	chr7	128437599	128438335	736	368.0	
41994	chr7	128454984	128456518	1534	767.0	
41995	chr7	128458848	128460001	1153	576.0	
41996	chr7	128461383	128461784	401	200.0	
41997	chr7	128474188	128474755	567	284.0	
41998	chr7	128476114	128477598	1484	742.0	
41999	chr7	128506710	128507273	563	282.0	
42000	chr7	128512379	128512699	320	160.0	
42001	chr7	128523166	128523732	566	283.0	
42002	chr7	128530074	128532730	2656	1328.0	
42003	chr7	128537267	128537887	620	310.0	
42004	chr7	128543360	128543464	104	52.0	
42005	chr7	128608908	128609424	516	258.0	
42006	chr7	128658462	128658693	231	116.0	
42007	chr7	128697108	128697990	882	441.0	
42008	chr7	128710533	128710933	400	200.0	
42009	chr7	128734736	128735910	1174	587.0	
42010	chr7	128738439	128740383	1944	972.0	
42011	chr7	128788762	128792168	3406	1703.0	
42012	chr7	128794003	128794435	432	216.0	
42013	chr7	128812577	128812864	287	144.0	
42014	chr7	128815456	128815943	487	244.0	
42015	chr7	128829790	128833543	3753	1876.0	
42016	chr7	128841143	128842603	1460	730.0	
42017	chr7	128860198	128860203	5	2.0	
42018	chr7	128862100	128864067	1967	984.0	
42019	chr7	128865957	128865959	2	1.0	
42020	chr7	128868673	128870354	1681	840.0	
42021	chr7	128880031	128880469	438	219.0	
42022	chr7	128883496	128884406	910	455.0	
42023	chr7	128890641	128891678	1037	518.0	
42024	chr7	128904412	128905095	683	342.0	
42025	chr7	128914505	128915716	1211	606.0	
42026	chr7	128932953	128933911	958	479.0	
42027	chr7	128934454	128935666	1212	606.0	
42028	chr7	128937390	128941523	4133	2066.0	
42029	chr7	128948423	128949454	1031	516.0	
42030	chr7	128954822	128955268	446	223.0	
42031	chr7	128963313	128963728	415	208.0	
42032	chr7	129009339	129009824	485	242.0	
42033	chr7	129013420	129013720	300	150.0	
42034	chr7	129014593	129015146	553	276.0	
42035	chr7	129053972	129055795	1823	912.0	
42036	chr7	129072144	129073165	1021	510.0	
42037	chr7	129082909	129083202	293	146.0	
42038	chr7	129089678	129090153	475	238.0	
42039	chr7	129091376	129091991	615	308.0	
42040	chr7	129095172	129095698	526	263.0	
42041	chr7	129122543	129123104	561	280.0	
42042	chr7	129134560	129135154	594	297.0	
42043	chr7	129136921	129137707	786	393.0	
42044	chr7	129144184	129145639	1455	728.0	
42045	chr7	129146355	129147045	690	345.0	
42046	chr7	129149488	129150514	1026	513.0	
42047	chr7	129163864	129164330	466	233.0	
42048	chr7	129169020	129170294	1274	637.0	
42049	chr7	129188370	129189626	1256	628.0	
42050	chr7	129197862	129198196	334	167.0	
42051	chr7	129202426	129202728	302	151.0	
42052	chr7	129206044	129206323	279	140.0	
42053	chr7	129210421	129210924	503	252.0	
42054	chr7	129218285	129219314	1029	514.0	
42055	chr7	129222009	129222539	530	265.0	
42056	chr7	129224073	129226221	2148	1074.0	
42057	chr7	129259522	129259790	268	134.0	
42058	chr7	129262407	129262632	225	112.0	
42059	chr7	129270523	129272351	1828	914.0	
42060	chr7	129298255	129298627	372	186.0	
42061	chr7	129343082	129343468	386	193.0	
42062	chr7	129367331	129369025	1694	847.0	
42063	chr7	129376450	129377732	1282	641.0	
42064	chr7	129401362	129401830	468	234.0	
42065	chr7	129433325	129435573	2248	1124.0	
42066	chr7	129462312	129462853	541	270.0	
42067	chr7	129465994	129466005	11	6.0	
42068	chr7	129468541	129469008	467	234.0	
42069	chr7	129472309	129472785	476	238.0	
42070	chr7	129493924	129494444	520	260.0	
42071	chr7	129500061	129500370	309	154.0	
42072	chr7	129501790	129503557	1767	884.0	
42073	chr7	129524466	129525694	1228	614.0	
42074	chr7	129530697	129531352	655	328.0	
42075	chr7	129534956	129536694	1738	869.0	
42076	chr7	129543153	129543604	451	226.0	
42077	chr7	129553918	129554613	695	348.0	
42078	chr7	129561860	129562428	568	284.0	
42079	chr7	129566192	129566752	560	280.0	
42080	chr7	129582982	129583104	122	61.0	
42081	chr7	129595009	129595516	507	254.0	
42082	chr7	129606679	129608246	1567	784.0	
42083	chr7	129610816	129613330	2514	1257.0	
42084	chr7	129614938	129615549	611	306.0	
42085	chr7	129617153	129618091	938	469.0	
42086	chr7	129635296	129636005	709	354.0	
42087	chr7	129644891	129644941	50	25.0	
42088	chr7	129767185	129767457	272	136.0	
42089	chr7	129771058	129771570	512	256.0	
42090	chr7	129777185	129783472	6287	3144.0	
42091	chr7	129784756	129786552	1796	898.0	
42092	chr7	129824500	129826403	1903	952.0	
42093	chr7	129829510	129830808	1298	649.0	
42094	chr7	129845597	129846142	545	272.0	
42095	chr7	129859097	129859773	676	338.0	
42096	chr7	129903892	129904383	491	246.0	
42097	chr7	129906285	129907199	914	457.0	
42098	chr7	129914648	129915548	900	450.0	
42099	chr7	129923750	129923973	223	112.0	
42100	chr7	129924631	129924964	333	166.0	
42101	chr7	129938802	129938839	37	18.0	
42102	chr7	129948430	129954184	5754	2877.0	
42103	chr7	129958514	129959836	1322	661.0	
42104	chr7	130010261	130011512	1251	626.0	
42105	chr7	130025823	130026710	887	444.0	
42106	chr7	130050871	130051889	1018	509.0	
42107	chr7	130062911	130063432	521	260.0	
42108	chr7	130069789	130071459	1670	835.0	
42109	chr7	130072049	130072649	600	300.0	
42110	chr7	130084142	130084431	289	144.0	
42111	chr7	130140970	130142108	1138	569.0	
42112	chr7	130145652	130146038	386	193.0	
42113	chr7	130149745	130152926	3181	1590.0	
42114	chr7	130204704	130206056	1352	676.0	
42115	chr7	130242494	130242926	432	216.0	
42116	chr7	130366902	130368031	1129	564.0	
42117	chr7	130369106	130369509	403	202.0	
42118	chr7	130393986	130394981	995	498.0	
42119	chr7	130414993	130415403	410	205.0	
42120	chr7	130417411	130417491	80	40.0	
42121	chr7	130426533	130426895	362	181.0	
42122	chr7	130433404	130433746	342	171.0	
42123	chr7	130440313	130441654	1341	670.0	
42124	chr7	130458230	130458691	461	230.0	
42125	chr7	130473288	130473737	449	224.0	
42126	chr7	130485793	130487194	1401	700.0	
42127	chr7	130490763	130492401	1638	819.0	
42128	chr7	130667782	130670156	2374	1187.0	
42129	chr7	130695897	130696182	285	142.0	
42130	chr7	130721940	130722310	370	185.0	
42131	chr7	130733535	130734873	1338	669.0	
42132	chr7	130740518	130742057	1539	770.0	
42133	chr7	130758418	130758829	411	206.0	
42134	chr7	130831901	130832240	339	170.0	
42135	chr7	130841474	130841740	266	133.0	
42136	chr7	130875254	130875720	466	233.0	
42137	chr7	130887918	130888093	175	88.0	
42138	chr7	130893296	130895206	1910	955.0	
42139	chr7	130896364	130898412	2048	1024.0	
42140	chr7	130899106	130900872	1766	883.0	
42141	chr7	130902485	130902857	372	186.0	
42142	chr7	130903421	130904568	1147	574.0	
42143	chr7	130905095	130905193	98	49.0	
42144	chr7	130905812	130905900	88	44.0	
42145	chr7	130909290	130909623	333	166.0	
42146	chr7	130910820	130911528	708	354.0	
42147	chr7	130912258	130914459	2201	1100.0	
42148	chr7	130915062	130916946	1884	942.0	
42149	chr7	130917705	130919138	1433	716.0	
42150	chr7	130921680	130921714	34	17.0	
42151	chr7	130925155	130928837	3682	1841.0	
42152	chr7	130929916	130931052	1136	568.0	
42153	chr7	130933045	130933446	401	200.0	
42154	chr7	130934956	130935310	354	177.0	
42155	chr7	130936669	130937293	624	312.0	
42156	chr7	130938055	130939932	1877	938.0	
42157	chr7	130940886	130944250	3364	1682.0	
42158	chr7	130944841	130945859	1018	509.0	
42159	chr7	130947777	130949020	1243	622.0	
42160	chr7	130950003	130952747	2744	1372.0	
42161	chr7	130954394	130958947	4553	2276.0	
42162	chr7	130959552	130962046	2494	1247.0	
42163	chr7	130971388	130971712	324	162.0	
42164	chr7	130981942	130983143	1201	600.0	
42165	chr7	130986071	130987184	1113	556.0	
42166	chr7	130988327	130991137	2810	1405.0	
42167	chr7	130993917	130994573	656	328.0	
42168	chr7	130996663	130997131	468	234.0	
42169	chr7	131004303	131004805	502	251.0	
42170	chr7	131007146	131008340	1194	597.0	
42171	chr7	131009181	131009242	61	30.0	
42172	chr7	131010296	131013627	3331	1666.0	
42173	chr7	131020679	131022257	1578	789.0	
42174	chr7	131026355	131028131	1776	888.0	
42175	chr7	131030478	131030922	444	222.0	
42176	chr7	131031462	131031807	345	172.0	
42177	chr7	131034207	131034661	454	227.0	
42178	chr7	131040347	131041124	777	388.0	
42179	chr7	131042724	131043904	1180	590.0	
42180	chr7	131044478	131044878	400	200.0	
42181	chr7	131046108	131047475	1367	684.0	
42182	chr7	131048618	131050829	2211	1106.0	
42183	chr7	131052485	131053337	852	426.0	
42184	chr7	131053872	131062243	8371	4186.0	
42185	chr7	131063145	131063199	54	27.0	
42186	chr7	131063808	131111901	48093	24046.0	"enhancer	sequence_feature"
42187	chr7	131112534	131112779	245	122.0	
42188	chr7	131123780	131124721	941	470.0	
42189	chr7	131183748	131184126	378	189.0	
42190	chr7	131188234	131189362	1128	564.0	
42191	chr7	131218749	131220180	1431	716.0	
42192	chr7	131231113	131232081	968	484.0	
42193	chr7	131235233	131236528	1295	648.0	
42194	chr7	131237996	131239042	1046	523.0	
42195	chr7	131265215	131265611	396	198.0	
42196	chr7	131326994	131328877	1883	942.0	
42197	chr7	131330115	131330745	630	315.0	
42198	chr7	131342947	131343241	294	147.0	
42199	chr7	131356127	131356243	116	58.0	
42200	chr7	131370416	131370906	490	245.0	
42201	chr7	131383491	131383796	305	152.0	
42202	chr7	131424180	131424644	464	232.0	
42203	chr7	131501386	131502048	662	331.0	
42204	chr7	131504442	131504445	3	2.0	
42205	chr7	131507599	131508472	873	436.0	
42206	chr7	131513376	131514001	625	312.0	
42207	chr7	131522551	131523040	489	244.0	
42208	chr7	131527368	131527759	391	196.0	
42209	chr7	131546578	131547076	498	249.0	
42210	chr7	131555162	131557380	2218	1109.0	
42211	chr7	131606545	131606866	321	160.0	
42212	chr7	131654601	131655114	513	256.0	
42213	chr7	131689109	131689510	401	200.0	
42214	chr7	131859211	131859493	282	141.0	
42215	chr7	131890262	131890663	401	200.0	
42216	chr7	132318646	132319201	555	278.0	
42217	chr7	132390538	132391296	758	379.0	
42218	chr7	132394264	132394790	526	263.0	
42219	chr7	132430239	132432053	1814	907.0	
42220	chr7	132433361	132433747	386	193.0	
42221	chr7	132435045	132435919	874	437.0	
42222	chr7	132437528	132438327	799	400.0	
42223	chr7	132446105	132447001	896	448.0	
42224	chr7	132450172	132451796	1624	812.0	
42225	chr7	132453917	132454413	496	248.0	
42226	chr7	132455257	132455715	458	229.0	
42227	chr7	132461189	132461590	401	200.0	
42228	chr7	132485291	132486326	1035	518.0	
42229	chr7	132488937	132489262	325	162.0	
42230	chr7	132509027	132509775	748	374.0	
42231	chr7	132518105	132518487	382	191.0	
42232	chr7	132519788	132520286	498	249.0	
42233	chr7	132532187	132532735	548	274.0	
42234	chr7	132537537	132537755	218	109.0	
42235	chr7	132575414	132577845	2431	1216.0	
42236	chr7	132580606	132581183	577	288.0	
42237	chr7	132654178	132654508	330	165.0	
42238	chr7	132655250	132655893	643	322.0	
42239	chr7	132666010	132666908	898	449.0	
42240	chr7	132771181	132771857	676	338.0	
42241	chr7	132882667	132883181	514	257.0	
42242	chr7	132941491	132941690	199	100.0	
42243	chr7	133035124	133035613	489	244.0	
42244	chr7	133059984	133060304	320	160.0	
42245	chr7	133081116	133082908	1792	896.0	
42246	chr7	133230598	133230976	378	189.0	
42247	chr7	133252496	133253922	1426	713.0	
42248	chr7	133255389	133256210	821	410.0	
42249	chr7	133434282	133434625	343	172.0	
42250	chr7	133480915	133481224	309	154.0	
42251	chr7	133484006	133484605	599	300.0	
42252	chr7	133633086	133633419	333	166.0	
42253	chr7	133650427	133651307	880	440.0	
42254	chr7	133688863	133689602	739	370.0	
42255	chr7	133853833	133854127	294	147.0	
42256	chr7	134032183	134032712	529	264.0	
42257	chr7	134042327	134042774	447	224.0	
42258	chr7	134084084	134085266	1182	591.0	
42259	chr7	134121593	134122112	519	260.0	
42260	chr7	134126874	134127945	1071	536.0	
42261	chr7	134129795	134130307	512	256.0	
42262	chr7	134141137	134141689	552	276.0	
42263	chr7	134174589	134175265	676	338.0	
42264	chr7	134184810	134185127	317	158.0	
42265	chr7	134212573	134213533	960	480.0	
42266	chr7	134292898	134293840	942	471.0	
42267	chr7	134315890	134317747	1857	928.0	
42268	chr7	134327826	134328345	519	260.0	
42269	chr7	134358190	134358625	435	218.0	
42270	chr7	134432184	134433720	1536	768.0	
42271	chr7	134444127	134444911	784	392.0	
42272	chr7	134454109	134455197	1088	544.0	
42273	chr7	134458054	134459935	1881	940.0	
42274	chr7	134502449	134502909	460	230.0	
42275	chr7	134513161	134513595	434	217.0	
42276	chr7	134514505	134515032	527	264.0	
42277	chr7	134522426	134522447	21	10.0	
42278	chr7	134547280	134547957	677	338.0	
42279	chr7	134562116	134562635	519	260.0	
42280	chr7	134602841	134603580	739	370.0	
42281	chr7	134606267	134606935	668	334.0	
42282	chr7	134613768	134614309	541	270.0	
42283	chr7	134632899	134633377	478	239.0	
42284	chr7	134635904	134636473	569	284.0	
42285	chr7	134640864	134641654	790	395.0	
42286	chr7	134645802	134648041	2239	1120.0	
42287	chr7	134669325	134670519	1194	597.0	
42288	chr7	134701289	134701656	367	184.0	
42289	chr7	134710678	134711737	1059	530.0	
42290	chr7	134750038	134750503	465	232.0	
42291	chr7	134766959	134767328	369	184.0	
42292	chr7	134864858	134865706	848	424.0	
42293	chr7	134954213	134954589	376	188.0	
42294	chr7	134985881	134987401	1520	760.0	
42295	chr7	134992756	134993212	456	228.0	
42296	chr7	134995179	134996353	1174	587.0	
42297	chr7	135146937	135149061	2124	1062.0	
42298	chr7	135150287	135152090	1803	902.0	
42299	chr7	135160099	135161457	1358	679.0	
42300	chr7	135164396	135165008	612	306.0	
42301	chr7	135165889	135172090	6201	3100.0	
42302	chr7	135206835	135207380	545	272.0	
42303	chr7	135208284	135208433	149	74.0	
42304	chr7	135209145	135209672	527	264.0	
42305	chr7	135210188	135212351	2163	1082.0	
42306	chr7	135253930	135254803	873	436.0	
42307	chr7	135274398	135274929	531	266.0	
42308	chr7	135281216	135282130	914	457.0	
42309	chr7	135415132	135415147	15	8.0	
42310	chr7	135464005	135464211	206	103.0	
42311	chr7	135499893	135500105	212	106.0	
42312	chr7	135508756	135511083	2327	1164.0	
42313	chr7	135512056	135512585	529	264.0	
42314	chr7	135536161	135536588	427	214.0	
42315	chr7	135537819	135538351	532	266.0	
42316	chr7	135557297	135559106	1809	904.0	
42317	chr7	135575281	135575666	385	192.0	
42318	chr7	135621190	135621660	470	235.0	
42319	chr7	135645262	135645730	468	234.0	
42320	chr7	135650855	135651148	293	146.0	
42321	chr7	135659466	135659910	444	222.0	
42322	chr7	135661759	135663319	1560	780.0	
42323	chr7	135666716	135667270	554	277.0	
42324	chr7	135672794	135673223	429	214.0	
42325	chr7	135710853	135711237	384	192.0	
42326	chr7	135801032	135801509	477	238.0	
42327	chr7	135831398	135831872	474	237.0	
42328	chr7	135901627	135901980	353	176.0	
42329	chr7	135905375	135905691	316	158.0	
42330	chr7	135923761	135924081	320	160.0	
42331	chr7	135931188	135931588	400	200.0	
42332	chr7	135961077	135961117	40	20.0	
42333	chr7	135964455	135964462	7	4.0	
42334	chr7	135970914	135971497	583	292.0	
42335	chr7	135976098	135977965	1867	934.0	
42336	chr7	135979965	135982727	2762	1381.0	
42337	chr7	135993808	135994530	722	361.0	
42338	chr7	136009462	136009856	394	197.0	
42339	chr7	136086685	136087220	535	268.0	
42340	chr7	136115264	136115668	404	202.0	
42341	chr7	136359414	136359732	318	159.0	
42342	chr7	136406222	136406531	309	154.0	
42343	chr7	137626527	137626540	13	6.0	
42344	chr7	137656262	137656663	401	200.0	
42345	chr7	137846503	137847078	575	288.0	
42346	chr7	137899024	137899928	904	452.0	
42347	chr7	137903368	137904285	917	458.0	
42348	chr7	137932790	137933299	509	254.0	
42349	chr7	137934901	137936544	1643	822.0	
42350	chr7	137958565	137959295	730	365.0	
42351	chr7	137961129	137961645	516	258.0	
42352	chr7	137985537	137986241	704	352.0	
42353	chr7	137988138	137988241	103	52.0	
42354	chr7	137992671	137992916	245	122.0	
42355	chr7	137996233	137996947	714	357.0	
42356	chr7	138000081	138003212	3131	1566.0	
42357	chr7	138008533	138009299	766	383.0	
42358	chr7	138125563	138126161	598	299.0	
42359	chr7	138161442	138162126	684	342.0	
42360	chr7	138196381	138196944	563	282.0	
42361	chr7	138239322	138239583	261	130.0	
42362	chr7	138245763	138246090	327	164.0	
42363	chr7	138257343	138258507	1164	582.0	
42364	chr7	138449581	138449961	380	190.0	
42365	chr7	138459167	138461689	2522	1261.0	
42366	chr7	138478756	138478774	18	9.0	
42367	chr7	138564951	138566067	1116	558.0	
42368	chr7	138717837	138718380	543	272.0	
42369	chr7	138738645	138739193	548	274.0	
42370	chr7	138752128	138754028	1900	950.0	
42371	chr7	138797778	138798045	267	134.0	
42372	chr7	138865854	138866301	447	224.0	
42373	chr7	138875643	138876367	724	362.0	
42374	chr7	138886184	138886968	784	392.0	
42375	chr7	138898356	138898549	193	96.0	
42376	chr7	138903171	138904077	906	453.0	
42377	chr7	138979181	138979555	374	187.0	
42378	chr7	138980758	138982316	1558	779.0	
42379	chr7	139016967	139017520	553	276.0	
42380	chr7	139034934	139036425	1491	746.0	
42381	chr7	139041342	139042360	1018	509.0	
42382	chr7	139042896	139045821	2925	1462.0	
42383	chr7	139060866	139062623	1757	878.0	
42384	chr7	139063510	139064919	1409	704.0	
42385	chr7	139065591	139069884	4293	2146.0	
42386	chr7	139070530	139073788	3258	1629.0	
42387	chr7	139074766	139082215	7449	3724.0	
42388	chr7	139083186	139089932	6746	3373.0	
42389	chr7	139090717	139096957	6240	3120.0	
42390	chr7	139097600	139098137	537	268.0	
42391	chr7	139099268	139101494	2226	1113.0	
42392	chr7	139102074	139110631	8557	4278.0	
42393	chr7	139111477	139112754	1277	638.0	
42394	chr7	139118131	139119698	1567	784.0	
42395	chr7	139127630	139128083	453	226.0	
42396	chr7	139131376	139132215	839	420.0	
42397	chr7	139133205	139134323	1118	559.0	
42398	chr7	139184074	139184382	308	154.0	
42399	chr7	139230309	139232651	2342	1171.0	
42400	chr7	139259213	139259514	301	150.0	
42401	chr7	139339207	139342586	3379	1690.0	
42402	chr7	139344974	139345469	495	248.0	
42403	chr7	139355365	139355627	262	131.0	
42404	chr7	139358442	139361210	2768	1384.0	
42405	chr7	139363051	139363374	323	162.0	
42406	chr7	139394457	139394960	503	252.0	
42407	chr7	139434468	139434983	515	258.0	
42408	chr7	139482842	139484198	1356	678.0	
42409	chr7	139495094	139495597	503	252.0	
42410	chr7	139499855	139500403	548	274.0	
42411	chr7	139543824	139544118	294	147.0	
42412	chr7	139563174	139563331	157	78.0	
42413	chr7	139582887	139583108	221	110.0	
42414	chr7	139588765	139588816	51	26.0	
42415	chr7	139602111	139602545	434	217.0	
42416	chr7	139618866	139619276	410	205.0	
42417	chr7	139620785	139621234	449	224.0	
42418	chr7	139626807	139627336	529	264.0	
42419	chr7	139635434	139636519	1085	542.0	
42420	chr7	139640684	139641090	406	203.0	
42421	chr7	139645680	139646568	888	444.0	
42422	chr7	139647070	139649577	2507	1254.0	
42423	chr7	139680523	139681276	753	376.0	
42424	chr7	139682700	139683101	401	200.0	
42425	chr7	139708564	139708850	286	143.0	
42426	chr7	139714245	139714949	704	352.0	
42427	chr7	139718223	139719394	1171	586.0	
42428	chr7	139720704	139721126	422	211.0	
42429	chr7	139722804	139723850	1046	523.0	
42430	chr7	139725186	139726943	1757	878.0	
42431	chr7	139731048	139732665	1617	808.0	
42432	chr7	139737667	139737849	182	91.0	
42433	chr7	139767188	139768926	1738	869.0	
42434	chr7	139771217	139771888	671	336.0	
42435	chr7	139772788	139773734	946	473.0	
42436	chr7	139775528	139778999	3471	1736.0	
42437	chr7	139799532	139800081	549	274.0	
42438	chr7	139819781	139820702	921	460.0	
42439	chr7	139828821	139829909	1088	544.0	
42440	chr7	139830797	139831580	783	392.0	
42441	chr7	139853853	139854582	729	364.0	
42442	chr7	139855171	139856286	1115	558.0	
42443	chr7	139859982	139860922	940	470.0	
42444	chr7	139873937	139874338	401	200.0	
42445	chr7	139875735	139876385	650	325.0	
42446	chr7	139886085	139886723	638	319.0	
42447	chr7	139888057	139888730	673	336.0	
42448	chr7	139900547	139902287	1740	870.0	
42449	chr7	139916008	139917056	1048	524.0	
42450	chr7	139937107	139937126	19	10.0	
42451	chr7	139937653	139938178	525	262.0	
42452	chr7	139946558	139946967	409	204.0	
42453	chr7	139980627	139981282	655	328.0	
42454	chr7	139992714	139992804	90	45.0	
42455	chr7	140002226	140002703	477	238.0	
42456	chr7	140003859	140004281	422	211.0	
42457	chr7	140021864	140021874	10	5.0	
42458	chr7	140036243	140036961	718	359.0	
42459	chr7	140053752	140054293	541	270.0	
42460	chr7	140059277	140060028	751	376.0	
42461	chr7	140061003	140063676	2673	1336.0	
42462	chr7	140074474	140074633	159	80.0	
42463	chr7	140078999	140079418	419	210.0	
42464	chr7	140082914	140083034	120	60.0	
42465	chr7	140083582	140085667	2085	1042.0	
42466	chr7	140162114	140162401	287	144.0	
42467	chr7	140165517	140165755	238	119.0	
42468	chr7	140174864	140178269	3405	1702.0	
42469	chr7	140178977	140179411	434	217.0	
42470	chr7	140209948	140211056	1108	554.0	enhancer
42471	chr7	140211988	140212814	826	413.0	enhancer
42472	chr7	140222700	140224358	1658	829.0	
42473	chr7	140225430	140226066	636	318.0	
42474	chr7	140228929	140233530	4601	2300.0	
42475	chr7	140239630	140239871	241	120.0	
42476	chr7	140241913	140242701	788	394.0	
42477	chr7	140251695	140253807	2112	1056.0	
42478	chr7	140263173	140263816	643	322.0	
42479	chr7	140269091	140269381	290	145.0	
42480	chr7	140285490	140285609	119	60.0	
42481	chr7	140294460	140294821	361	180.0	
42482	chr7	140304142	140305654	1512	756.0	
42483	chr7	140312461	140312835	374	187.0	
42484	chr7	140314056	140314559	503	252.0	
42485	chr7	140315989	140316848	859	430.0	
42486	chr7	140317543	140318109	566	283.0	
42487	chr7	140326037	140326824	787	394.0	
42488	chr7	140342819	140343553	734	367.0	
42489	chr7	140358463	140359772	1309	654.0	
42490	chr7	140375825	140376748	923	462.0	
42491	chr7	140390186	140391430	1244	622.0	
42492	chr7	140397738	140398985	1247	624.0	
42493	chr7	140402124	140402559	435	218.0	
42494	chr7	140403496	140404841	1345	672.0	
42495	chr7	140443989	140444410	421	210.0	
42496	chr7	140451776	140451906	130	65.0	
42497	chr7	140463090	140463486	396	198.0	
42498	chr7	140475704	140476197	493	246.0	
42499	chr7	140476773	140480209	3436	1718.0	
42500	chr7	140493001	140493509	508	254.0	
42501	chr7	140494846	140495242	396	198.0	
42502	chr7	140517867	140518378	511	256.0	
42503	chr7	140640144	140641287	1143	572.0	
42504	chr7	140645193	140645892	699	350.0	
42505	chr7	140646775	140647490	715	358.0	
42506	chr7	140649601	140649956	355	178.0	
42507	chr7	140653261	140653841	580	290.0	
42508	chr7	140656170	140657341	1171	586.0	
42509	chr7	140672255	140676870	4615	2308.0	
42510	chr7	140696010	140698104	2094	1047.0	
42511	chr7	140714539	140715112	573	286.0	
42512	chr7	140719746	140720161	415	208.0	
42513	chr7	140723001	140723459	458	229.0	
42514	chr7	140745405	140745733	328	164.0	
42515	chr7	140810997	140811689	692	346.0	
42516	chr7	140870571	140870867	296	148.0	
42517	chr7	140885973	140886576	603	302.0	
42518	chr7	140902277	140903178	901	450.0	
42519	chr7	140904062	140904155	93	46.0	
42520	chr7	140913404	140913406	2	1.0	
42521	chr7	140917249	140917711	462	231.0	
42522	chr7	140918256	140918601	345	172.0	
42523	chr7	140920416	140920423	7	4.0	
42524	chr7	140922108	140922836	728	364.0	
42525	chr7	140923425	140925630	2205	1102.0	
42526	chr7	140926402	140926667	265	132.0	
42527	chr7	140982598	140982839	241	120.0	
42528	chr7	141011843	141012731	888	444.0	
42529	chr7	141013252	141015717	2465	1232.0	
42530	chr7	141023294	141023641	347	174.0	
42531	chr7	141053475	141054412	937	468.0	
42532	chr7	141071263	141071948	685	342.0	
42533	chr7	141072518	141074535	2017	1008.0	
42534	chr7	141533268	141533726	458	229.0	
42535	chr7	141550805	141551992	1187	594.0	
42536	chr7	141557616	141559347	1731	866.0	
42537	chr7	141564164	141564704	540	270.0	
42538	chr7	141586912	141587243	331	166.0	
42539	chr7	141590669	141591084	415	208.0	
42540	chr7	141649522	141650317	795	398.0	
42541	chr7	141654389	141654998	609	304.0	
42542	chr7	141660165	141660757	592	296.0	
42543	chr7	141663203	141663362	159	80.0	
42544	chr7	141672045	141672547	502	251.0	
42545	chr7	141675808	141676209	401	200.0	
42546	chr7	141698539	141699116	577	288.0	
42547	chr7	141700542	141702798	2256	1128.0	
42548	chr7	141737131	141739022	1891	946.0	
42549	chr7	141754902	141755300	398	199.0	
42550	chr7	141785885	141786307	422	211.0	
42551	chr7	141864602	141865271	669	334.0	
42552	chr7	141874714	141875211	497	248.0	
42553	chr7	141884539	141885335	796	398.0	
42554	chr7	141889031	141889870	839	420.0	
42555	chr7	141928056	141929263	1207	604.0	
42556	chr7	141944763	141945949	1186	593.0	
42557	chr7	141946840	141947148	308	154.0	
42558	chr7	141949234	141949739	505	252.0	
42559	chr7	141950750	141951266	516	258.0	
42560	chr7	141955982	141956587	605	302.0	
42561	chr7	141960546	141961451	905	452.0	
42562	chr7	141975762	141976681	919	460.0	
42563	chr7	141979569	141979971	402	201.0	
42564	chr7	141990036	141990444	408	204.0	
42565	chr7	141991192	141991509	317	158.0	
42566	chr7	141992221	141992536	315	158.0	
42567	chr7	142012871	142013498	627	314.0	
42568	chr7	142030301	142031178	877	438.0	
42569	chr7	142098053	142098366	313	156.0	
42570	chr7	142104508	142105535	1027	514.0	
42571	chr7	142188210	142188452	242	121.0	
42572	chr7	142298149	142298152	3	2.0	
42573	chr7	142298774	142298856	82	41.0	
42574	chr7	142300806	142301065	259	130.0	
42575	chr7	142303537	142304019	482	241.0	
42576	chr7	142308554	142308639	85	42.0	
42577	chr7	142313463	142314024	561	280.0	"recombination_feature	recombination_feature	recombination_feature"
42578	chr7	142319948	142320752	804	402.0	
42579	chr7	142323609	142324511	902	451.0	
42580	chr7	142338812	142339043	231	116.0	
42581	chr7	142345369	142346713	1344	672.0	"recombination_feature	recombination_feature	recombination_feature"
42582	chr7_KI270803v1_alt	503933	504821	888	444.0	"recombination_feature	recombination_feature	recombination_feature"
42583	chr7_KI270803v1_alt	499491	500143	652	326.0	
42584	chr7_KI270803v1_alt	491424	492223	799	400.0	"recombination_feature	recombination_feature"
42585	chr7_KI270803v1_alt	483749	484369	620	310.0	"recombination_feature	recombination_feature	recombination_feature"
42586	chr7_KI270803v1_alt	480037	480706	669	334.0	
42587	chr7_KI270803v1_alt	469204	469772	568	284.0	
42588	chr7_KI270803v1_alt	466396	467363	967	484.0	"recombination_feature	recombination_feature	recombination_feature"
42589	chr7_KI270803v1_alt	461924	462521	597	298.0	
42590	chr7_KI270803v1_alt	460767	461267	500	250.0	
42591	chr7_KI270803v1_alt	452995	454010	1015	508.0	"recombination_feature	recombination_feature	recombination_feature"
42592	chr7_KI270803v1_alt	446776	447519	743	372.0	"recombination_feature	recombination_feature	recombination_feature"
42593	chr7_KI270803v1_alt	442967	443679	712	356.0	
42594	chr7_KI270803v1_alt	438227	439057	830	415.0	
42595	chr7_KI270803v1_alt	428586	429010	424	212.0	
42596	chr7_KI270803v1_alt	426828	427652	824	412.0	
42597	chr7_KI270803v1_alt	424326	425175	849	424.0	"recombination_feature	recombination_feature	recombination_feature"
42598	chr7_KI270803v1_alt	421724	422257	533	266.0	
42599	chr7_KI270803v1_alt	417771	418447	676	338.0	"recombination_feature	recombination_feature	recombination_feature"
42600	chr7_KI270803v1_alt	401930	402261	331	166.0	
42601	chr7_KI270803v1_alt	396103	396632	529	264.0	
42602	chr7_KI270803v1_alt	374736	375453	717	358.0	
42603	chr7_KI270803v1_alt	367480	369565	2085	1042.0	"recombination_feature	recombination_feature	recombination_feature"
42604	chr7_KI270803v1_alt	359371	360579	1208	604.0	
42605	chr7_KI270803v1_alt	345935	346357	422	211.0	
42606	chr7_KI270803v1_alt	341369	342231	862	431.0	
42607	chr7	142626349	142627019	670	335.0	
42608	chr7	142632437	142632993	556	278.0	
42609	chr7	142636593	142637601	1008	504.0	"recombination_feature	recombination_feature	recombination_feature"
42610	chr7	142646318	142646669	351	176.0	"recombination_feature	recombination_feature	recombination_feature"
42611	chr7	142668534	142669713	1179	590.0	
42612	chr7	142685910	142686311	401	200.0	
42613	chr7	142703971	142704241	270	135.0	
42614	chr7	142710027	142710206	179	90.0	
42615	chr7	142711470	142712717	1247	624.0	recombination_feature
42616	chr7	142714302	142714809	507	254.0	
42617	chr7	142717457	142717980	523	262.0	
42618	chr7	142720392	142720687	295	148.0	
42619	chr7	142722508	142722510	2	1.0	
42620	chr7	142739914	142740386	472	236.0	
42621	chr7	142782818	142813564	30746	15373.0	"recombination_feature	recombination_feature	recombination_feature	recombination_feature	recombination_feature	recombination_feature	recombination_feature	recombination_feature	recombination_feature	recombination_feature	recombination_feature	recombination_feature	recombination_feature	recombination_feature	recombination_feature	recombination_feature	recombination_feature	recombination_feature	recombination_feature	recombination_feature	recombination_feature	recombination_feature	recombination_feature	recombination_feature	recombination_feature	recombination_feature	recombination_feature	recombination_feature	recombination_feature	recombination_feature	recombination_feature	recombination_feature	recombination_feature	recombination_feature	recombination_feature	recombination_feature	recombination_feature	recombination_feature	recombination_feature	recombination_feature	recombination_feature	recombination_feature	recombination_feature	recombination_feature	recombination_feature	recombination_feature	recombination_feature	recombination_feature	recombination_feature	recombination_feature	recombination_feature	recombination_feature	recombination_feature	recombination_feature	recombination_feature"
42622	chr7	142815099	142815467	368	184.0	
42623	chr7	142835588	142835813	225	112.0	
42624	chr7	142853593	142857283	3690	1845.0	
42625	chr7	142866280	142866679	399	200.0	
42626	chr7	142873258	142873649	391	196.0	
42627	chr7	142880826	142881329	503	252.0	
42628	chr7	142908923	142909882	959	480.0	
42629	chr7	142910516	142910830	314	157.0	
42630	chr7	142926984	142927933	949	474.0	
42631	chr7	143003159	143003904	745	372.0	
42632	chr7	143007810	143008540	730	365.0	
42633	chr7	143015107	143015498	391	196.0	
42634	chr7	143047276	143047753	477	238.0	
42635	chr7	143085033	143085609	576	288.0	
42636	chr7	143125946	143126589	643	322.0	
42637	chr7	143128573	143128727	154	77.0	
42638	chr7	143181459	143181737	278	139.0	
42639	chr7	143205757	143206461	704	352.0	
42640	chr7	143214798	143215572	774	387.0	
42641	chr7	143222641	143223451	810	405.0	
42642	chr7	143233938	143234157	219	110.0	
42643	chr7	143239444	143241177	1733	866.0	
42644	chr7	143245101	143246237	1136	568.0	
42645	chr7	143250765	143251324	559	280.0	
42646	chr7	143252034	143252387	353	176.0	
42647	chr7	143256550	143257308	758	379.0	
42648	chr7	143258808	143259268	460	230.0	
42649	chr7	143262731	143264623	1892	946.0	
42650	chr7	143279239	143280374	1135	568.0	
42651	chr7	143283787	143283837	50	25.0	
42652	chr7	143287435	143289780	2345	1172.0	
42653	chr7	143299760	143300288	528	264.0	
42654	chr7	143301138	143301635	497	248.0	
42655	chr7	143305404	143306101	697	348.0	
42656	chr7	143310269	143311430	1161	580.0	
42657	chr7	143314198	143315393	1195	598.0	
42658	chr7	143316539	143316815	276	138.0	
42659	chr7	143321713	143322156	443	222.0	
42660	chr7	143345267	143346456	1189	594.0	
42661	chr7	143359825	143360385	560	280.0	
42662	chr7	143361582	143363199	1617	808.0	
42663	chr7	143371822	143372705	883	442.0	
42664	chr7	143374493	143376764	2271	1136.0	
42665	chr7	143379359	143386950	7591	3796.0	
42666	chr7	143388647	143389026	379	190.0	
42667	chr7	143395001	143395842	841	420.0	
42668	chr7	143407093	143409654	2561	1280.0	
42669	chr7	143410280	143411065	785	392.0	
42670	chr7	143413706	143414300	594	297.0	
42671	chr7	143416514	143417017	503	252.0	
42672	chr7	143430257	143430355	98	49.0	
42673	chr7	143458117	143458626	509	254.0	
42674	chr7	143485066	143485935	869	434.0	
42675	chr7	143487413	143488010	597	298.0	
42676	chr7	143491931	143492433	502	251.0	
42677	chr7	143495822	143496204	382	191.0	
42678	chr7	143620725	143621457	732	366.0	
42679	chr7	143736968	143737453	485	242.0	
42680	chr7	143836100	143837670	1570	785.0	
42681	chr7	143882836	143882870	34	17.0	
42682	chr7	143892594	143893050	456	228.0	
42683	chr7	143901230	143902839	1609	804.0	
42684	chr7	144127644	144128184	540	270.0	
42685	chr7	144178350	144178823	473	236.0	
42686	chr7	144391712	144392262	550	275.0	
42687	chr7	144691370	144691479	109	54.0	
42688	chr7	144738699	144739093	394	197.0	
42689	chr7	144786548	144786876	328	164.0	
42690	chr7	144812588	144813389	801	400.0	
42691	chr7	144818240	144819162	922	461.0	
42692	chr7	144820549	144820919	370	185.0	
42693	chr7	144834457	144836747	2290	1145.0	
42694	chr7	144842051	144843059	1008	504.0	
42695	chr7	145036653	145036979	326	163.0	
42696	chr7	146948877	146948955	78	39.0	
42697	chr7	147885754	147886294	540	270.0	
42698	chr7	148262682	148263122	440	220.0	
42699	chr7	148304421	148304834	413	206.0	
42700	chr7	148339228	148339655	427	214.0	
42701	chr7	148501795	148501965	170	85.0	
42702	chr7	148503873	148504300	427	214.0	
42703	chr7	148507088	148507467	379	190.0	
42704	chr7	148527218	148528103	885	442.0	
42705	chr7	148535276	148535735	459	230.0	
42706	chr7	148564141	148565010	869	434.0	
42707	chr7	148570545	148570991	446	223.0	
42708	chr7	148575511	148576216	705	352.0	
42709	chr7	148581477	148582145	668	334.0	
42710	chr7	148584157	148584823	666	333.0	
42711	chr7	148598323	148598589	266	133.0	
42712	chr7	148618214	148618517	303	152.0	
42713	chr7	148620613	148621245	632	316.0	
42714	chr7	148622882	148623263	381	190.0	
42715	chr7	148628437	148629360	923	462.0	
42716	chr7	148630254	148630326	72	36.0	
42717	chr7	148633134	148633451	317	158.0	
42718	chr7	148697198	148701810	4612	2306.0	
42719	chr7	148707978	148708702	724	362.0	
42720	chr7	148711468	148711470	2	1.0	
42721	chr7	148722760	148723285	525	262.0	
42722	chr7	148726417	148726786	369	184.0	
42723	chr7	148727618	148727937	319	160.0	
42724	chr7	148773244	148773819	575	288.0	
42725	chr7	148838784	148839367	583	292.0	
42726	chr7	148846633	148847048	415	208.0	
42727	chr7	148855993	148857320	1327	664.0	
42728	chr7	148867618	148867983	365	182.0	
42729	chr7	148881702	148881911	209	104.0	
42730	chr7	148882729	148885544	2815	1408.0	
42731	chr7	148912741	148913653	912	456.0	
42732	chr7	148914573	148914610	37	18.0	
42733	chr7	148940464	148942660	2196	1098.0	
42734	chr7	148945455	148945616	161	80.0	
42735	chr7	148962469	148967422	4953	2476.0	
42736	chr7	148972320	148972894	574	287.0	
42737	chr7	148979330	148980274	944	472.0	
42738	chr7	148982577	148984582	2005	1002.0	
42739	chr7	148985167	148988386	3219	1610.0	
42740	chr7	149005623	149006593	970	485.0	
42741	chr7	149007714	149007847	133	66.0	
42742	chr7	149021699	149021902	203	102.0	
42743	chr7	149026047	149029599	3552	1776.0	
42744	chr7	149064708	149066437	1729	864.0	
42745	chr7	149071300	149072357	1057	528.0	
42746	chr7	149085839	149086296	457	228.0	
42747	chr7	149087368	149087797	429	214.0	
42748	chr7	149090051	149092200	2149	1074.0	
42749	chr7	149125322	149128256	2934	1467.0	
42750	chr7	149146302	149148780	2478	1239.0	
42751	chr7	149191021	149191520	499	250.0	
42752	chr7	149195025	149197234	2209	1104.0	
42753	chr7	149209484	149210008	524	262.0	
42754	chr7	149238669	149240280	1611	806.0	
42755	chr7	149261211	149262968	1757	878.0	
42756	chr7	149284169	149286126	1957	978.0	
42757	chr7	149286824	149287168	344	172.0	
42758	chr7	149291067	149291353	286	143.0	
42759	chr7	149310162	149310661	499	250.0	
42760	chr7	149322138	149322325	187	94.0	
42761	chr7	149414815	149415732	917	458.0	
42762	chr7	149421834	149423410	1576	788.0	
42763	chr7	149459675	149461327	1652	826.0	
42764	chr7	149494587	149495681	1094	547.0	
42765	chr7	149496263	149498471	2208	1104.0	
42766	chr7	149500229	149500648	419	210.0	
42767	chr7	149552808	149553137	329	164.0	
42768	chr7	149580797	149581407	610	305.0	
42769	chr7	149599056	149601274	2218	1109.0	
42770	chr7	149620902	149622688	1786	893.0	
42771	chr7	149623215	149626012	2797	1398.0	
42772	chr7	149662523	149663013	490	245.0	
42773	chr7	149713943	149716617	2674	1337.0	
42774	chr7	149720576	149721352	776	388.0	
42775	chr7	149741625	149742830	1205	602.0	
42776	chr7	149753628	149753675	47	24.0	
42777	chr7	149770943	149774883	3940	1970.0	
42778	chr7	149775543	149777035	1492	746.0	
42779	chr7	149787441	149788029	588	294.0	
42780	chr7	149790045	149790543	498	249.0	
42781	chr7	149799738	149800223	485	242.0	
42782	chr7	149837646	149839247	1601	800.0	
42783	chr7	149854733	149854973	240	120.0	
42784	chr7	149856502	149856958	456	228.0	
42785	chr7	149861593	149861739	146	73.0	
42786	chr7	149865225	149867504	2279	1140.0	
42787	chr7	149868403	149868940	537	268.0	
42788	chr7	149869516	149872076	2560	1280.0	
42789	chr7	149872578	149874608	2030	1015.0	
42790	chr7	149883309	149883854	545	272.0	
42791	chr7	149960769	149962300	1531	766.0	
42792	chr7	150060497	150060848	351	176.0	
42793	chr7	150096594	150096948	354	177.0	
42794	chr7	150276092	150276539	447	224.0	
42795	chr7	150286119	150286518	399	200.0	
42796	chr7	150322138	150325806	3668	1834.0	
42797	chr7	150340529	150340733	204	102.0	
42798	chr7	150356210	150359460	3250	1625.0	
42799	chr7	150363826	150364389	563	282.0	
42800	chr7	150365558	150366634	1076	538.0	
42801	chr7	150367141	150370457	3316	1658.0	
42802	chr7	150375978	150376497	519	260.0	
42803	chr7	150377109	150380576	3467	1734.0	
42804	chr7	150384306	150384989	683	342.0	
42805	chr7	150388740	150389349	609	304.0	
42806	chr7	150404005	150407744	3739	1870.0	
42807	chr7	150408528	150409464	936	468.0	
42808	chr7	150420948	150421683	735	368.0	
42809	chr7	150428731	150429060	329	164.0	
42810	chr7	150433170	150434129	959	480.0	
42811	chr7	150435215	150436218	1003	502.0	
42812	chr7	150439969	150440301	332	166.0	
42813	chr7	150448197	150452574	4377	2188.0	
42814	chr7	150453075	150453996	921	460.0	
42815	chr7	150463554	150463912	358	179.0	
42816	chr7	150478882	150480058	1176	588.0	
42817	chr7	150480985	150482431	1446	723.0	
42818	chr7	150483479	150485096	1617	808.0	
42819	chr7	150489618	150490298	680	340.0	
42820	chr7	150502409	150504059	1650	825.0	
42821	chr7	150505340	150505500	160	80.0	
42822	chr7	150508174	150508647	473	236.0	
42823	chr7	150511133	150511419	286	143.0	
42824	chr7	150514266	150516177	1911	956.0	
42825	chr7	150517337	150517535	198	99.0	
42826	chr7	150519985	150520515	530	265.0	
42827	chr7	150556491	150557218	727	364.0	
42828	chr7	150563887	150564666	779	390.0	
42829	chr7	150566866	150570112	3246	1623.0	
42830	chr7	150579901	150580796	895	448.0	
42831	chr7	150586183	150587357	1174	587.0	
42832	chr7	150603605	150603975	370	185.0	
42833	chr7	150631156	150632815	1659	830.0	
42834	chr7	150663420	150664640	1220	610.0	
42835	chr7	150665233	150666911	1678	839.0	
42836	chr7	150667878	150669199	1321	660.0	
42837	chr7	150676247	150677531	1284	642.0	
42838	chr7	150683555	150684047	492	246.0	
42839	chr7	150684970	150687040	2070	1035.0	
42840	chr7	150687905	150688347	442	221.0	
42841	chr7	150715141	150717137	1996	998.0	
42842	chr7	150717793	150718497	704	352.0	
42843	chr7	150731902	150733600	1698	849.0	
42844	chr7	150735009	150735031	22	11.0	
42845	chr7	150735993	150739392	3399	1700.0	
42846	chr7	150739907	150740458	551	276.0	
42847	chr7	150742517	150742872	355	178.0	
42848	chr7	150744266	150744318	52	26.0	
42849	chr7	150745371	150745441	70	35.0	
42850	chr7	150746997	150747334	337	168.0	
42851	chr7	150748234	150748825	591	296.0	
42852	chr7	150750488	150750618	130	65.0	
42853	chr7	150753301	150757290	3989	1994.0	
42854	chr7	150778632	150779135	503	252.0	
42855	chr7	150780428	150781421	993	496.0	
42856	chr7	150784150	150784611	461	230.0	
42857	chr7	150785488	150786473	985	492.0	
42858	chr7	150787370	150788357	987	494.0	
42859	chr7	150800143	150801536	1393	696.0	
42860	chr7	150876693	150877727	1034	517.0	
42861	chr7	150898383	150899083	700	350.0	
42862	chr7	150909162	150909652	490	245.0	
42863	chr7	150938001	150938402	401	200.0	
42864	chr7	150942069	150942688	619	310.0	
42865	chr7	150962678	150963449	771	386.0	enhancer
42866	chr7	150973330	150975495	2165	1082.0	
42867	chr7	150977613	150980447	2834	1417.0	
42868	chr7	150983858	150984282	424	212.0	
42869	chr7	150985980	150986503	523	262.0	
42870	chr7	150988211	150989290	1079	540.0	
42871	chr7	150992677	150993166	489	244.0	
42872	chr7	150994313	150994984	671	336.0	
42873	chr7	150996717	150997050	333	166.0	
42874	chr7	150999339	151000370	1031	516.0	
42875	chr7	151007420	151009338	1918	959.0	
42876	chr7	151009956	151011867	1911	956.0	
42877	chr7	151012421	151019505	7084	3542.0	
42878	chr7	151027396	151029290	1894	947.0	
42879	chr7	151039049	151039975	926	463.0	
42880	chr7	151050824	151051589	765	382.0	
42881	chr7	151053138	151053512	374	187.0	
42882	chr7	151057316	151061164	3848	1924.0	
42883	chr7	151076823	151077224	401	200.0	
42884	chr7	151079882	151084229	4347	2174.0	
42885	chr7	151084797	151090012	5215	2608.0	
42886	chr7	151091333	151091852	519	260.0	
42887	chr7	151096020	151096339	319	160.0	
42888	chr7	151110576	151111633	1057	528.0	
42889	chr7	151114809	151116142	1333	666.0	
42890	chr7	151117505	151117992	487	244.0	
42891	chr7	151123647	151124552	905	452.0	
42892	chr7	151166992	151168847	1855	928.0	
42893	chr7	151172297	151173204	907	454.0	
42894	chr7	151174755	151175161	406	203.0	
42895	chr7	151206637	151207902	1265	632.0	
42896	chr7	151225901	151228095	2194	1097.0	
42897	chr7	151231813	151233916	2103	1052.0	
42898	chr7	151242992	151250017	7025	3512.0	
42899	chr7	151251141	151252370	1229	614.0	
42900	chr7	151271582	151272728	1146	573.0	
42901	chr7	151273593	151274762	1169	584.0	
42902	chr7	151276088	151277720	1632	816.0	
42903	chr7	151298838	151299014	176	88.0	
42904	chr7	151303216	151304108	892	446.0	
42905	chr7	151304900	151305093	193	96.0	
42906	chr7	151310544	151310910	366	183.0	
42907	chr7	151314810	151315635	825	412.0	
42908	chr7	151339456	151343130	3674	1837.0	
42909	chr7	151348801	151352728	3927	1964.0	
42910	chr7	151367892	151368726	834	417.0	
42911	chr7	151380730	151382606	1876	938.0	
42912	chr7	151390299	151390725	426	213.0	
42913	chr7	151400574	151401135	561	280.0	
42914	chr7	151404133	151404690	557	278.0	
42915	chr7	151408383	151410905	2522	1261.0	
42916	chr7	151411491	151412069	578	289.0	
42917	chr7	151415502	151417353	1851	926.0	
42918	chr7	151428220	151428524	304	152.0	
42919	chr7	151429321	151430704	1383	692.0	
42920	chr7	151432678	151433667	989	494.0	
42921	chr7	151439759	151440331	572	286.0	
42922	chr7	151441503	151441810	307	154.0	
42923	chr7	151448032	151449144	1112	556.0	
42924	chr7	151471859	151473155	1296	648.0	
42925	chr7	151485067	151485805	738	369.0	
42926	chr7	151491827	151492262	435	218.0	
42927	chr7	151503816	151504381	565	282.0	
42928	chr7	151509301	151509325	24	12.0	
42929	chr7	151512171	151512296	125	62.0	
42930	chr7	151514936	151516541	1605	802.0	
42931	chr7	151517700	151521135	3435	1718.0	
42932	chr7	151552536	151552550	14	7.0	
42933	chr7	151626410	151626789	379	190.0	
42934	chr7	151631349	151633650	2301	1150.0	
42935	chr7	151650973	151651464	491	246.0	
42936	chr7	151699942	151700286	344	172.0	
42937	chr7	151727559	151728226	667	334.0	
42938	chr7	151742819	151743349	530	265.0	
42939	chr7	151745072	151745765	693	346.0	
42940	chr7	151754072	151754507	435	218.0	enhancer
42941	chr7	151755935	151756708	773	386.0	enhancer
42942	chr7	151759450	151760152	702	351.0	enhancer
42943	chr7	151761252	151761576	324	162.0	
42944	chr7	151767523	151768077	554	277.0	
42945	chr7	151768644	151769983	1339	670.0	
42946	chr7	151782466	151783610	1144	572.0	
42947	chr7	151793415	151794536	1121	560.0	
42948	chr7	151795227	151798325	3098	1549.0	
42949	chr7	151805173	151806890	1717	858.0	
42950	chr7	151807728	151808301	573	286.0	
42951	chr7	151808885	151809261	376	188.0	
42952	chr7	151825793	151826480	687	344.0	
42953	chr7	151837610	151840112	2502	1251.0	
42954	chr7	151844108	151844993	885	442.0	
42955	chr7	151847745	151848207	462	231.0	
42956	chr7	151850462	151852645	2183	1092.0	
42957	chr7	151863361	151864337	976	488.0	
42958	chr7	151871896	151872234	338	169.0	
42959	chr7	151874650	151878317	3667	1834.0	
42960	chr7	151890336	151890746	410	205.0	
42961	chr7	151917609	151918470	861	430.0	
42962	chr7	151920351	151921160	809	404.0	
42963	chr7	151922906	151924080	1174	587.0	
42964	chr7	151925470	151926532	1062	531.0	
42965	chr7	151932158	151933725	1567	784.0	
42966	chr7	151935720	151937718	1998	999.0	
42967	chr7	151940023	151940430	407	204.0	
42968	chr7	151992292	151992828	536	268.0	
42969	chr7	152024861	152026538	1677	838.0	
42970	chr7	152027272	152028673	1401	700.0	
42971	chr7	152030082	152031089	1007	504.0	
42972	chr7	152143261	152143646	385	192.0	
42973	chr7	152144530	152145386	856	428.0	
42974	chr7	152145952	152146462	510	255.0	
42975	chr7	152158571	152159553	982	491.0	
42976	chr7	152176892	152177159	267	134.0	
42977	chr7	152313752	152314533	781	390.0	
42978	chr7	152317486	152317757	271	136.0	
42979	chr7	152335645	152337414	1769	884.0	
42980	chr7	152341445	152341471	26	13.0	
42981	chr7	152344291	152344707	416	208.0	
42982	chr7	152383953	152384025	72	36.0	
42983	chr7	152402466	152405357	2891	1446.0	
42984	chr7	152406214	152407081	867	434.0	
42985	chr7	152408276	152409320	1044	522.0	
42986	chr7	152411068	152413427	2359	1180.0	
42987	chr7	152414922	152414933	11	6.0	
42988	chr7	152419704	152420310	606	303.0	
42989	chr7	152433206	152437421	4215	2108.0	
42990	chr7	152441384	152441434	50	25.0	
42991	chr7	152451562	152451671	109	54.0	
42992	chr7	152459562	152460295	733	366.0	
42993	chr7	152462938	152465208	2270	1135.0	
42994	chr7	152470724	152470978	254	127.0	
42995	chr7	152474674	152474854	180	90.0	
42996	chr7	152512512	152513233	721	360.0	
42997	chr7	152667183	152668471	1288	644.0	
42998	chr7	152675364	152676736	1372	686.0	
42999	chr7	152690257	152690292	35	18.0	
43000	chr7	152699549	152700105	556	278.0	
43001	chr7	152706818	152707339	521	260.0	
43002	chr7	152759120	152761481	2361	1180.0	
43003	chr7	154913445	154914677	1232	616.0	
43004	chr7	154927442	154929511	2069	1034.0	
43005	chr7	154952959	154953435	476	238.0	
43006	chr7	154976325	154976328	3	2.0	
43007	chr7	155000848	155000921	73	36.0	
43008	chr7	155001776	155004682	2906	1453.0	
43009	chr7	155007917	155008382	465	232.0	
43010	chr7	155009513	155009972	459	230.0	
43011	chr7	155069873	155070625	752	376.0	
43012	chr7	155190542	155191182	640	320.0	
43013	chr7	155204305	155207487	3182	1591.0	
43014	chr7	155208840	155209597	757	378.0	
43015	chr7	155211802	155212135	333	166.0	
43016	chr7	155281317	155281361	44	22.0	
43017	chr7	155282585	155283164	579	290.0	
43018	chr7	155291032	155291500	468	234.0	
43019	chr7	155293839	155294729	890	445.0	
43020	chr7	155296260	155300204	3944	1972.0	
43021	chr7	155300845	155301303	458	229.0	
43022	chr7	155306300	155307022	722	361.0	
43023	chr7	155312888	155312896	8	4.0	
43024	chr7	155338580	155339507	927	464.0	
43025	chr7	155344336	155345725	1389	694.0	
43026	chr7	155357372	155358664	1292	646.0	
43027	chr7	155361041	155361360	319	160.0	
43028	chr7	155372405	155373653	1248	624.0	
43029	chr7	155374154	155375691	1537	768.0	
43030	chr7	155377804	155378207	403	202.0	
43031	chr7	155379488	155380560	1072	536.0	
43032	chr7	155381821	155382180	359	180.0	
43033	chr7	155405929	155406277	348	174.0	
43034	chr7	155408631	155409083	452	226.0	
43035	chr7	155412673	155413007	334	167.0	
43036	chr7	155457210	155457936	726	363.0	
43037	chr7	155458813	155458904	91	46.0	
43038	chr7	155482503	155482974	471	236.0	
43039	chr7	155490572	155491613	1041	520.0	
43040	chr7	155533366	155534173	807	404.0	
43041	chr7	155585247	155585672	425	212.0	
43042	chr7	155590108	155591535	1427	714.0	
43043	chr7	155593315	155595406	2091	1046.0	
43044	chr7	155598667	155599195	528	264.0	
43045	chr7	155643575	155645496	1921	960.0	
43046	chr7	155653680	155654282	602	301.0	
43047	chr7	155713378	155713771	393	196.0	
43048	chr7	155722155	155722423	268	134.0	
43049	chr7	155724595	155725350	755	378.0	
43050	chr7	155733592	155734047	455	228.0	
43051	chr7	155738621	155740121	1500	750.0	
43052	chr7	155741707	155742267	560	280.0	
43053	chr7	155753634	155753726	92	46.0	
43054	chr7	155756297	155756800	503	252.0	
43055	chr7	155761096	155761592	496	248.0	
43056	chr7	155763442	155764945	1503	752.0	
43057	chr7	155768074	155769396	1322	661.0	
43058	chr7	155786993	155787771	778	389.0	
43059	chr7	155796880	155797388	508	254.0	
43060	chr7	155798920	155798933	13	6.0	
43061	chr7	155803846	155804211	365	182.0	
43062	chr7	155804960	155805362	402	201.0	
43063	chr7	155815236	155815656	420	210.0	
43064	chr7	156612778	156613516	738	369.0	
43065	chr7	156616388	156616731	343	172.0	
43066	chr7	156639849	156641566	1717	858.0	
43067	chr7	156780802	156781028	226	113.0	
43068	chr7	156829722	156830164	442	221.0	
43069	chr7	156832450	156832948	498	249.0	
43070	chr7	156876780	156877166	386	193.0	
43071	chr7	156891947	156894089	2142	1071.0	
43072	chr7	156895073	156896786	1713	856.0	
43073	chr7	156908664	156909389	725	362.0	
43074	chr7	156922876	156923830	954	477.0	
43075	chr7	156929833	156930200	367	184.0	
43076	chr7	156943281	156943882	601	300.0	
43077	chr7	156948667	156950793	2126	1063.0	
43078	chr7	156970127	156970516	389	194.0	
43079	chr7	156999985	157000049	64	32.0	
43080	chr7	157009776	157011039	1263	632.0	
43081	chr7	157136281	157136879	598	299.0	
43082	chr7	157138100	157140871	2771	1386.0	
43083	chr7	157228877	157229257	380	190.0	
43084	chr7	157250232	157251047	815	408.0	
43085	chr7	157273249	157277638	4389	2194.0	
43086	chr7	157278967	157279818	851	426.0	
43087	chr7	157298238	157300608	2370	1185.0	
43088	chr7	157301607	157303123	1516	758.0	
43089	chr7	157306528	157306807	279	140.0	
43090	chr7	157307849	157308249	400	200.0	
43091	chr7	157318035	157318830	795	398.0	
43092	chr7	157335954	157344578	8624	4312.0	
43093	chr7	157345518	157354246	8728	4364.0	
43094	chr7	157355056	157356671	1615	808.0	
43095	chr7	157357183	157361483	4300	2150.0	
43096	chr7	157362742	157366153	3411	1706.0	
43097	chr7	157368287	157369439	1152	576.0	
43098	chr7	157370636	157375895	5259	2630.0	
43099	chr7	157377086	157378138	1052	526.0	
43100	chr7	157379394	157379752	358	179.0	
43101	chr7	157380735	157380771	36	18.0	
43102	chr7	157386721	157387840	1119	560.0	
43103	chr7	157389900	157390948	1048	524.0	
43104	chr7	157397935	157398258	323	162.0	
43105	chr7	157411455	157412374	919	460.0	
43106	chr7	157432507	157433463	956	478.0	
43107	chr7	157471116	157472237	1121	560.0	
43108	chr7	157474828	157474966	138	69.0	
43109	chr7	157477948	157477961	13	6.0	
43110	chr7	157490323	157491101	778	389.0	
43111	chr7	157502540	157503832	1292	646.0	
43112	chr7	157568412	157569446	1034	517.0	
43113	chr7	157576018	157576936	918	459.0	
43114	chr7	157585498	157585899	401	200.0	
43115	chr7	157612589	157613899	1310	655.0	
43116	chr7	157622097	157622424	327	164.0	
43117	chr7	157625987	157626872	885	442.0	
43118	chr7	157690671	157691237	566	283.0	
43119	chr7	157692155	157692188	33	16.0	
43120	chr7	157827132	157827367	235	118.0	
43121	chr7	157845744	157846683	939	470.0	
43122	chr7	157851437	157852225	788	394.0	
43123	chr7	157853885	157855026	1141	570.0	
43124	chr7	157874855	157875883	1028	514.0	
43125	chr7	157881390	157881827	437	218.0	
43126	chr7	158376117	158376460	343	172.0	
43127	chr7	158541598	158541751	153	76.0	
43128	chr7	158587431	158588566	1135	568.0	
43129	chr7	158595027	158595494	467	234.0	
43130	chr7	158656216	158656457	241	120.0	
43131	chr7	158662888	158663562	674	337.0	
43132	chr7	158695818	158696737	919	460.0	
43133	chr7	158704214	158705845	1631	816.0	
43134	chr7	158707705	158708064	359	180.0	
43135	chr7	158710036	158711328	1292	646.0	
43136	chr7	158712166	158712842	676	338.0	
43137	chr7	158730295	158730807	512	256.0	
43138	chr7	158733079	158733119	40	20.0	
43139	chr7	158734915	158735222	307	154.0	
43140	chr7	158739878	158740502	624	312.0	
43141	chr7	158760993	158761325	332	166.0	
43142	chr7	158778957	158779468	511	256.0	
43143	chr7	158782695	158784612	1917	958.0	
43144	chr7	158786938	158787366	428	214.0	
43145	chr7	158789243	158789263	20	10.0	
43146	chr7	158789870	158790041	171	86.0	
43147	chr7	158794399	158796170	1771	886.0	
43148	chr7	158797175	158797343	168	84.0	
43149	chr7	158799565	158799966	401	200.0	
43150	chr7	158802908	158805127	2219	1110.0	
43151	chr7	158805632	158806129	497	248.0	
43152	chr7	158809227	158813572	4345	2172.0	
43153	chr7	158814508	158817488	2980	1490.0	
43154	chr7	158818026	158820165	2139	1070.0	
43155	chr7	158821078	158822225	1147	574.0	
43156	chr7	158823236	158824654	1418	709.0	
43157	chr7	158825457	158826112	655	328.0	
43158	chr7	158826680	158831788	5108	2554.0	
43159	chr7	158842481	158842799	318	159.0	
43160	chr7	158847495	158848036	541	270.0	
43161	chr7	158855851	158857272	1421	710.0	
43162	chr7	158862961	158864559	1598	799.0	
43163	chr7	158957623	158958601	978	489.0	
43164	chr7	158973299	158973927	628	314.0	
43165	chr7	158975872	158977687	1815	908.0	
43166	chr7	159030549	159030869	320	160.0	
43167	chr7	159144005	159145918	1913	956.0	
43168	chr7	159174883	159176210	1327	664.0	
43169	chr7	159195594	159196296	702	351.0	
43170	chr7	159196976	159198771	1795	898.0	
43171	chr7	159209310	159210051	741	370.0	
43172	chr7	159253687	159254027	340	170.0	
43173	chr8	206707	207315	608	304.0	
43174	chr8	229543	229830	287	144.0	
43175	chr8	231913	233284	1371	686.0	
43176	chr8	265741	266131	390	195.0	
43177	chr8	406231	407640	1409	704.0	
43178	chr8	477476	477892	416	208.0	
43179	chr8	486655	486996	341	170.0	
43180	chr8	628088	628432	344	172.0	
43181	chr8	628978	631583	2605	1302.0	
43182	chr8	636865	637483	618	309.0	
43183	chr8	651442	652569	1127	564.0	
43184	chr8	653282	653748	466	233.0	
43185	chr8	664915	665527	612	306.0	
43186	chr8	671951	674091	2140	1070.0	
43187	chr8	676817	677442	625	312.0	
43188	chr8	680933	681439	506	253.0	
43189	chr8	683757	683800	43	22.0	
43190	chr8	687472	688858	1386	693.0	
43191	chr8	704672	704931	259	130.0	
43192	chr8	721307	721937	630	315.0	
43193	chr8	723676	724693	1017	508.0	
43194	chr8	727245	727591	346	173.0	
43195	chr8	730288	732892	2604	1302.0	
43196	chr8	737383	737675	292	146.0	
43197	chr8	763782	764416	634	317.0	
43198	chr8	789080	789519	439	220.0	
43199	chr8	822079	822393	314	157.0	
43200	chr8	867502	867714	212	106.0	
43201	chr8	946822	947132	310	155.0	
43202	chr8	1287231	1289049	1818	909.0	
43203	chr8	1372971	1374248	1277	638.0	
43204	chr8	1438267	1438706	439	220.0	
43205	chr8	1466498	1467026	528	264.0	
43206	chr8	1476308	1476631	323	162.0	
43207	chr8	1479964	1480169	205	102.0	
43208	chr8	1483124	1483319	195	98.0	
43209	chr8	1501868	1502326	458	229.0	
43210	chr8	1670121	1670818	697	348.0	
43211	chr8	1672763	1673123	360	180.0	
43212	chr8	1695712	1696165	453	226.0	
43213	chr8	1699605	1700074	469	234.0	
43214	chr8	1700991	1701910	919	460.0	enhancer
43215	chr8	1735336	1736779	1443	722.0	
43216	chr8	1744813	1747233	2420	1210.0	
43217	chr8	1755107	1756346	1239	620.0	
43218	chr8	1759799	1761139	1340	670.0	
43219	chr8	1762563	1765382	2819	1410.0	
43220	chr8	1766302	1767534	1232	616.0	
43221	chr8	1772960	1773335	375	188.0	
43222	chr8	1780970	1781969	999	500.0	
43223	chr8	1787632	1788723	1091	546.0	
43224	chr8	1791771	1792352	581	290.0	
43225	chr8	1813897	1814139	242	121.0	
43226	chr8	1816812	1818387	1575	788.0	
43227	chr8	1823175	1824551	1376	688.0	
43228	chr8	1858602	1858865	263	132.0	
43229	chr8	1868134	1868829	695	348.0	
43230	chr8	1892347	1892835	488	244.0	
43231	chr8	1894947	1895370	423	212.0	
43232	chr8	1913540	1913976	436	218.0	
43233	chr8	1921956	1922928	972	486.0	
43234	chr8	1924143	1925257	1114	557.0	
43235	chr8	1943095	1943356	261	130.0	
43236	chr8	1949256	1950247	991	496.0	
43237	chr8	1952385	1952855	470	235.0	
43238	chr8	1959887	1960341	454	227.0	
43239	chr8	1972892	1974642	1750	875.0	
43240	chr8	1978171	1978345	174	87.0	
43241	chr8	1980377	1980876	499	250.0	
43242	chr8	2000361	2003291	2930	1465.0	
43243	chr8	2005026	2006787	1761	880.0	
43244	chr8	2010007	2010392	385	192.0	
43245	chr8	2010975	2011266	291	146.0	
43246	chr8	2020756	2021157	401	200.0	
43247	chr8	2022941	2024473	1532	766.0	
43248	chr8	2030484	2030995	511	256.0	
43249	chr8	2086459	2087148	689	344.0	
43250	chr8	2089722	2090359	637	318.0	
43251	chr8	2091369	2091834	465	232.0	
43252	chr8	2101519	2102391	872	436.0	
43253	chr8	2110162	2110693	531	266.0	
43254	chr8	2118058	2118259	201	100.0	
43255	chr8	2118829	2118950	121	60.0	
43256	chr8	2121647	2121998	351	176.0	
43257	chr8	2126326	2128195	1869	934.0	
43258	chr8	2130204	2131892	1688	844.0	
43259	chr8	2132697	2133064	367	184.0	
43260	chr8	2133732	2134565	833	416.0	
43261	chr8	2140007	2140233	226	113.0	
43262	chr8	2143249	2143388	139	70.0	
43263	chr8	2144897	2147022	2125	1062.0	
43264	chr8	2156174	2156839	665	332.0	
43265	chr8	2162601	2163187	586	293.0	
43266	chr8	2181555	2183539	1984	992.0	
43267	chr8	2205575	2205751	176	88.0	
43268	chr8	2214977	2215342	365	182.0	
43269	chr8	2219200	2219786	586	293.0	
43270	chr8	2265906	2267155	1249	624.0	
43271	chr8	2316908	2317613	705	352.0	
43272	chr8	2727007	2728645	1638	819.0	
43273	chr8	2733440	2734292	852	426.0	
43274	chr8	2814469	2814864	395	198.0	
43275	chr8	3097080	3097754	674	337.0	
43276	chr8	3107428	3107898	470	235.0	
43277	chr8	3112106	3112495	389	194.0	
43278	chr8	3112998	3113155	157	78.0	
43279	chr8	3324357	3324528	171	86.0	
43280	chr8	6291329	6292328	999	500.0	
43281	chr8	6361226	6361428	202	101.0	
43282	chr8	6405456	6407633	2177	1088.0	
43283	chr8	6416142	6416548	406	203.0	
43284	chr8	6417119	6418370	1251	626.0	
43285	chr8	6423835	6424508	673	336.0	
43286	chr8	6425110	6425454	344	172.0	
43287	chr8	6426243	6426750	507	254.0	
43288	chr8	6428339	6429655	1316	658.0	
43289	chr8	6690005	6690924	919	460.0	
43290	chr8	6707577	6709886	2309	1154.0	
43291	chr8	6717980	6718717	737	368.0	
43292	chr8	6729296	6729903	607	304.0	
43293	chr8	6736664	6736942	278	139.0	
43294	chr8	6746019	6746732	713	356.0	
43295	chr8	6748170	6748909	739	370.0	
43296	chr8	6777808	6778155	347	174.0	
43297	chr8	6779399	6780047	648	324.0	
43298	chr8	6800644	6801287	643	322.0	
43299	chr8	6816239	6816610	371	186.0	
43300	chr8	6830134	6830465	331	166.0	
43301	chr8	6835201	6835774	573	286.0	
43302	chr8	6840563	6841510	947	474.0	
43303	chr8	6864390	6864829	439	220.0	
43304	chr8	6868263	6869468	1205	602.0	
43305	chr8	6877712	6878283	571	286.0	
43306	chr8	6890281	6890677	396	198.0	
43307	chr8	6920120	6920484	364	182.0	
43308	chr8	6928539	6928946	407	204.0	
43309	chr8	6939389	6939925	536	268.0	
43310	chr8	6953551	6954005	454	227.0	
43311	chr8	6958119	6958426	307	154.0	
43312	chr8	7035722	7036111	389	194.0	
43313	chr8	7080883	7081036	153	76.0	
43314	chr8	7091677	7092767	1090	545.0	
43315	chr8	7228016	7228393	377	188.0	
43316	chr8	7354752	7355647	895	448.0	
43317	chr8	7397747	7398201	454	227.0	
43318	chr8	7913421	7913851	430	215.0	
43319	chr8	7955089	7955424	335	168.0	
43320	chr8	8139470	8139845	375	188.0	
43321	chr8	8198883	8199328	445	222.0	
43322	chr8	8226986	8229485	2499	1250.0	
43323	chr8	8238382	8239128	746	373.0	
43324	chr8	8244303	8245027	724	362.0	
43325	chr8	8247786	8248184	398	199.0	
43326	chr8	8260629	8261258	629	314.0	
43327	chr8	8273113	8273763	650	325.0	
43328	chr8	8281493	8281893	400	200.0	
43329	chr8	8289070	8289756	686	343.0	
43330	chr8	8296349	8296572	223	112.0	
43331	chr8	8299527	8300050	523	262.0	
43332	chr8	8310376	8311079	703	352.0	
43333	chr8	8312606	8312923	317	158.0	
43334	chr8	8316870	8317276	406	203.0	
43335	chr8	8330583	8331696	1113	556.0	
43336	chr8	8333328	8334590	1262	631.0	
43337	chr8	8338464	8339019	555	278.0	
43338	chr8	8344755	8347670	2915	1458.0	
43339	chr8	8352042	8352816	774	387.0	
43340	chr8	8363356	8363709	353	176.0	
43341	chr8	8373845	8374300	455	228.0	
43342	chr8	8375326	8375729	403	202.0	
43343	chr8	8383938	8387356	3418	1709.0	
43344	chr8	8388120	8388589	469	234.0	
43345	chr8	8397774	8398277	503	252.0	
43346	chr8	8450857	8451375	518	259.0	
43347	chr8	8452625	8453067	442	221.0	
43348	chr8	8477447	8477672	225	112.0	
43349	chr8	8548416	8548818	402	201.0	
43350	chr8	8568946	8569459	513	256.0	
43351	chr8	8625757	8626289	532	266.0	
43352	chr8	8646402	8646409	7	4.0	
43353	chr8	8662222	8662831	609	304.0	
43354	chr8	8669640	8671020	1380	690.0	
43355	chr8	8701298	8702733	1435	718.0	
43356	chr8	8706877	8707208	331	166.0	
43357	chr8	8709838	8709990	152	76.0	
43358	chr8	8721191	8721717	526	263.0	
43359	chr8	8736833	8737363	530	265.0	
43360	chr8	8744478	8745002	524	262.0	
43361	chr8	8750632	8751304	672	336.0	
43362	chr8	8752908	8753543	635	318.0	
43363	chr8	8754264	8754786	522	261.0	
43364	chr8	8779596	8780948	1352	676.0	
43365	chr8	8783425	8784054	629	314.0	
43366	chr8	8788686	8790212	1526	763.0	
43367	chr8	8790833	8791526	693	346.0	
43368	chr8	8793675	8793970	295	148.0	
43369	chr8	8796898	8798195	1297	648.0	
43370	chr8	8811903	8812175	272	136.0	
43371	chr8	8820863	8821245	382	191.0	
43372	chr8	8848139	8849324	1185	592.0	
43373	chr8	8869057	8870088	1031	516.0	
43374	chr8	8871962	8872802	840	420.0	
43375	chr8	8892181	8894274	2093	1046.0	
43376	chr8	8895469	8895478	9	4.0	
43377	chr8	8917352	8918111	759	380.0	
43378	chr8	8919339	8920591	1252	626.0	
43379	chr8	8922000	8922389	389	194.0	
43380	chr8	8942545	8943009	464	232.0	
43381	chr8	8989260	8989714	454	227.0	
43382	chr8	8994803	8995699	896	448.0	
43383	chr8	9002179	9003685	1506	753.0	
43384	chr8	9006643	9006944	301	150.0	
43385	chr8	9011857	9012409	552	276.0	
43386	chr8	9025799	9026643	844	422.0	
43387	chr8	9029715	9030251	536	268.0	
43388	chr8	9040096	9040584	488	244.0	
43389	chr8	9065647	9066500	853	426.0	
43390	chr8	9074745	9075389	644	322.0	
43391	chr8	9079832	9080581	749	374.0	
43392	chr8	9081881	9082622	741	370.0	
43393	chr8	9087808	9089344	1536	768.0	
43394	chr8	9101296	9101468	172	86.0	
43395	chr8	9109112	9109419	307	154.0	
43396	chr8	9135413	9136673	1260	630.0	
43397	chr8	9149540	9152187	2647	1324.0	
43398	chr8	9152928	9153142	214	107.0	
43399	chr8	9188011	9188271	260	130.0	
43400	chr8	9189594	9189997	403	202.0	
43401	chr8	9248891	9249324	433	216.0	
43402	chr8	9324770	9324954	184	92.0	
43403	chr8	9338297	9338561	264	132.0	
43404	chr8	9368983	9369349	366	183.0	
43405	chr8	9552104	9552738	634	317.0	
43406	chr8	9555169	9557030	1861	930.0	
43407	chr8	9577422	9577590	168	84.0	
43408	chr8	9592392	9592766	374	187.0	
43409	chr8	9653412	9653772	360	180.0	
43410	chr8	9760505	9760850	345	172.0	
43411	chr8	9829210	9829866	656	328.0	
43412	chr8	9830836	9831452	616	308.0	
43413	chr8	10041519	10042072	553	276.0	
43414	chr8	10053422	10055836	2414	1207.0	
43415	chr8	10273933	10274089	156	78.0	
43416	chr8	10332461	10335427	2966	1483.0	
43417	chr8	10417677	10418158	481	240.0	
43418	chr8	10425080	10425568	488	244.0	
43419	chr8	10548031	10548481	450	225.0	
43420	chr8	10590060	10590606	546	273.0	
43421	chr8	10630089	10630815	726	363.0	
43422	chr8	10631580	10632341	761	380.0	
43423	chr8	10710935	10711616	681	340.0	
43424	chr8	10734304	10734414	110	55.0	
43425	chr8	10805179	10805721	542	271.0	
43426	chr8	10815999	10816506	507	254.0	
43427	chr8	10825119	10825911	792	396.0	
43428	chr8	10838598	10840675	2077	1038.0	
43429	chr8	10850383	10851006	623	312.0	
43430	chr8	10928160	10929039	879	440.0	
43431	chr8	10977161	10977553	392	196.0	
43432	chr8	10990126	10990574	448	224.0	
43433	chr8	11014703	11017320	2617	1308.0	
43434	chr8	11048027	11048490	463	232.0	
43435	chr8	11090922	11091282	360	180.0	
43436	chr8	11123835	11124921	1086	543.0	
43437	chr8	11199307	11202375	3068	1534.0	
43438	chr8	11250997	11251477	480	240.0	
43439	chr8	11251997	11252028	31	16.0	
43440	chr8	11269479	11269614	135	68.0	
43441	chr8	11279466	11279942	476	238.0	
43442	chr8	11280921	11281109	188	94.0	
43443	chr8	11283679	11285497	1818	909.0	
43444	chr8	11288493	11288734	241	120.0	
43445	chr8	11297455	11297910	455	228.0	
43446	chr8	11304343	11304806	463	232.0	
43447	chr8	11409410	11409809	399	200.0	
43448	chr8	11411432	11411906	474	237.0	
43449	chr8	11413597	11414152	555	278.0	
43450	chr8	11417831	11418542	711	356.0	
43451	chr8	11421960	11422074	114	57.0	
43452	chr8	11454087	11459423	5336	2668.0	
43453	chr8	11464763	11468215	3452	1726.0	
43454	chr8	11474351	11475111	760	380.0	
43455	chr8	11480035	11480586	551	276.0	
43456	chr8	11481997	11482144	147	74.0	
43457	chr8	11482994	11483378	384	192.0	
43458	chr8	11491734	11494851	3117	1558.0	
43459	chr8	11497605	11498151	546	273.0	
43460	chr8	11498745	11499453	708	354.0	
43461	chr8	11501525	11502013	488	244.0	
43462	chr8	11530937	11531031	94	47.0	
43463	chr8	11533510	11533938	428	214.0	
43464	chr8	11537690	11538361	671	336.0	
43465	chr8	11545412	11546476	1064	532.0	
43466	chr8	11553515	11554185	670	335.0	
43467	chr8	11557904	11559446	1542	771.0	
43468	chr8	11563746	11565796	2050	1025.0	
43469	chr8	11567162	11567255	93	46.0	
43470	chr8	11589217	11589927	710	355.0	
43471	chr8	11642346	11642673	327	164.0	
43472	chr8	11653179	11653494	315	158.0	
43473	chr8	11736224	11736851	627	314.0	
43474	chr8	11746253	11746782	529	264.0	enhancer
43475	chr8	11765236	11766099	863	432.0	
43476	chr8	11768179	11771064	2885	1442.0	
43477	chr8	11783092	11784044	952	476.0	
43478	chr8	11796337	11796918	581	290.0	
43479	chr8	11800329	11800653	324	162.0	
43480	chr8	11801816	11806674	4858	2429.0	
43481	chr8	11807767	11809181	1414	707.0	
43482	chr8	11820168	11821072	904	452.0	
43483	chr8	11823978	11824693	715	358.0	
43484	chr8	11826639	11827042	403	202.0	
43485	chr8	11834265	11834592	327	164.0	
43486	chr8	11836312	11836846	534	267.0	
43487	chr8	11840794	11841265	471	236.0	
43488	chr8	11845380	11846017	637	318.0	
43489	chr8	11849019	11849703	684	342.0	
43490	chr8	11853497	11854545	1048	524.0	
43491	chr8	11857091	11857775	684	342.0	
43492	chr8	11858288	11859420	1132	566.0	
43493	chr8	11860055	11863200	3145	1572.0	
43494	chr8	11863719	11864022	303	152.0	
43495	chr8	11865368	11869890	4522	2261.0	
43496	chr8	11872110	11872527	417	208.0	
43497	chr8	11874557	11875313	756	378.0	
43498	chr8	11877001	11879095	2094	1047.0	
43499	chr8	11885805	11889020	3215	1608.0	
43500	chr8	11891509	11892024	515	258.0	
43501	chr8	11896716	11898796	2080	1040.0	
43502	chr8	11901861	11903038	1177	588.0	
43503	chr8	11936104	11936387	283	142.0	
43504	chr8	11943586	11944072	486	243.0	
43505	chr8	11956203	11956660	457	228.0	
43506	chr8	11958813	11959371	558	279.0	
43507	chr8	11986392	11986437	45	22.0	
43508	chr8	12014466	12015465	999	500.0	
43509	chr8	12115556	12115962	406	203.0	
43510	chr8	12182607	12182951	344	172.0	
43511	chr8	12193937	12195226	1289	644.0	
43512	chr8	12436266	12437162	896	448.0	
43513	chr8	12525791	12526227	436	218.0	
43514	chr8	12587310	12587746	436	218.0	
43515	chr8	12600849	12601768	919	460.0	
43516	chr8	12658509	12659932	1423	712.0	
43517	chr8	12664977	12666078	1101	550.0	
43518	chr8	12708616	12708987	371	186.0	
43519	chr8	12731856	12732353	497	248.0	
43520	chr8	12750960	12751005	45	22.0	
43521	chr8	12753354	12758377	5023	2512.0	
43522	chr8	12764983	12767288	2305	1152.0	
43523	chr8	12774711	12775241	530	265.0	
43524	chr8	12795207	12795390	183	92.0	
43525	chr8	12840606	12841113	507	254.0	
43526	chr8	12934530	12934570	40	20.0	
43527	chr8	12951370	12952033	663	332.0	
43528	chr8	13033878	13034233	355	178.0	
43529	chr8	13042269	13042737	468	234.0	
43530	chr8	13065526	13065585	59	30.0	
43531	chr8	13131810	13133941	2131	1066.0	
43532	chr8	13213638	13213741	103	52.0	
43533	chr8	13224426	13225044	618	309.0	
43534	chr8	13566652	13567006	354	177.0	
43535	chr8	15378289	15378652	363	182.0	
43536	chr8	15540508	15540688	180	90.0	
43537	chr8	16163894	16164424	530	265.0	
43538	chr8	16186037	16186379	342	171.0	
43539	chr8	16192553	16193139	586	293.0	
43540	chr8	16194632	16194778	146	73.0	
43541	chr8	16196682	16197512	830	415.0	
43542	chr8	16201731	16202868	1137	568.0	
43543	chr8	16328122	16328258	136	68.0	
43544	chr8	16353310	16353594	284	142.0	
43545	chr8	16361657	16363283	1626	813.0	
43546	chr8	16423328	16423868	540	270.0	
43547	chr8	16603943	16604440	497	248.0	
43548	chr8	16632012	16632771	759	380.0	
43549	chr8	16779783	16780158	375	188.0	
43550	chr8	17001309	17002054	745	372.0	
43551	chr8	17012931	17013549	618	309.0	
43552	chr8	17026519	17028126	1607	804.0	
43553	chr8	17152344	17152994	650	325.0	
43554	chr8	17155461	17157667	2206	1103.0	
43555	chr8	17160204	17160327	123	62.0	
43556	chr8	17245836	17248131	2295	1148.0	
43557	chr8	17264930	17265779	849	424.0	
43558	chr8	17333975	17334325	350	175.0	
43559	chr8	17576191	17578002	1811	906.0	
43560	chr8	17591106	17591607	501	250.0	
43561	chr8	17602529	17603006	477	238.0	
43562	chr8	17630395	17630923	528	264.0	
43563	chr8	17697115	17697969	854	427.0	
43564	chr8	17699468	17700011	543	272.0	
43565	chr8	17724328	17724666	338	169.0	
43566	chr8	17801061	17801742	681	340.0	
43567	chr8	17864523	17864875	352	176.0	
43568	chr8	17902906	17903597	691	346.0	
43569	chr8	17904935	17905670	735	368.0	
43570	chr8	17907403	17908241	838	419.0	
43571	chr8	17908948	17909272	324	162.0	
43572	chr8	17912390	17913083	693	346.0	
43573	chr8	17915972	17916719	747	374.0	
43574	chr8	17919311	17919966	655	328.0	
43575	chr8	17922141	17924625	2484	1242.0	
43576	chr8	17926149	17929051	2902	1451.0	
43577	chr8	17941261	17941687	426	213.0	
43578	chr8	17962931	17963575	644	322.0	
43579	chr8	18068296	18069862	1566	783.0	
43580	chr8	18071851	18072521	670	335.0	
43581	chr8	18082402	18085598	3196	1598.0	
43582	chr8	18196779	18197717	938	469.0	
43583	chr8	18209378	18210813	1435	718.0	
43584	chr8	18565153	18565208	55	28.0	
43585	chr8	18731237	18731851	614	307.0	
43586	chr8	18747509	18748369	860	430.0	
43587	chr8	18755752	18756080	328	164.0	
43588	chr8	18846714	18847425	711	356.0	
43589	chr8	18868388	18868749	361	180.0	
43590	chr8	18911163	18912549	1386	693.0	
43591	chr8	18957156	18958026	870	435.0	
43592	chr8	18978698	18979227	529	264.0	
43593	chr8	19013270	19014715	1445	722.0	
43594	chr8	19052567	19053138	571	286.0	
43595	chr8	19067586	19067935	349	174.0	
43596	chr8	19084778	19085240	462	231.0	
43597	chr8	19095756	19096940	1184	592.0	
43598	chr8	19127808	19128725	917	458.0	
43599	chr8	19129392	19129861	469	234.0	
43600	chr8	19135755	19136056	301	150.0	
43601	chr8	19200723	19201193	470	235.0	
43602	chr8	19209246	19209885	639	320.0	
43603	chr8	19216668	19217362	694	347.0	
43604	chr8	19252713	19253114	401	200.0	
43605	chr8	19254415	19255036	621	310.0	
43606	chr8	19267557	19268004	447	224.0	
43607	chr8	19295545	19295946	401	200.0	
43608	chr8	19313502	19314622	1120	560.0	
43609	chr8	19345282	19345334	52	26.0	
43610	chr8	19372031	19372662	631	316.0	
43611	chr8	19385608	19386295	687	344.0	
43612	chr8	19389312	19389769	457	228.0	
43613	chr8	19393265	19393666	401	200.0	
43614	chr8	19408346	19409257	911	456.0	
43615	chr8	19445193	19445719	526	263.0	
43616	chr8	19458132	19458577	445	222.0	
43617	chr8	19459741	19460605	864	432.0	
43618	chr8	19461686	19462284	598	299.0	
43619	chr8	19473254	19473864	610	305.0	
43620	chr8	19474886	19476145	1259	630.0	
43621	chr8	19496320	19497983	1663	832.0	
43622	chr8	19510813	19511990	1177	588.0	
43623	chr8	19515049	19515869	820	410.0	
43624	chr8	19560614	19560782	168	84.0	
43625	chr8	19578892	19579163	271	136.0	
43626	chr8	19624468	19624837	369	184.0	
43627	chr8	19635467	19635868	401	200.0	
43628	chr8	19637816	19638221	405	202.0	
43629	chr8	19644543	19644948	405	202.0	
43630	chr8	19665296	19666030	734	367.0	
43631	chr8	19682203	19682931	728	364.0	
43632	chr8	19695566	19698356	2790	1395.0	
43633	chr8	19700031	19700718	687	344.0	
43634	chr8	19704636	19705259	623	312.0	
43635	chr8	19707965	19708364	399	200.0	
43636	chr8	19709757	19711140	1383	692.0	
43637	chr8	19754597	19758947	4350	2175.0	
43638	chr8	19767322	19767675	353	176.0	
43639	chr8	19779458	19779927	469	234.0	
43640	chr8	19813215	19813881	666	333.0	
43641	chr8	19816541	19818610	2069	1034.0	
43642	chr8	19843635	19845396	1761	880.0	
43643	chr8	19846675	19846974	299	150.0	
43644	chr8	19886523	19887212	689	344.0	
43645	chr8	19898318	19898793	475	238.0	
43646	chr8	19904657	19905004	347	174.0	
43647	chr8	19928855	19929191	336	168.0	
43648	chr8	19939292	19940552	1260	630.0	
43649	chr8	19962105	19962898	793	396.0	
43650	chr8	19969157	19969476	319	160.0	
43651	chr8	19975491	19975751	260	130.0	
43652	chr8	20086711	20087165	454	227.0	
43653	chr8	20099108	20099115	7	4.0	
43654	chr8	20105875	20105969	94	47.0	
43655	chr8	20122253	20122528	275	138.0	
43656	chr8	20125313	20125645	332	166.0	
43657	chr8	20133564	20134064	500	250.0	
43658	chr8	20141337	20141862	525	262.0	
43659	chr8	20146824	20147359	535	268.0	
43660	chr8	20155512	20155988	476	238.0	
43661	chr8	20175666	20176373	707	354.0	
43662	chr8	20184749	20185247	498	249.0	
43663	chr8	20186316	20187650	1334	667.0	
43664	chr8	20188862	20189830	968	484.0	
43665	chr8	20193088	20193557	469	234.0	
43666	chr8	20196453	20199000	2547	1274.0	
43667	chr8	20200715	20201257	542	271.0	
43668	chr8	20223665	20224365	700	350.0	
43669	chr8	20231533	20232388	855	428.0	
43670	chr8	20251516	20252547	1031	516.0	
43671	chr8	20254486	20254908	422	211.0	
43672	chr8	20265431	20266200	769	384.0	
43673	chr8	20268646	20269136	490	245.0	
43674	chr8	20273721	20274132	411	206.0	
43675	chr8	20276711	20277287	576	288.0	
43676	chr8	20301817	20304465	2648	1324.0	
43677	chr8	20344499	20344787	288	144.0	
43678	chr8	20375454	20376698	1244	622.0	
43679	chr8	20380744	20381143	399	200.0	
43680	chr8	20435030	20437723	2693	1346.0	
43681	chr8	20492928	20493898	970	485.0	
43682	chr8	20515826	20516317	491	246.0	
43683	chr8	20542948	20543302	354	177.0	
43684	chr8	21039327	21040305	978	489.0	
43685	chr8	21040858	21041726	868	434.0	
43686	chr8	21182149	21182804	655	328.0	
43687	chr8	21479081	21479194	113	56.0	
43688	chr8	21484075	21484352	277	138.0	
43689	chr8	21672169	21672794	625	312.0	
43690	chr8	21674472	21675396	924	462.0	
43691	chr8	21697159	21697260	101	50.0	
43692	chr8	21764632	21765691	1059	530.0	
43693	chr8	21812200	21812592	392	196.0	
43694	chr8	21822902	21823270	368	184.0	
43695	chr8	21857659	21859070	1411	706.0	
43696	chr8	21863726	21864421	695	348.0	
43697	chr8	21896922	21898107	1185	592.0	
43698	chr8	21901572	21901597	25	12.0	
43699	chr8	21904022	21915942	11920	5960.0	
43700	chr8	21917988	21920959	2971	1486.0	
43701	chr8	21921729	21922580	851	426.0	
43702	chr8	21938383	21938684	301	150.0	
43703	chr8	21959879	21960547	668	334.0	
43704	chr8	21985070	21985765	695	348.0	
43705	chr8	22009718	22010995	1277	638.0	
43706	chr8	22021768	22022197	429	214.0	
43707	chr8	22023788	22024975	1187	594.0	
43708	chr8	22036513	22037650	1137	568.0	
43709	chr8	22040006	22040171	165	82.0	
43710	chr8	22047425	22051193	3768	1884.0	enhancer
43711	chr8	22053937	22055860	1923	962.0	
43712	chr8	22059327	22060961	1634	817.0	
43713	chr8	22066220	22067406	1186	593.0	
43714	chr8	22088569	22091225	2656	1328.0	
43715	chr8	22095178	22096113	935	468.0	
43716	chr8	22106597	22106769	172	86.0	
43717	chr8	22107607	22110550	2943	1472.0	
43718	chr8	22111825	22112018	193	96.0	
43719	chr8	22114690	22114692	2	1.0	
43720	chr8	22116113	22116613	500	250.0	
43721	chr8	22129953	22131472	1519	760.0	
43722	chr8	22133069	22133792	723	362.0	
43723	chr8	22137026	22142757	5731	2866.0	
43724	chr8	22146697	22147221	524	262.0	
43725	chr8	22155888	22157448	1560	780.0	
43726	chr8	22163839	22166634	2795	1398.0	
43727	chr8	22188724	22188880	156	78.0	
43728	chr8	22190840	22191504	664	332.0	
43729	chr8	22210867	22211697	830	415.0	
43730	chr8	22212333	22212446	113	56.0	
43731	chr8	22237160	22237900	740	370.0	
43732	chr8	22244302	22246855	2553	1276.0	
43733	chr8	22255845	22256047	202	101.0	
43734	chr8	22274124	22274446	322	161.0	
43735	chr8	22287219	22287831	612	306.0	
43736	chr8	22366666	22368271	1605	802.0	
43737	chr8	22422489	22423148	659	330.0	
43738	chr8	22430118	22430903	785	392.0	
43739	chr8	22440056	22444903	4847	2424.0	
43740	chr8	22446574	22446975	401	200.0	
43741	chr8	22447694	22448617	923	462.0	
43742	chr8	22456499	22456787	288	144.0	
43743	chr8	22531545	22532177	632	316.0	
43744	chr8	22537853	22538643	790	395.0	
43745	chr8	22539923	22542073	2150	1075.0	
43746	chr8	22547607	22555479	7872	3936.0	
43747	chr8	22560834	22562580	1746	873.0	
43748	chr8	22564468	22567216	2748	1374.0	
43749	chr8	22572203	22572628	425	212.0	
43750	chr8	22573972	22575156	1184	592.0	
43751	chr8	22577882	22581231	3349	1674.0	
43752	chr8	22589061	22589279	218	109.0	
43753	chr8	22593612	22593952	340	170.0	
43754	chr8	22594458	22596083	1625	812.0	
43755	chr8	22596846	22600682	3836	1918.0	
43756	chr8	22601464	22601755	291	146.0	
43757	chr8	22603690	22606178	2488	1244.0	
43758	chr8	22621574	22621601	27	14.0	
43759	chr8	22622488	22623648	1160	580.0	
43760	chr8	22624222	22624365	143	72.0	
43761	chr8	22626006	22627017	1011	506.0	
43762	chr8	22639160	22640305	1145	572.0	
43763	chr8	22642264	22644054	1790	895.0	
43764	chr8	22666532	22666895	363	182.0	
43765	chr8	22667478	22687762	20284	10142.0	
43766	chr8	22688341	22696925	8584	4292.0	
43767	chr8	22700666	22701923	1257	628.0	
43768	chr8	22703165	22706184	3019	1510.0	
43769	chr8	22713666	22714114	448	224.0	
43770	chr8	22715176	22717204	2028	1014.0	
43771	chr8	22718436	22720054	1618	809.0	
43772	chr8	22723896	22724033	137	68.0	
43773	chr8	22740470	22740566	96	48.0	
43774	chr8	22741680	22741989	309	154.0	
43775	chr8	22745170	22745479	309	154.0	
43776	chr8	22747589	22748773	1184	592.0	
43777	chr8	22755924	22756752	828	414.0	
43778	chr8	22848238	22848701	463	232.0	
43779	chr8	22864704	22865711	1007	504.0	
43780	chr8	22908883	22909465	582	291.0	
43781	chr8	22916139	22918848	2709	1354.0	
43782	chr8	22953356	22954070	714	357.0	
43783	chr8	22973689	22975808	2119	1060.0	
43784	chr8	22980978	22981562	584	292.0	
43785	chr8	22982335	22983424	1089	544.0	
43786	chr8	22987951	22988385	434	217.0	
43787	chr8	22990405	22990901	496	248.0	
43788	chr8	22997450	23001197	3747	1874.0	
43789	chr8	23004494	23004936	442	221.0	
43790	chr8	23014618	23014699	81	40.0	
43791	chr8	23017772	23020276	2504	1252.0	
43792	chr8	23041065	23041144	79	40.0	
43793	chr8	23043748	23043835	87	44.0	
43794	chr8	23049724	23050517	793	396.0	
43795	chr8	23063072	23065642	2570	1285.0	
43796	chr8	23067356	23070686	3330	1665.0	
43797	chr8	23072385	23072864	479	240.0	
43798	chr8	23074001	23075965	1964	982.0	
43799	chr8	23083898	23084898	1000	500.0	
43800	chr8	23090318	23091481	1163	582.0	
43801	chr8	23092468	23092666	198	99.0	
43802	chr8	23102439	23104705	2266	1133.0	
43803	chr8	23105286	23105569	283	142.0	
43804	chr8	23120056	23120853	797	398.0	
43805	chr8	23129783	23130129	346	173.0	
43806	chr8	23160703	23164672	3969	1984.0	
43807	chr8	23172885	23173286	401	200.0	
43808	chr8	23176557	23177650	1093	546.0	
43809	chr8	23179960	23182530	2570	1285.0	
43810	chr8	23202167	23202279	112	56.0	
43811	chr8	23217654	23221855	4201	2100.0	
43812	chr8	23223630	23225966	2336	1168.0	
43813	chr8	23230280	23231458	1178	589.0	
43814	chr8	23236571	23236666	95	48.0	
43815	chr8	23241059	23241626	567	284.0	
43816	chr8	23243082	23244016	934	467.0	
43817	chr8	23246048	23247758	1710	855.0	
43818	chr8	23250326	23250778	452	226.0	
43819	chr8	23263128	23263149	21	10.0	
43820	chr8	23287279	23288879	1600	800.0	
43821	chr8	23296129	23296567	438	219.0	
43822	chr8	23336062	23336268	206	103.0	
43823	chr8	23381598	23381928	330	165.0	
43824	chr8	23400643	23401037	394	197.0	
43825	chr8	23403690	23403931	241	120.0	
43826	chr8	23409989	23411364	1375	688.0	
43827	chr8	23421430	23421654	224	112.0	
43828	chr8	23447385	23447798	413	206.0	
43829	chr8	23454891	23458694	3803	1902.0	
43830	chr8	23472068	23472830	762	381.0	
43831	chr8	23474179	23474729	550	275.0	
43832	chr8	23498230	23498794	564	282.0	
43833	chr8	23501820	23502124	304	152.0	
43834	chr8	23508871	23509300	429	214.0	
43835	chr8	23518933	23519408	475	238.0	
43836	chr8	23525108	23525736	628	314.0	
43837	chr8	23527953	23530637	2684	1342.0	
43838	chr8	23534607	23534640	33	16.0	
43839	chr8	23538380	23539706	1326	663.0	
43840	chr8	23540385	23542194	1809	904.0	
43841	chr8	23547506	23548456	950	475.0	
43842	chr8	23552624	23553126	502	251.0	
43843	chr8	23554091	23554644	553	276.0	
43844	chr8	23558631	23559875	1244	622.0	
43845	chr8	23560759	23561388	629	314.0	
43846	chr8	23574242	23574793	551	276.0	
43847	chr8	23589526	23589940	414	207.0	
43848	chr8	23682152	23683641	1489	744.0	
43849	chr8	23692544	23693061	517	258.0	
43850	chr8	23761253	23762358	1105	552.0	
43851	chr8	23763470	23763632	162	81.0	
43852	chr8	23973024	23973361	337	168.0	
43853	chr8	24033115	24033791	676	338.0	
43854	chr8	24154155	24154469	314	157.0	
43855	chr8	24229237	24229767	530	265.0	
43856	chr8	24244962	24245441	479	240.0	
43857	chr8	24271691	24272575	884	442.0	
43858	chr8	24277302	24277635	333	166.0	
43859	chr8	24293732	24294357	625	312.0	
43860	chr8	24297904	24298186	282	141.0	
43861	chr8	24330397	24330878	481	240.0	
43862	chr8	24349187	24350176	989	494.0	
43863	chr8	24357515	24357565	50	25.0	
43864	chr8	24367057	24367766	709	354.0	
43865	chr8	24371018	24371627	609	304.0	
43866	chr8	24384156	24384557	401	200.0	
43867	chr8	24387144	24388257	1113	556.0	
43868	chr8	24414873	24415484	611	306.0	
43869	chr8	24418168	24419632	1464	732.0	
43870	chr8	24891746	24892135	389	194.0	
43871	chr8	24913477	24915582	2105	1052.0	
43872	chr8	24941628	24943411	1783	892.0	
43873	chr8	24956469	24956616	147	74.0	
43874	chr8	24999880	25000703	823	412.0	
43875	chr8	25001440	25001570	130	65.0	
43876	chr8	25030593	25030916	323	162.0	
43877	chr8	25169942	25170641	699	350.0	
43878	chr8	25171284	25171793	509	254.0	
43879	chr8	25177868	25178910	1042	521.0	
43880	chr8	25183911	25186637	2726	1363.0	
43881	chr8	25188242	25188587	345	172.0	
43882	chr8	25198457	25199653	1196	598.0	
43883	chr8	25201618	25201827	209	104.0	
43884	chr8	25205956	25206446	490	245.0	
43885	chr8	25214608	25215027	419	210.0	
43886	chr8	25226797	25227186	389	194.0	
43887	chr8	25230930	25231205	275	138.0	
43888	chr8	25234760	25235576	816	408.0	
43889	chr8	25238484	25239815	1331	666.0	
43890	chr8	25243269	25244539	1270	635.0	
43891	chr8	25250795	25251284	489	244.0	
43892	chr8	25301797	25302039	242	121.0	
43893	chr8	25319710	25319856	146	73.0	
43894	chr8	25322642	25323103	461	230.0	
43895	chr8	25345190	25345987	797	398.0	
43896	chr8	25346811	25347157	346	173.0	
43897	chr8	25348734	25349332	598	299.0	
43898	chr8	25383997	25384320	323	162.0	
43899	chr8	25385161	25385640	479	240.0	
43900	chr8	25457296	25459796	2500	1250.0	
43901	chr8	25507180	25507780	600	300.0	
43902	chr8	25509791	25510259	468	234.0	
43903	chr8	26045191	26045826	635	318.0	
43904	chr8	26046536	26046589	53	26.0	
43905	chr8	26053229	26053596	367	184.0	
43906	chr8	26088618	26089367	749	374.0	
43907	chr8	26133666	26134695	1029	514.0	
43908	chr8	26149963	26150358	395	198.0	
43909	chr8	26166015	26166439	424	212.0	
43910	chr8	26193428	26193764	336	168.0	
43911	chr8	26198522	26199498	976	488.0	
43912	chr8	26212669	26213172	503	252.0	
43913	chr8	26215259	26215280	21	10.0	
43914	chr8	26258066	26258307	241	120.0	
43915	chr8	26265728	26266493	765	382.0	
43916	chr8	26267073	26267599	526	263.0	
43917	chr8	26287079	26287637	558	279.0	
43918	chr8	26290808	26293750	2942	1471.0	
43919	chr8	26296386	26297193	807	404.0	
43920	chr8	26298151	26298166	15	8.0	
43921	chr8	26304347	26305578	1231	616.0	
43922	chr8	26309591	26309757	166	83.0	
43923	chr8	26317472	26318345	873	436.0	
43924	chr8	26320967	26322045	1078	539.0	
43925	chr8	26322576	26322978	402	201.0	
43926	chr8	26323679	26323866	187	94.0	
43927	chr8	26327014	26328074	1060	530.0	
43928	chr8	26373976	26374865	889	444.0	
43929	chr8	26382221	26384459	2238	1119.0	
43930	chr8	26414659	26414763	104	52.0	
43931	chr8	26437518	26438688	1170	585.0	
43932	chr8	26440219	26441563	1344	672.0	
43933	chr8	26445797	26446645	848	424.0	
43934	chr8	26448205	26450499	2294	1147.0	
43935	chr8	26451174	26451894	720	360.0	
43936	chr8	26456010	26456580	570	285.0	
43937	chr8	26467192	26467879	687	344.0	
43938	chr8	26513053	26515270	2217	1108.0	
43939	chr8	26570974	26572822	1848	924.0	
43940	chr8	26573759	26573992	233	116.0	
43941	chr8	26575710	26580217	4507	2254.0	
43942	chr8	26589110	26590087	977	488.0	
43943	chr8	26595501	26596463	962	481.0	
43944	chr8	26608552	26610314	1762	881.0	
43945	chr8	26611428	26612007	579	290.0	
43946	chr8	26617735	26618330	595	298.0	
43947	chr8	26628396	26629156	760	380.0	
43948	chr8	26630098	26630206	108	54.0	
43949	chr8	26655453	26655900	447	224.0	
43950	chr8	26661592	26662205	613	306.0	
43951	chr8	26667363	26667771	408	204.0	
43952	chr8	26670468	26670999	531	266.0	
43953	chr8	26690889	26691047	158	79.0	
43954	chr8	27205034	27205153	119	60.0	
43955	chr8	27274164	27275117	953	476.0	
43956	chr8	27283986	27284160	174	87.0	
43957	chr8	27286928	27287107	179	90.0	
43958	chr8	27309387	27312430	3043	1522.0	
43959	chr8	27315006	27315889	883	442.0	
43960	chr8	27318290	27318403	113	56.0	
43961	chr8	27319788	27320587	799	400.0	
43962	chr8	27323489	27328695	5206	2603.0	
43963	chr8	27331676	27332349	673	336.0	
43964	chr8	27332922	27335368	2446	1223.0	
43965	chr8	27337305	27338108	803	402.0	
43966	chr8	27339344	27339796	452	226.0	
43967	chr8	27340409	27341298	889	444.0	
43968	chr8	27343096	27343636	540	270.0	
43969	chr8	27345998	27346782	784	392.0	
43970	chr8	27348281	27348991	710	355.0	
43971	chr8	27351594	27352450	856	428.0	
43972	chr8	27354188	27354447	259	130.0	
43973	chr8	27356971	27358305	1334	667.0	
43974	chr8	27360245	27364579	4334	2167.0	
43975	chr8	27365613	27367574	1961	980.0	
43976	chr8	27368287	27369476	1189	594.0	
43977	chr8	27370055	27370952	897	448.0	
43978	chr8	27371634	27372479	845	422.0	
43979	chr8	27375722	27381182	5460	2730.0	
43980	chr8	27384259	27384734	475	238.0	
43981	chr8	27386582	27386782	200	100.0	
43982	chr8	27389406	27391385	1979	990.0	
43983	chr8	27392620	27395725	3105	1552.0	
43984	chr8	27403869	27406272	2403	1202.0	
43985	chr8	27408138	27409635	1497	748.0	
43986	chr8	27412948	27414531	1583	792.0	
43987	chr8	27423277	27423731	454	227.0	
43988	chr8	27425909	27426768	859	430.0	
43989	chr8	27439568	27440331	763	382.0	
43990	chr8	27460113	27463803	3690	1845.0	
43991	chr8	27465023	27466263	1240	620.0	
43992	chr8	27490522	27491983	1461	730.0	
43993	chr8	27500378	27500576	198	99.0	
43994	chr8	27515845	27516223	378	189.0	
43995	chr8	27547586	27548488	902	451.0	
43996	chr8	27591991	27592891	900	450.0	
43997	chr8	27597031	27597601	570	285.0	
43998	chr8	27601978	27602486	508	254.0	
43999	chr8	27611271	27611777	506	253.0	
44000	chr8	27613983	27615052	1069	534.0	
44001	chr8	27727130	27727683	553	276.0	
44002	chr8	27763823	27764217	394	197.0	
44003	chr8	27771697	27775397	3700	1850.0	
44004	chr8	27827534	27828134	600	300.0	
44005	chr8	27837264	27838311	1047	524.0	
44006	chr8	27855489	27855829	340	170.0	
44007	chr8	27863574	27864272	698	349.0	
44008	chr8	27890213	27890429	216	108.0	
44009	chr8	27897217	27897832	615	308.0	
44010	chr8	27923699	27924208	509	254.0	
44011	chr8	27962799	27963394	595	298.0	
44012	chr8	27992525	27992970	445	222.0	
44013	chr8	28060803	28061505	702	351.0	
44014	chr8	28072527	28073356	829	414.0	
44015	chr8	28077845	28079603	1758	879.0	
44016	chr8	28081910	28082417	507	254.0	
44017	chr8	28083681	28084321	640	320.0	
44018	chr8	28092328	28093811	1483	742.0	
44019	chr8	28100272	28100759	487	244.0	
44020	chr8	28190155	28190554	399	200.0	
44021	chr8	28317144	28317716	572	286.0	
44022	chr8	28324043	28324909	866	433.0	
44023	chr8	28338141	28340044	1903	952.0	
44024	chr8	28342883	28343291	408	204.0	
44025	chr8	28346903	28349601	2698	1349.0	
44026	chr8	28355491	28355993	502	251.0	
44027	chr8	28363140	28364451	1311	656.0	
44028	chr8	28365612	28366206	594	297.0	
44029	chr8	28367154	28368247	1093	546.0	
44030	chr8	28370144	28370635	491	246.0	
44031	chr8	28371254	28372005	751	376.0	
44032	chr8	28374678	28375860	1182	591.0	
44033	chr8	28383098	28387217	4119	2060.0	
44034	chr8	28388020	28388584	564	282.0	
44035	chr8	28398670	28399092	422	211.0	
44036	chr8	28400548	28403350	2802	1401.0	
44037	chr8	28403970	28404238	268	134.0	
44038	chr8	28405284	28405500	216	108.0	
44039	chr8	28406224	28406766	542	271.0	
44040	chr8	28411341	28412970	1629	814.0	
44041	chr8	28419285	28420159	874	437.0	
44042	chr8	28442537	28443190	653	326.0	
44043	chr8	28444076	28444411	335	168.0	
44044	chr8	28464333	28464712	379	190.0	
44045	chr8	28475890	28476281	391	196.0	
44046	chr8	28489939	28491031	1092	546.0	
44047	chr8	28493494	28495648	2154	1077.0	
44048	chr8	28593901	28594570	669	334.0	
44049	chr8	28608393	28608683	290	145.0	
44050	chr8	28616696	28617499	803	402.0	
44051	chr8	28621734	28623719	1985	992.0	
44052	chr8	28633674	28634205	531	266.0	
44053	chr8	28657812	28658213	401	200.0	
44054	chr8	28699979	28702851	2872	1436.0	
44055	chr8	28705171	28705510	339	170.0	
44056	chr8	28707940	28709050	1110	555.0	
44057	chr8	28711319	28711816	497	248.0	
44058	chr8	28724928	28724980	52	26.0	
44059	chr8	28730670	28731107	437	218.0	
44060	chr8	28745038	28745439	401	200.0	
44061	chr8	28769550	28770408	858	429.0	
44062	chr8	28773154	28774006	852	426.0	
44063	chr8	28776182	28780038	3856	1928.0	
44064	chr8	28781760	28782578	818	409.0	
44065	chr8	28787666	28788216	550	275.0	
44066	chr8	28882777	28883599	822	411.0	
44067	chr8	28884543	28884936	393	196.0	
44068	chr8	28889081	28891743	2662	1331.0	
44069	chr8	28905334	28905824	490	245.0	
44070	chr8	29004220	29005048	828	414.0	
44071	chr8	29012966	29013472	506	253.0	
44072	chr8	29025126	29025450	324	162.0	
44073	chr8	29028559	29029004	445	222.0	
44074	chr8	29033014	29033336	322	161.0	
44075	chr8	29035435	29035841	406	203.0	
44076	chr8	29036367	29036972	605	302.0	
44077	chr8	29047340	29047795	455	228.0	
44078	chr8	29049824	29050745	921	460.0	
44079	chr8	29054042	29054535	493	246.0	
44080	chr8	29056000	29057038	1038	519.0	
44081	chr8	29060172	29062101	1929	964.0	
44082	chr8	29065154	29066272	1118	559.0	
44083	chr8	29067457	29068085	628	314.0	
44084	chr8	29085471	29085981	510	255.0	
44085	chr8	29087554	29087699	145	72.0	
44086	chr8	29088574	29088577	3	2.0	
44087	chr8	29101501	29101723	222	111.0	
44088	chr8	29108253	29108359	106	53.0	
44089	chr8	29109149	29109737	588	294.0	
44090	chr8	29116631	29117142	511	256.0	
44091	chr8	29127064	29127498	434	217.0	
44092	chr8	29176891	29177406	515	258.0	
44093	chr8	29185422	29185877	455	228.0	
44094	chr8	29192932	29193064	132	66.0	
44095	chr8	29200166	29200843	677	338.0	
44096	chr8	29209913	29210157	244	122.0	
44097	chr8	29225179	29225605	426	213.0	
44098	chr8	29226317	29226987	670	335.0	
44099	chr8	29228620	29231695	3075	1538.0	
44100	chr8	29249751	29250536	785	392.0	
44101	chr8	29253604	29253990	386	193.0	
44102	chr8	29254496	29255084	588	294.0	
44103	chr8	29258429	29258911	482	241.0	
44104	chr8	29261940	29263847	1907	954.0	
44105	chr8	29266661	29267006	345	172.0	
44106	chr8	29273677	29273922	245	122.0	
44107	chr8	29289438	29289931	493	246.0	
44108	chr8	29314451	29315767	1316	658.0	
44109	chr8	29320298	29320747	449	224.0	
44110	chr8	29339775	29340817	1042	521.0	
44111	chr8	29347271	29353332	6061	3030.0	
44112	chr8	29366250	29367246	996	498.0	
44113	chr8	29371225	29371675	450	225.0	
44114	chr8	29372685	29373767	1082	541.0	
44115	chr8	29408137	29410028	1891	946.0	
44116	chr8	29417179	29417332	153	76.0	
44117	chr8	29458968	29459702	734	367.0	
44118	chr8	29485624	29485802	178	89.0	
44119	chr8	29489849	29491682	1833	916.0	
44120	chr8	29498495	29500302	1807	904.0	
44121	chr8	29513270	29513779	509	254.0	
44122	chr8	29526270	29526770	500	250.0	
44123	chr8	29528680	29532345	3665	1832.0	
44124	chr8	29539097	29539676	579	290.0	
44125	chr8	29555054	29556266	1212	606.0	
44126	chr8	29562224	29562615	391	196.0	
44127	chr8	29583605	29584152	547	274.0	
44128	chr8	29594393	29594902	509	254.0	
44129	chr8	29634873	29635456	583	292.0	
44130	chr8	29637478	29637877	399	200.0	
44131	chr8	29641610	29642439	829	414.0	
44132	chr8	29647249	29647744	495	248.0	
44133	chr8	29654572	29654724	152	76.0	
44134	chr8	29655347	29656812	1465	732.0	
44135	chr8	29665022	29665694	672	336.0	
44136	chr8	29680890	29681340	450	225.0	
44137	chr8	29701259	29701630	371	186.0	
44138	chr8	29722786	29723442	656	328.0	
44139	chr8	29737167	29738245	1078	539.0	
44140	chr8	29747843	29748278	435	218.0	
44141	chr8	29749419	29749895	476	238.0	
44142	chr8	29752162	29752840	678	339.0	
44143	chr8	29767407	29767797	390	195.0	
44144	chr8	29773315	29775520	2205	1102.0	
44145	chr8	29790459	29790968	509	254.0	
44146	chr8	29806305	29806925	620	310.0	
44147	chr8	29809045	29809354	309	154.0	
44148	chr8	29823566	29823711	145	72.0	
44149	chr8	29824995	29825343	348	174.0	
44150	chr8	29835714	29835745	31	16.0	
44151	chr8	29836362	29836852	490	245.0	
44152	chr8	29848223	29848635	412	206.0	
44153	chr8	29885787	29886240	453	226.0	
44154	chr8	29956873	29957226	353	176.0	
44155	chr8	29990156	29991453	1297	648.0	
44156	chr8	29995021	29995422	401	200.0	
44157	chr8	29999292	29999731	439	220.0	
44158	chr8	30015980	30016517	537	268.0	
44159	chr8	30026055	30026417	362	181.0	
44160	chr8	30028610	30029026	416	208.0	
44161	chr8	30046395	30046605	210	105.0	
44162	chr8	30050221	30052757	2536	1268.0	
44163	chr8	30055300	30062472	7172	3586.0	
44164	chr8	30063939	30064403	464	232.0	
44165	chr8	30067177	30068391	1214	607.0	
44166	chr8	30069233	30070238	1005	502.0	
44167	chr8	30070923	30074205	3282	1641.0	
44168	chr8	30075220	30079137	3917	1958.0	
44169	chr8	30079646	30086876	7230	3615.0	
44170	chr8	30088480	30088788	308	154.0	
44171	chr8	30089557	30101870	12313	6156.0	
44172	chr8	30103479	30104357	878	439.0	
44173	chr8	30105601	30106019	418	209.0	
44174	chr8	30107613	30107979	366	183.0	
44175	chr8	30112603	30113900	1297	648.0	
44176	chr8	30116027	30116657	630	315.0	
44177	chr8	30133463	30134679	1216	608.0	
44178	chr8	30136979	30137756	777	388.0	
44179	chr8	30141233	30142298	1065	532.0	
44180	chr8	30144557	30145211	654	327.0	
44181	chr8	30149979	30149999	20	10.0	
44182	chr8	30155062	30158727	3665	1832.0	
44183	chr8	30169959	30170663	704	352.0	
44184	chr8	30227581	30228035	454	227.0	
44185	chr8	30324451	30324868	417	208.0	
44186	chr8	30384701	30385378	677	338.0	
44187	chr8	30423098	30423693	595	298.0	
44188	chr8	30555740	30556721	981	490.0	
44189	chr8	30600676	30601206	530	265.0	
44190	chr8	30648429	30648786	357	178.0	
44191	chr8	30654965	30659103	4138	2069.0	
44192	chr8	30666651	30667257	606	303.0	
44193	chr8	30671711	30672044	333	166.0	
44194	chr8	30719974	30720676	702	351.0	
44195	chr8	30721962	30724691	2729	1364.0	
44196	chr8	30725572	30728548	2976	1488.0	
44197	chr8	30737115	30737456	341	170.0	
44198	chr8	30743352	30744972	1620	810.0	
44199	chr8	30811770	30813568	1798	899.0	
44200	chr8	30918952	30919331	379	190.0	
44201	chr8	31011870	31012295	425	212.0	
44202	chr8	31032174	31034893	2719	1360.0	
44203	chr8	31185058	31185682	624	312.0	
44204	chr8	31252044	31252402	358	179.0	
44205	chr8	31833454	31833959	505	252.0	
44206	chr8	31876023	31876444	421	210.0	
44207	chr8	32487070	32487575	505	252.0	
44208	chr8	32547975	32549466	1491	746.0	
44209	chr8	32554664	32555065	401	200.0	
44210	chr8	32571996	32572235	239	120.0	
44211	chr8	32574801	32575633	832	416.0	
44212	chr8	32582509	32583022	513	256.0	
44213	chr8	32614177	32614516	339	170.0	
44214	chr8	32697267	32697331	64	32.0	
44215	chr8	32770602	32770918	316	158.0	
44216	chr8	32868736	32868737	1	0.0	
44217	chr8	32927680	32928296	616	308.0	
44218	chr8	33317915	33318014	99	50.0	
44219	chr8	33329450	33329709	259	130.0	
44220	chr8	33334696	33335129	433	216.0	
44221	chr8	33424580	33425021	441	220.0	
44222	chr8	33471605	33473730	2125	1062.0	
44223	chr8	33484394	33485943	1549	774.0	
44224	chr8	33496419	33496877	458	229.0	
44225	chr8	33512168	33516441	4273	2136.0	
44226	chr8	33524369	33525295	926	463.0	
44227	chr8	33533642	33533934	292	146.0	
44228	chr8	33543253	33543594	341	170.0	
44229	chr8	33545720	33545969	249	124.0	
44230	chr8	33553711	33555514	1803	902.0	
44231	chr8	33561149	33562102	953	476.0	
44232	chr8	33563176	33563904	728	364.0	
44233	chr8	33564760	33567881	3121	1560.0	
44234	chr8	33574484	33575137	653	326.0	
44235	chr8	33590816	33591386	570	285.0	
44236	chr8	33597612	33597746	134	67.0	
44237	chr8	33599485	33599828	343	172.0	
44238	chr8	33681549	33681551	2	1.0	
44239	chr8	33683166	33683462	296	148.0	
44240	chr8	35867765	35868174	409	204.0	
44241	chr8	35887085	35887521	436	218.0	
44242	chr8	35897730	35898287	557	278.0	
44243	chr8	36858911	36859248	337	168.0	
44244	chr8	37179840	37180159	319	160.0	
44245	chr8	37261731	37261970	239	120.0	
44246	chr8	37275630	37275701	71	36.0	
44247	chr8	37276502	37276711	209	104.0	
44248	chr8	37321032	37321602	570	285.0	
44249	chr8	37325952	37326522	570	285.0	
44250	chr8	37331708	37332245	537	268.0	
44251	chr8	37361187	37361789	602	301.0	
44252	chr8	37366954	37367055	101	50.0	
44253	chr8	37390426	37390889	463	232.0	
44254	chr8	37401571	37402355	784	392.0	
44255	chr8	37525133	37525284	151	76.0	
44256	chr8	37546894	37547365	471	236.0	
44257	chr8	37551010	37552094	1084	542.0	
44258	chr8	37574056	37575678	1622	811.0	
44259	chr8	37581256	37581804	548	274.0	
44260	chr8	37584059	37584528	469	234.0	
44261	chr8	37589216	37589780	564	282.0	
44262	chr8	37590880	37592052	1172	586.0	
44263	chr8	37599748	37600201	453	226.0	
44264	chr8	37610083	37610336	253	126.0	
44265	chr8	37629901	37630582	681	340.0	
44266	chr8	37631302	37632191	889	444.0	
44267	chr8	37691166	37691829	663	332.0	
44268	chr8	37694273	37701073	6800	3400.0	
44269	chr8	37701633	37702010	377	188.0	
44270	chr8	37708378	37708637	259	130.0	
44271	chr8	37717468	37717469	1	0.0	
44272	chr8	37735790	37738383	2593	1296.0	
44273	chr8	37747270	37748649	1379	690.0	
44274	chr8	37761970	37763589	1619	810.0	
44275	chr8	37779620	37780453	833	416.0	
44276	chr8	37786226	37786885	659	330.0	
44277	chr8	37787902	37788239	337	168.0	
44278	chr8	37790996	37791450	454	227.0	
44279	chr8	37792000	37792603	603	302.0	
44280	chr8	37793191	37793686	495	248.0	
44281	chr8	37796448	37798838	2390	1195.0	
44282	chr8	37802176	37802606	430	215.0	
44283	chr8	37804259	37805228	969	484.0	
44284	chr8	37814753	37815058	305	152.0	
44285	chr8	37821681	37822816	1135	568.0	
44286	chr8	37826433	37826918	485	242.0	enhancer
44287	chr8	37841138	37843154	2016	1008.0	
44288	chr8	37849243	37850584	1341	670.0	
44289	chr8	37851347	37851830	483	242.0	
44290	chr8	37854670	37854958	288	144.0	
44291	chr8	37856337	37856339	2	1.0	
44292	chr8	37863967	37864163	196	98.0	
44293	chr8	37870689	37872258	1569	784.0	
44294	chr8	37872965	37875160	2195	1098.0	
44295	chr8	37876730	37877040	310	155.0	
44296	chr8	37879252	37883862	4610	2305.0	
44297	chr8	37886369	37886973	604	302.0	
44298	chr8	37889841	37894783	4942	2471.0	
44299	chr8	37895997	37901739	5742	2871.0	
44300	chr8	37902798	37904354	1556	778.0	
44301	chr8	37905559	37905953	394	197.0	
44302	chr8	37909991	37910194	203	102.0	
44303	chr8	37915920	37916649	729	364.0	
44304	chr8	37924527	37924930	403	202.0	
44305	chr8	37948601	37949150	549	274.0	
44306	chr8	37968977	37969064	87	44.0	
44307	chr8	37996216	37996722	506	253.0	
44308	chr8	38029764	38031978	2214	1107.0	
44309	chr8	38066892	38067564	672	336.0	
44310	chr8	38086020	38086675	655	328.0	
44311	chr8	38090210	38091225	1015	508.0	
44312	chr8	38104528	38106475	1947	974.0	
44313	chr8	38120543	38121073	530	265.0	
44314	chr8	38134263	38135225	962	481.0	
44315	chr8	38150633	38151037	404	202.0	"promoter	TATA_box	protein_binding_site	protein_binding_site	protein_binding_site	protein_binding_site	protein_binding_site	protein_binding_site"
44316	chr8	38171274	38172136	862	431.0	
44317	chr8	38175590	38178228	2638	1319.0	
44318	chr8	38181565	38182230	665	332.0	
44319	chr8	38184340	38184993	653	326.0	
44320	chr8	38230766	38232753	1987	994.0	
44321	chr8	38267999	38270161	2162	1081.0	
44322	chr8	38274387	38274711	324	162.0	
44323	chr8	38278650	38278678	28	14.0	
44324	chr8	38295523	38295667	144	72.0	
44325	chr8	38303280	38303592	312	156.0	
44326	chr8	38347576	38347738	162	81.0	
44327	chr8	38359251	38360306	1055	528.0	
44328	chr8	38362482	38364066	1584	792.0	
44329	chr8	38368312	38369017	705	352.0	
44330	chr8	38378410	38378718	308	154.0	
44331	chr8	38379892	38388309	8417	4208.0	
44332	chr8	38390023	38390314	291	146.0	
44333	chr8	38404965	38405641	676	338.0	
44334	chr8	38406631	38407590	959	480.0	
44335	chr8	38408794	38412321	3527	1764.0	
44336	chr8	38431178	38431668	490	245.0	
44337	chr8	38442336	38442650	314	157.0	
44338	chr8	38445982	38446442	460	230.0	
44339	chr8	38465280	38469097	3817	1908.0	
44340	chr8	38528066	38528504	438	219.0	
44341	chr8	38714256	38714718	462	231.0	
44342	chr8	38720970	38721825	855	428.0	
44343	chr8	38756579	38757861	1282	641.0	
44344	chr8	38767122	38767223	101	50.0	
44345	chr8	38768005	38770985	2980	1490.0	
44346	chr8	38784790	38785428	638	319.0	
44347	chr8	38786500	38788780	2280	1140.0	
44348	chr8	38789506	38791182	1676	838.0	
44349	chr8	38793178	38793251	73	36.0	
44350	chr8	38793866	38794278	412	206.0	
44351	chr8	38797095	38798096	1001	500.0	
44352	chr8	38798665	38799066	401	200.0	
44353	chr8	38803184	38803633	449	224.0	
44354	chr8	38804663	38808464	3801	1900.0	
44355	chr8	38830440	38831245	805	402.0	
44356	chr8	38846817	38847258	441	220.0	
44357	chr8	38850808	38851711	903	452.0	
44358	chr8	38856068	38856761	693	346.0	
44359	chr8	38864755	38865899	1144	572.0	
44360	chr8	38883592	38883935	343	172.0	
44361	chr8	38899580	38906447	6867	3434.0	
44362	chr8	38912341	38912835	494	247.0	
44363	chr8	38914251	38914561	310	155.0	
44364	chr8	38916677	38917057	380	190.0	
44365	chr8	38918057	38918725	668	334.0	
44366	chr8	38924379	38924751	372	186.0	
44367	chr8	38933172	38933332	160	80.0	
44368	chr8	38935963	38939520	3557	1778.0	
44369	chr8	38941802	38941963	161	80.0	
44370	chr8	38943594	38944789	1195	598.0	
44371	chr8	38957128	38958179	1051	526.0	
44372	chr8	38962937	38963583	646	323.0	
44373	chr8	38965132	38965489	357	178.0	
44374	chr8	38966035	38967023	988	494.0	
44375	chr8	38973587	38975064	1477	738.0	
44376	chr8	38986643	38987332	689	344.0	
44377	chr8	38995694	38999706	4012	2006.0	
44378	chr8	39002430	39003117	687	344.0	
44379	chr8	39006911	39007485	574	287.0	
44380	chr8	39037884	39038585	701	350.0	
44381	chr8	39041902	39042261	359	180.0	
44382	chr8	39848645	39849087	442	221.0	
44383	chr8	39891978	39892384	406	203.0	
44384	chr8	39912845	39914049	1204	602.0	
44385	chr8	39939609	39940463	854	427.0	
44386	chr8	39943687	39944330	643	322.0	
44387	chr8	39948611	39948715	104	52.0	
44388	chr8	39949302	39950317	1015	508.0	
44389	chr8	39951401	39952587	1186	593.0	
44390	chr8	39960933	39961585	652	326.0	
44391	chr8	39964077	39964563	486	243.0	
44392	chr8	39969978	39970245	267	134.0	
44393	chr8	39971687	39972086	399	200.0	
44394	chr8	39989729	39990198	469	234.0	
44395	chr8	39995611	39996112	501	250.0	
44396	chr8	40007417	40007939	522	261.0	
44397	chr8	40009200	40009819	619	310.0	
44398	chr8	40172714	40173295	581	290.0	
44399	chr8	40199645	40200046	401	200.0	
44400	chr8	40201697	40202142	445	222.0	
44401	chr8	40745217	40745224	7	4.0	
44402	chr8	40872165	40872616	451	226.0	
44403	chr8	41250744	41251069	325	162.0	
44404	chr8	41264280	41264590	310	155.0	
44405	chr8	41415538	41416172	634	317.0	
44406	chr8	41430005	41430579	574	287.0	
44407	chr8	41466482	41467287	805	402.0	
44408	chr8	41477229	41477677	448	224.0	
44409	chr8	41489583	41491644	2061	1030.0	
44410	chr8	41507518	41508867	1349	674.0	
44411	chr8	41514592	41515738	1146	573.0	
44412	chr8	41528440	41530294	1854	927.0	
44413	chr8	41535815	41536289	474	237.0	
44414	chr8	41542425	41543327	902	451.0	
44415	chr8	41544311	41545657	1346	673.0	
44416	chr8	41566751	41567679	928	464.0	
44417	chr8	41569433	41570398	965	482.0	
44418	chr8	41577350	41579662	2312	1156.0	
44419	chr8	41590234	41591156	922	461.0	
44420	chr8	41612446	41613204	758	379.0	
44421	chr8	41622205	41623613	1408	704.0	
44422	chr8	41646446	41646848	402	201.0	
44423	chr8	41651158	41652183	1025	512.0	
44424	chr8	41653409	41654786	1377	688.0	
44425	chr8	41661169	41661372	203	102.0	
44426	chr8	41662559	41664325	1766	883.0	
44427	chr8	41665020	41666156	1136	568.0	
44428	chr8	41684022	41684508	486	243.0	
44429	chr8	41685301	41685884	583	292.0	
44430	chr8	41701312	41702499	1187	594.0	
44431	chr8	41703776	41704133	357	178.0	
44432	chr8	41715334	41716632	1298	649.0	
44433	chr8	41766616	41766696	80	40.0	
44434	chr8	41791976	41792885	909	454.0	
44435	chr8	41797452	41798261	809	404.0	
44436	chr8	41822567	41823220	653	326.0	
44437	chr8	41827665	41829394	1729	864.0	
44438	chr8	41834491	41835164	673	336.0	
44439	chr8	41835989	41836654	665	332.0	
44440	chr8	41895784	41897484	1700	850.0	
44441	chr8	41928649	41930493	1844	922.0	
44442	chr8	41933113	41933513	400	200.0	
44443	chr8	41944123	41944548	425	212.0	
44444	chr8	41956716	41957560	844	422.0	
44445	chr8	41961790	41962163	373	186.0	
44446	chr8	41971325	41971945	620	310.0	
44447	chr8	41975473	41975825	352	176.0	
44448	chr8	41985598	41985904	306	153.0	
44449	chr8	41986802	41987681	879	440.0	
44450	chr8	41995050	41995922	872	436.0	
44451	chr8	42006031	42006380	349	174.0	
44452	chr8	42010752	42010785	33	16.0	
44453	chr8	42012287	42012722	435	218.0	
44454	chr8	42028451	42029376	925	462.0	
44455	chr8	42032558	42034400	1842	921.0	
44456	chr8	42037272	42038239	967	484.0	
44457	chr8	42044640	42044854	214	107.0	
44458	chr8	42049487	42053465	3978	1989.0	
44459	chr8	42068798	42069092	294	147.0	
44460	chr8	42139040	42142416	3376	1688.0	
44461	chr8	42147695	42148347	652	326.0	
44462	chr8	42151770	42156320	4550	2275.0	
44463	chr8	42162562	42162786	224	112.0	
44464	chr8	42171357	42172343	986	493.0	
44465	chr8	42175222	42175865	643	322.0	
44466	chr8	42177181	42178224	1043	522.0	
44467	chr8	42179586	42181629	2043	1022.0	
44468	chr8	42182631	42183432	801	400.0	
44469	chr8	42207591	42207957	366	183.0	
44470	chr8	42216982	42217680	698	349.0	
44471	chr8	42221251	42221823	572	286.0	
44472	chr8	42222985	42223645	660	330.0	
44473	chr8	42245977	42246285	308	154.0	
44474	chr8	42246978	42247325	347	174.0	
44475	chr8	42249773	42249840	67	34.0	
44476	chr8	42265313	42266381	1068	534.0	
44477	chr8	42269585	42272416	2831	1416.0	
44478	chr8	42279633	42279714	81	40.0	
44479	chr8	42284495	42285007	512	256.0	
44480	chr8	42292173	42293750	1577	788.0	
44481	chr8	42319678	42319981	303	152.0	
44482	chr8	42326302	42327037	735	368.0	
44483	chr8	42329732	42330358	626	313.0	
44484	chr8	42330944	42331814	870	435.0	
44485	chr8	42337612	42340264	2652	1326.0	
44486	chr8	42346758	42347225	467	234.0	
44487	chr8	42355308	42356339	1031	516.0	
44488	chr8	42385166	42385877	711	356.0	
44489	chr8	42390967	42392910	1943	972.0	
44490	chr8	42406066	42406182	116	58.0	
44491	chr8	42412093	42413463	1370	685.0	
44492	chr8	42515769	42517071	1302	651.0	
44493	chr8	42537326	42538695	1369	684.0	
44494	chr8	42540561	42543537	2976	1488.0	
44495	chr8	42555126	42555594	468	234.0	
44496	chr8	42618670	42619228	558	279.0	
44497	chr8	42655668	42655691	23	12.0	
44498	chr8	42656595	42656688	93	46.0	
44499	chr8	42665831	42666329	498	249.0	
44500	chr8	42674006	42674465	459	230.0	
44501	chr8	42692405	42693081	676	338.0	
44502	chr8	42708966	42709367	401	200.0	
44503	chr8	42712728	42712927	199	100.0	
44504	chr8	42740954	42742068	1114	557.0	
44505	chr8	42753797	42753823	26	13.0	
44506	chr8	42760857	42761558	701	350.0	
44507	chr8	42768402	42768942	540	270.0	
44508	chr8	42784092	42784145	53	26.0	
44509	chr8	42789774	42790884	1110	555.0	
44510	chr8	42797269	42797918	649	324.0	
44511	chr8	42803202	42804093	891	446.0	
44512	chr8	42804940	42805689	749	374.0	
44513	chr8	42822933	42823449	516	258.0	
44514	chr8	42842223	42844069	1846	923.0	
44515	chr8	42856925	42857299	374	187.0	
44516	chr8	42891643	42892264	621	310.0	
44517	chr8	42893158	42894705	1547	774.0	
44518	chr8	42895441	42899028	3587	1794.0	
44519	chr8	42919665	42920835	1170	585.0	
44520	chr8	42926658	42926993	335	168.0	
44521	chr8	42957905	42958426	521	260.0	
44522	chr8	43044318	43044613	295	148.0	
44523	chr8	43055061	43058106	3045	1522.0	
44524	chr8	43073486	43073953	467	234.0	
44525	chr8	43091059	43091545	486	243.0	
44526	chr8	43092255	43094494	2239	1120.0	
44527	chr8	43100359	43100489	130	65.0	
44528	chr8	43101826	43103773	1947	974.0	
44529	chr8	43138970	43142812	3842	1921.0	
44530	chr8	43145057	43146170	1113	556.0	
44531	chr8	43161807	43161815	8	4.0	
44532	chr8	43162860	43163775	915	458.0	
44533	chr8	43166704	43167529	825	412.0	
44534	chr8	43237543	43241991	4448	2224.0	
44535	chr8	43976235	43976653	418	209.0	
44536	chr8	43983511	43983725	214	107.0	
44537	chr8	45933622	45933997	375	188.0	
44538	chr8	46910843	46911254	411	206.0	
44539	chr8	46917392	46918567	1175	588.0	
44540	chr8	46919562	46920416	854	427.0	
44541	chr8	46955993	46957515	1522	761.0	
44542	chr8	47167312	47167713	401	200.0	
44543	chr8	47188640	47188976	336	168.0	
44544	chr8	47198121	47199018	897	448.0	
44545	chr8	47203139	47203589	450	225.0	
44546	chr8	47259476	47261773	2297	1148.0	
44547	chr8	47353162	47354075	913	456.0	
44548	chr8	47360343	47362322	1979	990.0	
44549	chr8	47363116	47363793	677	338.0	
44550	chr8	47366233	47366234	1	0.0	
44551	chr8	47368872	47370441	1569	784.0	
44552	chr8	47382739	47383032	293	146.0	
44553	chr8	47395106	47395226	120	60.0	
44554	chr8	47396833	47397159	326	163.0	
44555	chr8	47398786	47399442	656	328.0	
44556	chr8	47406554	47407026	472	236.0	
44557	chr8	47431057	47432005	948	474.0	
44558	chr8	47438069	47438919	850	425.0	
44559	chr8	47459512	47459897	385	192.0	
44560	chr8	47471913	47472294	381	190.0	
44561	chr8	47478018	47478488	470	235.0	
44562	chr8	47479545	47479874	329	164.0	
44563	chr8	47496075	47496435	360	180.0	
44564	chr8	47506259	47507389	1130	565.0	
44565	chr8	47508299	47508757	458	229.0	
44566	chr8	47509359	47510040	681	340.0	
44567	chr8	47513357	47514449	1092	546.0	
44568	chr8	47522280	47522746	466	233.0	
44569	chr8	47523456	47524014	558	279.0	
44570	chr8	47525849	47526976	1127	564.0	
44571	chr8	47542042	47542443	401	200.0	
44572	chr8	47573394	47574773	1379	690.0	
44573	chr8	47591652	47592425	773	386.0	
44574	chr8	47593673	47593908	235	118.0	
44575	chr8	47597332	47598954	1622	811.0	
44576	chr8	47600211	47601531	1320	660.0	
44577	chr8	47602229	47603129	900	450.0	
44578	chr8	47610362	47610601	239	120.0	
44579	chr8	47612560	47612912	352	176.0	
44580	chr8	47627500	47628286	786	393.0	
44581	chr8	47632704	47633071	367	184.0	
44582	chr8	47644045	47644639	594	297.0	
44583	chr8	47670304	47670321	17	8.0	
44584	chr8	47680453	47680789	336	168.0	
44585	chr8	47703779	47704650	871	436.0	
44586	chr8	47733827	47739374	5547	2774.0	
44587	chr8	47862589	47863021	432	216.0	
44588	chr8	47869531	47869773	242	121.0	
44589	chr8	47920158	47920464	306	153.0	
44590	chr8	47959402	47962018	2616	1308.0	"protein_binding_site	protein_binding_site	origin_of_replication	protein_binding_site	protein_binding_site"
44591	chr8	47997222	47997639	417	208.0	
44592	chr8	47999071	47999371	300	150.0	
44593	chr8	48007631	48009705	2074	1037.0	
44594	chr8	48034865	48035266	401	200.0	
44595	chr8	48318655	48319537	882	441.0	
44596	chr8	48513930	48515517	1587	794.0	
44597	chr8	48517834	48518385	551	276.0	
44598	chr8	48521395	48521441	46	23.0	
44599	chr8	48652949	48653317	368	184.0	
44600	chr8	48695694	48696057	363	182.0	
44601	chr8	48735098	48735808	710	355.0	
44602	chr8	48788832	48789095	263	132.0	
44603	chr8	48810424	48810603	179	90.0	
44604	chr8	48921220	48922224	1004	502.0	
44605	chr8	48925402	48926248	846	423.0	
44606	chr8	48949213	48950163	950	475.0	
44607	chr8	48950706	48951122	416	208.0	
44608	chr8	48979004	48979321	317	158.0	
44609	chr8	51121946	51121999	53	26.0	
44610	chr8	51452488	51452857	369	184.0	
44611	chr8	51526051	51526393	342	171.0	
44612	chr8	51804938	51805175	237	118.0	
44613	chr8	51850442	51850892	450	225.0	
44614	chr8	51869883	51871572	1689	844.0	
44615	chr8	51884750	51885580	830	415.0	
44616	chr8	51897144	51900620	3476	1738.0	
44617	chr8	51901911	51902696	785	392.0	
44618	chr8	51937365	51937739	374	187.0	
44619	chr8	51939408	51939561	153	76.0	
44620	chr8	51961612	51963048	1436	718.0	
44621	chr8	52000312	52000702	390	195.0	
44622	chr8	52008166	52009079	913	456.0	
44623	chr8	52014288	52014697	409	204.0	
44624	chr8	52294049	52294697	648	324.0	
44625	chr8	52407669	52407964	295	148.0	
44626	chr8	52460192	52461250	1058	529.0	
44627	chr8	52464064	52464621	557	278.0	
44628	chr8	52467093	52467671	578	289.0	"enhancer	sequence_feature"
44629	chr8	52496090	52496562	472	236.0	
44630	chr8	52578009	52578025	16	8.0	
44631	chr8	52688460	52688775	315	158.0	
44632	chr8	52712852	52715328	2476	1238.0	
44633	chr8	52720108	52720248	140	70.0	
44634	chr8	52727364	52727617	253	126.0	
44635	chr8	52737036	52737506	470	235.0	
44636	chr8	52764260	52764760	500	250.0	
44637	chr8	52782984	52783799	815	408.0	
44638	chr8	52793417	52793423	6	3.0	
44639	chr8	52838349	52838702	353	176.0	
44640	chr8	52939208	52942070	2862	1431.0	
44641	chr8	52965822	52966178	356	178.0	
44642	chr8	52986016	52986118	102	51.0	
44643	chr8	53654132	53654427	295	148.0	
44644	chr8	53657474	53658358	884	442.0	
44645	chr8	53693127	53693271	144	72.0	
44646	chr8	53761622	53762022	400	200.0	
44647	chr8	53807523	53807876	353	176.0	
44648	chr8	53841149	53841711	562	281.0	
44649	chr8	53842442	53845070	2628	1314.0	
44650	chr8	53846255	53847074	819	410.0	
44651	chr8	53877585	53878229	644	322.0	
44652	chr8	53879296	53882035	2739	1370.0	
44653	chr8	53944771	53945640	869	434.0	
44654	chr8	53979804	53980234	430	215.0	
44655	chr8	54018648	54018914	266	133.0	
44656	chr8	54020315	54020674	359	180.0	
44657	chr8	54021187	54023062	1875	938.0	
44658	chr8	54070881	54071528	647	324.0	
44659	chr8	54100783	54103819	3036	1518.0	
44660	chr8	54134520	54136017	1497	748.0	
44661	chr8	54152804	54153893	1089	544.0	
44662	chr8	54159035	54159436	401	200.0	
44663	chr8	54165712	54166591	879	440.0	
44664	chr8	54169250	54169961	711	356.0	
44665	chr8	54170717	54170970	253	126.0	
44666	chr8	54171740	54172074	334	167.0	
44667	chr8	54232429	54232574	145	72.0	
44668	chr8	54267673	54268016	343	172.0	
44669	chr8	54268748	54269394	646	323.0	
44670	chr8	54282500	54282812	312	156.0	
44671	chr8	54304253	54304652	399	200.0	
44672	chr8	54454729	54455115	386	193.0	
44673	chr8	54775092	54775457	365	182.0	
44674	chr8	54858229	54858669	440	220.0	
44675	chr8	55772091	55774241	2150	1075.0	
44676	chr8	55815088	55815429	341	170.0	
44677	chr8	55818782	55819224	442	221.0	
44678	chr8	55840356	55841021	665	332.0	
44679	chr8	55843387	55845578	2191	1096.0	
44680	chr8	55856358	55856486	128	64.0	
44681	chr8	55860960	55861035	75	38.0	
44682	chr8	55863761	55864820	1059	530.0	
44683	chr8	55865609	55866359	750	375.0	
44684	chr8	55867232	55867587	355	178.0	
44685	chr8	55871537	55871910	373	186.0	
44686	chr8	55878726	55882137	3411	1706.0	
44687	chr8	55883387	55886523	3136	1568.0	
44688	chr8	55890310	55891979	1669	834.0	
44689	chr8	55892902	55893848	946	473.0	
44690	chr8	55895874	55896134	260	130.0	
44691	chr8	55901635	55902111	476	238.0	
44692	chr8	55905655	55905944	289	144.0	
44693	chr8	55909554	55909804	250	125.0	
44694	chr8	55914019	55914677	658	329.0	
44695	chr8	55918087	55920114	2027	1014.0	
44696	chr8	55924256	55925255	999	500.0	
44697	chr8	55927928	55928389	461	230.0	
44698	chr8	55929476	55931125	1649	824.0	
44699	chr8	55934709	55935196	487	244.0	
44700	chr8	55939058	55940477	1419	710.0	
44701	chr8	55948197	55948722	525	262.0	
44702	chr8	55971127	55971561	434	217.0	
44703	chr8	55972096	55973722	1626	813.0	
44704	chr8	55975207	55976140	933	466.0	
44705	chr8	55978524	55979004	480	240.0	
44706	chr8	55988907	55989697	790	395.0	
44707	chr8	55990298	55992091	1793	896.0	
44708	chr8	56005156	56007399	2243	1122.0	
44709	chr8	56010329	56011172	843	422.0	
44710	chr8	56015987	56016414	427	214.0	
44711	chr8	56017048	56017136	88	44.0	
44712	chr8	56018927	56019095	168	84.0	
44713	chr8	56028576	56029285	709	354.0	
44714	chr8	56060008	56060685	677	338.0	
44715	chr8	56067774	56068018	244	122.0	
44716	chr8	56071406	56071817	411	206.0	
44717	chr8	56073220	56075318	2098	1049.0	
44718	chr8	56079078	56079506	428	214.0	
44719	chr8	56093544	56094133	589	294.0	
44720	chr8	56108928	56108994	66	33.0	
44721	chr8	56162957	56163278	321	160.0	
44722	chr8	56202181	56202645	464	232.0	
44723	chr8	56209313	56212991	3678	1839.0	
44724	chr8	56241847	56242372	525	262.0	
44725	chr8	56447864	56448316	452	226.0	
44726	chr8	56557831	56560618	2787	1394.0	
44727	chr8	56566577	56566874	297	148.0	
44728	chr8	56572521	56573214	693	346.0	
44729	chr8	56662327	56662729	402	201.0	
44730	chr8	56682055	56682780	725	362.0	
44731	chr8	56699214	56699521	307	154.0	
44732	chr8	56757618	56757844	226	113.0	
44733	chr8	56787550	56787853	303	152.0	
44734	chr8	56929133	56929505	372	186.0	
44735	chr8	56968441	56968451	10	5.0	
44736	chr8	56971025	56971175	150	75.0	
44737	chr8	56992490	56994635	2145	1072.0	
44738	chr8	56999384	57000927	1543	772.0	
44739	chr8	57113597	57114204	607	304.0	
44740	chr8	57205750	57206132	382	191.0	
44741	chr8	57209831	57210357	526	263.0	
44742	chr8	57343244	57343729	485	242.0	
44743	chr8	57378477	57378715	238	119.0	
44744	chr8	57412494	57412922	428	214.0	
44745	chr8	57420520	57421194	674	337.0	
44746	chr8	57441363	57441801	438	219.0	
44747	chr8	57444538	57444918	380	190.0	
44748	chr8	57445635	57446041	406	203.0	
44749	chr8	57447543	57447947	404	202.0	
44750	chr8	57448675	57449606	931	466.0	
44751	chr8	57463065	57463519	454	227.0	
44752	chr8	57745414	57745763	349	174.0	
44753	chr8	57748305	57748324	19	10.0	
44754	chr8	57862038	57862431	393	196.0	
44755	chr8	57894290	57894679	389	194.0	
44756	chr8	57933801	57934236	435	218.0	
44757	chr8	57994208	57995695	1487	744.0	
44758	chr8	58098439	58098443	4	2.0	
44759	chr8	58128229	58128911	682	341.0	
44760	chr8	58137343	58138337	994	497.0	
44761	chr8	58145426	58146342	916	458.0	
44762	chr8	58148535	58148855	320	160.0	
44763	chr8	58155027	58156208	1181	590.0	
44764	chr8	58172461	58173530	1069	534.0	
44765	chr8	58217927	58218423	496	248.0	
44766	chr8	58220786	58220893	107	54.0	
44767	chr8	58234388	58234855	467	234.0	
44768	chr8	58255158	58255193	35	18.0	
44769	chr8	58257320	58257534	214	107.0	enhancer
44770	chr8	58265281	58265729	448	224.0	
44771	chr8	58321449	58322080	631	316.0	
44772	chr8	58345438	58345741	303	152.0	
44773	chr8	58360944	58361484	540	270.0	
44774	chr8	58378202	58379050	848	424.0	
44775	chr8	58392637	58393217	580	290.0	
44776	chr8	58395135	58395761	626	313.0	
44777	chr8	58396279	58398375	2096	1048.0	
44778	chr8	58410756	58412433	1677	838.0	
44779	chr8	58413829	58413839	10	5.0	
44780	chr8	58513182	58513853	671	336.0	
44781	chr8	58534805	58535229	424	212.0	
44782	chr8	58552495	58556638	4143	2072.0	
44783	chr8	58557497	58558895	1398	699.0	
44784	chr8	58559894	58560978	1084	542.0	
44785	chr8	58563166	58564331	1165	582.0	
44786	chr8	58566925	58566952	27	14.0	
44787	chr8	58567606	58567787	181	90.0	
44788	chr8	58568410	58569333	923	462.0	
44789	chr8	58577020	58577176	156	78.0	
44790	chr8	58578536	58578728	192	96.0	
44791	chr8	58579760	58579852	92	46.0	
44792	chr8	58580947	58581356	409	204.0	
44793	chr8	58584575	58585187	612	306.0	
44794	chr8	58585727	58586020	293	146.0	
44795	chr8	58594513	58596616	2103	1052.0	
44796	chr8	58608329	58609015	686	343.0	
44797	chr8	58616561	58616837	276	138.0	
44798	chr8	58632012	58632617	605	302.0	
44799	chr8	58649688	58650153	465	232.0	
44800	chr8	58650715	58651829	1114	557.0	
44801	chr8	58657661	58660611	2950	1475.0	
44802	chr8	58669685	58669795	110	55.0	
44803	chr8	58672087	58672400	313	156.0	
44804	chr8	58691559	58691831	272	136.0	
44805	chr8	58701686	58702201	515	258.0	
44806	chr8	58713895	58714557	662	331.0	
44807	chr8	58715737	58716099	362	181.0	
44808	chr8	58721583	58722078	495	248.0	
44809	chr8	58790733	58791344	611	306.0	
44810	chr8	58799289	58799306	17	8.0	
44811	chr8	58800734	58802672	1938	969.0	
44812	chr8	58804901	58805573	672	336.0	
44813	chr8	58807482	58808385	903	452.0	
44814	chr8	58841984	58842468	484	242.0	
44815	chr8	58881731	58882419	688	344.0	
44816	chr8	58898281	58898782	501	250.0	
44817	chr8	58961784	58962264	480	240.0	
44818	chr8	58973681	58974405	724	362.0	
44819	chr8	58991253	58992264	1011	506.0	
44820	chr8	59017655	59018060	405	202.0	
44821	chr8	59035717	59036130	413	206.0	
44822	chr8	59043676	59044380	704	352.0	
44823	chr8	59065476	59065547	71	36.0	
44824	chr8	59075837	59076476	639	320.0	
44825	chr8	59106544	59106982	438	219.0	
44826	chr8	59107492	59108645	1153	576.0	
44827	chr8	59115608	59116020	412	206.0	
44828	chr8	59117154	59120377	3223	1612.0	
44829	chr8	59260840	59261222	382	191.0	
44830	chr8	59327717	59327804	87	44.0	
44831	chr8	59381011	59381558	547	274.0	
44832	chr8	59531969	59532180	211	106.0	
44833	chr8	59630881	59631177	296	148.0	
44834	chr8	59655560	59656493	933	466.0	
44835	chr8	59657595	59657996	401	200.0	
44836	chr8	59737678	59737808	130	65.0	
44837	chr8	59920018	59920472	454	227.0	
44838	chr8	59921315	59921948	633	316.0	
44839	chr8	59968866	59969267	401	200.0	
44840	chr8	59972524	59972974	450	225.0	
44841	chr8	60026527	60026634	107	54.0	
44842	chr8	60051917	60052518	601	300.0	
44843	chr8	60056849	60057207	358	179.0	
44844	chr8	60233244	60233647	403	202.0	
44845	chr8	60280951	60281600	649	324.0	
44846	chr8	60332880	60333370	490	245.0	
44847	chr8	60385206	60385568	362	181.0	
44848	chr8	60392405	60392699	294	147.0	
44849	chr8	60396812	60397295	483	242.0	
44850	chr8	60409026	60409688	662	331.0	
44851	chr8	60412421	60413079	658	329.0	
44852	chr8	60481024	60481119	95	48.0	
44853	chr8	60516145	60519939	3794	1897.0	
44854	chr8	60521039	60521263	224	112.0	
44855	chr8	60521972	60522444	472	236.0	
44856	chr8	60523083	60523390	307	154.0	
44857	chr8	60524866	60525807	941	470.0	
44858	chr8	60526946	60527446	500	250.0	
44859	chr8	60534627	60535594	967	484.0	
44860	chr8	60540312	60540804	492	246.0	
44861	chr8	60541648	60541718	70	35.0	
44862	chr8	60556583	60556879	296	148.0	
44863	chr8	60559059	60559491	432	216.0	
44864	chr8	60583797	60584213	416	208.0	
44865	chr8	60592223	60592668	445	222.0	
44866	chr8	60610988	60611404	416	208.0	
44867	chr8	60613839	60614193	354	177.0	
44868	chr8	60651402	60654311	2909	1454.0	
44869	chr8	60660406	60661135	729	364.0	
44870	chr8	60672464	60672837	373	186.0	
44871	chr8	60677887	60681319	3432	1716.0	
44872	chr8	60684108	60684776	668	334.0	
44873	chr8	60700535	60700904	369	184.0	
44874	chr8	60703177	60703715	538	269.0	
44875	chr8	60714105	60714322	217	108.0	
44876	chr8	60724363	60724637	274	137.0	
44877	chr8	60736170	60736198	28	14.0	
44878	chr8	60780811	60781299	488	244.0	
44879	chr8	60792390	60793403	1013	506.0	
44880	chr8	60796386	60797098	712	356.0	
44881	chr8	60798161	60798550	389	194.0	
44882	chr8	60807548	60808284	736	368.0	
44883	chr8	60816490	60817291	801	400.0	
44884	chr8	60828088	60828435	347	174.0	
44885	chr8	60851715	60852499	784	392.0	
44886	chr8	60865155	60865903	748	374.0	
44887	chr8	60868281	60868390	109	54.0	
44888	chr8	60885560	60886100	540	270.0	
44889	chr8	60894727	60895029	302	151.0	
44890	chr8	60899679	60900237	558	279.0	
44891	chr8	60903576	60904645	1069	534.0	
44892	chr8	60908636	60913177	4541	2270.0	
44893	chr8	60916178	60917224	1046	523.0	
44894	chr8	60918010	60918231	221	110.0	
44895	chr8	60922985	60923497	512	256.0	
44896	chr8	60924996	60928203	3207	1604.0	
44897	chr8	60928904	60929913	1009	504.0	
44898	chr8	60939153	60939900	747	374.0	
44899	chr8	60945442	60945937	495	248.0	
44900	chr8	60946530	60946999	469	234.0	
44901	chr8	60950423	60951489	1066	533.0	
44902	chr8	60952698	60953300	602	301.0	
44903	chr8	60967233	60968038	805	402.0	
44904	chr8	60979611	60980313	702	351.0	
44905	chr8	60981271	60981720	449	224.0	
44906	chr8	60982773	60982904	131	66.0	
44907	chr8	60993364	60993719	355	178.0	
44908	chr8	60998059	60999891	1832	916.0	
44909	chr8	61004278	61004965	687	344.0	
44910	chr8	61012031	61012335	304	152.0	
44911	chr8	61014045	61014677	632	316.0	
44912	chr8	61023270	61024130	860	430.0	
44913	chr8	61044300	61045151	851	426.0	
44914	chr8	61095275	61096536	1261	630.0	
44915	chr8	61125304	61125320	16	8.0	
44916	chr8	61126032	61126386	354	177.0	
44917	chr8	61138809	61139873	1064	532.0	
44918	chr8	61467452	61467882	430	215.0	
44919	chr8	61468726	61469178	452	226.0	
44920	chr8	61563185	61563659	474	237.0	
44921	chr8	61581927	61582733	806	403.0	
44922	chr8	61652771	61653140	369	184.0	
44923	chr8	61657025	61657664	639	320.0	
44924	chr8	61695435	61695807	372	186.0	
44925	chr8	61699963	61700561	598	299.0	
44926	chr8	61710495	61711444	949	474.0	
44927	chr8	61712171	61712947	776	388.0	
44928	chr8	61713612	61715342	1730	865.0	
44929	chr8	61719412	61719818	406	203.0	
44930	chr8	61721484	61721688	204	102.0	"enhancer	sequence_feature"
44931	chr8	61731542	61731876	334	167.0	
44932	chr8	61733464	61735674	2210	1105.0	
44933	chr8	61748198	61748837	639	320.0	
44934	chr8	61759702	61760874	1172	586.0	
44935	chr8	61767086	61767535	449	224.0	
44936	chr8	61810006	61810379	373	186.0	
44937	chr8	61839881	61840347	466	233.0	
44938	chr8	61882482	61882852	370	185.0	
44939	chr8	63009127	63010712	1585	792.0	
44940	chr8	63032519	63033137	618	309.0	
44941	chr8	63038252	63040054	1802	901.0	
44942	chr8	63146750	63147398	648	324.0	
44943	chr8	63165562	63166771	1209	604.0	
44944	chr8	63167535	63170283	2748	1374.0	
44945	chr8	63173469	63174127	658	329.0	
44946	chr8	63186448	63186849	401	200.0	
44947	chr8	63191893	63193454	1561	780.0	
44948	chr8	63196285	63196673	388	194.0	
44949	chr8	63199741	63200565	824	412.0	
44950	chr8	63213385	63213777	392	196.0	
44951	chr8	63222224	63222623	399	200.0	
44952	chr8	63226363	63226984	621	310.0	
44953	chr8	63268777	63269405	628	314.0	
44954	chr8	63323830	63324122	292	146.0	
44955	chr8	63391230	63392171	941	470.0	
44956	chr8	64382115	64382468	353	176.0	
44957	chr8	64567604	64568031	427	214.0	
44958	chr8	64575130	64575419	289	144.0	
44959	chr8	64576976	64577791	815	408.0	
44960	chr8	64579933	64581957	2024	1012.0	
44961	chr8	64598412	64598813	401	200.0	
44962	chr8	64695047	64695907	860	430.0	
44963	chr8	64798143	64798997	854	427.0	
44964	chr8	64802567	64802821	254	127.0	
44965	chr8	64817506	64817793	287	144.0	
44966	chr8	64863600	64864303	703	352.0	
44967	chr8	65174902	65175268	366	183.0	
44968	chr8	65533343	65533754	411	206.0	
44969	chr8	65539805	65540477	672	336.0	
44970	chr8	65562038	65562378	340	170.0	
44971	chr8	65633367	65634829	1462	731.0	
44972	chr8	65643579	65645800	2221	1110.0	
44973	chr8	65676771	65676963	192	96.0	
44974	chr8	65706049	65706360	311	156.0	
44975	chr8	65711295	65712554	1259	630.0	
44976	chr8	65743416	65743767	351	176.0	
44977	chr8	65744872	65745254	382	191.0	
44978	chr8	65752104	65752350	246	123.0	
44979	chr8	65761790	65762434	644	322.0	
44980	chr8	65785058	65785422	364	182.0	
44981	chr8	65791460	65791577	117	58.0	
44982	chr8	65794127	65794511	384	192.0	
44983	chr8	65807719	65808120	401	200.0	
44984	chr8	65809074	65809092	18	9.0	
44985	chr8	65811022	65811410	388	194.0	
44986	chr8	65822123	65822763	640	320.0	
44987	chr8	65829639	65830330	691	346.0	
44988	chr8	65831440	65831581	141	70.0	
44989	chr8	65833079	65833372	293	146.0	
44990	chr8	65834292	65836097	1805	902.0	
44991	chr8	65836844	65838074	1230	615.0	
44992	chr8	65838664	65838989	325	162.0	
44993	chr8	65840106	65843330	3224	1612.0	
44994	chr8	65848516	65848944	428	214.0	
44995	chr8	65853976	65854369	393	196.0	
44996	chr8	65878483	65878544	61	30.0	
44997	chr8	65879129	65879830	701	350.0	
44998	chr8	65899104	65899393	289	144.0	
44999	chr8	65930593	65932246	1653	826.0	
45000	chr8	65941999	65942693	694	347.0	
45001	chr8	65945940	65946623	683	342.0	
45002	chr8	65948334	65949272	938	469.0	
45003	chr8	65950239	65952748	2509	1254.0	
45004	chr8	65954329	65956178	1849	924.0	
45005	chr8	65959678	65960320	642	321.0	
45006	chr8	65981621	65982624	1003	502.0	
45007	chr8	65998122	65998618	496	248.0	
45008	chr8	66001890	66002261	371	186.0	
45009	chr8	66009784	66010836	1052	526.0	
45010	chr8	66022184	66023167	983	492.0	
45011	chr8	66027896	66028301	405	202.0	
45012	chr8	66029571	66030061	490	245.0	
45013	chr8	66032151	66034321	2170	1085.0	
45014	chr8	66036412	66036932	520	260.0	
45015	chr8	66063909	66065533	1624	812.0	
45016	chr8	66091854	66092333	479	240.0	
45017	chr8	66093055	66093620	565	282.0	
45018	chr8	66103328	66103930	602	301.0	
45019	chr8	66112428	66115882	3454	1727.0	
45020	chr8	66121349	66121942	593	296.0	
45021	chr8	66123607	66124570	963	482.0	
45022	chr8	66129674	66130663	989	494.0	
45023	chr8	66133312	66133730	418	209.0	
45024	chr8	66141841	66142530	689	344.0	
45025	chr8	66176814	66177896	1082	541.0	
45026	chr8	66336259	66336510	251	126.0	
45027	chr8	66428021	66433285	5264	2632.0	
45028	chr8	66436804	66437444	640	320.0	
45029	chr8	66438642	66439951	1309	654.0	
45030	chr8	66440771	66441119	348	174.0	
45031	chr8	66445970	66446529	559	280.0	
45032	chr8	66452938	66453815	877	438.0	
45033	chr8	66459692	66460404	712	356.0	
45034	chr8	66467287	66468619	1332	666.0	
45035	chr8	66485833	66486063	230	115.0	
45036	chr8	66486897	66486950	53	26.0	
45037	chr8	66487694	66489037	1343	672.0	
45038	chr8	66490418	66491551	1133	566.0	
45039	chr8	66503233	66504260	1027	514.0	
45040	chr8	66507493	66507532	39	20.0	
45041	chr8	66512141	66512566	425	212.0	
45042	chr8	66514000	66514220	220	110.0	
45043	chr8	66521500	66523515	2015	1008.0	
45044	chr8	66525127	66525477	350	175.0	
45045	chr8	66526709	66527687	978	489.0	
45046	chr8	66532866	66536654	3788	1894.0	
45047	chr8	66539984	66540468	484	242.0	
45048	chr8	66589191	66590144	953	476.0	
45049	chr8	66607393	66608498	1105	552.0	
45050	chr8	66609267	66610929	1662	831.0	
45051	chr8	66612171	66614632	2461	1230.0	
45052	chr8	66615343	66615537	194	97.0	
45053	chr8	66651933	66652296	363	182.0	
45054	chr8	66663650	66665377	1727	864.0	
45055	chr8	66665987	66668377	2390	1195.0	
45056	chr8	66670302	66670507	205	102.0	
45057	chr8	66679726	66680834	1108	554.0	
45058	chr8	66688817	66689548	731	366.0	
45059	chr8	66711397	66714334	2937	1468.0	
45060	chr8	66716008	66716725	717	358.0	
45061	chr8	66752166	66752909	743	372.0	
45062	chr8	66774220	66776114	1894	947.0	
45063	chr8	66777800	66777994	194	97.0	
45064	chr8	66781348	66782719	1371	686.0	
45065	chr8	66783848	66786165	2317	1158.0	
45066	chr8	66787334	66788068	734	367.0	
45067	chr8	66870279	66871362	1083	542.0	
45068	chr8	66916410	66918343	1933	966.0	
45069	chr8	66919298	66920366	1068	534.0	
45070	chr8	66921365	66921769	404	202.0	
45071	chr8	66923626	66926232	2606	1303.0	
45072	chr8	66961377	66963486	2109	1054.0	
45073	chr8	67028250	67029013	763	382.0	
45074	chr8	67061367	67065407	4040	2020.0	
45075	chr8	67339292	67340845	1553	776.0	
45076	chr8	67342155	67344894	2739	1370.0	
45077	chr8	67373630	67374044	414	207.0	
45078	chr8	67384298	67384691	393	196.0	
45079	chr8	67392640	67393806	1166	583.0	
45080	chr8	67400826	67401394	568	284.0	
45081	chr8	67415800	67416648	848	424.0	
45082	chr8	67467362	67467836	474	237.0	
45083	chr8	67490037	67490718	681	340.0	
45084	chr8	67505822	67506500	678	339.0	
45085	chr8	67540547	67541019	472	236.0	
45086	chr8	67579707	67580566	859	430.0	
45087	chr8	67599280	67599655	375	188.0	
45088	chr8	67602382	67603032	650	325.0	
45089	chr8	67604017	67604512	495	248.0	
45090	chr8	67661364	67661475	111	56.0	
45091	chr8	67686289	67686635	346	173.0	
45092	chr8	67734749	67735101	352	176.0	
45093	chr8	67746147	67746610	463	232.0	
45094	chr8	67968387	67969011	624	312.0	
45095	chr8	68241125	68241713	588	294.0	
45096	chr8	68257897	68257983	86	43.0	
45097	chr8	68260123	68260616	493	246.0	
45098	chr8	68372848	68372964	116	58.0	
45099	chr8	68394654	68394941	287	144.0	
45100	chr8	69663697	69664129	432	216.0	
45101	chr8	69676120	69676782	662	331.0	
45102	chr8	69681780	69682523	743	372.0	
45103	chr8	69720861	69721290	429	214.0	
45104	chr8	69738273	69739034	761	380.0	
45105	chr8	69763990	69764427	437	218.0	
45106	chr8	69832317	69835324	3007	1504.0	
45107	chr8	69853949	69854345	396	198.0	
45108	chr8	69942284	69943030	746	373.0	
45109	chr8	69946126	69946530	404	202.0	
45110	chr8	69994608	69994982	374	187.0	
45111	chr8	70035090	70035356	266	133.0	
45112	chr8	70068892	70072740	3848	1924.0	
45113	chr8	70088295	70088958	663	332.0	
45114	chr8	70113863	70113992	129	64.0	
45115	chr8	70140520	70142676	2156	1078.0	
45116	chr8	70147886	70148585	699	350.0	
45117	chr8	70152591	70153524	933	466.0	
45118	chr8	70159983	70161221	1238	619.0	
45119	chr8	70172506	70173202	696	348.0	
45120	chr8	70199561	70199600	39	20.0	
45121	chr8	70211724	70212327	603	302.0	
45122	chr8	70212838	70215629	2791	1396.0	
45123	chr8	70216866	70220021	3155	1578.0	
45124	chr8	70220999	70221013	14	7.0	
45125	chr8	70226918	70227306	388	194.0	
45126	chr8	70233445	70233880	435	218.0	
45127	chr8	70246178	70246999	821	410.0	
45128	chr8	70258742	70259127	385	192.0	
45129	chr8	70276493	70276904	411	206.0	
45130	chr8	70315380	70316057	677	338.0	
45131	chr8	70317204	70317639	435	218.0	
45132	chr8	70348510	70348963	453	226.0	
45133	chr8	70353879	70354214	335	168.0	
45134	chr8	70374380	70374988	608	304.0	
45135	chr8	70376044	70376469	425	212.0	
45136	chr8	70393855	70394890	1035	518.0	
45137	chr8	70400911	70404964	4053	2026.0	
45138	chr8	70466049	70466157	108	54.0	
45139	chr8	70468896	70469251	355	178.0	
45140	chr8	70523609	70524579	970	485.0	
45141	chr8	70534210	70535104	894	447.0	
45142	chr8	70540389	70541404	1015	508.0	
45143	chr8	70557451	70557742	291	146.0	
45144	chr8	70607075	70610052	2977	1488.0	
45145	chr8	70614709	70615490	781	390.0	
45146	chr8	70616514	70617607	1093	546.0	
45147	chr8	70631281	70631800	519	260.0	
45148	chr8	70641733	70642200	467	234.0	
45149	chr8	70651545	70652148	603	302.0	
45150	chr8	70668112	70670356	2244	1122.0	
45151	chr8	70745532	70745821	289	144.0	
45152	chr8	70775888	70776241	353	176.0	
45153	chr8	70834946	70835282	336	168.0	
45154	chr8	70942271	70942790	519	260.0	
45155	chr8	70950087	70951000	913	456.0	
45156	chr8	71040038	71040542	504	252.0	
45157	chr8	71046890	71047457	567	284.0	
45158	chr8	71054752	71055015	263	132.0	
45159	chr8	71056358	71056714	356	178.0	
45160	chr8	71068250	71068318	68	34.0	
45161	chr8	71246806	71247579	773	386.0	
45162	chr8	71695156	71695383	227	114.0	
45163	chr8	71737426	71737856	430	215.0	
45164	chr8	71774975	71775411	436	218.0	
45165	chr8	71810809	71811122	313	156.0	
45166	chr8	71819955	71820330	375	188.0	
45167	chr8	71827789	71829057	1268	634.0	
45168	chr8	71831128	71831787	659	330.0	
45169	chr8	71840424	71840821	397	198.0	
45170	chr8	71841519	71844796	3277	1638.0	
45171	chr8	71845379	71845787	408	204.0	
45172	chr8	71847777	71848070	293	146.0	
45173	chr8	71874887	71874946	59	30.0	
45174	chr8	71922861	71923259	398	199.0	
45175	chr8	71923964	71924547	583	292.0	
45176	chr8	71975196	71975669	473	236.0	
45177	chr8	72000263	72000998	735	368.0	
45178	chr8	72004794	72005514	720	360.0	
45179	chr8	72018565	72018927	362	181.0	
45180	chr8	72144228	72144577	349	174.0	
45181	chr8	72155124	72155593	469	234.0	
45182	chr8	72943984	72944399	415	208.0	
45183	chr8	72994939	72995017	78	39.0	
45184	chr8	73008192	73009861	1669	834.0	
45185	chr8	73063774	73064152	378	189.0	
45186	chr8	73093168	73093478	310	155.0	
45187	chr8	73156634	73157147	513	256.0	
45188	chr8	73167109	73169067	1958	979.0	
45189	chr8	73174101	73174761	660	330.0	
45190	chr8	73292735	73296188	3453	1726.0	
45191	chr8	73305436	73305949	513	256.0	
45192	chr8	73306821	73306916	95	48.0	
45193	chr8	73346341	73347031	690	345.0	
45194	chr8	73356415	73356678	263	132.0	
45195	chr8	73665446	73665879	433	216.0	
45196	chr8	73667608	73668009	401	200.0	
45197	chr8	73672969	73673396	427	214.0	
45198	chr8	73694893	73695519	626	313.0	
45199	chr8	73745539	73748655	3116	1558.0	
45200	chr8	73756072	73756395	323	162.0	
45201	chr8	73835661	73836092	431	216.0	
45202	chr8	73841068	73841517	449	224.0	
45203	chr8	73867609	73868844	1235	618.0	
45204	chr8	73877035	73880805	3770	1885.0	
45205	chr8	73892841	73893436	595	298.0	
45206	chr8	73894884	73896297	1413	706.0	
45207	chr8	73966264	73966765	501	250.0	
45208	chr8	73970948	73973263	2315	1158.0	
45209	chr8	73975374	73977033	1659	830.0	
45210	chr8	73990884	73992510	1626	813.0	
45211	chr8	74048770	74049238	468	234.0	
45212	chr8	74051970	74052634	664	332.0	
45213	chr8	74088144	74088468	324	162.0	
45214	chr8	74146691	74147336	645	322.0	
45215	chr8	74295826	74296020	194	97.0	
45216	chr8	74321389	74321824	435	218.0	
45217	chr8	74349959	74351088	1129	564.0	
45218	chr8	74366317	74366406	89	44.0	
45219	chr8	74853500	74853742	242	121.0	
45220	chr8	74984400	74984680	280	140.0	
45221	chr8	74999756	75000356	600	300.0	
45222	chr8	75407349	75407768	419	210.0	
45223	chr8	76367838	76368160	322	161.0	
45224	chr8	76454668	76455200	532	266.0	
45225	chr8	76545556	76546268	712	356.0	
45226	chr8	76572892	76573400	508	254.0	
45227	chr8	76580762	76582261	1499	750.0	
45228	chr8	76673320	76674319	999	500.0	
45229	chr8	76677809	76678293	484	242.0	
45230	chr8	76682296	76682499	203	102.0	
45231	chr8	76998974	77001317	2343	1172.0	
45232	chr8	78200015	78200330	315	158.0	
45233	chr8	78206620	78207126	506	253.0	
45234	chr8	78224151	78224592	441	220.0	
45235	chr8	78232280	78232687	407	204.0	
45236	chr8	78393389	78393814	425	212.0	
45237	chr8	78444786	78445811	1025	512.0	
45238	chr8	78507559	78507920	361	180.0	
45239	chr8	78515426	78517163	1737	868.0	
45240	chr8	78525774	78526181	407	204.0	
45241	chr8	78665053	78667023	1970	985.0	
45242	chr8	78720335	78720714	379	190.0	
45243	chr8	78726932	78727303	371	186.0	
45244	chr8	78804125	78805821	1696	848.0	
45245	chr8	78806657	78807086	429	214.0	
45246	chr8	78854187	78854637	450	225.0	
45247	chr8	78859119	78859120	1	0.0	
45248	chr8	79323057	79323235	178	89.0	
45249	chr8	79326234	79326379	145	72.0	
45250	chr8	79443616	79444091	475	238.0	
45251	chr8	79611841	79612409	568	284.0	
45252	chr8	79615264	79615738	474	237.0	
45253	chr8	79684522	79685037	515	258.0	
45254	chr8	79692855	79693726	871	436.0	
45255	chr8	79723196	79723645	449	224.0	
45256	chr8	79760748	79761331	583	292.0	
45257	chr8	79764935	79769504	4569	2284.0	
45258	chr8	79770060	79770389	329	164.0	
45259	chr8	79783375	79784549	1174	587.0	
45260	chr8	79788267	79788623	356	178.0	
45261	chr8	79793693	79794022	329	164.0	
45262	chr8	79828894	79829236	342	171.0	
45263	chr8	79880063	79880438	375	188.0	
45264	chr8	79890642	79892186	1544	772.0	
45265	chr8	79901029	79901172	143	72.0	
45266	chr8	79991705	79992132	427	214.0	
45267	chr8	80017168	80017551	383	192.0	
45268	chr8	80023534	80024207	673	336.0	
45269	chr8	80028927	80030810	1883	942.0	
45270	chr8	80037996	80038630	634	317.0	
45271	chr8	80043323	80044036	713	356.0	
45272	chr8	80052514	80052817	303	152.0	
45273	chr8	80054861	80055509	648	324.0	
45274	chr8	80064157	80064220	63	32.0	
45275	chr8	80067092	80067552	460	230.0	
45276	chr8	80075692	80076003	311	156.0	
45277	chr8	80084437	80085981	1544	772.0	
45278	chr8	80091555	80092047	492	246.0	
45279	chr8	80099647	80100571	924	462.0	
45280	chr8	80101975	80102188	213	106.0	
45281	chr8	80102839	80104141	1302	651.0	
45282	chr8	80121946	80123208	1262	631.0	
45283	chr8	80134546	80134932	386	193.0	
45284	chr8	80138456	80141201	2745	1372.0	
45285	chr8	80146409	80147468	1059	530.0	
45286	chr8	80158392	80158709	317	158.0	
45287	chr8	80162004	80162219	215	108.0	
45288	chr8	80170588	80172117	1529	764.0	
45289	chr8	80230496	80231435	939	470.0	
45290	chr8	80240424	80241156	732	366.0	
45291	chr8	80249608	80249731	123	62.0	
45292	chr8	80296971	80297910	939	470.0	
45293	chr8	80315188	80315521	333	166.0	
45294	chr8	80347795	80348323	528	264.0	
45295	chr8	80349562	80349963	401	200.0	
45296	chr8	80363694	80363717	23	12.0	
45297	chr8	80367011	80368178	1167	584.0	
45298	chr8	80377117	80378269	1152	576.0	
45299	chr8	80391494	80391913	419	210.0	
45300	chr8	80432384	80432886	502	251.0	
45301	chr8	80435962	80436429	467	234.0	
45302	chr8	80439257	80439681	424	212.0	
45303	chr8	80482549	80483113	564	282.0	
45304	chr8	80484950	80491741	6791	3396.0	
45305	chr8	80492350	80495469	3119	1560.0	
45306	chr8	80496553	80498148	1595	798.0	
45307	chr8	80499382	80499972	590	295.0	
45308	chr8	80501260	80501677	417	208.0	
45309	chr8	80503793	80503941	148	74.0	
45310	chr8	80505631	80506074	443	222.0	
45311	chr8	80507502	80510893	3391	1696.0	
45312	chr8	80512120	80512788	668	334.0	
45313	chr8	80516312	80517267	955	478.0	
45314	chr8	80526911	80526920	9	4.0	
45315	chr8	80529843	80530235	392	196.0	
45316	chr8	80534312	80534834	522	261.0	
45317	chr8	80565830	80566290	460	230.0	
45318	chr8	80577911	80579096	1185	592.0	
45319	chr8	80682712	80683363	651	326.0	
45320	chr8	80686954	80687631	677	338.0	
45321	chr8	80690775	80691330	555	278.0	
45322	chr8	80711646	80712053	407	204.0	
45323	chr8	80715330	80715777	447	224.0	
45324	chr8	80727528	80727804	276	138.0	
45325	chr8	80864515	80865312	797	398.0	
45326	chr8	80872433	80874972	2539	1270.0	
45327	chr8	80893576	80894338	762	381.0	
45328	chr8	80918443	80919136	693	346.0	
45329	chr8	80934470	80934765	295	148.0	
45330	chr8	80957335	80957708	373	186.0	
45331	chr8	80981695	80982096	401	200.0	
45332	chr8	80991850	80992576	726	363.0	
45333	chr8	80998053	80999707	1654	827.0	
45334	chr8	81001371	81002040	669	334.0	
45335	chr8	81002958	81003302	344	172.0	
45336	chr8	81004388	81005091	703	352.0	
45337	chr8	81009901	81010409	508	254.0	
45338	chr8	81011657	81012058	401	200.0	
45339	chr8	81014563	81014942	379	190.0	
45340	chr8	81021928	81022387	459	230.0	
45341	chr8	81025763	81026740	977	488.0	
45342	chr8	81028176	81028432	256	128.0	
45343	chr8	81028946	81029500	554	277.0	
45344	chr8	81034558	81035478	920	460.0	
45345	chr8	81036839	81036914	75	38.0	
45346	chr8	81038151	81038360	209	104.0	
45347	chr8	81047816	81048277	461	230.0	
45348	chr8	81061381	81061384	3	2.0	
45349	chr8	81064763	81065635	872	436.0	
45350	chr8	81067459	81067841	382	191.0	
45351	chr8	81071174	81072248	1074	537.0	
45352	chr8	81073804	81073962	158	79.0	
45353	chr8	81074471	81075228	757	378.0	
45354	chr8	81077126	81077289	163	82.0	
45355	chr8	81080094	81080781	687	344.0	
45356	chr8	81081374	81081775	401	200.0	
45357	chr8	81082319	81082651	332	166.0	
45358	chr8	81090384	81091372	988	494.0	
45359	chr8	81093177	81094599	1422	711.0	
45360	chr8	81096683	81098132	1449	724.0	
45361	chr8	81098654	81098675	21	10.0	
45362	chr8	81100607	81100614	7	4.0	
45363	chr8	81106096	81112830	6734	3367.0	
45364	chr8	81129982	81131587	1605	802.0	
45365	chr8	81132431	81133393	962	481.0	
45366	chr8	81140507	81141556	1049	524.0	
45367	chr8	81143066	81143375	309	154.0	
45368	chr8	81147113	81147577	464	232.0	
45369	chr8	81153625	81154957	1332	666.0	
45370	chr8	81156273	81157073	800	400.0	
45371	chr8	81160870	81161928	1058	529.0	
45372	chr8	81173891	81174122	231	116.0	
45373	chr8	81218274	81218707	433	216.0	
45374	chr8	81226193	81226385	192	96.0	
45375	chr8	81227457	81227724	267	134.0	
45376	chr8	81229303	81229455	152	76.0	
45377	chr8	81234300	81235726	1426	713.0	
45378	chr8	81253828	81254313	485	242.0	
45379	chr8	81259989	81260283	294	147.0	
45380	chr8	81277630	81278145	515	258.0	
45381	chr8	81279843	81282177	2334	1167.0	
45382	chr8	81286657	81287115	458	229.0	
45383	chr8	81289204	81289449	245	122.0	
45384	chr8	81291048	81291555	507	254.0	
45385	chr8	81312941	81313342	401	200.0	
45386	chr8	81364325	81365013	688	344.0	
45387	chr8	81546962	81547272	310	155.0	
45388	chr8	81557946	81558213	267	134.0	
45389	chr8	81574925	81575286	361	180.0	
45390	chr8	81630495	81631377	882	441.0	
45391	chr8	81633208	81633568	360	180.0	
45392	chr8	81641457	81641911	454	227.0	
45393	chr8	81682724	81683914	1190	595.0	
45394	chr8	81685633	81686795	1162	581.0	
45395	chr8	81708502	81708978	476	238.0	
45396	chr8	81720295	81722147	1852	926.0	
45397	chr8	81731932	81732927	995	498.0	
45398	chr8	81780408	81781126	718	359.0	
45399	chr8	81795512	81795637	125	62.0	
45400	chr8	81836831	81837286	455	228.0	
45401	chr8	81839685	81839855	170	85.0	
45402	chr8	81841109	81843397	2288	1144.0	
45403	chr8	81870683	81871272	589	294.0	
45404	chr8	81932281	81932695	414	207.0	
45405	chr8	81956674	81956996	322	161.0	
45406	chr8	81959126	81959428	302	151.0	
45407	chr8	83139520	83140006	486	243.0	
45408	chr8	83317803	83318293	490	245.0	
45409	chr8	84626225	84626436	211	106.0	
45410	chr8	85106479	85108025	1546	773.0	
45411	chr8	85137128	85137247	119	60.0	
45412	chr8	85147399	85147804	405	202.0	
45413	chr8	85153546	85154110	564	282.0	
45414	chr8	85171639	85172394	755	378.0	
45415	chr8	85175141	85175525	384	192.0	
45416	chr8	85176549	85178900	2351	1176.0	
45417	chr8	85187444	85187878	434	217.0	
45418	chr8	85189925	85190498	573	286.0	
45419	chr8	85192382	85192610	228	114.0	
45420	chr8	85200316	85201104	788	394.0	
45421	chr8	85219748	85221813	2065	1032.0	
45422	chr8	85235787	85236287	500	250.0	
45423	chr8	85244965	85246589	1624	812.0	
45424	chr8	85263735	85264157	422	211.0	
45425	chr8	85290081	85290492	411	206.0	
45426	chr8	85297361	85297811	450	225.0	
45427	chr8	85371655	85371751	96	48.0	
45428	chr8	85451569	85451970	401	200.0	
45429	chr8	85459082	85459971	889	444.0	
45430	chr8	85462175	85462488	313	156.0	
45431	chr8	85463030	85464736	1706	853.0	
45432	chr8	85467674	85468164	490	245.0	
45433	chr8	85501163	85501395	232	116.0	
45434	chr8	85502127	85502494	367	184.0	
45435	chr8	85513425	85514089	664	332.0	
45436	chr8	85534933	85535753	820	410.0	
45437	chr8	85582091	85582393	302	151.0	
45438	chr8	85835431	85836589	1158	579.0	
45439	chr8	85843099	85843457	358	179.0	
45440	chr8	85973329	85973761	432	216.0	
45441	chr8	85974608	85975165	557	278.0	
45442	chr8	85975937	85976331	394	197.0	
45443	chr8	86033182	86033576	394	197.0	
45444	chr8	86034090	86034423	333	166.0	
45445	chr8	86048959	86050174	1215	608.0	
45446	chr8	86088520	86088931	411	206.0	
45447	chr8	86108602	86109044	442	221.0	
45448	chr8	86118357	86119508	1151	576.0	
45449	chr8	86125053	86125485	432	216.0	
45450	chr8	86127037	86127313	276	138.0	
45451	chr8	86130681	86130901	220	110.0	
45452	chr8	86338085	86338472	387	194.0	
45453	chr8	86341082	86345321	4239	2120.0	
45454	chr8	86356447	86357115	668	334.0	
45455	chr8	86472170	86473056	886	443.0	
45456	chr8	86507760	86509451	1691	846.0	
45457	chr8	86510509	86510842	333	166.0	
45458	chr8	86513888	86516185	2297	1148.0	
45459	chr8	86523204	86523719	515	258.0	
45460	chr8	86618946	86619357	411	206.0	
45461	chr8	87916657	87916968	311	156.0	
45462	chr8	89243549	89243975	426	213.0	
45463	chr8	89718048	89718830	782	391.0	
45464	chr8	89721567	89721938	371	186.0	
45465	chr8	89725519	89726413	894	447.0	
45466	chr8	89728642	89730768	2126	1063.0	
45467	chr8	89756399	89759977	3578	1789.0	
45468	chr8	89763577	89763972	395	198.0	
45469	chr8	89765821	89766235	414	207.0	
45470	chr8	89776790	89777574	784	392.0	
45471	chr8	89780966	89782746	1780	890.0	
45472	chr8	89784722	89785213	491	246.0	
45473	chr8	89805247	89805587	340	170.0	
45474	chr8	89833780	89833956	176	88.0	
45475	chr8	89834504	89834989	485	242.0	
45476	chr8	89836796	89837650	854	427.0	
45477	chr8	89838906	89839277	371	186.0	
45478	chr8	89841432	89842074	642	321.0	
45479	chr8	89844418	89844903	485	242.0	
45480	chr8	89848178	89848831	653	326.0	
45481	chr8	89855824	89856378	554	277.0	
45482	chr8	89887229	89888411	1182	591.0	
45483	chr8	89889442	89889831	389	194.0	
45484	chr8	89901504	89903492	1988	994.0	
45485	chr8	89904228	89904504	276	138.0	
45486	chr8	89970532	89970942	410	205.0	
45487	chr8	89974291	89976230	1939	970.0	
45488	chr8	89981444	89981993	549	274.0	
45489	chr8	89982626	89985364	2738	1369.0	
45490	chr8	89989264	89989529	265	132.0	
45491	chr8	89993648	89993659	11	6.0	
45492	chr8	89995211	89996025	814	407.0	
45493	chr8	90000268	90002840	2572	1286.0	
45494	chr8	90005272	90006589	1317	658.0	
45495	chr8	90008750	90009088	338	169.0	
45496	chr8	90230934	90231600	666	333.0	
45497	chr8	90467369	90468149	780	390.0	
45498	chr8	90479246	90479354	108	54.0	
45499	chr8	90553988	90554324	336	168.0	
45500	chr8	90570983	90571440	457	228.0	
45501	chr8	90626389	90628713	2324	1162.0	
45502	chr8	90644308	90647092	2784	1392.0	
45503	chr8	90948251	90948668	417	208.0	
45504	chr8	90984260	90985975	1715	858.0	
45505	chr8	90991159	90991560	401	200.0	
45506	chr8	91029248	91029717	469	234.0	
45507	chr8	91032061	91032419	358	179.0	
45508	chr8	91037420	91037467	47	24.0	
45509	chr8	91040020	91041695	1675	838.0	
45510	chr8	91048084	91048901	817	408.0	
45511	chr8	91051098	91051504	406	203.0	
45512	chr8	91069112	91071179	2067	1034.0	
45513	chr8	91076544	91076990	446	223.0	
45514	chr8	92482731	92483514	783	392.0	
45515	chr8	92491283	92491731	448	224.0	
45516	chr8	92511116	92512088	972	486.0	
45517	chr8	92514235	92514894	659	330.0	
45518	chr8	92520738	92521160	422	211.0	
45519	chr8	92524313	92525801	1488	744.0	
45520	chr8	92668799	92668803	4	2.0	
45521	chr8	92900029	92900571	542	271.0	
45522	chr8	92924481	92924550	69	34.0	
45523	chr8	92945394	92945487	93	46.0	
45524	chr8	92956915	92957124	209	104.0	
45525	chr8	92964622	92966464	1842	921.0	
45526	chr8	93320570	93321037	467	234.0	
45527	chr8	93361297	93361449	152	76.0	
45528	chr8	93445126	93445611	485	242.0	
45529	chr8	93565709	93565743	34	17.0	
45530	chr8	93689172	93689841	669	334.0	
45531	chr8	93694032	93694452	420	210.0	
45532	chr8	93700100	93701072	972	486.0	
45533	chr8	93739893	93741776	1883	942.0	
45534	chr8	93753775	93755638	1863	932.0	
45535	chr8	93790373	93790602	229	114.0	
45536	chr8	93822251	93822774	523	262.0	
45537	chr8	93879968	93880806	838	419.0	
45538	chr8	93883841	93884964	1123	562.0	
45539	chr8	93885769	93886535	766	383.0	
45540	chr8	93888227	93888705	478	239.0	
45541	chr8	93894110	93894784	674	337.0	
45542	chr8	93904144	93904668	524	262.0	
45543	chr8	93905423	93905584	161	80.0	
45544	chr8	93906224	93906268	44	22.0	
45545	chr8	93912261	93912445	184	92.0	
45546	chr8	93915715	93918459	2744	1372.0	
45547	chr8	93923081	93923605	524	262.0	
45548	chr8	93932389	93932907	518	259.0	
45549	chr8	93935166	93936407	1241	620.0	
45550	chr8	93953596	93953672	76	38.0	
45551	chr8	93960888	93961395	507	254.0	
45552	chr8	93969256	93969751	495	248.0	
45553	chr8	93972003	93972323	320	160.0	
45554	chr8	93975072	93975585	513	256.0	
45555	chr8	93983036	93983405	369	184.0	
45556	chr8	93985784	93986040	256	128.0	
45557	chr8	93990832	93992253	1421	710.0	
45558	chr8	93994676	93995007	331	166.0	
45559	chr8	94009240	94009248	8	4.0	
45560	chr8	94065746	94066010	264	132.0	
45561	chr8	94079710	94080181	471	236.0	
45562	chr8	94119536	94120773	1237	618.0	
45563	chr8	94234428	94234766	338	169.0	
45564	chr8	94259207	94259360	153	76.0	
45565	chr8	94261548	94262971	1423	712.0	
45566	chr8	94272469	94272536	67	34.0	
45567	chr8	94419872	94420568	696	348.0	
45568	chr8	94436556	94437465	909	454.0	
45569	chr8	94440539	94441164	625	312.0	
45570	chr8	94474410	94475820	1410	705.0	
45571	chr8	94552829	94554666	1837	918.0	
45572	chr8	94574104	94574481	377	188.0	
45573	chr8	94592366	94592664	298	149.0	
45574	chr8	94640646	94640854	208	104.0	
45575	chr8	94642312	94642684	372	186.0	
45576	chr8	94713419	94713576	157	78.0	
45577	chr8	94719239	94720760	1521	760.0	
45578	chr8	94813212	94814036	824	412.0	
45579	chr8	94822196	94824690	2494	1247.0	
45580	chr8	94846908	94847309	401	200.0	
45581	chr8	94862227	94863501	1274	637.0	
45582	chr8	94893371	94897178	3807	1904.0	
45583	chr8	94904978	94906065	1087	544.0	
45584	chr8	94914278	94914783	505	252.0	
45585	chr8	94928789	94929311	522	261.0	
45586	chr8	94944363	94944640	277	138.0	
45587	chr8	94946685	94950481	3796	1898.0	
45588	chr8	94959977	94961062	1085	542.0	
45589	chr8	94961849	94962266	417	208.0	
45590	chr8	94963649	94964335	686	343.0	
45591	chr8	94964937	94965271	334	167.0	
45592	chr8	94968111	94968458	347	174.0	
45593	chr8	94978927	94979251	324	162.0	
45594	chr8	94987495	94987967	472	236.0	
45595	chr8	95001520	95002016	496	248.0	
45596	chr8	95002779	95003144	365	182.0	
45597	chr8	95005724	95006075	351	176.0	
45598	chr8	95018585	95019012	427	214.0	
45599	chr8	95020026	95020653	627	314.0	
45600	chr8	95024209	95025982	1773	886.0	
45601	chr8	95054131	95054683	552	276.0	
45602	chr8	95056880	95057298	418	209.0	
45603	chr8	95072958	95075070	2112	1056.0	
45604	chr8	95085843	95086238	395	198.0	
45605	chr8	95087184	95088407	1223	612.0	
45606	chr8	95090122	95090738	616	308.0	
45607	chr8	95093990	95094078	88	44.0	
45608	chr8	95100088	95101143	1055	528.0	
45609	chr8	95102682	95102964	282	141.0	
45610	chr8	95115258	95116064	806	403.0	
45611	chr8	95117541	95117977	436	218.0	
45612	chr8	95120841	95121320	479	240.0	
45613	chr8	95130461	95131696	1235	618.0	
45614	chr8	95132857	95135644	2787	1394.0	
45615	chr8	95137026	95138410	1384	692.0	
45616	chr8	95142691	95143216	525	262.0	
45617	chr8	95144884	95145240	356	178.0	
45618	chr8	95159970	95160460	490	245.0	
45619	chr8	95165121	95165909	788	394.0	
45620	chr8	95181185	95182718	1533	766.0	
45621	chr8	95212830	95215140	2310	1155.0	
45622	chr8	95228196	95228690	494	247.0	
45623	chr8	95231305	95231662	357	178.0	
45624	chr8	95237172	95237537	365	182.0	
45625	chr8	95248626	95249126	500	250.0	
45626	chr8	95268171	95270616	2445	1222.0	
45627	chr8	95305378	95305738	360	180.0	
45628	chr8	95890563	95890915	352	176.0	
45629	chr8	96144804	96146167	1363	682.0	
45630	chr8	96153884	96154068	184	92.0	
45631	chr8	96155394	96156103	709	354.0	
45632	chr8	96157554	96158870	1316	658.0	
45633	chr8	96159471	96161421	1950	975.0	
45634	chr8	96163284	96164741	1457	728.0	
45635	chr8	96180061	96180534	473	236.0	
45636	chr8	96186805	96186876	71	36.0	
45637	chr8	96227176	96227681	505	252.0	
45638	chr8	96231476	96231876	400	200.0	
45639	chr8	96234204	96236288	2084	1042.0	
45640	chr8	96260890	96263964	3074	1537.0	
45641	chr8	96264545	96264875	330	165.0	
45642	chr8	96282656	96284170	1514	757.0	
45643	chr8	96312602	96313437	835	418.0	
45644	chr8	96327566	96328479	913	456.0	
45645	chr8	96332905	96333598	693	346.0	
45646	chr8	96337612	96338759	1147	574.0	
45647	chr8	96351945	96351992	47	24.0	
45648	chr8	96360729	96360869	140	70.0	
45649	chr8	96364784	96365715	931	466.0	
45650	chr8	96384910	96385324	414	207.0	
45651	chr8	96444390	96444781	391	196.0	
45652	chr8	96448869	96449346	477	238.0	
45653	chr8	96454517	96455051	534	267.0	
45654	chr8	96493559	96495515	1956	978.0	
45655	chr8	96570698	96571458	760	380.0	
45656	chr8	96620299	96621604	1305	652.0	
45657	chr8	96644531	96646931	2400	1200.0	
45658	chr8	96657159	96657847	688	344.0	
45659	chr8	96760437	96762202	1765	882.0	
45660	chr8	96791006	96791394	388	194.0	
45661	chr8	96792121	96792568	447	224.0	
45662	chr8	96809767	96810154	387	194.0	
45663	chr8	96811783	96812056	273	136.0	
45664	chr8	96820591	96821269	678	339.0	
45665	chr8	96828118	96828375	257	128.0	
45666	chr8	96853801	96855155	1354	677.0	
45667	chr8	96858399	96858825	426	213.0	
45668	chr8	96861102	96861842	740	370.0	
45669	chr8	96887853	96888477	624	312.0	
45670	chr8	96893755	96894281	526	263.0	
45671	chr8	96904639	96905298	659	330.0	
45672	chr8	96926547	96927585	1038	519.0	
45673	chr8	96979172	96979911	739	370.0	
45674	chr8	96988924	96989634	710	355.0	
45675	chr8	97170551	97171042	491	246.0	
45676	chr8	97258994	97259720	726	363.0	
45677	chr8	97277424	97278470	1046	523.0	
45678	chr8	97361758	97362088	330	165.0	
45679	chr8	97553377	97553859	482	241.0	
45680	chr8	97559980	97560549	569	284.0	
45681	chr8	97582438	97582926	488	244.0	
45682	chr8	97595760	97596418	658	329.0	
45683	chr8	97598062	97598829	767	384.0	
45684	chr8	97627872	97628493	621	310.0	
45685	chr8	97637650	97638917	1267	634.0	
45686	chr8	97639609	97640718	1109	554.0	
45687	chr8	97643049	97646876	3827	1914.0	
45688	chr8	97649030	97649623	593	296.0	
45689	chr8	97736250	97736882	632	316.0	
45690	chr8	97774770	97776926	2156	1078.0	
45691	chr8	97847099	97847556	457	228.0	
45692	chr8	97868754	97869949	1195	598.0	
45693	chr8	97980174	97980501	327	164.0	
45694	chr8	98036663	98037532	869	434.0	
45695	chr8	98044232	98046607	2375	1188.0	
45696	chr8	98064349	98064997	648	324.0	
45697	chr8	98085538	98085939	401	200.0	
45698	chr8	98116363	98118125	1762	881.0	
45699	chr8	98163670	98164136	466	233.0	
45700	chr8	98169911	98170459	548	274.0	
45701	chr8	98293090	98294666	1576	788.0	
45702	chr8	98300718	98301255	537	268.0	
45703	chr8	98364867	98365005	138	69.0	
45704	chr8	98471079	98471477	398	199.0	
45705	chr8	98727654	98727992	338	169.0	
45706	chr8	98809394	98809461	67	34.0	
45707	chr8	98817233	98817709	476	238.0	
45708	chr8	98824957	98826660	1703	852.0	
45709	chr8	98840848	98841257	409	204.0	
45710	chr8	98938393	98942967	4574	2287.0	
45711	chr8	98943922	98946530	2608	1304.0	
45712	chr8	98947606	98949211	1605	802.0	
45713	chr8	98951411	98951921	510	255.0	
45714	chr8	98973679	98974894	1215	608.0	
45715	chr8	99002225	99002718	493	246.0	
45716	chr8	99012296	99014129	1833	916.0	
45717	chr8	99020631	99021082	451	226.0	
45718	chr8	99065452	99065800	348	174.0	
45719	chr8	99080720	99081154	434	217.0	
45720	chr8	99168147	99168478	331	166.0	
45721	chr8	99340831	99340935	104	52.0	
45722	chr8	99358498	99358947	449	224.0	
45723	chr8	99498587	99499511	924	462.0	
45724	chr8	99596536	99596592	56	28.0	
45725	chr8	99663519	99663803	284	142.0	
45726	chr8	99702559	99702677	118	59.0	
45727	chr8	99715008	99715423	415	208.0	
45728	chr8	99775015	99775085	70	35.0	
45729	chr8	99838042	99838405	363	182.0	
45730	chr8	99860073	99860116	43	22.0	
45731	chr8	99862486	99863015	529	264.0	
45732	chr8	99884911	99885317	406	203.0	
45733	chr8	99892697	99894313	1616	808.0	
45734	chr8	100143818	100144530	712	356.0	
45735	chr8	100145220	100146361	1141	570.0	
45736	chr8	100149727	100151391	1664	832.0	
45737	chr8	100155847	100156169	322	161.0	
45738	chr8	100157554	100159093	1539	770.0	
45739	chr8	100212591	100213998	1407	704.0	
45740	chr8	100218594	100219182	588	294.0	
45741	chr8	100226843	100227395	552	276.0	
45742	chr8	100228948	100229848	900	450.0	
45743	chr8	100258241	100259414	1173	586.0	
45744	chr8	100266851	100267560	709	354.0	
45745	chr8	100283162	100283368	206	103.0	
45746	chr8	100290338	100290993	655	328.0	
45747	chr8	100301114	100301197	83	42.0	
45748	chr8	100303013	100304964	1951	976.0	
45749	chr8	100306502	100306853	351	176.0	
45750	chr8	100307798	100311080	3282	1641.0	
45751	chr8	100312508	100315132	2624	1312.0	
45752	chr8	100316196	100316342	146	73.0	
45753	chr8	100359609	100359706	97	48.0	
45754	chr8	100380152	100380309	157	78.0	
45755	chr8	100382357	100382400	43	22.0	
45756	chr8	100385898	100386803	905	452.0	
45757	chr8	100409470	100411876	2406	1203.0	
45758	chr8	100413334	100413583	249	124.0	
45759	chr8	100415523	100416432	909	454.0	"enhancer	sequence_feature"
45760	chr8	100417130	100417186	56	28.0	
45761	chr8	100419299	100419604	305	152.0	
45762	chr8	100426046	100426992	946	473.0	
45763	chr8	100428569	100429193	624	312.0	
45764	chr8	100430317	100431661	1344	672.0	
45765	chr8	100437546	100438810	1264	632.0	
45766	chr8	100440499	100440928	429	214.0	
45767	chr8	100442611	100444403	1792	896.0	
45768	chr8	100451684	100452550	866	433.0	
45769	chr8	100462869	100464007	1138	569.0	
45770	chr8	100472142	100472563	421	210.0	
45771	chr8	100475756	100476427	671	336.0	
45772	chr8	100492217	100495835	3618	1809.0	
45773	chr8	100500156	100500292	136	68.0	
45774	chr8	100501651	100503151	1500	750.0	
45775	chr8	100515149	100515711	562	281.0	
45776	chr8	100526725	100527708	983	492.0	
45777	chr8	100540677	100541430	753	376.0	
45778	chr8	100558778	100560317	1539	770.0	
45779	chr8	100563816	100564496	680	340.0	
45780	chr8	100574009	100574355	346	173.0	
45781	chr8	100623399	100623772	373	186.0	
45782	chr8	100649467	100649812	345	172.0	
45783	chr8	100664409	100664933	524	262.0	
45784	chr8	100680764	100681315	551	276.0	
45785	chr8	100685049	100685051	2	1.0	
45786	chr8	100687742	100687882	140	70.0	
45787	chr8	100690233	100690841	608	304.0	
45788	chr8	100691520	100693093	1573	786.0	
45789	chr8	100693731	100702870	9139	4570.0	
45790	chr8	100703433	100723397	19964	9982.0	
45791	chr8	100724041	100724819	778	389.0	
45792	chr8	100738597	100739057	460	230.0	
45793	chr8	100762191	100762979	788	394.0	
45794	chr8	100791370	100792253	883	442.0	
45795	chr8	100806592	100807720	1128	564.0	
45796	chr8	100809159	100810853	1694	847.0	
45797	chr8	100826576	100827621	1045	522.0	
45798	chr8	100832274	100833130	856	428.0	
45799	chr8	100835388	100835938	550	275.0	
45800	chr8	100847022	100847867	845	422.0	
45801	chr8	100899824	100900956	1132	566.0	
45802	chr8	100901504	100902439	935	468.0	
45803	chr8	100905991	100909567	3576	1788.0	
45804	chr8	100910522	100910829	307	154.0	
45805	chr8	100913478	100919199	5721	2860.0	
45806	chr8	100920213	100922904	2691	1346.0	
45807	chr8	100924027	100954037	30010	15005.0	
45808	chr8	100956593	100956960	367	184.0	
45809	chr8	101025993	101026694	701	350.0	
45810	chr8	101051645	101052214	569	284.0	
45811	chr8	101063833	101064000	167	84.0	
45812	chr8	101071695	101072132	437	218.0	
45813	chr8	101080439	101081444	1005	502.0	
45814	chr8	101098430	101098911	481	240.0	
45815	chr8	101108351	101110189	1838	919.0	
45816	chr8	101117823	101118213	390	195.0	
45817	chr8	101122997	101123885	888	444.0	
45818	chr8	101125652	101128221	2569	1284.0	
45819	chr8	101136578	101138050	1472	736.0	
45820	chr8	101139892	101140340	448	224.0	
45821	chr8	101153666	101156538	2872	1436.0	
45822	chr8	101158803	101159361	558	279.0	
45823	chr8	101165251	101166765	1514	757.0	
45824	chr8	101184373	101184779	406	203.0	
45825	chr8	101199652	101200120	468	234.0	
45826	chr8	101203246	101207760	4514	2257.0	
45827	chr8	101223884	101224448	564	282.0	
45828	chr8	101235747	101236204	457	228.0	
45829	chr8	101246316	101246476	160	80.0	
45830	chr8	101301288	101302009	721	360.0	
45831	chr8	101326915	101327372	457	228.0	
45832	chr8	101332840	101333325	485	242.0	
45833	chr8	101358999	101359486	487	244.0	
45834	chr8	101375976	101376729	753	376.0	
45835	chr8	101493601	101494332	731	366.0	
45836	chr8	101501106	101501791	685	342.0	
45837	chr8	101632514	101632887	373	186.0	
45838	chr8	101655015	101655476	461	230.0	
45839	chr8	101731013	101731394	381	190.0	
45840	chr8	101790819	101791278	459	230.0	
45841	chr8	101891733	101892201	468	234.0	
45842	chr8	101902435	101903178	743	372.0	
45843	chr8	101967600	101968164	564	282.0	
45844	chr8	102032757	102033112	355	178.0	
45845	chr8	102074453	102074764	311	156.0	
45846	chr8	102076694	102077277	583	292.0	
45847	chr8	102079978	102080007	29	14.0	
45848	chr8	102095506	102098452	2946	1473.0	
45849	chr8	102100964	102101169	205	102.0	
45850	chr8	102106478	102108817	2339	1170.0	
45851	chr8	102113904	102114486	582	291.0	
45852	chr8	102122527	102124909	2382	1191.0	
45853	chr8	102128338	102128907	569	284.0	
45854	chr8	102196959	102197888	929	464.0	
45855	chr8	102236653	102240587	3934	1967.0	
45856	chr8	102267825	102268072	247	124.0	
45857	chr8	102272446	102272806	360	180.0	
45858	chr8	102287061	102287970	909	454.0	
45859	chr8	102289864	102290598	734	367.0	
45860	chr8	102368097	102368654	557	278.0	
45861	chr8	102375428	102376034	606	303.0	
45862	chr8	102382992	102383501	509	254.0	
45863	chr8	102390997	102391338	341	170.0	
45864	chr8	102394803	102396168	1365	682.0	
45865	chr8	102403762	102403958	196	98.0	
45866	chr8	102404783	102404831	48	24.0	
45867	chr8	102407766	102408222	456	228.0	
45868	chr8	102409030	102409418	388	194.0	
45869	chr8	102410216	102413509	3293	1646.0	
45870	chr8	102415780	102416259	479	240.0	
45871	chr8	102429883	102430203	320	160.0	
45872	chr8	102528328	102529273	945	472.0	
45873	chr8	102535672	102536432	760	380.0	
45874	chr8	102557181	102557688	507	254.0	
45875	chr8	102567725	102568567	842	421.0	
45876	chr8	102577681	102578226	545	272.0	
45877	chr8	102583162	102583978	816	408.0	
45878	chr8	102585066	102586421	1355	678.0	
45879	chr8	102600377	102601827	1450	725.0	
45880	chr8	102635357	102636208	851	426.0	
45881	chr8	102645089	102645858	769	384.0	
45882	chr8	102646940	102648673	1733	866.0	
45883	chr8	102649788	102650305	517	258.0	
45884	chr8	102651057	102652779	1722	861.0	
45885	chr8	102653376	102659076	5700	2850.0	
45886	chr8	102660686	102663444	2758	1379.0	
45887	chr8	102682521	102682929	408	204.0	
45888	chr8	102692694	102692997	303	152.0	
45889	chr8	102701993	102702266	273	136.0	
45890	chr8	102738278	102739178	900	450.0	
45891	chr8	102751061	102751485	424	212.0	
45892	chr8	102752252	102752740	488	244.0	
45893	chr8	102767877	102768449	572	286.0	
45894	chr8	102769069	102769682	613	306.0	
45895	chr8	102773994	102774514	520	260.0	
45896	chr8	102776355	102776834	479	240.0	
45897	chr8	102782950	102783601	651	326.0	
45898	chr8	102787849	102789633	1784	892.0	
45899	chr8	102790774	102791480	706	353.0	
45900	chr8	102792836	102793376	540	270.0	
45901	chr8	102794994	102796066	1072	536.0	
45902	chr8	102797418	102797837	419	210.0	
45903	chr8	102803115	102803385	270	135.0	
45904	chr8	102804430	102811612	7182	3591.0	
45905	chr8	102814331	102815090	759	380.0	
45906	chr8	102819326	102819438	112	56.0	
45907	chr8	102820216	102820518	302	151.0	
45908	chr8	102822918	102823319	401	200.0	
45909	chr8	102824185	102825764	1579	790.0	
45910	chr8	102830428	102831041	613	306.0	
45911	chr8	102831664	102832075	411	206.0	
45912	chr8	102842144	102842839	695	348.0	
45913	chr8	102844102	102845271	1169	584.0	
45914	chr8	102847335	102849533	2198	1099.0	
45915	chr8	102854334	102854415	81	40.0	
45916	chr8	102855777	102855832	55	28.0	
45917	chr8	102859007	102859909	902	451.0	
45918	chr8	102861638	102865368	3730	1865.0	
45919	chr8	102865997	102866023	26	13.0	
45920	chr8	102884143	102884562	419	210.0	
45921	chr8	102886689	102887557	868	434.0	
45922	chr8	102895656	102895940	284	142.0	
45923	chr8	102898125	102899172	1047	524.0	
45924	chr8	102919118	102919472	354	177.0	
45925	chr8	102930076	102930490	414	207.0	
45926	chr8	102956030	102957039	1009	504.0	
45927	chr8	102970830	102971368	538	269.0	
45928	chr8	102976887	102977390	503	252.0	
45929	chr8	102978174	102980255	2081	1040.0	
45930	chr8	103000290	103000582	292	146.0	
45931	chr8	103020076	103021838	1762	881.0	
45932	chr8	103022970	103022976	6	3.0	
45933	chr8	103025847	103026152	305	152.0	
45934	chr8	103031272	103031659	387	194.0	
45935	chr8	103055210	103055792	582	291.0	
45936	chr8	103073565	103074416	851	426.0	
45937	chr8	103077749	103079057	1308	654.0	
45938	chr8	103090223	103090266	43	22.0	
45939	chr8	103111405	103111903	498	249.0	
45940	chr8	103119364	103119392	28	14.0	
45941	chr8	103124895	103125220	325	162.0	
45942	chr8	103138664	103139224	560	280.0	
45943	chr8	103140547	103141556	1009	504.0	
45944	chr8	103152175	103152562	387	194.0	
45945	chr8	103184718	103184987	269	134.0	
45946	chr8	103293953	103294301	348	174.0	
45947	chr8	103298373	103299600	1227	614.0	
45948	chr8	103336341	103336902	561	280.0	
45949	chr8	103370935	103371949	1014	507.0	
45950	chr8	103373094	103373638	544	272.0	
45951	chr8	103406156	103406927	771	386.0	
45952	chr8	103412004	103412785	781	390.0	
45953	chr8	103414168	103416902	2734	1367.0	
45954	chr8	103419489	103420240	751	376.0	
45955	chr8	103445461	103445977	516	258.0	
45956	chr8	103448529	103448535	6	3.0	
45957	chr8	103498625	103500760	2135	1068.0	
45958	chr8	103501444	103502123	679	340.0	
45959	chr8	103511906	103512497	591	296.0	
45960	chr8	104130206	104130508	302	151.0	
45961	chr8	104319789	104319969	180	90.0	
45962	chr8	104325378	104326412	1034	517.0	
45963	chr8	104329599	104330511	912	456.0	
45964	chr8	104338797	104339959	1162	581.0	
45965	chr8	104361123	104362619	1496	748.0	
45966	chr8	104411741	104412477	736	368.0	
45967	chr8	104417343	104418455	1112	556.0	
45968	chr8	104428483	104428839	356	178.0	
45969	chr8	104437410	104437698	288	144.0	
45970	chr8	104446358	104446871	513	256.0	
45971	chr8	104464189	104464542	353	176.0	
45972	chr8	104588082	104590209	2127	1064.0	
45973	chr8	104622892	104623226	334	167.0	
45974	chr8	104642995	104643396	401	200.0	
45975	chr8	104665167	104666341	1174	587.0	
45976	chr8	104759634	104760102	468	234.0	
45977	chr8	104787793	104788245	452	226.0	
45978	chr8	105318818	105319890	1072	536.0	
45979	chr8	105729451	105729933	482	241.0	
45980	chr8	105747559	105748038	479	240.0	
45981	chr8	106162097	106162346	249	124.0	
45982	chr8	106170673	106170985	312	156.0	
45983	chr8	106206470	106206664	194	97.0	
45984	chr8	106269402	106272429	3027	1514.0	
45985	chr8	106556444	106557137	693	346.0	
45986	chr8	106591738	106592393	655	328.0	
45987	chr8	106656939	106659151	2212	1106.0	
45988	chr8	106659750	106660214	464	232.0	
45989	chr8	106667838	106668261	423	212.0	
45990	chr8	106669910	106670318	408	204.0	
45991	chr8	106674624	106675025	401	200.0	
45992	chr8	106705015	106705470	455	228.0	
45993	chr8	106725781	106726347	566	283.0	
45994	chr8	106757803	106758525	722	361.0	
45995	chr8	106760095	106760433	338	169.0	
45996	chr8	106762925	106763531	606	303.0	
45997	chr8	106765178	106765647	469	234.0	
45998	chr8	106833424	106833706	282	141.0	
45999	chr8	106856451	106856938	487	244.0	
46000	chr8	106857882	106858187	305	152.0	
46001	chr8	107223368	107223627	259	130.0	
46002	chr8	107267463	107267779	316	158.0	
46003	chr8	107331661	107331994	333	166.0	
46004	chr8	107495050	107496480	1430	715.0	
46005	chr8	107496996	107498061	1065	532.0	
46006	chr8	107533736	107533916	180	90.0	
46007	chr8	107632079	107632760	681	340.0	
46008	chr8	107692043	107692322	279	140.0	
46009	chr8	107703285	107703813	528	264.0	
46010	chr8	107779788	107780137	349	174.0	
46011	chr8	107808376	107808635	259	130.0	
46012	chr8	107813459	107813836	377	188.0	
46013	chr8	107908541	107908682	141	70.0	
46014	chr8	108080437	108080791	354	177.0	
46015	chr8	108082459	108083591	1132	566.0	
46016	chr8	108103599	108103681	82	41.0	
46017	chr8	108119645	108120517	872	436.0	
46018	chr8	108136828	108137491	663	332.0	
46019	chr8	108139553	108140318	765	382.0	
46020	chr8	108149237	108149576	339	170.0	
46021	chr8	108179246	108179636	390	195.0	
46022	chr8	108186894	108187361	467	234.0	
46023	chr8	108245729	108246177	448	224.0	
46024	chr8	108247852	108249465	1613	806.0	
46025	chr8	108266468	108266749	281	140.0	
46026	chr8	108442532	108444480	1948	974.0	
46027	chr8	108468419	108469245	826	413.0	
46028	chr8	108473745	108474130	385	192.0	
46029	chr8	108651651	108652052	401	200.0	
46030	chr8	108670099	108670669	570	285.0	
46031	chr8	108671384	108671775	391	196.0	
46032	chr8	108691236	108691520	284	142.0	
46033	chr8	108703767	108704196	429	214.0	
46034	chr8	108722895	108723276	381	190.0	
46035	chr8	108787449	108787754	305	152.0	
46036	chr8	108907326	108907614	288	144.0	
46037	chr8	108918406	108918767	361	180.0	
46038	chr8	108976881	108977133	252	126.0	
46039	chr8	109325750	109326452	702	351.0	
46040	chr8	109333190	109335217	2027	1014.0	
46041	chr8	109346845	109347289	444	222.0	
46042	chr8	109524966	109525567	601	300.0	
46043	chr8	109538868	109541016	2148	1074.0	
46044	chr8	109574707	109575065	358	179.0	
46045	chr8	109592476	109592733	257	128.0	
46046	chr8	109595751	109596241	490	245.0	
46047	chr8	109644170	109645565	1395	698.0	
46048	chr8	109735253	109735571	318	159.0	
46049	chr8	110673847	110674345	498	249.0	
46050	chr8	113437645	113438296	651	326.0	
46051	chr8	113684790	113685581	791	396.0	
46052	chr8	113691829	113692398	569	284.0	
46053	chr8	114298453	114298857	404	202.0	
46054	chr8	115056163	115056843	680	340.0	
46055	chr8	115071575	115072368	793	396.0	
46056	chr8	115076616	115077122	506	253.0	
46057	chr8	115218409	115219448	1039	520.0	
46058	chr8	115222425	115223387	962	481.0	
46059	chr8	115271277	115271683	406	203.0	
46060	chr8	115274773	115275128	355	178.0	
46061	chr8	115427343	115428244	901	450.0	
46062	chr8	115429012	115429763	751	376.0	
46063	chr8	115430410	115430711	301	150.0	
46064	chr8	115431379	115431779	400	200.0	
46065	chr8	115446285	115446809	524	262.0	
46066	chr8	115449422	115450306	884	442.0	
46067	chr8	115451287	115452502	1215	608.0	
46068	chr8	115457746	115458373	627	314.0	
46069	chr8	115494899	115495588	689	344.0	
46070	chr8	115569082	115569279	197	98.0	
46071	chr8	115576321	115576818	497	248.0	
46072	chr8	115581982	115582647	665	332.0	
46073	chr8	115585073	115585474	401	200.0	
46074	chr8	115588876	115589397	521	260.0	
46075	chr8	115614861	115615146	285	142.0	
46076	chr8	115647868	115650204	2336	1168.0	
46077	chr8	115663274	115663284	10	5.0	
46078	chr8	115665945	115669920	3975	1988.0	
46079	chr8	115845900	115847155	1255	628.0	
46080	chr8	115870500	115870856	356	178.0	
46081	chr8	115877153	115878659	1506	753.0	
46082	chr8	115922523	115922857	334	167.0	
46083	chr8	115978327	115978673	346	173.0	
46084	chr8	116056797	116057303	506	253.0	
46085	chr8	116058029	116058669	640	320.0	
46086	chr8	116115807	116116488	681	340.0	
46087	chr8	116120396	116120970	574	287.0	
46088	chr8	116289467	116289715	248	124.0	
46089	chr8	116322163	116322750	587	294.0	
46090	chr8	116351973	116352690	717	358.0	
46091	chr8	116384339	116384744	405	202.0	
46092	chr8	116437319	116438475	1156	578.0	
46093	chr8	116444767	116445275	508	254.0	
46094	chr8	116447642	116448605	963	482.0	
46095	chr8	116449327	116449590	263	132.0	
46096	chr8	116471674	116473244	1570	785.0	
46097	chr8	116474607	116475320	713	356.0	
46098	chr8	116548309	116548550	241	120.0	
46099	chr8	116629475	116630102	627	314.0	
46100	chr8	116651658	116652619	961	480.0	
46101	chr8	116660456	116660951	495	248.0	
46102	chr8	116694450	116695490	1040	520.0	
46103	chr8	116709249	116710077	828	414.0	
46104	chr8	116715651	116716021	370	185.0	
46105	chr8	116755183	116756409	1226	613.0	
46106	chr8	116765673	116768193	2520	1260.0	
46107	chr8	116786457	116786736	279	140.0	
46108	chr8	116788250	116788791	541	270.0	
46109	chr8	116851200	116851539	339	170.0	
46110	chr8	116872491	116875462	2971	1486.0	
46111	chr8	116887286	116887975	689	344.0	
46112	chr8	116938257	116938644	387	194.0	
46113	chr8	117044635	117045095	460	230.0	
46114	chr8	117304085	117304486	401	200.0	
46115	chr8	117328894	117329352	458	229.0	
46116	chr8	117330059	117330529	470	235.0	
46117	chr8	117386410	117386578	168	84.0	
46118	chr8	117439246	117440435	1189	594.0	
46119	chr8	117443279	117443751	472	236.0	
46120	chr8	117474299	117474711	412	206.0	
46121	chr8	117494941	117495069	128	64.0	
46122	chr8	117513721	117514161	440	220.0	
46123	chr8	117519858	117522102	2244	1122.0	
46124	chr8	117560103	117560525	422	211.0	
46125	chr8	117615429	117615579	150	75.0	
46126	chr8	117862008	117862471	463	232.0	insulator
46127	chr8	117877088	117877571	483	242.0	
46128	chr8	117881319	117882075	756	378.0	
46129	chr8	117914657	117915092	435	218.0	
46130	chr8	117929142	117929572	430	215.0	
46131	chr8	117937268	117937951	683	342.0	
46132	chr8	117956801	117957735	934	467.0	
46133	chr8	117969886	117970159	273	136.0	
46134	chr8	117980751	117981094	343	172.0	
46135	chr8	117989301	117990813	1512	756.0	
46136	chr8	118019301	118019919	618	309.0	
46137	chr8	118056180	118056676	496	248.0	
46138	chr8	118060475	118061456	981	490.0	
46139	chr8	118080678	118081089	411	206.0	
46140	chr8	118086299	118086648	349	174.0	
46141	chr8	118088165	118088805	640	320.0	
46142	chr8	118089350	118090487	1137	568.0	
46143	chr8	118099049	118100367	1318	659.0	
46144	chr8	118101672	118101896	224	112.0	
46145	chr8	118103493	118103866	373	186.0	
46146	chr8	118108355	118113538	5183	2592.0	
46147	chr8	118120488	118121176	688	344.0	
46148	chr8	118127042	118127180	138	69.0	
46149	chr8	118142718	118143236	518	259.0	
46150	chr8	118190078	118190446	368	184.0	
46151	chr8	118195626	118196512	886	443.0	
46152	chr8	118201134	118201591	457	228.0	
46153	chr8	118279223	118279969	746	373.0	
46154	chr8	118281739	118282597	858	429.0	
46155	chr8	118284814	118285836	1022	511.0	
46156	chr8	118309971	118310353	382	191.0	
46157	chr8	118350087	118350458	371	186.0	
46158	chr8	118351511	118351910	399	200.0	
46159	chr8	118414902	118415374	472	236.0	
46160	chr8	118419151	118419426	275	138.0	
46161	chr8	118499282	118499339	57	28.0	
46162	chr8	118548464	118549247	783	392.0	
46163	chr8	118563868	118564599	731	366.0	
46164	chr8	118589089	118589333	244	122.0	
46165	chr8	118620616	118622819	2203	1102.0	
46166	chr8	118743572	118744014	442	221.0	
46167	chr8	118902842	118903133	291	146.0	
46168	chr8	118905123	118905658	535	268.0	
46169	chr8	118951674	118952087	413	206.0	
46170	chr8	119416026	119417181	1155	578.0	
46171	chr8	119448620	119449218	598	299.0	
46172	chr8	119452454	119452840	386	193.0	
46173	chr8	119495592	119496099	507	254.0	
46174	chr8	119509636	119510036	400	200.0	
46175	chr8	119579154	119579509	355	178.0	
46176	chr8	119601115	119602149	1034	517.0	
46177	chr8	119614402	119615971	1569	784.0	
46178	chr8	119618884	119619332	448	224.0	
46179	chr8	119626703	119627007	304	152.0	
46180	chr8	119638436	119639817	1381	690.0	
46181	chr8	119641438	119642315	877	438.0	
46182	chr8	119643827	119644301	474	237.0	
46183	chr8	119648299	119648913	614	307.0	
46184	chr8	119654960	119655592	632	316.0	
46185	chr8	119688705	119689041	336	168.0	
46186	chr8	119689610	119689862	252	126.0	
46187	chr8	119767785	119768186	401	200.0	
46188	chr8	119768923	119769403	480	240.0	
46189	chr8	119832206	119833606	1400	700.0	
46190	chr8	119855034	119856842	1808	904.0	
46191	chr8	119862965	119863566	601	300.0	
46192	chr8	119866851	119867567	716	358.0	
46193	chr8	119873162	119875143	1981	990.0	
46194	chr8	119951922	119952410	488	244.0	
46195	chr8	119955694	119956797	1103	552.0	
46196	chr8	119962276	119962716	440	220.0	
46197	chr8	119973548	119973896	348	174.0	
46198	chr8	119980188	119980584	396	198.0	
46199	chr8	119982097	119983191	1094	547.0	
46200	chr8	120008941	120009137	196	98.0	
46201	chr8	120065761	120066190	429	214.0	
46202	chr8	120069902	120070282	380	190.0	
46203	chr8	120074983	120075389	406	203.0	
46204	chr8	120084347	120084973	626	313.0	
46205	chr8	120110831	120111154	323	162.0	
46206	chr8	120123467	120123902	435	218.0	
46207	chr8	120298764	120299185	421	210.0	
46208	chr8	120444138	120445825	1687	844.0	
46209	chr8	120452628	120453139	511	256.0	
46210	chr8	120458620	120459101	481	240.0	
46211	chr8	120472298	120472768	470	235.0	
46212	chr8	120678256	120678725	469	234.0	
46213	chr8	120682383	120682682	299	150.0	
46214	chr8	120701952	120702766	814	407.0	
46215	chr8	120706403	120707256	853	426.0	
46216	chr8	120731127	120733276	2149	1074.0	
46217	chr8	120735045	120735261	216	108.0	
46218	chr8	120740727	120741188	461	230.0	
46219	chr8	120742507	120743106	599	300.0	
46220	chr8	120745699	120745780	81	40.0	
46221	chr8	120747973	120748451	478	239.0	
46222	chr8	120749078	120750261	1183	592.0	
46223	chr8	120775048	120775709	661	330.0	
46224	chr8	120780225	120780539	314	157.0	
46225	chr8	120785254	120786460	1206	603.0	
46226	chr8	120803442	120804545	1103	552.0	
46227	chr8	120808304	120812937	4633	2316.0	
46228	chr8	120827432	120828145	713	356.0	
46229	chr8	120836405	120836809	404	202.0	
46230	chr8	120857034	120858066	1032	516.0	
46231	chr8	120861191	120862044	853	426.0	
46232	chr8	120868563	120869292	729	364.0	
46233	chr8	120912882	120913453	571	286.0	
46234	chr8	120938959	120939483	524	262.0	
46235	chr8	120951129	120951607	478	239.0	
46236	chr8	120956626	120957087	461	230.0	
46237	chr8	121248807	121249172	365	182.0	
46238	chr8	121260827	121261301	474	237.0	
46239	chr8	121328076	121328762	686	343.0	
46240	chr8	121348898	121349195	297	148.0	
46241	chr8	121375623	121376047	424	212.0	
46242	chr8	121382695	121383179	484	242.0	
46243	chr8	121405900	121406243	343	172.0	
46244	chr8	121406811	121406847	36	18.0	
46245	chr8	121413158	121413762	604	302.0	
46246	chr8	121425765	121426158	393	196.0	
46247	chr8	121530594	121530599	5	2.0	
46248	chr8	121639004	121640248	1244	622.0	
46249	chr8	121642182	121642702	520	260.0	
46250	chr8	121711109	121711201	92	46.0	
46251	chr8	121724454	121725085	631	316.0	
46252	chr8	121725898	121726143	245	122.0	
46253	chr8	121811565	121812277	712	356.0	
46254	chr8	121822595	121823195	600	300.0	
46255	chr8	121830059	121830378	319	160.0	
46256	chr8	122467105	122467458	353	176.0	
46257	chr8	122489601	122490150	549	274.0	
46258	chr8	122572283	122572694	411	206.0	
46259	chr8	122606573	122607241	668	334.0	
46260	chr8	122638807	122639496	689	344.0	
46261	chr8	122673382	122673924	542	271.0	
46262	chr8	122678852	122679263	411	206.0	
46263	chr8	122713452	122713814	362	181.0	
46264	chr8	122732520	122734180	1660	830.0	
46265	chr8	122773780	122773926	146	73.0	
46266	chr8	122776244	122776576	332	166.0	
46267	chr8	122779641	122789625	9984	4992.0	
46268	chr8	122790476	122790480	4	2.0	
46269	chr8	122792784	122795695	2911	1456.0	
46270	chr8	122797204	122797613	409	204.0	
46271	chr8	122798567	122799822	1255	628.0	
46272	chr8	122830170	122830244	74	37.0	
46273	chr8	122847635	122847979	344	172.0	
46274	chr8	122864690	122864782	92	46.0	
46275	chr8	122909757	122911566	1809	904.0	
46276	chr8	122918412	122919798	1386	693.0	
46277	chr8	122920586	122920915	329	164.0	
46278	chr8	122944314	122944775	461	230.0	
46279	chr8	123000828	123001079	251	126.0	
46280	chr8	123017636	123017661	25	12.0	
46281	chr8	123018877	123019261	384	192.0	
46282	chr8	123022313	123022838	525	262.0	
46283	chr8	123029068	123029333	265	132.0	
46284	chr8	123036662	123039892	3230	1615.0	
46285	chr8	123041222	123043040	1818	909.0	
46286	chr8	123060761	123061038	277	138.0	
46287	chr8	123065393	123066237	844	422.0	
46288	chr8	123072020	123074010	1990	995.0	
46289	chr8	123084074	123084465	391	196.0	
46290	chr8	123085510	123086819	1309	654.0	
46291	chr8	123095783	123096737	954	477.0	
46292	chr8	123112681	123113086	405	202.0	
46293	chr8	123139402	123139885	483	242.0	
46294	chr8	123149165	123149336	171	86.0	
46295	chr8	123154472	123155428	956	478.0	
46296	chr8	123156147	123158929	2782	1391.0	
46297	chr8	123160141	123161730	1589	794.0	
46298	chr8	123166153	123166761	608	304.0	
46299	chr8	123167454	123167937	483	242.0	
46300	chr8	123178818	123179236	418	209.0	
46301	chr8	123220563	123221035	472	236.0	
46302	chr8	123240204	123241893	1689	844.0	
46303	chr8	123250856	123251470	614	307.0	
46304	chr8	123272819	123275808	2989	1494.0	
46305	chr8	123282573	123282672	99	50.0	
46306	chr8	123386040	123386733	693	346.0	
46307	chr8	123394607	123397256	2649	1324.0	
46308	chr8	123413126	123413386	260	130.0	
46309	chr8	123415781	123417872	2091	1046.0	
46310	chr8	123447744	123448161	417	208.0	
46311	chr8	123479786	123480198	412	206.0	
46312	chr8	123487097	123487282	185	92.0	
46313	chr8	123491617	123491962	345	172.0	
46314	chr8	123512042	123512681	639	320.0	
46315	chr8	123516687	123517645	958	479.0	
46316	chr8	123519861	123521363	1502	751.0	
46317	chr8	123534340	123535361	1021	510.0	
46318	chr8	123537496	123538972	1476	738.0	
46319	chr8	123539763	123542349	2586	1293.0	
46320	chr8	123693698	123694225	527	264.0	
46321	chr8	123727801	123728165	364	182.0	
46322	chr8	123763320	123763850	530	265.0	
46323	chr8	123766060	123766729	669	334.0	
46324	chr8	123767561	123769363	1802	901.0	
46325	chr8	123770076	123771310	1234	617.0	
46326	chr8	123772802	123773201	399	200.0	
46327	chr8	123777545	123777968	423	212.0	
46328	chr8	123817030	123817285	255	128.0	
46329	chr8	123823442	123823769	327	164.0	
46330	chr8	123838160	123838504	344	172.0	
46331	chr8	123858539	123858728	189	94.0	
46332	chr8	123920651	123921053	402	201.0	
46333	chr8	123921784	123922812	1028	514.0	
46334	chr8	124021964	124022320	356	178.0	
46335	chr8	124037507	124038190	683	342.0	
46336	chr8	124040350	124040961	611	306.0	
46337	chr8	124141376	124141830	454	227.0	
46338	chr8	124181494	124181861	367	184.0	
46339	chr8	124190905	124191405	500	250.0	
46340	chr8	124195469	124198448	2979	1490.0	
46341	chr8	124199736	124200570	834	417.0	
46342	chr8	124247148	124247853	705	352.0	
46343	chr8	124251689	124252020	331	166.0	
46344	chr8	124254690	124255260	570	285.0	
46345	chr8	124256776	124257263	487	244.0	
46346	chr8	124261276	124263600	2324	1162.0	
46347	chr8	124266947	124267514	567	284.0	
46348	chr8	124364247	124364322	75	38.0	
46349	chr8	124371122	124373632	2510	1255.0	
46350	chr8	124425191	124426774	1583	792.0	
46351	chr8	124440154	124441007	853	426.0	
46352	chr8	124449763	124451724	1961	980.0	
46353	chr8	124472445	124472638	193	96.0	
46354	chr8	124473196	124477012	3816	1908.0	
46355	chr8	124478993	124478994	1	0.0	
46356	chr8	124479507	124480794	1287	644.0	
46357	chr8	124489128	124489144	16	8.0	
46358	chr8	124491144	124491502	358	179.0	
46359	chr8	124492206	124492830	624	312.0	
46360	chr8	124525845	124526364	519	260.0	
46361	chr8	124527145	124527757	612	306.0	
46362	chr8	124538027	124539798	1771	886.0	
46363	chr8	124545054	124545787	733	366.0	
46364	chr8	124561841	124562165	324	162.0	
46365	chr8	124563532	124565501	1969	984.0	
46366	chr8	124579343	124579991	648	324.0	
46367	chr8	124585743	124586341	598	299.0	
46368	chr8	124592652	124594981	2329	1164.0	
46369	chr8	124595919	124596498	579	290.0	
46370	chr8	124600599	124601982	1383	692.0	
46371	chr8	124604307	124605758	1451	726.0	
46372	chr8	124607407	124607740	333	166.0	
46373	chr8	124608269	124608332	63	32.0	
46374	chr8	124611732	124612609	877	438.0	
46375	chr8	124627949	124628671	722	361.0	
46376	chr8	124629492	124630659	1167	584.0	
46377	chr8	124635186	124635812	626	313.0	
46378	chr8	124637005	124638529	1524	762.0	
46379	chr8	124640224	124642623	2399	1200.0	
46380	chr8	124643800	124644611	811	406.0	
46381	chr8	124649782	124651669	1887	944.0	
46382	chr8	124655143	124655862	719	360.0	
46383	chr8	124659918	124661059	1141	570.0	
46384	chr8	124673210	124673841	631	316.0	
46385	chr8	124687328	124689058	1730	865.0	
46386	chr8	124689814	124690547	733	366.0	
46387	chr8	124702782	124703254	472	236.0	
46388	chr8	124708931	124710323	1392	696.0	
46389	chr8	124713915	124714345	430	215.0	
46390	chr8	124714938	124715407	469	234.0	
46391	chr8	124720435	124721036	601	300.0	
46392	chr8	124726522	124729057	2535	1268.0	
46393	chr8	124751349	124752403	1054	527.0	
46394	chr8	124757294	124757942	648	324.0	
46395	chr8	124761656	124762367	711	356.0	
46396	chr8	124771937	124772648	711	356.0	
46397	chr8	124782592	124783236	644	322.0	
46398	chr8	124785171	124785479	308	154.0	
46399	chr8	124789942	124790627	685	342.0	
46400	chr8	124802941	124803028	87	44.0	
46401	chr8	124814887	124815223	336	168.0	
46402	chr8	124825219	124825567	348	174.0	
46403	chr8	124840202	124840912	710	355.0	
46404	chr8	124847724	124848509	785	392.0	
46405	chr8	124866428	124867020	592	296.0	
46406	chr8	124888709	124889159	450	225.0	
46407	chr8	124905349	124906087	738	369.0	
46408	chr8	124924608	124925018	410	205.0	
46409	chr8	124953661	124954146	485	242.0	
46410	chr8	124972906	124974009	1103	552.0	
46411	chr8	124997270	125000079	2809	1404.0	
46412	chr8	125090793	125093352	2559	1280.0	
46413	chr8	125099901	125100411	510	255.0	
46414	chr8	125110825	125111124	299	150.0	
46415	chr8	125118140	125119431	1291	646.0	
46416	chr8	125125477	125125964	487	244.0	
46417	chr8	125163262	125163868	606	303.0	
46418	chr8	125168806	125169207	401	200.0	
46419	chr8	125174571	125175411	840	420.0	
46420	chr8	125181707	125181884	177	88.0	
46421	chr8	125191646	125192299	653	326.0	
46422	chr8	125210398	125210772	374	187.0	
46423	chr8	125219128	125220876	1748	874.0	
46424	chr8	125226522	125227348	826	413.0	
46425	chr8	125232793	125233185	392	196.0	
46426	chr8	125262533	125263059	526	263.0	
46427	chr8	125268605	125269003	398	199.0	
46428	chr8	125272982	125274303	1321	660.0	
46429	chr8	125275283	125275719	436	218.0	
46430	chr8	125278283	125278558	275	138.0	
46431	chr8	125309655	125310147	492	246.0	
46432	chr8	125311415	125311722	307	154.0	
46433	chr8	125339712	125340046	334	167.0	
46434	chr8	125341297	125342830	1533	766.0	
46435	chr8	125343879	125344660	781	390.0	
46436	chr8	125346811	125347283	472	236.0	
46437	chr8	125352703	125353364	661	330.0	
46438	chr8	125362525	125363268	743	372.0	
46439	chr8	125373845	125374319	474	237.0	
46440	chr8	125385739	125386981	1242	621.0	
46441	chr8	125410498	125411249	751	376.0	
46442	chr8	125427427	125427431	4	2.0	
46443	chr8	125428979	125437202	8223	4112.0	
46444	chr8	125439500	125441074	1574	787.0	
46445	chr8	125480658	125481121	463	232.0	
46446	chr8	125495197	125495660	463	232.0	
46447	chr8	125505476	125506764	1288	644.0	
46448	chr8	125508305	125508578	273	136.0	
46449	chr8	125509812	125510327	515	258.0	
46450	chr8	125512364	125513712	1348	674.0	
46451	chr8	125514462	125515354	892	446.0	
46452	chr8	125527413	125530028	2615	1308.0	
46453	chr8	125576005	125576660	655	328.0	
46454	chr8	125594098	125594327	229	114.0	
46455	chr8	125596028	125596489	461	230.0	
46456	chr8	125601687	125602998	1311	656.0	
46457	chr8	125604657	125605074	417	208.0	
46458	chr8	125606072	125606670	598	299.0	
46459	chr8	125607515	125608709	1194	597.0	
46460	chr8	125610822	125613346	2524	1262.0	
46461	chr8	125620289	125620764	475	238.0	
46462	chr8	125621730	125621731	1	0.0	
46463	chr8	125637294	125638110	816	408.0	
46464	chr8	125644010	125645156	1146	573.0	
46465	chr8	125646021	125646501	480	240.0	
46466	chr8	125648106	125649900	1794	897.0	
46467	chr8	125694036	125694905	869	434.0	
46468	chr8	125696591	125697317	726	363.0	
46469	chr8	125698062	125699314	1252	626.0	
46470	chr8	125700191	125701517	1326	663.0	
46471	chr8	125702045	125702932	887	444.0	
46472	chr8	125706236	125706806	570	285.0	
46473	chr8	125708257	125708791	534	267.0	
46474	chr8	125721955	125722557	602	301.0	
46475	chr8	125729175	125730386	1211	606.0	
46476	chr8	125828666	125829181	515	258.0	
46477	chr8	125901413	125901777	364	182.0	
46478	chr8	125911701	125912499	798	399.0	
46479	chr8	125923042	125925385	2343	1172.0	
46480	chr8	125926116	125926122	6	3.0	
46481	chr8	125929532	125931222	1690	845.0	
46482	chr8	125931828	125932505	677	338.0	
46483	chr8	125933635	125934609	974	487.0	
46484	chr8	125941513	125943067	1554	777.0	
46485	chr8	125947174	125952168	4994	2497.0	
46486	chr8	125957749	125958152	403	202.0	
46487	chr8	125969000	125969315	315	158.0	
46488	chr8	125971347	125972789	1442	721.0	
46489	chr8	126274884	126275727	843	422.0	
46490	chr8	126383633	126384093	460	230.0	
46491	chr8	126488172	126488561	389	194.0	
46492	chr8	126499718	126500289	571	286.0	
46493	chr8	126500830	126502235	1405	702.0	
46494	chr8	126556092	126559203	3111	1556.0	
46495	chr8	126566860	126567310	450	225.0	
46496	chr8	126810092	126810207	115	58.0	
46497	chr8	126824347	126824893	546	273.0	
46498	chr8	126876498	126877070	572	286.0	
46499	chr8	126890784	126891200	416	208.0	
46500	chr8	126991625	126992166	541	270.0	
46501	chr8	127035602	127036090	488	244.0	
46502	chr8	127125152	127125395	243	122.0	
46503	chr8	127161999	127162248	249	124.0	
46504	chr8	127163625	127164297	672	336.0	
46505	chr8	127168820	127170957	2137	1068.0	
46506	chr8	127178486	127179021	535	268.0	
46507	chr8	127181884	127182340	456	228.0	
46508	chr8	127184641	127184898	257	128.0	
46509	chr8	127196476	127197510	1034	517.0	
46510	chr8	127201117	127201796	679	340.0	
46511	chr8	127206110	127207347	1237	618.0	"sequence_feature	enhancer"
46512	chr8	127208050	127208418	368	184.0	
46513	chr8	127209766	127211067	1301	650.0	enhancer
46514	chr8	127215573	127216038	465	232.0	
46515	chr8	127222343	127223221	878	439.0	
46516	chr8	127300647	127301329	682	341.0	
46517	chr8	127302647	127303262	615	308.0	
46518	chr8	127307593	127308126	533	266.0	
46519	chr8	127366165	127366190	25	12.0	
46520	chr8	127386866	127387540	674	337.0	
46521	chr8	127399695	127400119	424	212.0	
46522	chr8	127426693	127427370	677	338.0	
46523	chr8	127441060	127441672	612	306.0	
46524	chr8	127444427	127444693	266	133.0	
46525	chr8	127456104	127456270	166	83.0	
46526	chr8	127457154	127458627	1473	736.0	
46527	chr8	127563490	127563739	249	124.0	
46528	chr8	127567000	127567394	394	197.0	
46529	chr8	127576421	127576757	336	168.0	
46530	chr8	127625188	127625567	379	190.0	
46531	chr8	127668620	127669249	629	314.0	
46532	chr8	127670894	127671327	433	216.0	
46533	chr8	127674714	127675375	661	330.0	
46534	chr8	127725673	127726185	512	256.0	
46535	chr8	127732412	127733011	599	300.0	
46536	chr8	127733682	127739560	5878	2939.0	"origin_of_replication	origin_of_replication	origin_of_replication	origin_of_replication	protein_binding_site	protein_binding_site	origin_of_replication	region	protein_binding_site	protein_binding_site	region	region	origin_of_replication	origin_of_replication	region	origin_of_replication	region"
46537	chr8	127741887	127742600	713	356.0	
46538	chr8	127751167	127751435	268	134.0	
46539	chr8	127759422	127761260	1838	919.0	
46540	chr8	127763395	127763791	396	198.0	
46541	chr8	127766591	127767373	782	391.0	
46542	chr8	127783488	127783538	50	25.0	
46543	chr8	127793744	127795925	2181	1090.0	
46544	chr8	127799501	127800005	504	252.0	
46545	chr8	127831570	127831971	401	200.0	
46546	chr8	127875419	127876521	1102	551.0	
46547	chr8	127886994	127887429	435	218.0	
46548	chr8	127889965	127890432	467	234.0	
46549	chr8	127916389	127918263	1874	937.0	
46550	chr8	127920996	127921253	257	128.0	
46551	chr8	127931670	127932142	472	236.0	
46552	chr8	127949684	127949752	68	34.0	
46553	chr8	127959568	127959949	381	190.0	
46554	chr8	127965409	127965479	70	35.0	
46555	chr8	127973916	127974386	470	235.0	
46556	chr8	127975359	127978396	3037	1518.0	
46557	chr8	127979981	127982476	2495	1248.0	
46558	chr8	127992299	127994121	1822	911.0	
46559	chr8	127996483	127997030	547	274.0	
46560	chr8	128001297	128001321	24	12.0	
46561	chr8	128031027	128031540	513	256.0	
46562	chr8	128035015	128035606	591	296.0	
46563	chr8	128041821	128042717	896	448.0	
46564	chr8	128048129	128051428	3299	1650.0	
46565	chr8	128076729	128077294	565	282.0	
46566	chr8	128103688	128103866	178	89.0	
46567	chr8	128120742	128120878	136	68.0	
46568	chr8	128149749	128150448	699	350.0	
46569	chr8	128151118	128151630	512	256.0	
46570	chr8	128167379	128168754	1375	688.0	
46571	chr8	128173493	128174526	1033	516.0	
46572	chr8	128183288	128183876	588	294.0	
46573	chr8	128185874	128186331	457	228.0	
46574	chr8	128191080	128191664	584	292.0	
46575	chr8	128192364	128192813	449	224.0	
46576	chr8	128193612	128194219	607	304.0	
46577	chr8	128205133	128205150	17	8.0	
46578	chr8	128205761	128206363	602	301.0	
46579	chr8	128230979	128231462	483	242.0	
46580	chr8	128239071	128239725	654	327.0	
46581	chr8	128240280	128240776	496	248.0	
46582	chr8	128250601	128252175	1574	787.0	
46583	chr8	128267395	128268088	693	346.0	
46584	chr8	128269430	128269901	471	236.0	
46585	chr8	128277029	128277548	519	260.0	
46586	chr8	128311849	128312264	415	208.0	
46587	chr8	128313466	128314426	960	480.0	
46588	chr8	128322634	128323099	465	232.0	
46589	chr8	128376772	128377459	687	344.0	
46590	chr8	128381907	128382250	343	172.0	
46591	chr8	128390233	128390383	150	75.0	
46592	chr8	128537717	128538069	352	176.0	
46593	chr8	128540301	128541512	1211	606.0	
46594	chr8	128543209	128543975	766	383.0	
46595	chr8	128554897	128555698	801	400.0	
46596	chr8	128556611	128557155	544	272.0	
46597	chr8	128591235	128591646	411	206.0	
46598	chr8	128597645	128598028	383	192.0	
46599	chr8	128605401	128605748	347	174.0	
46600	chr8	128631540	128631869	329	164.0	
46601	chr8	128650041	128650320	279	140.0	
46602	chr8	128653094	128653778	684	342.0	
46603	chr8	128657203	128658361	1158	579.0	
46604	chr8	128659365	128660231	866	433.0	
46605	chr8	128682076	128682575	499	250.0	
46606	chr8	128683535	128683707	172	86.0	
46607	chr8	128734327	128734756	429	214.0	
46608	chr8	128859033	128859569	536	268.0	
46609	chr8	128948582	128949225	643	322.0	
46610	chr8	128949845	128950342	497	248.0	
46611	chr8	128973279	128973790	511	256.0	
46612	chr8	129024093	129024098	5	2.0	
46613	chr8	129237604	129238018	414	207.0	
46614	chr8	129269044	129269965	921	460.0	
46615	chr8	129303343	129303792	449	224.0	
46616	chr8	129394252	129394455	203	102.0	
46617	chr8	129411239	129411538	299	150.0	
46618	chr8	129418519	129419080	561	280.0	
46619	chr8	129420451	129420978	527	264.0	
46620	chr8	129422478	129422957	479	240.0	
46621	chr8	129483197	129483266	69	34.0	
46622	chr8	129484897	129485210	313	156.0	
46623	chr8	129489174	129489773	599	300.0	
46624	chr8	129535545	129536539	994	497.0	
46625	chr8	129546603	129549194	2591	1296.0	
46626	chr8	129552219	129552752	533	266.0	
46627	chr8	129581778	129581865	87	44.0	
46628	chr8	129666237	129666808	571	286.0	
46629	chr8	129676743	129677210	467	234.0	
46630	chr8	129678810	129679252	442	221.0	
46631	chr8	129681938	129682477	539	270.0	
46632	chr8	129683490	129683929	439	220.0	
46633	chr8	129690913	129691333	420	210.0	
46634	chr8	129726261	129726669	408	204.0	
46635	chr8	129819898	129820512	614	307.0	
46636	chr8	129821600	129821977	377	188.0	
46637	chr8	129825709	129826685	976	488.0	
46638	chr8	129885321	129887283	1962	981.0	
46639	chr8	129887797	129888744	947	474.0	
46640	chr8	129891590	129892049	459	230.0	
46641	chr8	129899832	129900947	1115	558.0	
46642	chr8	129938675	129941237	2562	1281.0	
46643	chr8	129958129	129959691	1562	781.0	
46644	chr8	129970117	129970589	472	236.0	
46645	chr8	129971389	129975110	3721	1860.0	
46646	chr8	129981846	129982257	411	206.0	
46647	chr8	129983996	129986515	2519	1260.0	
46648	chr8	129987035	129989487	2452	1226.0	
46649	chr8	129992677	129996602	3925	1962.0	
46650	chr8	129999847	130000401	554	277.0	
46651	chr8	130005118	130005800	682	341.0	
46652	chr8	130006769	130007433	664	332.0	
46653	chr8	130008290	130009399	1109	554.0	
46654	chr8	130012483	130012854	371	186.0	
46655	chr8	130013364	130017437	4073	2036.0	
46656	chr8	130021810	130022703	893	446.0	
46657	chr8	130032718	130033592	874	437.0	
46658	chr8	130041998	130043045	1047	524.0	
46659	chr8	130045414	130046598	1184	592.0	
46660	chr8	130063916	130064754	838	419.0	
46661	chr8	130067767	130069095	1328	664.0	
46662	chr8	130080237	130080240	3	2.0	
46663	chr8	130094633	130095111	478	239.0	
46664	chr8	130101615	130102335	720	360.0	
46665	chr8	130129526	130129990	464	232.0	
46666	chr8	130152635	130153024	389	194.0	
46667	chr8	130182264	130182828	564	282.0	
46668	chr8	130191638	130192323	685	342.0	
46669	chr8	130193765	130195087	1322	661.0	
46670	chr8	130201153	130201902	749	374.0	
46671	chr8	130206272	130206858	586	293.0	
46672	chr8	130207506	130207978	472	236.0	
46673	chr8	130220565	130221184	619	310.0	
46674	chr8	130242696	130243400	704	352.0	
46675	chr8	130244206	130246210	2004	1002.0	
46676	chr8	130247484	130249353	1869	934.0	
46677	chr8	130263864	130263945	81	40.0	
46678	chr8	130276604	130278096	1492	746.0	
46679	chr8	130278843	130280017	1174	587.0	
46680	chr8	130283782	130285211	1429	714.0	
46681	chr8	130286700	130286781	81	40.0	
46682	chr8	130293234	130293846	612	306.0	
46683	chr8	130302595	130302788	193	96.0	
46684	chr8	130304474	130304882	408	204.0	
46685	chr8	130309239	130309868	629	314.0	
46686	chr8	130313742	130314123	381	190.0	
46687	chr8	130316838	130319254	2416	1208.0	
46688	chr8	130322374	130322911	537	268.0	
46689	chr8	130323929	130324884	955	478.0	
46690	chr8	130326775	130327138	363	182.0	
46691	chr8	130327891	130328695	804	402.0	
46692	chr8	130329704	130330416	712	356.0	
46693	chr8	130331349	130331676	327	164.0	
46694	chr8	130334724	130335419	695	348.0	
46695	chr8	130340444	130341603	1159	580.0	
46696	chr8	130342910	130343421	511	256.0	
46697	chr8	130345199	130345306	107	54.0	
46698	chr8	130346354	130346573	219	110.0	
46699	chr8	130352187	130352605	418	209.0	
46700	chr8	130356516	130359521	3005	1502.0	
46701	chr8	130364552	130365100	548	274.0	
46702	chr8	130366379	130366570	191	96.0	
46703	chr8	130411497	130411936	439	220.0	
46704	chr8	130416616	130417002	386	193.0	
46705	chr8	130421309	130421581	272	136.0	
46706	chr8	130433056	130433139	83	42.0	
46707	chr8	130437459	130438089	630	315.0	
46708	chr8	130442787	130445770	2983	1492.0	
46709	chr8	130465465	130466790	1325	662.0	
46710	chr8	130675464	130676053	589	294.0	
46711	chr8	130749659	130750019	360	180.0	
46712	chr8	131022573	131022923	350	175.0	
46713	chr8	131250303	131250737	434	217.0	
46714	chr8	131317388	131317903	515	258.0	
46715	chr8	131793448	131794173	725	362.0	
46716	chr8	131804191	131804596	405	202.0	
46717	chr8	131814237	131814752	515	258.0	
46718	chr8	131816004	131817170	1166	583.0	
46719	chr8	131827354	131828039	685	342.0	
46720	chr8	131856650	131857456	806	403.0	
46721	chr8	131861219	131861357	138	69.0	
46722	chr8	131903205	131906973	3768	1884.0	
46723	chr8	131910027	131910405	378	189.0	
46724	chr8	131911313	131911749	436	218.0	
46725	chr8	131913079	131913391	312	156.0	
46726	chr8	131916087	131917350	1263	632.0	
46727	chr8	131920169	131920797	628	314.0	
46728	chr8	131925483	131925790	307	154.0	
46729	chr8	131927272	131928098	826	413.0	
46730	chr8	131938595	131939077	482	241.0	
46731	chr8	131947408	131947678	270	135.0	
46732	chr8	131952254	131952262	8	4.0	
46733	chr8	132033847	132034090	243	122.0	
46734	chr8	132128931	132129327	396	198.0	
46735	chr8	132192070	132192368	298	149.0	
46736	chr8	132395885	132396143	258	129.0	
46737	chr8	132479988	132480001	13	6.0	
46738	chr8	132480813	132481468	655	328.0	
46739	chr8	132489525	132489969	444	222.0	
46740	chr8	132651392	132651878	486	243.0	
46741	chr8	132668280	132668674	394	197.0	
46742	chr8	132674837	132676204	1367	684.0	
46743	chr8	132676929	132677302	373	186.0	
46744	chr8	132740150	132740604	454	227.0	
46745	chr8	132758296	132759330	1034	517.0	
46746	chr8	132759954	132761310	1356	678.0	
46747	chr8	132761988	132762070	82	41.0	
46748	chr8	132765181	132766407	1226	613.0	
46749	chr8	132768415	132769079	664	332.0	
46750	chr8	132772401	132772568	167	84.0	
46751	chr8	132773076	132773486	410	205.0	
46752	chr8	132774605	132776393	1788	894.0	
46753	chr8	132787103	132787237	134	67.0	
46754	chr8	132812491	132812526	35	18.0	
46755	chr8	132833768	132834264	496	248.0	
46756	chr8	132875400	132876072	672	336.0	
46757	chr8	132895274	132896207	933	466.0	
46758	chr8	132920719	132921023	304	152.0	
46759	chr8	132969404	132969909	505	252.0	
46760	chr8	132978297	132979794	1497	748.0	
46761	chr8	132980901	132981464	563	282.0	
46762	chr8	132981988	132982950	962	481.0	
46763	chr8	132985516	132985927	411	206.0	
46764	chr8	132994807	132995466	659	330.0	
46765	chr8	132997349	132998026	677	338.0	
46766	chr8	133001521	133001710	189	94.0	
46767	chr8	133015176	133017512	2336	1168.0	
46768	chr8	133025804	133027356	1552	776.0	
46769	chr8	133033247	133033686	439	220.0	
46770	chr8	133046342	133046835	493	246.0	
46771	chr8	133052963	133063436	10473	5236.0	
46772	chr8	133064480	133064572	92	46.0	
46773	chr8	133065908	133076998	11090	5545.0	
46774	chr8	133077659	133078532	873	436.0	
46775	chr8	133081439	133083221	1782	891.0	
46776	chr8	133090979	133091071	92	46.0	
46777	chr8	133092085	133093155	1070	535.0	
46778	chr8	133093689	133094404	715	358.0	
46779	chr8	133120321	133120701	380	190.0	
46780	chr8	133128227	133128434	207	104.0	
46781	chr8	133129655	133131344	1689	844.0	
46782	chr8	133138591	133140121	1530	765.0	
46783	chr8	133142486	133142487	1	0.0	
46784	chr8	133144039	133145388	1349	674.0	
46785	chr8	133146832	133147530	698	349.0	
46786	chr8	133149824	133151213	1389	694.0	
46787	chr8	133171220	133171335	115	58.0	
46788	chr8	133176151	133176625	474	237.0	
46789	chr8	133178004	133178653	649	324.0	
46790	chr8	133202503	133203512	1009	504.0	
46791	chr8	133205038	133205257	219	110.0	
46792	chr8	133209036	133210004	968	484.0	
46793	chr8	133216424	133218578	2154	1077.0	
46794	chr8	133231249	133231802	553	276.0	
46795	chr8	133234683	133235807	1124	562.0	
46796	chr8	133238202	133238645	443	222.0	
46797	chr8	133245532	133246389	857	428.0	
46798	chr8	133249036	133250151	1115	558.0	
46799	chr8	133250937	133251333	396	198.0	
46800	chr8	133251962	133252524	562	281.0	
46801	chr8	133253042	133253290	248	124.0	
46802	chr8	133254525	133257512	2987	1494.0	
46803	chr8	133258488	133260373	1885	942.0	
46804	chr8	133261171	133261244	73	36.0	
46805	chr8	133262393	133263102	709	354.0	
46806	chr8	133264169	133276905	12736	6368.0	
46807	chr8	133277857	133280569	2712	1356.0	
46808	chr8	133282509	133286290	3781	1890.0	
46809	chr8	133287372	133298706	11334	5667.0	
46810	chr8	133302716	133304009	1293	646.0	
46811	chr8	133321547	133321819	272	136.0	
46812	chr8	133341085	133341845	760	380.0	
46813	chr8	133354963	133355236	273	136.0	
46814	chr8	133375539	133375878	339	170.0	
46815	chr8	133390459	133391653	1194	597.0	
46816	chr8	133397186	133397648	462	231.0	
46817	chr8	133403370	133404339	969	484.0	
46818	chr8	133449176	133450101	925	462.0	
46819	chr8	133451305	133451663	358	179.0	
46820	chr8	133453072	133454301	1229	614.0	
46821	chr8	133455223	133457455	2232	1116.0	
46822	chr8	133482143	133482874	731	366.0	
46823	chr8	133484965	133486756	1791	896.0	
46824	chr8	133496189	133501546	5357	2678.0	
46825	chr8	133503423	133505927	2504	1252.0	
46826	chr8	133507085	133508089	1004	502.0	
46827	chr8	133516618	133517260	642	321.0	
46828	chr8	133519785	133521025	1240	620.0	
46829	chr8	133522000	133522278	278	139.0	
46830	chr8	133525872	133527579	1707	854.0	
46831	chr8	133531558	133532153	595	298.0	
46832	chr8	133533726	133534095	369	184.0	
46833	chr8	133538691	133539293	602	301.0	
46834	chr8	133546729	133547352	623	312.0	
46835	chr8	133552491	133552762	271	136.0	
46836	chr8	133559437	133559822	385	192.0	
46837	chr8	133563786	133565368	1582	791.0	
46838	chr8	133567402	133573550	6148	3074.0	
46839	chr8	133575351	133576484	1133	566.0	
46840	chr8	133577756	133578324	568	284.0	
46841	chr8	133580521	133581052	531	266.0	
46842	chr8	133582041	133582363	322	161.0	
46843	chr8	133583339	133583342	3	2.0	
46844	chr8	133584214	133584524	310	155.0	
46845	chr8	133591762	133592191	429	214.0	
46846	chr8	133615056	133615536	480	240.0	
46847	chr8	133616253	133617152	899	450.0	
46848	chr8	133634554	133634901	347	174.0	
46849	chr8	133645045	133646341	1296	648.0	
46850	chr8	133651986	133652386	400	200.0	
46851	chr8	133654260	133654893	633	316.0	
46852	chr8	133662734	133662873	139	70.0	
46853	chr8	133666989	133667190	201	100.0	
46854	chr8	133693876	133694701	825	412.0	
46855	chr8	133752777	133753501	724	362.0	
46856	chr8	133883121	133883150	29	14.0	
46857	chr8	133885877	133886548	671	336.0	
46858	chr8	133890549	133891155	606	303.0	
46859	chr8	133892479	133893906	1427	714.0	
46860	chr8	133897020	133897470	450	225.0	
46861	chr8	133897982	133898322	340	170.0	
46862	chr8	133898857	133899974	1117	558.0	
46863	chr8	133903248	133903514	266	133.0	
46864	chr8	133913424	133913825	401	200.0	
46865	chr8	133915530	133916010	480	240.0	
46866	chr8	133918872	133920117	1245	622.0	
46867	chr8	133921989	133922145	156	78.0	
46868	chr8	133950911	133951601	690	345.0	
46869	chr8	133952637	133952724	87	44.0	
46870	chr8	133976512	133977028	516	258.0	
46871	chr8	134020858	134021857	999	500.0	
46872	chr8	134023426	134024055	629	314.0	
46873	chr8	134026582	134027075	493	246.0	
46874	chr8	134033794	134034957	1163	582.0	
46875	chr8	134039218	134039729	511	256.0	
46876	chr8	134043461	134044153	692	346.0	
46877	chr8	134152399	134152651	252	126.0	
46878	chr8	134161201	134161584	383	192.0	
46879	chr8	134261563	134262060	497	248.0	
46880	chr8	134278120	134278762	642	321.0	
46881	chr8	134311431	134311735	304	152.0	
46882	chr8	134318724	134319037	313	156.0	
46883	chr8	134320055	134320724	669	334.0	
46884	chr8	134324770	134325178	408	204.0	
46885	chr8	134332709	134333610	901	450.0	
46886	chr8	134334137	134334327	190	95.0	
46887	chr8	134367671	134367957	286	143.0	
46888	chr8	134457171	134457610	439	220.0	
46889	chr8	134598435	134598939	504	252.0	
46890	chr8	134601693	134602229	536	268.0	
46891	chr8	134619860	134620423	563	282.0	
46892	chr8	134631527	134631909	382	191.0	
46893	chr8	134683283	134683654	371	186.0	
46894	chr8	134684961	134686227	1266	633.0	
46895	chr8	134687523	134688147	624	312.0	
46896	chr8	134691005	134691772	767	384.0	
46897	chr8	134711604	134714521	2917	1458.0	
46898	chr8	134719404	134721300	1896	948.0	
46899	chr8	134791255	134791356	101	50.0	
46900	chr8	134830428	134833704	3276	1638.0	
46901	chr8	134886379	134886848	469	234.0	
46902	chr8	134905503	134906469	966	483.0	
46903	chr8	134976846	134977168	322	161.0	
46904	chr8	135452300	135453060	760	380.0	
46905	chr8	135456354	135458675	2321	1160.0	
46906	chr8	135465823	135466265	442	221.0	
46907	chr8	135923061	135923423	362	181.0	
46908	chr8	137890933	137891206	273	136.0	
46909	chr8	137934186	137935067	881	440.0	
46910	chr8	137983012	137983513	501	250.0	
46911	chr8	138191723	138192842	1119	560.0	
46912	chr8	138253412	138255513	2101	1050.0	
46913	chr8	138311087	138311310	223	112.0	
46914	chr8	138680043	138680506	463	232.0	
46915	chr8	138686500	138686854	354	177.0	
46916	chr8	138700375	138700738	363	182.0	
46917	chr8	138727309	138727861	552	276.0	
46918	chr8	138740145	138740714	569	284.0	
46919	chr8	138767632	138767959	327	164.0	
46920	chr8	138831221	138831546	325	162.0	
46921	chr8	138936185	138936509	324	162.0	
46922	chr8	138939179	138939260	81	40.0	
46923	chr8	139405777	139406114	337	168.0	
46924	chr8	139505236	139505747	511	256.0	
46925	chr8	139630890	139631169	279	140.0	
46926	chr8	139705505	139706354	849	424.0	
46927	chr8	139754731	139755132	401	200.0	
46928	chr8	140050145	140050323	178	89.0	
46929	chr8	140098158	140101229	3071	1536.0	
46930	chr8	140114611	140115012	401	200.0	
46931	chr8	140150837	140151478	641	320.0	
46932	chr8	140159557	140160049	492	246.0	
46933	chr8	140168331	140168747	416	208.0	
46934	chr8	140169328	140170062	734	367.0	
46935	chr8	140228481	140228909	428	214.0	
46936	chr8	140233413	140233721	308	154.0	
46937	chr8	140273064	140273465	401	200.0	
46938	chr8	140358548	140358974	426	213.0	
46939	chr8	140390720	140390761	41	20.0	
46940	chr8	140393704	140394416	712	356.0	
46941	chr8	140431979	140432330	351	176.0	
46942	chr8	140456638	140458791	2153	1076.0	
46943	chr8	140463497	140465509	2012	1006.0	
46944	chr8	140467083	140467727	644	322.0	
46945	chr8	140496335	140496578	243	122.0	
46946	chr8	140504904	140505321	417	208.0	
46947	chr8	140507102	140507791	689	344.0	
46948	chr8	140509003	140513207	4204	2102.0	
46949	chr8	140518462	140518964	502	251.0	
46950	chr8	140527514	140527912	398	199.0	
46951	chr8	140540155	140540616	461	230.0	
46952	chr8	140541864	140545474	3610	1805.0	
46953	chr8	140558249	140558774	525	262.0	
46954	chr8	140564336	140564411	75	38.0	
46955	chr8	140572111	140572937	826	413.0	
46956	chr8	140574357	140575697	1340	670.0	
46957	chr8	140576680	140576794	114	57.0	
46958	chr8	140588511	140589898	1387	694.0	
46959	chr8	140590545	140592213	1668	834.0	
46960	chr8	140593388	140594056	668	334.0	
46961	chr8	140596325	140599520	3195	1598.0	
46962	chr8	140615378	140615755	377	188.0	
46963	chr8	140618226	140618777	551	276.0	
46964	chr8	140623528	140624408	880	440.0	
46965	chr8	140629910	140630741	831	416.0	
46966	chr8	140633380	140638132	4752	2376.0	
46967	chr8	140668224	140668661	437	218.0	
46968	chr8	140790613	140791935	1322	661.0	
46969	chr8	140831060	140831516	456	228.0	
46970	chr8	140838791	140839577	786	393.0	
46971	chr8	140944149	140944643	494	247.0	
46972	chr8	140955147	140955834	687	344.0	
46973	chr8	140999909	141003677	3768	1884.0	
46974	chr8	141004568	141005454	886	443.0	
46975	chr8	141010211	141010787	576	288.0	
46976	chr8	141035387	141036574	1187	594.0	
46977	chr8	141059888	141060269	381	190.0	
46978	chr8	141072965	141073784	819	410.0	
46979	chr8	141075469	141075971	502	251.0	
46980	chr8	141079462	141079812	350	175.0	
46981	chr8	141084040	141084935	895	448.0	
46982	chr8	141085993	141087036	1043	522.0	
46983	chr8	141089003	141090417	1414	707.0	
46984	chr8	141093394	141096983	3589	1794.0	
46985	chr8	141099352	141099750	398	199.0	
46986	chr8	141104269	141105197	928	464.0	
46987	chr8	141118075	141121688	3613	1806.0	
46988	chr8	141126754	141130537	3783	1892.0	
46989	chr8	141131098	141132285	1187	594.0	
46990	chr8	141133116	141133507	391	196.0	
46991	chr8	141137616	141138707	1091	546.0	
46992	chr8	141140077	141140953	876	438.0	
46993	chr8	141145997	141146647	650	325.0	
46994	chr8	141149723	141150430	707	354.0	
46995	chr8	141152023	141153249	1226	613.0	
46996	chr8	141156854	141157673	819	410.0	
46997	chr8	141160821	141161381	560	280.0	
46998	chr8	141162837	141163312	475	238.0	
46999	chr8	141164318	141165639	1321	660.0	
47000	chr8	141169186	141169379	193	96.0	
47001	chr8	141171518	141171626	108	54.0	
47002	chr8	141172176	141173790	1614	807.0	
47003	chr8	141174782	141175351	569	284.0	
47004	chr8	141182210	141182816	606	303.0	
47005	chr8	141183400	141183905	505	252.0	
47006	chr8	141205414	141207630	2216	1108.0	
47007	chr8	141208413	141209584	1171	586.0	
47008	chr8	141226948	141228092	1144	572.0	
47009	chr8	141228690	141228709	19	10.0	
47010	chr8	141234626	141235866	1240	620.0	
47011	chr8	141238396	141240012	1616	808.0	
47012	chr8	141243159	141243284	125	62.0	
47013	chr8	141244678	141246076	1398	699.0	
47014	chr8	141264993	141267229	2236	1118.0	
47015	chr8	141272303	141272693	390	195.0	
47016	chr8	141276234	141277073	839	420.0	
47017	chr8	141277976	141279356	1380	690.0	
47018	chr8	141279973	141280846	873	436.0	
47019	chr8	141282321	141284275	1954	977.0	
47020	chr8	141284784	141285792	1008	504.0	
47021	chr8	141286820	141288886	2066	1033.0	
47022	chr8	141291857	141292857	1000	500.0	
47023	chr8	141294279	141295804	1525	762.0	
47024	chr8	141297011	141297508	497	248.0	
47025	chr8	141298478	141300194	1716	858.0	
47026	chr8	141303778	141304787	1009	504.0	
47027	chr8	141305411	141310591	5180	2590.0	
47028	chr8	141323714	141323748	34	17.0	
47029	chr8	141326873	141329931	3058	1529.0	
47030	chr8	141346685	141347499	814	407.0	
47031	chr8	141358986	141359360	374	187.0	
47032	chr8	141367037	141367490	453	226.0	
47033	chr8	141373935	141374353	418	209.0	
47034	chr8	141380618	141381200	582	291.0	
47035	chr8	141381884	141382265	381	190.0	
47036	chr8	141386489	141388523	2034	1017.0	
47037	chr8	141391169	141392896	1727	864.0	
47038	chr8	141401101	141404642	3541	1770.0	
47039	chr8	141406018	141406648	630	315.0	
47040	chr8	141411137	141411188	51	26.0	
47041	chr8	141414513	141418512	3999	2000.0	enhancer
47042	chr8	141431208	141432065	857	428.0	
47043	chr8	141507989	141508302	313	156.0	
47044	chr8	141540562	141541041	479	240.0	
47045	chr8	141726861	141727286	425	212.0	
47046	chr8	141745584	141745624	40	20.0	
47047	chr8	142021341	142021736	395	198.0	
47048	chr8	142030897	142031250	353	176.0	
47049	chr8	142041081	142041915	834	417.0	
47050	chr8	142198104	142198342	238	119.0	
47051	chr8	142277351	142277913	562	281.0	
47052	chr8	142304393	142304395	2	1.0	
47053	chr8	142322696	142322981	285	142.0	
47054	chr8	142323526	142323989	463	232.0	
47055	chr8	142325647	142326791	1144	572.0	
47056	chr8	142340053	142340660	607	304.0	
47057	chr8	142368203	142368616	413	206.0	
47058	chr8	142393833	142394065	232	116.0	
47059	chr8	142401668	142404503	2835	1418.0	
47060	chr8	142447344	142448108	764	382.0	
47061	chr8	142449319	142453865	4546	2273.0	
47062	chr8	142454399	142454631	232	116.0	
47063	chr8	142471674	142476586	4912	2456.0	
47064	chr8	142545580	142545939	359	180.0	
47065	chr8	142608967	142609534	567	284.0	
47066	chr8	142612749	142612812	63	32.0	
47067	chr8	142614031	142615830	1799	900.0	
47068	chr8	142621935	142622378	443	222.0	
47069	chr8	142623963	142624421	458	229.0	
47070	chr8	142634614	142635110	496	248.0	
47071	chr8	142668987	142670772	1785	892.0	
47072	chr8	142676976	142677032	56	28.0	
47073	chr8	142682044	142682085	41	20.0	
47074	chr8	142699731	142700145	414	207.0	
47075	chr8	142717847	142718581	734	367.0	
47076	chr8	142726092	142729218	3126	1563.0	
47077	chr8	142730128	142730397	269	134.0	
47078	chr8	142731685	142732773	1088	544.0	
47079	chr8	142738367	142741380	3013	1506.0	
47080	chr8	142756941	142757664	723	362.0	
47081	chr8	142776392	142778210	1818	909.0	
47082	chr8	142782251	142783106	855	428.0	
47083	chr8	142802977	142804013	1036	518.0	
47084	chr8	142816025	142816836	811	406.0	
47085	chr8	142838335	142838662	327	164.0	
47086	chr8	142841662	142842503	841	420.0	
47087	chr8	142844506	142845438	932	466.0	
47088	chr8	142864844	142865279	435	218.0	
47089	chr8	142869218	142869561	343	172.0	
47090	chr8	142870697	142871036	339	170.0	
47091	chr8	142984074	142984777	703	352.0	
47092	chr8	142990633	142991258	625	312.0	
47093	chr8	143015902	143016650	748	374.0	
47094	chr8	143017254	143020038	2784	1392.0	
47095	chr8	143020845	143020981	136	68.0	
47096	chr8	143022317	143029718	7401	3700.0	
47097	chr8	143038601	143039685	1084	542.0	
47098	chr8	143047892	143048736	844	422.0	
47099	chr8	143112606	143113321	715	358.0	
47100	chr8	143120913	143121298	385	192.0	
47101	chr8	143130947	143131577	630	315.0	
47102	chr8	143135985	143136728	743	372.0	
47103	chr8	143174040	143175347	1307	654.0	
47104	chr8	143179395	143179838	443	222.0	
47105	chr8	143190894	143192177	1283	642.0	
47106	chr8	143201549	143201945	396	198.0	
47107	chr8	143203962	143204365	403	202.0	
47108	chr8	143206052	143207732	1680	840.0	
47109	chr8	143208325	143208818	493	246.0	
47110	chr8	143219517	143219695	178	89.0	
47111	chr8	143220478	143220684	206	103.0	
47112	chr8	143231444	143231932	488	244.0	
47113	chr8	143245107	143247932	2825	1412.0	
47114	chr8	143266635	143268409	1774	887.0	
47115	chr8	143272487	143272873	386	193.0	
47116	chr8	143275712	143277709	1997	998.0	
47117	chr8	143278283	143279379	1096	548.0	
47118	chr8	143280788	143282364	1576	788.0	
47119	chr8	143288972	143289976	1004	502.0	
47120	chr8	143290618	143291940	1322	661.0	
47121	chr8	143314835	143315194	359	180.0	
47122	chr8	143325877	143326732	855	428.0	
47123	chr8	143328367	143329050	683	342.0	
47124	chr8	143331859	143332207	348	174.0	
47125	chr8	143333995	143335582	1587	794.0	
47126	chr8	143337608	143338161	553	276.0	
47127	chr8	143341472	143342040	568	284.0	
47128	chr8	143352025	143352617	592	296.0	
47129	chr8	143354823	143356333	1510	755.0	
47130	chr8	143360695	143361248	553	276.0	
47131	chr8	143367999	143370278	2279	1140.0	
47132	chr8	143374803	143374880	77	38.0	
47133	chr8	143379964	143379984	20	10.0	
47134	chr8	143383152	143385666	2514	1257.0	
47135	chr8	143397979	143398698	719	360.0	
47136	chr8	143401059	143401725	666	333.0	
47137	chr8	143407391	143408420	1029	514.0	
47138	chr8	143421158	143421333	175	88.0	
47139	chr8	143422009	143422524	515	258.0	
47140	chr8	143426165	143431856	5691	2846.0	
47141	chr8	143434467	143436202	1735	868.0	
47142	chr8	143452815	143453166	351	176.0	
47143	chr8	143454331	143455138	807	404.0	
47144	chr8	143461154	143463135	1981	990.0	
47145	chr8	143512353	143513356	1003	502.0	
47146	chr8	143515396	143517829	2433	1216.0	
47147	chr8	143529177	143530168	991	496.0	
47148	chr8	143531876	143533211	1335	668.0	
47149	chr8	143540698	143542368	1670	835.0	
47150	chr8	143544342	143549963	5621	2810.0	
47151	chr8	143552822	143554280	1458	729.0	
47152	chr8	143557742	143559175	1433	716.0	
47153	chr8	143567145	143570193	3048	1524.0	
47154	chr8	143571163	143575105	3942	1971.0	
47155	chr8	143577508	143579881	2373	1186.0	
47156	chr8	143580601	143580674	73	36.0	
47157	chr8	143583866	143585179	1313	656.0	
47158	chr8	143585858	143585911	53	26.0	
47159	chr8	143588178	143588306	128	64.0	
47160	chr8	143592527	143594881	2354	1177.0	
47161	chr8	143595699	143599054	3355	1678.0	
47162	chr8	143601932	143602765	833	416.0	
47163	chr8	143608412	143610531	2119	1060.0	
47164	chr8	143616633	143618733	2100	1050.0	
47165	chr8	143631495	143632128	633	316.0	
47166	chr8	143635266	143636953	1687	844.0	
47167	chr8	143684021	143685158	1137	568.0	
47168	chr8	143702921	143703391	470	235.0	
47169	chr8	143715890	143717118	1228	614.0	
47170	chr8	143728016	143728312	296	148.0	
47171	chr8	143733247	143734433	1186	593.0	
47172	chr8	143739793	143740871	1078	539.0	
47173	chr8	143771057	143772274	1217	608.0	
47174	chr8	143786889	143787111	222	111.0	
47175	chr8	143798126	143798645	519	260.0	
47176	chr8	143814360	143817072	2712	1356.0	
47177	chr8	143828255	143830257	2002	1001.0	
47178	chr8	143836413	143836834	421	210.0	
47179	chr8	143840281	143843351	3070	1535.0	
47180	chr8	143843928	143844441	513	256.0	
47181	chr8	143856178	143856903	725	362.0	
47182	chr8	143866284	143866509	225	112.0	
47183	chr8	143877797	143880181	2384	1192.0	
47184	chr8	143902263	143903135	872	436.0	
47185	chr8	143914047	143915130	1083	542.0	
47186	chr8	143926768	143927069	301	150.0	
47187	chr8	143927662	143931039	3377	1688.0	
47188	chr8	143933036	143934771	1735	868.0	
47189	chr8	143935459	143955954	20495	10248.0	
47190	chr8	143956617	143957666	1049	524.0	
47191	chr8	143960540	143961165	625	312.0	
47192	chr8	143962300	143963559	1259	630.0	
47193	chr8	143966005	143967051	1046	523.0	
47194	chr8	143968630	143969275	645	322.0	
47195	chr8	143970947	143971688	741	370.0	
47196	chr8	143972796	143979252	6456	3228.0	
47197	chr8	143982354	143983347	993	496.0	
47198	chr8	143985641	143987411	1770	885.0	
47199	chr8	143989424	143991815	2391	1196.0	
47200	chr8	143993815	143997009	3194	1597.0	
47201	chr8	144003087	144004195	1108	554.0	
47202	chr8	144004926	144005544	618	309.0	
47203	chr8	144006541	144006894	353	176.0	
47204	chr8	144008302	144009633	1331	666.0	
47205	chr8	144011712	144013057	1345	672.0	
47206	chr8	144014515	144014995	480	240.0	
47207	chr8	144045746	144046204	458	229.0	
47208	chr8	144048278	144052396	4118	2059.0	
47209	chr8	144060296	144061266	970	485.0	
47210	chr8	144073929	144074909	980	490.0	
47211	chr8	144077107	144079678	2571	1286.0	
47212	chr8	144081931	144083421	1490	745.0	
47213	chr8	144093338	144093843	505	252.0	
47214	chr8	144094351	144096759	2408	1204.0	
47215	chr8	144097622	144098175	553	276.0	
47216	chr8	144100511	144100608	97	48.0	
47217	chr8	144102722	144105731	3009	1504.0	
47218	chr8	144106402	144106410	8	4.0	
47219	chr8	144107118	144107228	110	55.0	
47220	chr8	144107965	144108923	958	479.0	
47221	chr8	144109791	144109858	67	34.0	
47222	chr8	144126219	144127015	796	398.0	
47223	chr8	144184836	144185180	344	172.0	
47224	chr8	144203260	144203671	411	206.0	
47225	chr8	144209667	144210095	428	214.0	
47226	chr8	144233579	144233964	385	192.0	
47227	chr8	144147584	144148017	433	216.0	
47228	chr8	144277505	144277984	479	240.0	
47229	chr8	144290457	144293086	2629	1314.0	
47230	chr8	144310724	144310969	245	122.0	
47231	chr8	144312323	144313817	1494	747.0	
47232	chr8	144315235	144321375	6140	3070.0	
47233	chr8	144322123	144322749	626	313.0	
47234	chr8	144323635	144327749	4114	2057.0	
47235	chr8	144331609	144333446	1837	918.0	
47236	chr8	144334184	144334535	351	176.0	
47237	chr8	144335088	144335108	20	10.0	
47238	chr8	144336482	144338344	1862	931.0	
47239	chr8	144351458	144351570	112	56.0	
47240	chr8	144354396	144354611	215	108.0	
47241	chr8	144357423	144359335	1912	956.0	
47242	chr8	144372207	144375225	3018	1509.0	
47243	chr8	144396820	144397339	519	260.0	
47244	chr8	144402617	144403018	401	200.0	
47245	chr8	144408585	144410122	1537	768.0	
47246	chr8	144412512	144414402	1890	945.0	
47247	chr8	144427382	144430339	2957	1478.0	
47248	chr8	144443481	144445429	1948	974.0	
47249	chr8	144456105	144457436	1331	666.0	
47250	chr8	144461600	144468267	6667	3334.0	
47251	chr8	144472170	144475453	3283	1642.0	
47252	chr8	144477351	144479611	2260	1130.0	
47253	chr8	144500669	144501528	859	430.0	
47254	chr8	144507729	144510455	2726	1363.0	
47255	chr8	144516895	144518858	1963	982.0	
47256	chr8	144521802	144523653	1851	926.0	
47257	chr8	144526618	144527683	1065	532.0	
47258	chr8	144528272	144530254	1982	991.0	
47259	chr8	144532694	144533000	306	153.0	
47260	chr8	144575410	144575840	430	215.0	
47261	chr8	144580426	144581184	758	379.0	
47262	chr8	144583131	144583799	668	334.0	
47263	chr8	144607206	144607224	18	9.0	
47264	chr8	144675307	144676012	705	352.0	
47265	chr8	144684170	144686901	2731	1366.0	
47266	chr8	144687526	144688222	696	348.0	
47267	chr8	144729980	144730472	492	246.0	
47268	chr8	144754661	144756236	1575	788.0	
47269	chr8	144757098	144757569	471	236.0	
47270	chr8	144766985	144767738	753	376.0	
47271	chr8	144770445	144770978	533	266.0	
47272	chr8	144785487	144793542	8055	4028.0	
47273	chr8	144798219	144799590	1371	686.0	
47274	chr8	144804752	144805434	682	341.0	
47275	chr8	144825934	144829092	3158	1579.0	
47276	chr8	144852073	144854018	1945	972.0	
47277	chr8	144869609	144870174	565	282.0	
47278	chr8	144877903	144879838	1935	968.0	
47279	chr8	144899950	144903459	3509	1754.0	
47280	chr8	144950226	144951246	1020	510.0	
47281	chr8	144997507	144998227	720	360.0	
47282	chr8	145000912	145003863	2951	1476.0	
47283	chr8	145019963	145020420	457	228.0	
47284	chr8	145026735	145027085	350	175.0	
47285	chr8	145051266	145053255	1989	994.0	
47286	chr9	10995	11641	646	323.0	
47287	chr9	41403	41784	381	190.0	
47288	chr9	62973	63663	690	345.0	
47289	chr9	73196	74025	829	414.0	
47290	chr9	113394	115202	1808	904.0	
47291	chr9	117439	117829	390	195.0	
47292	chr9	178150	178529	379	190.0	
47293	chr9	208810	209776	966	483.0	
47294	chr9	211636	212752	1116	558.0	
47295	chr9	214322	215879	1557	778.0	
47296	chr9	216519	216995	476	238.0	
47297	chr9	219658	220335	677	338.0	
47298	chr9	221985	223378	1393	696.0	
47299	chr9	224558	224885	327	164.0	
47300	chr9	227820	228305	485	242.0	
47301	chr9	248902	249483	581	290.0	
47302	chr9	257678	258448	770	385.0	
47303	chr9	269031	271099	2068	1034.0	
47304	chr9	271712	274586	2874	1437.0	
47305	chr9	275606	276143	537	268.0	
47306	chr9	277179	279234	2055	1028.0	
47307	chr9	281374	282869	1495	748.0	
47308	chr9	296640	298243	1603	802.0	
47309	chr9	306687	307416	729	364.0	
47310	chr9	385827	386180	353	176.0	
47311	chr9	445740	446411	671	336.0	
47312	chr9	447236	448139	903	452.0	
47313	chr9	459587	460214	627	314.0	
47314	chr9	468725	471145	2420	1210.0	
47315	chr9	503757	505841	2084	1042.0	
47316	chr9	565803	565813	10	5.0	
47317	chr9	567334	567794	460	230.0	
47318	chr9	613591	614825	1234	617.0	
47319	chr9	621112	622018	906	453.0	
47320	chr9	642205	642209	4	2.0	
47321	chr9	650311	650791	480	240.0	
47322	chr9	656836	657618	782	391.0	
47323	chr9	677573	677964	391	196.0	
47324	chr9	685079	685084	5	2.0	
47325	chr9	694884	695227	343	172.0	
47326	chr9	706431	707528	1097	548.0	
47327	chr9	708533	709244	711	356.0	
47328	chr9	755651	756416	765	382.0	
47329	chr9	757638	757646	8	4.0	
47330	chr9	763980	764503	523	262.0	
47331	chr9	806604	806926	322	161.0	
47332	chr9	893723	894400	677	338.0	
47333	chr9	899329	900119	790	395.0	
47334	chr9	904710	905199	489	244.0	
47335	chr9	971857	972984	1127	564.0	
47336	chr9	974914	975014	100	50.0	enhancer
47337	chr9	993970	994508	538	269.0	
47338	chr9	1005008	1005466	458	229.0	
47339	chr9	1008283	1009687	1404	702.0	
47340	chr9	1012965	1013448	483	242.0	
47341	chr9	1018141	1018437	296	148.0	
47342	chr9	1042463	1042888	425	212.0	
47343	chr9	1047808	1048433	625	312.0	
47344	chr9	1050036	1050543	507	254.0	
47345	chr9	1366370	1366669	299	150.0	
47346	chr9	1994249	1994529	280	140.0	
47347	chr9	2000317	2000685	368	184.0	
47348	chr9	2013706	2019681	5975	2988.0	
47349	chr9	2021907	2027931	6024	3012.0	
47350	chr9	2040065	2040086	21	10.0	
47351	chr9	2041813	2042279	466	233.0	
47352	chr9	2043825	2044715	890	445.0	
47353	chr9	2047657	2047996	339	170.0	
47354	chr9	2053573	2054632	1059	530.0	
47355	chr9	2066871	2067267	396	198.0	
47356	chr9	2087606	2088158	552	276.0	
47357	chr9	2116224	2116467	243	122.0	
47358	chr9	2125623	2126308	685	342.0	
47359	chr9	2146670	2146946	276	138.0	
47360	chr9	2156667	2156769	102	51.0	
47361	chr9	2157452	2158752	1300	650.0	
47362	chr9	2159669	2160265	596	298.0	
47363	chr9	2208940	2209912	972	486.0	
47364	chr9	2228167	2229695	1528	764.0	
47365	chr9	2241515	2242939	1424	712.0	enhancer
47366	chr9	2263561	2264010	449	224.0	
47367	chr9	2270523	2271935	1412	706.0	
47368	chr9	2570558	2571166	608	304.0	
47369	chr9	2621124	2623409	2285	1142.0	
47370	chr9	2655321	2656078	757	378.0	
47371	chr9	2657319	2657872	553	276.0	
47372	chr9	2728007	2728364	357	178.0	
47373	chr9	2764312	2764863	551	276.0	
47374	chr9	2843034	2844995	1961	980.0	
47375	chr9	2850028	2850237	209	104.0	
47376	chr9	2857474	2858045	571	286.0	
47377	chr9	2859800	2860201	401	200.0	
47378	chr9	2872584	2873301	717	358.0	
47379	chr9	3125761	3126503	742	371.0	
47380	chr9	3240619	3241299	680	340.0	
47381	chr9	3243935	3244061	126	63.0	
47382	chr9	3245242	3245620	378	189.0	
47383	chr9	3299858	3300317	459	230.0	
47384	chr9	3361111	3361559	448	224.0	
47385	chr9	3385857	3386288	431	216.0	
47386	chr9	3397716	3398877	1161	580.0	
47387	chr9	3434453	3435089	636	318.0	
47388	chr9	3441141	3441638	497	248.0	
47389	chr9	3467537	3468090	553	276.0	
47390	chr9	3473366	3473759	393	196.0	
47391	chr9	3475286	3475975	689	344.0	
47392	chr9	3477150	3477833	683	342.0	
47393	chr9	3478406	3479116	710	355.0	
47394	chr9	3507463	3508996	1533	766.0	
47395	chr9	3513454	3513822	368	184.0	
47396	chr9	3516929	3516934	5	2.0	
47397	chr9	3522219	3522304	85	42.0	
47398	chr9	3524273	3529230	4957	2478.0	
47399	chr9	3530272	3530623	351	176.0	
47400	chr9	3576060	3576925	865	432.0	
47401	chr9	3732542	3733062	520	260.0	
47402	chr9	3900655	3901127	472	236.0	
47403	chr9	4086068	4086891	823	412.0	
47404	chr9	4117748	4118132	384	192.0	
47405	chr9	4293144	4293870	726	363.0	
47406	chr9	4296947	4300425	3478	1739.0	
47407	chr9	4315559	4316042	483	242.0	
47408	chr9	4339088	4339959	871	436.0	
47409	chr9	4344973	4345428	455	228.0	
47410	chr9	4366717	4367064	347	174.0	
47411	chr9	4375386	4375727	341	170.0	
47412	chr9	4382703	4383076	373	186.0	
47413	chr9	4489952	4490796	844	422.0	
47414	chr9	4518204	4518605	401	200.0	
47415	chr9	4530376	4530820	444	222.0	
47416	chr9	4572397	4572810	413	206.0	
47417	chr9	4596316	4597071	755	378.0	
47418	chr9	4600321	4600828	507	254.0	
47419	chr9	4604508	4605187	679	340.0	
47420	chr9	4606021	4606024	3	2.0	
47421	chr9	4620082	4620462	380	190.0	
47422	chr9	4640022	4640431	409	204.0	
47423	chr9	4653715	4654619	904	452.0	
47424	chr9	4661483	4664387	2904	1452.0	
47425	chr9	4665409	4666900	1491	746.0	
47426	chr9	4667603	4668043	440	220.0	
47427	chr9	4678595	4681190	2595	1298.0	
47428	chr9	4739631	4742699	3068	1534.0	
47429	chr9	4749989	4750497	508	254.0	
47430	chr9	4759109	4760619	1510	755.0	
47431	chr9	4762024	4763704	1680	840.0	
47432	chr9	4791722	4794399	2677	1338.0	
47433	chr9	4797301	4799015	1714	857.0	
47434	chr9	4901507	4902105	598	299.0	
47435	chr9	4924118	4924655	537	268.0	
47436	chr9	4936073	4937783	1710	855.0	
47437	chr9	4938699	4939698	999	500.0	
47438	chr9	4942304	4942630	326	163.0	
47439	chr9	4944370	4944695	325	162.0	
47440	chr9	4971019	4971872	853	426.0	
47441	chr9	4980051	4980725	674	337.0	
47442	chr9	4982668	4983385	717	358.0	
47443	chr9	4984090	4986764	2674	1337.0	
47444	chr9	4987681	4988741	1060	530.0	
47445	chr9	5178381	5178844	463	232.0	
47446	chr9	5186341	5186877	536	268.0	
47447	chr9	5263846	5263911	65	32.0	
47448	chr9	5301544	5301917	373	186.0	
47449	chr9	5304146	5304917	771	386.0	
47450	chr9	5326897	5327741	844	422.0	
47451	chr9	5336640	5337148	508	254.0	
47452	chr9	5339303	5340117	814	407.0	
47453	chr9	5352593	5353182	589	294.0	
47454	chr9	5424988	5425490	502	251.0	
47455	chr9	5437018	5439290	2272	1136.0	
47456	chr9	5442343	5442853	510	255.0	
47457	chr9	5445885	5446308	423	212.0	
47458	chr9	5449517	5452646	3129	1564.0	
47459	chr9	5459215	5459778	563	282.0	
47460	chr9	5464860	5465336	476	238.0	
47461	chr9	5478232	5478539	307	154.0	
47462	chr9	5490033	5490472	439	220.0	
47463	chr9	5493340	5494643	1303	652.0	
47464	chr9	5509667	5511034	1367	684.0	
47465	chr9	5512993	5513090	97	48.0	
47466	chr9	5518297	5518959	662	331.0	
47467	chr9	5530024	5530040	16	8.0	
47468	chr9	5531415	5531887	472	236.0	
47469	chr9	5536424	5537156	732	366.0	
47470	chr9	5556289	5556695	406	203.0	
47471	chr9	5557894	5558807	913	456.0	
47472	chr9	5560395	5560973	578	289.0	
47473	chr9	5563015	5563365	350	175.0	
47474	chr9	5566122	5566576	454	227.0	
47475	chr9	5569091	5569948	857	428.0	
47476	chr9	5582825	5583629	804	402.0	
47477	chr9	5586320	5587174	854	427.0	
47478	chr9	5589841	5590486	645	322.0	
47479	chr9	5593733	5594345	612	306.0	
47480	chr9	5600251	5600959	708	354.0	
47481	chr9	5608526	5609367	841	420.0	
47482	chr9	5617520	5618302	782	391.0	
47483	chr9	5625741	5630656	4915	2458.0	
47484	chr9	5631356	5631486	130	65.0	
47485	chr9	5633541	5633571	30	15.0	
47486	chr9	5650572	5650883	311	156.0	
47487	chr9	5671916	5672373	457	228.0	
47488	chr9	5799349	5799580	231	116.0	
47489	chr9	5831986	5833612	1626	813.0	
47490	chr9	5834160	5834615	455	228.0	
47491	chr9	5841205	5845309	4104	2052.0	
47492	chr9	5851298	5851942	644	322.0	
47493	chr9	5886039	5886718	679	340.0	
47494	chr9	5922259	5922307	48	24.0	
47495	chr9	5947913	5948165	252	126.0	
47496	chr9	5949042	5949535	493	246.0	
47497	chr9	5976767	5977363	596	298.0	
47498	chr9	6006640	6009195	2555	1278.0	
47499	chr9	6014675	6016311	1636	818.0	
47500	chr9	6023899	6024596	697	348.0	
47501	chr9	6049839	6050223	384	192.0	
47502	chr9	6054282	6055727	1445	722.0	
47503	chr9	6068588	6069731	1143	572.0	
47504	chr9	6079919	6080989	1070	535.0	
47505	chr9	6107026	6107298	272	136.0	
47506	chr9	6354037	6354532	495	248.0	
47507	chr9	6412256	6415703	3447	1724.0	
47508	chr9	6417044	6417904	860	430.0	
47509	chr9	6428773	6429910	1137	568.0	
47510	chr9	6432403	6432804	401	200.0	
47511	chr9	6439182	6439719	537	268.0	
47512	chr9	6444104	6444622	518	259.0	
47513	chr9	6449190	6449370	180	90.0	
47514	chr9	6449928	6449929	1	0.0	
47515	chr9	6564435	6564573	138	69.0	
47516	chr9	6568167	6568496	329	164.0	
47517	chr9	6575289	6575595	306	153.0	
47518	chr9	6581292	6581570	278	139.0	
47519	chr9	6583651	6584239	588	294.0	
47520	chr9	6585119	6585491	372	186.0	
47521	chr9	6590326	6590752	426	213.0	
47522	chr9	6605253	6605582	329	164.0	
47523	chr9	6631084	6631281	197	98.0	
47524	chr9	6632620	6632911	291	146.0	
47525	chr9	6644952	6646590	1638	819.0	
47526	chr9	6655140	6655304	164	82.0	
47527	chr9	6667658	6668023	365	182.0	
47528	chr9	6680401	6683735	3334	1667.0	
47529	chr9	6689985	6690631	646	323.0	
47530	chr9	6703380	6705051	1671	836.0	
47531	chr9	6714266	6714498	232	116.0	
47532	chr9	6715586	6716903	1317	658.0	
47533	chr9	6750179	6751350	1171	586.0	
47534	chr9	6756540	6759881	3341	1670.0	
47535	chr9	6761017	6761053	36	18.0	
47536	chr9	6782994	6783259	265	132.0	
47537	chr9	6785711	6785743	32	16.0	
47538	chr9	6827318	6827739	421	210.0	
47539	chr9	6874020	6874150	130	65.0	
47540	chr9	6889625	6890365	740	370.0	
47541	chr9	6902509	6902782	273	136.0	
47542	chr9	7011716	7012105	389	194.0	
47543	chr9	7052554	7053065	511	256.0	
47544	chr9	7081140	7081620	480	240.0	
47545	chr9	7105072	7105555	483	242.0	
47546	chr9	7121075	7121532	457	228.0	
47547	chr9	7150025	7150896	871	436.0	
47548	chr9	7216192	7216731	539	270.0	
47549	chr9	7298120	7298570	450	225.0	
47550	chr9	7536386	7536501	115	58.0	
47551	chr9	7570081	7570528	447	224.0	
47552	chr9	7613944	7614261	317	158.0	
47553	chr9	7626381	7627345	964	482.0	
47554	chr9	7783723	7783892	169	84.0	
47555	chr9	7798768	7800287	1519	760.0	
47556	chr9	7844289	7844690	401	200.0	
47557	chr9	7879528	7880250	722	361.0	
47558	chr9	7935283	7936630	1347	674.0	
47559	chr9	7967050	7967876	826	413.0	
47560	chr9	7974472	7975131	659	330.0	
47561	chr9	7976005	7977953	1948	974.0	
47562	chr9	7982929	7983302	373	186.0	
47563	chr9	8261782	8262089	307	154.0	
47564	chr9	8649091	8649640	549	274.0	
47565	chr9	8653853	8654099	246	123.0	
47566	chr9	8660389	8660862	473	236.0	
47567	chr9	9942827	9943176	349	174.0	
47568	chr9	9998984	9999282	298	149.0	
47569	chr9	14313166	14316117	2951	1476.0	
47570	chr9	14322045	14323257	1212	606.0	
47571	chr9	14353445	14353853	408	204.0	
47572	chr9	14585774	14586106	332	166.0	
47573	chr9	14616402	14616716	314	157.0	
47574	chr9	14688133	14688600	467	234.0	
47575	chr9	14692661	14693955	1294	647.0	
47576	chr9	14768708	14768730	22	11.0	
47577	chr9	14847003	14847073	70	35.0	
47578	chr9	14991990	14994425	2435	1218.0	
47579	chr9	15104857	15105196	339	170.0	
47580	chr9	15121755	15121864	109	54.0	
47581	chr9	15135095	15135592	497	248.0	
47582	chr9	15142895	15143308	413	206.0	
47583	chr9	15211398	15211916	518	259.0	
47584	chr9	15271439	15271767	328	164.0	
47585	chr9	15277795	15278187	392	196.0	
47586	chr9	15293643	15297367	3724	1862.0	
47587	chr9	15298806	15300617	1811	906.0	
47588	chr9	15304559	15308524	3965	1982.0	
47589	chr9	15310238	15310927	689	344.0	
47590	chr9	15354763	15355211	448	224.0	
47591	chr9	15357029	15357375	346	173.0	
47592	chr9	15374433	15374529	96	48.0	
47593	chr9	15403171	15403504	333	166.0	
47594	chr9	15416855	15417296	441	220.0	
47595	chr9	15421972	15423985	2013	1006.0	
47596	chr9	15426132	15426349	217	108.0	
47597	chr9	15427685	15428107	422	211.0	
47598	chr9	15430866	15431357	491	246.0	
47599	chr9	15433221	15433569	348	174.0	
47600	chr9	15485961	15486188	227	114.0	
47601	chr9	15505894	15506332	438	219.0	
47602	chr9	15509881	15511798	1917	958.0	
47603	chr9	15533090	15533647	557	278.0	
47604	chr9	15543043	15543432	389	194.0	
47605	chr9	15551974	15554336	2362	1181.0	
47606	chr9	15606643	15607076	433	216.0	
47607	chr9	16133873	16134057	184	92.0	
47608	chr9	16179660	16179885	225	112.0	
47609	chr9	16289551	16290094	543	272.0	
47610	chr9	16321930	16322033	103	52.0	
47611	chr9	16335816	16336271	455	228.0	
47612	chr9	16345916	16346337	421	210.0	
47613	chr9	16401686	16402180	494	247.0	
47614	chr9	16413338	16414039	701	350.0	
47615	chr9	16870210	16872116	1906	953.0	
47616	chr9	16884612	16885434	822	411.0	
47617	chr9	17130322	17130762	440	220.0	
47618	chr9	17134626	17135828	1202	601.0	
47619	chr9	18255079	18255481	402	201.0	
47620	chr9	18442899	18442982	83	42.0	
47621	chr9	18947895	18948492	597	298.0	
47622	chr9	19028870	19029232	362	181.0	
47623	chr9	19048503	19050981	2478	1239.0	
47624	chr9	19085269	19085715	446	223.0	
47625	chr9	19102056	19103816	1760	880.0	
47626	chr9	19118919	19119657	738	369.0	
47627	chr9	19123852	19124554	702	351.0	
47628	chr9	19125714	19129209	3495	1748.0	
47629	chr9	19129881	19130464	583	292.0	
47630	chr9	19142461	19142912	451	226.0	
47631	chr9	19153952	19154750	798	399.0	
47632	chr9	19156223	19156256	33	16.0	
47633	chr9	19161293	19163984	2691	1346.0	
47634	chr9	19166525	19166867	342	171.0	
47635	chr9	19168472	19168978	506	253.0	
47636	chr9	19174047	19174687	640	320.0	
47637	chr9	19182568	19182908	340	170.0	
47638	chr9	19183721	19184950	1229	614.0	
47639	chr9	19186307	19186536	229	114.0	
47640	chr9	19228476	19228497	21	10.0	
47641	chr9	19229515	19232908	3393	1696.0	
47642	chr9	19372697	19372935	238	119.0	
47643	chr9	19374543	19375579	1036	518.0	
47644	chr9	19377092	19381028	3936	1968.0	
47645	chr9	19407714	19410165	2451	1226.0	
47646	chr9	19441377	19442189	812	406.0	
47647	chr9	19451429	19452023	594	297.0	
47648	chr9	19457166	19458028	862	431.0	
47649	chr9	19464399	19465524	1125	562.0	
47650	chr9	19471720	19472355	635	318.0	
47651	chr9	19493055	19493704	649	324.0	
47652	chr9	19748544	19749032	488	244.0	
47653	chr9	19925708	19926616	908	454.0	
47654	chr9	19934665	19934696	31	16.0	
47655	chr9	20041804	20042304	500	250.0	
47656	chr9	20042833	20043691	858	429.0	
47657	chr9	20209380	20210398	1018	509.0	
47658	chr9	20242546	20243326	780	390.0	
47659	chr9	20314860	20315575	715	358.0	
47660	chr9	20319897	20320298	401	200.0	
47661	chr9	20321490	20322312	822	411.0	
47662	chr9	20356291	20356747	456	228.0	
47663	chr9	20505003	20505379	376	188.0	
47664	chr9	20508213	20508661	448	224.0	
47665	chr9	20514683	20515001	318	159.0	
47666	chr9	20604559	20604960	401	200.0	
47667	chr9	20611706	20612063	357	178.0	
47668	chr9	20619732	20625229	5497	2748.0	
47669	chr9	20640249	20641126	877	438.0	
47670	chr9	20658170	20658993	823	412.0	
47671	chr9	20683245	20685589	2344	1172.0	
47672	chr9	20884984	20885393	409	204.0	
47673	chr9	20940809	20941521	712	356.0	
47674	chr9	20973344	20973757	413	206.0	
47675	chr9	20980694	20981383	689	344.0	
47676	chr9	20984590	20984889	299	150.0	
47677	chr9	20989855	20991336	1481	740.0	
47678	chr9	20997690	20997838	148	74.0	
47679	chr9	21001463	21002466	1003	502.0	
47680	chr9	21023761	21024481	720	360.0	
47681	chr9	21028458	21028930	472	236.0	
47682	chr9	21030126	21032127	2001	1000.0	
47683	chr9	21047494	21047781	287	144.0	
47684	chr9	21054058	21054181	123	62.0	
47685	chr9	21061149	21061325	176	88.0	
47686	chr9	21077843	21077931	88	44.0	
47687	chr9	21078743	21079141	398	199.0	
47688	chr9	21082116	21082260	144	72.0	
47689	chr9	21095887	21097161	1274	637.0	
47690	chr9	21097798	21098250	452	226.0	
47691	chr9	21104671	21105335	664	332.0	
47692	chr9	21110710	21111392	682	341.0	
47693	chr9	21118809	21119745	936	468.0	
47694	chr9	21144639	21144982	343	172.0	
47695	chr9	21153275	21154415	1140	570.0	
47696	chr9	21160120	21160599	479	240.0	
47697	chr9	21182996	21183718	722	361.0	
47698	chr9	21195062	21195822	760	380.0	
47699	chr9	21213591	21214084	493	246.0	
47700	chr9	21235645	21236353	708	354.0	
47701	chr9	21239823	21240313	490	245.0	
47702	chr9	21244816	21245195	379	190.0	
47703	chr9	21252953	21253710	757	378.0	
47704	chr9	21255791	21255946	155	78.0	
47705	chr9	21267844	21268182	338	169.0	
47706	chr9	21286557	21287359	802	401.0	
47707	chr9	21295235	21295591	356	178.0	
47708	chr9	21318256	21318718	462	231.0	
47709	chr9	21326497	21327184	687	344.0	
47710	chr9	21334455	21335914	1459	730.0	
47711	chr9	21336632	21336635	3	2.0	
47712	chr9	21357417	21358406	989	494.0	
47713	chr9	21381437	21382329	892	446.0	
47714	chr9	21384941	21385697	756	378.0	
47715	chr9	21392229	21392695	466	233.0	
47716	chr9	21395845	21396595	750	375.0	
47717	chr9	21402471	21403192	721	360.0	
47718	chr9	21412173	21412603	430	215.0	
47719	chr9	21413718	21414039	321	160.0	
47720	chr9	21432726	21432948	222	111.0	
47721	chr9	21434408	21434837	429	214.0	
47722	chr9	21443872	21445075	1203	602.0	
47723	chr9	21455253	21455896	643	322.0	
47724	chr9	21465860	21466362	502	251.0	
47725	chr9	21481401	21482135	734	367.0	
47726	chr9	21506001	21506212	211	106.0	
47727	chr9	21527687	21527918	231	116.0	
47728	chr9	21558829	21560444	1615	808.0	
47729	chr9	21576389	21577104	715	358.0	
47730	chr9	21578617	21579681	1064	532.0	
47731	chr9	21591503	21592069	566	283.0	
47732	chr9	21611839	21612179	340	170.0	
47733	chr9	21709399	21709898	499	250.0	
47734	chr9	21744814	21745377	563	282.0	
47735	chr9	21778375	21778732	357	178.0	
47736	chr9	21789370	21790151	781	390.0	
47737	chr9	21801889	21803817	1928	964.0	
47738	chr9	21812717	21814351	1634	817.0	
47739	chr9	21817049	21817634	585	292.0	
47740	chr9	21831879	21834034	2155	1078.0	
47741	chr9	21883798	21884003	205	102.0	
47742	chr9	21919427	21920335	908	454.0	
47743	chr9	21964665	21966253	1588	794.0	
47744	chr9	21968401	21968763	362	181.0	
47745	chr9	21969483	21969560	77	38.0	
47746	chr9	21971280	21971461	181	90.0	
47747	chr9	21974314	21976179	1865	932.0	
47748	chr9	21983156	21983910	754	377.0	
47749	chr9	21986775	21987236	461	230.0	
47750	chr9	21993390	21996391	3001	1500.0	
47751	chr9	22004969	22006269	1300	650.0	
47752	chr9	22008339	22009876	1537	768.0	
47753	chr9	22029958	22030718	760	380.0	
47754	chr9	22037812	22038461	649	324.0	
47755	chr9	22050896	22051375	479	240.0	
47756	chr9	22079800	22080390	590	295.0	
47757	chr9	22119554	22119955	401	200.0	
47758	chr9	22144009	22144135	126	63.0	
47759	chr9	22158825	22159965	1140	570.0	
47760	chr9	22169241	22170212	971	486.0	
47761	chr9	22171004	22171383	379	190.0	
47762	chr9	22196978	22197431	453	226.0	
47763	chr9	22209126	22209539	413	206.0	
47764	chr9	22238985	22239386	401	200.0	
47765	chr9	22240679	22241020	341	170.0	
47766	chr9	22241616	22242023	407	204.0	
47767	chr9	22244663	22245093	430	215.0	
47768	chr9	22447116	22447685	569	284.0	
47769	chr9	22452409	22452817	408	204.0	
47770	chr9	23932457	23932828	371	186.0	
47771	chr9	25677397	25678744	1347	674.0	
47772	chr9	26828383	26828972	589	294.0	
47773	chr9	26891581	26893532	1951	976.0	
47774	chr9	26946447	26948152	1705	852.0	
47775	chr9	26954045	26957092	3047	1524.0	
47776	chr9	26975625	26976078	453	226.0	
47777	chr9	27033791	27034208	417	208.0	
47778	chr9	27184511	27184912	401	200.0	
47779	chr9	27194692	27195039	347	174.0	
47780	chr9	27227216	27227646	430	215.0	
47781	chr9	27276454	27276762	308	154.0	
47782	chr9	27333098	27333764	666	333.0	
47783	chr9	27334935	27335602	667	334.0	
47784	chr9	27338037	27338533	496	248.0	
47785	chr9	27341203	27341971	768	384.0	
47786	chr9	27347843	27348300	457	228.0	
47787	chr9	27352221	27353155	934	467.0	
47788	chr9	27353839	27354157	318	159.0	
47789	chr9	27356461	27356905	444	222.0	
47790	chr9	27367177	27367561	384	192.0	
47791	chr9	27369477	27370127	650	325.0	
47792	chr9	27377498	27378504	1006	503.0	
47793	chr9	27379466	27379567	101	50.0	
47794	chr9	27437988	27438072	84	42.0	
47795	chr9	27460456	27461201	745	372.0	
47796	chr9	27479953	27480429	476	238.0	
47797	chr9	27483886	27483940	54	27.0	
47798	chr9	27485177	27485544	367	184.0	
47799	chr9	27491148	27491565	417	208.0	
47800	chr9	27499543	27499775	232	116.0	
47801	chr9	27501753	27501890	137	68.0	
47802	chr9	27528006	27530293	2287	1144.0	
47803	chr9	27539673	27540203	530	265.0	
47804	chr9	27548189	27548313	124	62.0	
47805	chr9	27563992	27565127	1135	568.0	
47806	chr9	27570961	27574861	3900	1950.0	"repeat_region	sequence_feature"
47807	chr9	27581844	27582287	443	222.0	
47808	chr9	27586233	27586922	689	344.0	
47809	chr9	27588172	27588928	756	378.0	
47810	chr9	27590669	27591646	977	488.0	
47811	chr9	27598974	27599628	654	327.0	
47812	chr9	27600154	27600777	623	312.0	
47813	chr9	27601403	27602532	1129	564.0	
47814	chr9	27622702	27623119	417	208.0	
47815	chr9	27633743	27634159	416	208.0	
47816	chr9	27634800	27635455	655	328.0	
47817	chr9	27655438	27655685	247	124.0	
47818	chr9	27700992	27702171	1179	590.0	
47819	chr9	27703288	27703370	82	41.0	
47820	chr9	27719989	27720036	47	24.0	
47821	chr9	27726156	27726547	391	196.0	
47822	chr9	29212045	29212584	539	270.0	
47823	chr9	29322461	29322557	96	48.0	
47824	chr9	29865918	29866284	366	183.0	
47825	chr9	30075604	30075670	66	33.0	
47826	chr9	30301259	30301977	718	359.0	
47827	chr9	31119856	31120322	466	233.0	
47828	chr9	31211015	31211437	422	211.0	
47829	chr9	31259811	31260358	547	274.0	
47830	chr9	31323741	31324505	764	382.0	
47831	chr9	31335580	31336200	620	310.0	
47832	chr9	31346973	31347743	770	385.0	
47833	chr9	31445977	31446392	415	208.0	
47834	chr9	31542366	31542751	385	192.0	
47835	chr9	32256380	32256781	401	200.0	
47836	chr9	32344501	32344826	325	162.0	
47837	chr9	32378436	32379905	1469	734.0	
47838	chr9	32383713	32385352	1639	820.0	
47839	chr9	32431934	32432342	408	204.0	
47840	chr9	32523194	32523249	55	28.0	
47841	chr9	32523963	32527032	3069	1534.0	
47842	chr9	32529510	32529993	483	242.0	
47843	chr9	32549992	32553443	3451	1726.0	
47844	chr9	32556581	32557138	557	278.0	
47845	chr9	32558596	32558874	278	139.0	
47846	chr9	32571934	32573811	1877	938.0	
47847	chr9	32579615	32580153	538	269.0	
47848	chr9	32581486	32581934	448	224.0	
47849	chr9	32906436	32906531	95	48.0	
47850	chr9	32968423	32968758	335	168.0	
47851	chr9	32993099	32993149	50	25.0	
47852	chr9	33000608	33002437	1829	914.0	
47853	chr9	33022669	33023134	465	232.0	
47854	chr9	33023910	33048509	24599	12300.0	
47855	chr9	33049711	33049947	236	118.0	
47856	chr9	33050520	33051890	1370	685.0	
47857	chr9	33052527	33052737	210	105.0	
47858	chr9	33065007	33065917	910	455.0	
47859	chr9	33074712	33077503	2791	1396.0	
47860	chr9	33081000	33083199	2199	1100.0	
47861	chr9	33106898	33107848	950	475.0	
47862	chr9	33109658	33110137	479	240.0	
47863	chr9	33110758	33110784	26	13.0	
47864	chr9	33111663	33112261	598	299.0	
47865	chr9	33114060	33114090	30	15.0	
47866	chr9	33116742	33118250	1508	754.0	
47867	chr9	33123691	33123909	218	109.0	
47868	chr9	33124683	33126612	1929	964.0	
47869	chr9	33129657	33131339	1682	841.0	
47870	chr9	33135031	33140140	5109	2554.0	
47871	chr9	33140698	33144171	3473	1736.0	
47872	chr9	33145468	33145839	371	186.0	
47873	chr9	33148407	33148988	581	290.0	
47874	chr9	33150901	33151628	727	364.0	
47875	chr9	33153537	33157363	3826	1913.0	
47876	chr9	33158013	33169485	11472	5736.0	
47877	chr9	33170591	33171307	716	358.0	
47878	chr9	33179292	33179677	385	192.0	
47879	chr9	33202190	33203152	962	481.0	
47880	chr9	33221089	33221778	689	344.0	
47881	chr9	33225406	33227562	2156	1078.0	
47882	chr9	33244321	33244436	115	58.0	
47883	chr9	33249029	33249411	382	191.0	
47884	chr9	33262822	33265998	3176	1588.0	
47885	chr9	33286748	33287624	876	438.0	
47886	chr9	33288263	33291550	3287	1644.0	
47887	chr9	33297305	33297985	680	340.0	
47888	chr9	33339780	33340095	315	158.0	
47889	chr9	33374677	33375600	923	462.0	
47890	chr9	33403240	33403802	562	281.0	
47891	chr9	33414496	33416285	1789	894.0	
47892	chr9	33417008	33417473	465	232.0	
47893	chr9	33426554	33427444	890	445.0	
47894	chr9	33445416	33448425	3009	1504.0	
47895	chr9	33452589	33453552	963	482.0	
47896	chr9	33454402	33454568	166	83.0	
47897	chr9	33455953	33456354	401	200.0	
47898	chr9	33458253	33459475	1222	611.0	
47899	chr9	33466381	33467082	701	350.0	
47900	chr9	33472937	33474725	1788	894.0	
47901	chr9	33510681	33511407	726	363.0	
47902	chr9	33517443	33517576	133	66.0	
47903	chr9	33523322	33524736	1414	707.0	
47904	chr9	33617470	33617964	494	247.0	
47905	chr9	33623855	33624428	573	286.0	
47906	chr9	33659887	33660328	441	220.0	
47907	chr9	33676554	33677609	1055	528.0	
47908	chr9	33687769	33688177	408	204.0	
47909	chr9	33690457	33690955	498	249.0	
47910	chr9	33714957	33715473	516	258.0	
47911	chr9	33718751	33720502	1751	876.0	
47912	chr9	33721818	33722587	769	384.0	
47913	chr9	33738043	33738438	395	198.0	
47914	chr9	33748641	33749703	1062	531.0	
47915	chr9	33751966	33752362	396	198.0	
47916	chr9	33759534	33760120	586	293.0	
47917	chr9	33778680	33779190	510	255.0	
47918	chr9	33813470	33819379	5909	2954.0	
47919	chr9	33829524	33830109	585	292.0	
47920	chr9	33835920	33836840	920	460.0	
47921	chr9	33843143	33843976	833	416.0	
47922	chr9	33852131	33852670	539	270.0	
47923	chr9	33921983	33922377	394	197.0	
47924	chr9	33923973	33924011	38	19.0	
47925	chr9	33925120	33925521	401	200.0	
47926	chr9	33952110	33952229	119	60.0	
47927	chr9	34046660	34050060	3400	1700.0	
47928	chr9	34074171	34074637	466	233.0	
47929	chr9	34123570	34127427	3857	1928.0	
47930	chr9	34163391	34163857	466	233.0	
47931	chr9	34171534	34172292	758	379.0	
47932	chr9	34178219	34181413	3194	1597.0	
47933	chr9	34185619	34186727	1108	554.0	
47934	chr9	34188741	34189427	686	343.0	
47935	chr9	34190846	34190857	11	6.0	
47936	chr9	34191566	34191592	26	13.0	
47937	chr9	34193102	34194262	1160	580.0	
47938	chr9	34197697	34198759	1062	531.0	
47939	chr9	34252638	34253504	866	433.0	
47940	chr9	34257223	34257420	197	98.0	
47941	chr9	34290942	34291469	527	264.0	
47942	chr9	34328511	34330574	2063	1032.0	
47943	chr9	34332379	34332693	314	157.0	
47944	chr9	34364214	34364264	50	25.0	
47945	chr9	34370849	34371369	520	260.0	
47946	chr9	34375137	34377807	2670	1335.0	
47947	chr9	34379031	34381789	2758	1379.0	
47948	chr9	34403760	34404212	452	226.0	
47949	chr9	34437244	34437958	714	357.0	
47950	chr9	34457523	34460293	2770	1385.0	
47951	chr9	34494017	34494365	348	174.0	
47952	chr9	34500553	34501101	548	274.0	
47953	chr9	34519684	34519753	69	34.0	
47954	chr9	34520807	34520924	117	58.0	
47955	chr9	34522109	34524020	1911	956.0	
47956	chr9	34546870	34547232	362	181.0	
47957	chr9	34547997	34548370	373	186.0	
47958	chr9	34572045	34572339	294	147.0	
47959	chr9	34589561	34593374	3813	1906.0	
47960	chr9	34603438	34604274	836	418.0	
47961	chr9	34610534	34610543	9	4.0	
47962	chr9	34611193	34613619	2426	1213.0	
47963	chr9	34619837	34621203	1366	683.0	
47964	chr9	34622159	34622273	114	57.0	
47965	chr9	34623289	34624863	1574	787.0	
47966	chr9	34626046	34626104	58	29.0	
47967	chr9	34628286	34629675	1389	694.0	
47968	chr9	34633648	34634525	877	438.0	
47969	chr9	34636773	34638663	1890	945.0	
47970	chr9	34641461	34641980	519	260.0	
47971	chr9	34645979	34648106	2127	1064.0	
47972	chr9	34651938	34652527	589	294.0	
47973	chr9	34662958	34668587	5629	2814.0	
47974	chr9	34674961	34675522	561	280.0	
47975	chr9	34681717	34681834	117	58.0	
47976	chr9	34691054	34692037	983	492.0	
47977	chr9	34701029	34702734	1705	852.0	
47978	chr9	34760467	34760803	336	168.0	
47979	chr9	34777640	34778049	409	204.0	
47980	chr9	34899478	34900043	565	282.0	
47981	chr9	34957636	34958672	1036	518.0	
47982	chr9	34982237	34984434	2197	1098.0	
47983	chr9	34985127	34990796	5669	2834.0	
47984	chr9	34991759	34992847	1088	544.0	
47985	chr9	34994403	34994786	383	192.0	
47986	chr9	35036115	35036791	676	338.0	
47987	chr9	35040020	35040039	19	10.0	
47988	chr9	35043087	35043146	59	30.0	
47989	chr9	35051179	35051826	647	324.0	
47990	chr9	35053876	35055342	1466	733.0	
47991	chr9	35056359	35057327	968	484.0	
47992	chr9	35061665	35061705	40	20.0	
47993	chr9	35069938	35073558	3620	1810.0	
47994	chr9	35078980	35080736	1756	878.0	
47995	chr9	35095302	35097246	1944	972.0	
47996	chr9	35102390	35104040	1650	825.0	
47997	chr9	35110586	35112861	2275	1138.0	
47998	chr9	35113824	35117480	3656	1828.0	
47999	chr9	35161414	35162961	1547	774.0	
48000	chr9	35258460	35259237	777	388.0	
48001	chr9	35276527	35276871	344	172.0	
48002	chr9	35406580	35406878	298	149.0	
48003	chr9	35407844	35408225	381	190.0	
48004	chr9	35477172	35477676	504	252.0	
48005	chr9	35481352	35481771	419	210.0	
48006	chr9	35489069	35490793	1724	862.0	
48007	chr9	35492214	35492313	99	50.0	
48008	chr9	35526342	35526737	395	198.0	
48009	chr9	35531281	35532037	756	378.0	
48010	chr9	35534939	35535410	471	236.0	
48011	chr9	35538331	35539246	915	458.0	
48012	chr9	35553524	35554391	867	434.0	
48013	chr9	35569223	35571097	1874	937.0	
48014	chr9	35600033	35600201	168	84.0	
48015	chr9	35603370	35606450	3080	1540.0	
48016	chr9	35611007	35611844	837	418.0	
48017	chr9	35615657	35620455	4798	2399.0	
48018	chr9	35621905	35622242	337	168.0	
48019	chr9	35634513	35635023	510	255.0	
48020	chr9	35635977	35636668	691	346.0	
48021	chr9	35638261	35639836	1575	788.0	
48022	chr9	35641414	35641845	431	216.0	
48023	chr9	35644472	35645138	666	333.0	
48024	chr9	35645742	35651478	5736	2868.0	
48025	chr9	35652553	35652688	135	68.0	
48026	chr9	35656037	35659758	3721	1860.0	
48027	chr9	35661131	35661138	7	4.0	
48028	chr9	35661677	35662778	1101	550.0	
48029	chr9	35663316	35665735	2419	1210.0	
48030	chr9	35675406	35676317	911	456.0	
48031	chr9	35689439	35691728	2289	1144.0	
48032	chr9	35696123	35697332	1209	604.0	
48033	chr9	35718961	35719639	678	339.0	
48034	chr9	35726776	35733709	6933	3466.0	
48035	chr9	35735839	35736879	1040	520.0	
48036	chr9	35738498	35738620	122	61.0	
48037	chr9	35741720	35742088	368	184.0	
48038	chr9	35743437	35744028	591	296.0	
48039	chr9	35747385	35750489	3104	1552.0	
48040	chr9	35756130	35757949	1819	910.0	
48041	chr9	35775169	35775702	533	266.0	
48042	chr9	35790191	35790894	703	352.0	
48043	chr9	35791543	35791925	382	191.0	
48044	chr9	35811214	35812747	1533	766.0	
48045	chr9	35814198	35816191	1993	996.0	
48046	chr9	35825750	35826828	1078	539.0	
48047	chr9	35828385	35830049	1664	832.0	
48048	chr9	35833389	35834263	874	437.0	
48049	chr9	35835348	35835640	292	146.0	
48050	chr9	35839927	35840351	424	212.0	
48051	chr9	35842023	35843154	1131	566.0	
48052	chr9	35844129	35846425	2296	1148.0	
48053	chr9	35848188	35848517	329	164.0	
48054	chr9	35857826	35857974	148	74.0	
48055	chr9	35859251	35859727	476	238.0	
48056	chr9	35882201	35882674	473	236.0	
48057	chr9	35891692	35892044	352	176.0	
48058	chr9	35902943	35903457	514	257.0	
48059	chr9	35908083	35908635	552	276.0	
48060	chr9	35910602	35911448	846	423.0	
48061	chr9	35914352	35914994	642	321.0	
48062	chr9	35932726	35933152	426	213.0	
48063	chr9	35940458	35940924	466	233.0	
48064	chr9	35945718	35946143	425	212.0	
48065	chr9	35954865	35955350	485	242.0	
48066	chr9	35972074	35972456	382	191.0	
48067	chr9	35976741	35977101	360	180.0	
48068	chr9	36006573	36006930	357	178.0	
48069	chr9	36008670	36009413	743	372.0	
48070	chr9	36023365	36023836	471	236.0	
48071	chr9	36029741	36030142	401	200.0	
48072	chr9	36036383	36038057	1674	837.0	
48073	chr9	36041423	36041942	519	260.0	
48074	chr9	36078102	36078424	322	161.0	
48075	chr9	36092442	36093211	769	384.0	
48076	chr9	36102921	36103631	710	355.0	
48077	chr9	36123500	36123906	406	203.0	
48078	chr9	36126030	36126175	145	72.0	
48079	chr9	36127598	36129987	2389	1194.0	
48080	chr9	36135673	36138199	2526	1263.0	
48081	chr9	36139705	36141728	2023	1012.0	
48082	chr9	36142447	36145457	3010	1505.0	
48083	chr9	36148188	36149665	1477	738.0	
48084	chr9	36150320	36155147	4827	2414.0	
48085	chr9	36158064	36158480	416	208.0	
48086	chr9	36166026	36167199	1173	586.0	
48087	chr9	36187382	36187719	337	168.0	
48088	chr9	36189942	36192519	2577	1288.0	
48089	chr9	36193817	36193920	103	52.0	
48090	chr9	36218299	36218400	101	50.0	
48091	chr9	36248007	36248548	541	270.0	
48092	chr9	36257566	36259215	1649	824.0	
48093	chr9	36325082	36325522	440	220.0	
48094	chr9	36328759	36329251	492	246.0	
48095	chr9	36346381	36347040	659	330.0	
48096	chr9	36378748	36379524	776	388.0	
48097	chr9	36383026	36383752	726	363.0	
48098	chr9	36399756	36401917	2161	1080.0	
48099	chr9	36406959	36407883	924	462.0	
48100	chr9	36450156	36450524	368	184.0	
48101	chr9	36457895	36459794	1899	950.0	
48102	chr9	36460310	36461555	1245	622.0	
48103	chr9	36470099	36471705	1606	803.0	
48104	chr9	36485482	36488860	3378	1689.0	
48105	chr9	36492764	36494094	1330	665.0	
48106	chr9	36504185	36504585	400	200.0	
48107	chr9	36555724	36556251	527	264.0	
48108	chr9	36572189	36574053	1864	932.0	
48109	chr9	36603260	36603428	168	84.0	
48110	chr9	36690835	36690963	128	64.0	
48111	chr9	36728840	36729341	501	250.0	
48112	chr9	36731457	36731995	538	269.0	
48113	chr9	36765475	36766669	1194	597.0	
48114	chr9	36835582	36835588	6	3.0	
48115	chr9	36855464	36855927	463	232.0	
48116	chr9	36873238	36873724	486	243.0	
48117	chr9	36949557	36949738	181	90.0	
48118	chr9	36993724	36994515	791	396.0	
48119	chr9	36995786	36996524	738	369.0	
48120	chr9	36999953	37000095	142	71.0	
48121	chr9	37004435	37004912	477	238.0	
48122	chr9	37025038	37028576	3538	1769.0	
48123	chr9	37029157	37031012	1855	928.0	
48124	chr9	37032674	37038432	5758	2879.0	"silencer	promoter"
48125	chr9	37040752	37040794	42	21.0	
48126	chr9	37061785	37062699	914	457.0	
48127	chr9	37066110	37066535	425	212.0	
48128	chr9	37079075	37080840	1765	882.0	
48129	chr9	37119646	37121541	1895	948.0	
48130	chr9	37146317	37146877	560	280.0	
48131	chr9	37157883	37157887	4	2.0	
48132	chr9	37187279	37188167	888	444.0	
48133	chr9	37197041	37199165	2124	1062.0	
48134	chr9	37251632	37251911	279	140.0	enhancer
48135	chr9	37290829	37291309	480	240.0	
48136	chr9	37294197	37294402	205	102.0	
48137	chr9	37301536	37302813	1277	638.0	
48138	chr9	37303410	37303818	408	204.0	
48139	chr9	37304365	37304882	517	258.0	
48140	chr9	37309077	37309371	294	147.0	
48141	chr9	37324139	37325095	956	478.0	
48142	chr9	37369633	37370109	476	238.0	
48143	chr9	37370918	37372358	1440	720.0	
48144	chr9	37374819	37375407	588	294.0	
48145	chr9	37382703	37383105	402	201.0	
48146	chr9	37387144	37387309	165	82.0	
48147	chr9	37390757	37391161	404	202.0	
48148	chr9	37408882	37409902	1020	510.0	
48149	chr9	37411200	37411431	231	116.0	
48150	chr9	37414969	37415900	931	466.0	
48151	chr9	37421943	37423456	1513	756.0	
48152	chr9	37464406	37467176	2770	1385.0	
48153	chr9	37472050	37472475	425	212.0	
48154	chr9	37482173	37482722	549	274.0	
48155	chr9	37485200	37487258	2058	1029.0	
48156	chr9	37488417	37488558	141	70.0	
48157	chr9	37495895	37495961	66	33.0	
48158	chr9	37503356	37505430	2074	1037.0	
48159	chr9	37507796	37509247	1451	726.0	
48160	chr9	37510955	37512989	2034	1017.0	
48161	chr9	37515244	37515329	85	42.0	
48162	chr9	37517563	37517747	184	92.0	
48163	chr9	37528575	37529761	1186	593.0	
48164	chr9	37531477	37532406	929	464.0	
48165	chr9	37565648	37565921	273	136.0	
48166	chr9	37575464	37576832	1368	684.0	
48167	chr9	37582535	37583016	481	240.0	
48168	chr9	37591634	37593111	1477	738.0	
48169	chr9	37594257	37594906	649	324.0	
48170	chr9	37650541	37651545	1004	502.0	
48171	chr9	37747081	37747582	501	250.0	
48172	chr9	37753274	37754588	1314	657.0	
48173	chr9	37784286	37785936	1650	825.0	
48174	chr9	37788586	37788691	105	52.0	
48175	chr9	37800155	37801865	1710	855.0	
48176	chr9	37902962	37905131	2169	1084.0	
48177	chr9	37908506	37909535	1029	514.0	
48178	chr9	37911815	37912037	222	111.0	
48179	chr9	37913287	37914351	1064	532.0	
48180	chr9	37920379	37920742	363	182.0	
48181	chr9	37926142	37926346	204	102.0	
48182	chr9	37929583	37929986	403	202.0	
48183	chr9	37961558	37961669	111	56.0	
48184	chr9	37992968	37993466	498	249.0	
48185	chr9	37994490	37995733	1243	622.0	
48186	chr9	37998730	37999260	530	265.0	
48187	chr9	38003277	38003616	339	170.0	
48188	chr9	38008015	38008838	823	412.0	
48189	chr9	38020606	38020780	174	87.0	
48190	chr9	38035849	38036163	314	157.0	
48191	chr9	38038119	38038737	618	309.0	enhancer
48192	chr9	38039455	38039855	400	200.0	enhancer
48193	chr9	38046699	38046889	190	95.0	
48194	chr9	38047390	38048065	675	338.0	
48195	chr9	38051708	38051710	2	1.0	
48196	chr9	38065618	38070272	4654	2327.0	
48197	chr9	38070967	38071570	603	302.0	
48198	chr9	38074501	38074923	422	211.0	
48199	chr9	38079394	38079761	367	184.0	
48200	chr9	38084498	38084927	429	214.0	
48201	chr9	38087884	38088424	540	270.0	
48202	chr9	38091336	38091672	336	168.0	
48203	chr9	38160658	38160961	303	152.0	
48204	chr9	38226498	38228068	1570	785.0	
48205	chr9	38339105	38339513	408	204.0	
48206	chr9	38362679	38363512	833	416.0	
48207	chr9	38392149	38393661	1512	756.0	
48208	chr9	38400619	38401034	415	208.0	
48209	chr9	38432926	38433324	398	199.0	
48210	chr9	38445682	38445694	12	6.0	
48211	chr9	38546491	38546894	403	202.0	
48212	chr9	38619870	38622740	2870	1435.0	
48213	chr9	38672337	38672922	585	292.0	
48214	chr9	66900442	66901039	597	298.0	
48215	chr9	39809201	39810257	1056	528.0	
48216	chr9	40105912	40106784	872	436.0	
48217	chr9	40109063	40109261	198	99.0	
48218	chr9	66764980	66765110	130	65.0	
48219	chr9	42743400	42743904	504	252.0	
48220	chr9	41272865	41274517	1652	826.0	
48221	chr9	40110491	40111456	965	482.0	
48222	chr9	40108468	40109343	875	438.0	
48223	chr9	40105905	40107300	1395	698.0	
48224	chr9	41790819	41790910	91	46.0	
48225	chr9	62798832	62803166	4334	2167.0	
48226	chr9	62815137	62815610	473	236.0	
48227	chr9	62816397	62816644	247	124.0	
48228	chr9	62837180	62839069	1889	944.0	
48229	chr9	62864457	62864776	319	160.0	
48230	chr9	62897427	62898388	961	480.0	
48231	chr9	40870608	40871765	1157	578.0	
48232	chr9	40879964	40880351	387	194.0	
48233	chr9	40882041	40882771	730	365.0	
48234	chr9	40908239	40908409	170	85.0	
48235	chr9	63066294	63066507	213	106.0	
48236	chr9	63337888	63338314	426	213.0	
48237	chr9	63365619	63366010	391	196.0	
48238	chr9	63384252	63386008	1756	878.0	
48239	chr9	63812775	63813463	688	344.0	
48240	chr9	63815423	63815548	125	62.0	
48241	chr9	63816453	63826736	10283	5142.0	
48242	chr9	63828061	63830774	2713	1356.0	
48243	chr9	63859054	63860311	1257	628.0	
48244	chr9	40991744	40992540	796	398.0	
48245	chr9	41064357	41064718	361	180.0	
48246	chr9	40924563	40924736	173	86.0	
48247	chr9	40927047	40927445	398	199.0	
48248	chr9	40929152	40929192	40	20.0	
48249	chr9	40991745	40992545	800	400.0	
48250	chr9	64369076	64369518	442	221.0	
48251	chr9	64773479	64775396	1917	958.0	
48252	chr9	65258494	65258917	423	212.0	
48253	chr9	65762606	65763228	622	311.0	
48254	chr9	65675420	65676716	1296	648.0	
48255	chr9	41358634	41359630	996	498.0	
48256	chr9	68356417	68357137	720	360.0	
48257	chr9	68505981	68506580	599	300.0	
48258	chr9	68522053	68522608	555	278.0	
48259	chr9	68530667	68530993	326	163.0	
48260	chr9	68532171	68532508	337	168.0	
48261	chr9	68546413	68548128	1715	858.0	
48262	chr9	68551110	68551591	481	240.0	
48263	chr9	68559671	68561030	1359	680.0	
48264	chr9	68563942	68564532	590	295.0	
48265	chr9	68567983	68568517	534	267.0	
48266	chr9	68578080	68578548	468	234.0	
48267	chr9	68584337	68584923	586	293.0	
48268	chr9	68639288	68641111	1823	912.0	
48269	chr9	68643797	68644307	510	255.0	
48270	chr9	68685754	68686184	430	215.0	
48271	chr9	68704636	68707094	2458	1229.0	
48272	chr9	68779202	68781146	1944	972.0	
48273	chr9	68844096	68845463	1367	684.0	
48274	chr9	68919666	68920021	355	178.0	
48275	chr9	68932937	68933209	272	136.0	
48276	chr9	68952134	68952715	581	290.0	
48277	chr9	68974977	68976184	1207	604.0	
48278	chr9	68978012	68978691	679	340.0	
48279	chr9	68979543	68980847	1304	652.0	
48280	chr9	68995783	68996883	1100	550.0	
48281	chr9	68998837	69000105	1268	634.0	
48282	chr9	69012648	69013338	690	345.0	
48283	chr9	69019767	69020353	586	293.0	
48284	chr9	69027365	69029245	1880	940.0	
48285	chr9	69035231	69037034	1803	902.0	
48286	chr9	69054129	69054621	492	246.0	
48287	chr9	69120877	69122710	1833	916.0	
48288	chr9	69158109	69158478	369	184.0	
48289	chr9	69168544	69169454	910	455.0	
48290	chr9	69171030	69171420	390	195.0	
48291	chr9	69173637	69175924	2287	1144.0	
48292	chr9	69180604	69181138	534	267.0	
48293	chr9	69181742	69182347	605	302.0	
48294	chr9	69193093	69193541	448	224.0	
48295	chr9	69422159	69422606	447	224.0	
48296	chr9	69454409	69454660	251	126.0	
48297	chr9	69475019	69475159	140	70.0	
48298	chr9	69485716	69485737	21	10.0	
48299	chr9	69549234	69549796	562	281.0	
48300	chr9	69582259	69583000	741	370.0	
48301	chr9	69671217	69673506	2289	1144.0	
48302	chr9	69745464	69746571	1107	554.0	
48303	chr9	69758878	69760620	1742	871.0	
48304	chr9	69811578	69811787	209	104.0	
48305	chr9	69820466	69820958	492	246.0	
48306	chr9	69822306	69822696	390	195.0	
48307	chr9	69877931	69878317	386	193.0	
48308	chr9	69916994	69917159	165	82.0	
48309	chr9	69919461	69919922	461	230.0	
48310	chr9	69937505	69938221	716	358.0	
48311	chr9	69940744	69940793	49	24.0	
48312	chr9	69945477	69946225	748	374.0	
48313	chr9	69946731	69947254	523	262.0	
48314	chr9	69971949	69972256	307	154.0	
48315	chr9	70038201	70038432	231	116.0	
48316	chr9	70061099	70061513	414	207.0	
48317	chr9	70080768	70080782	14	7.0	
48318	chr9	70094014	70094142	128	64.0	
48319	chr9	70110950	70111377	427	214.0	
48320	chr9	70113461	70113722	261	130.0	
48321	chr9	70257799	70260924	3125	1562.0	
48322	chr9	70261558	70261884	326	163.0	
48323	chr9	70263095	70263108	13	6.0	
48324	chr9	70389788	70390086	298	149.0	
48325	chr9	70390763	70391320	557	278.0	
48326	chr9	70392111	70393063	952	476.0	
48327	chr9	70397251	70400793	3542	1771.0	
48328	chr9	70405863	70408619	2756	1378.0	
48329	chr9	70409936	70415043	5107	2554.0	
48330	chr9	70418104	70424139	6035	3018.0	
48331	chr9	70438648	70438706	58	29.0	
48332	chr9	70466910	70467435	525	262.0	
48333	chr9	70484443	70484982	539	270.0	
48334	chr9	70494058	70494929	871	436.0	
48335	chr9	70504865	70505171	306	153.0	
48336	chr9	70510231	70510526	295	148.0	
48337	chr9	70525525	70525943	418	209.0	
48338	chr9	70551476	70552177	701	350.0	
48339	chr9	70557690	70558419	729	364.0	
48340	chr9	70563020	70564590	1570	785.0	
48341	chr9	70569157	70569171	14	7.0	
48342	chr9	70577194	70577801	607	304.0	
48343	chr9	70580599	70581111	512	256.0	
48344	chr9	70602364	70602908	544	272.0	
48345	chr9	70607855	70608399	544	272.0	
48346	chr9	71285141	71285526	385	192.0	
48347	chr9	71487108	71487464	356	178.0	
48348	chr9	71506850	71507197	347	174.0	
48349	chr9	71548893	71549392	499	250.0	
48350	chr9	71604377	71604927	550	275.0	
48351	chr9	71628266	71628633	367	184.0	
48352	chr9	71638512	71639251	739	370.0	
48353	chr9	71647054	71647687	633	316.0	
48354	chr9	71677867	71678478	611	306.0	
48355	chr9	71683753	71684296	543	272.0	
48356	chr9	71685260	71686362	1102	551.0	
48357	chr9	71690266	71691062	796	398.0	
48358	chr9	71692271	71692786	515	258.0	
48359	chr9	71719621	71719965	344	172.0	
48360	chr9	71731518	71731919	401	200.0	
48361	chr9	71734750	71734874	124	62.0	
48362	chr9	71735501	71736978	1477	738.0	
48363	chr9	71739496	71739758	262	131.0	
48364	chr9	71740776	71741314	538	269.0	
48365	chr9	71742302	71742371	69	34.0	
48366	chr9	71743078	71745439	2361	1180.0	
48367	chr9	71746190	71748883	2693	1346.0	
48368	chr9	71752414	71752664	250	125.0	
48369	chr9	71755501	71755975	474	237.0	
48370	chr9	71757084	71757089	5	2.0	
48371	chr9	71758941	71759396	455	228.0	
48372	chr9	71761831	71763193	1362	681.0	
48373	chr9	71764320	71770276	5956	2978.0	
48374	chr9	71774846	71775443	597	298.0	
48375	chr9	71781127	71781862	735	368.0	
48376	chr9	71782657	71784131	1474	737.0	
48377	chr9	71794891	71796910	2019	1010.0	
48378	chr9	71806722	71807420	698	349.0	
48379	chr9	71819137	71819531	394	197.0	
48380	chr9	71824273	71824648	375	188.0	
48381	chr9	71894966	71895533	567	284.0	
48382	chr9	71897537	71898045	508	254.0	
48383	chr9	71898915	71899202	287	144.0	
48384	chr9	71901684	71902238	554	277.0	
48385	chr9	71909591	71912345	2754	1377.0	
48386	chr9	72022867	72023150	283	142.0	
48387	chr9	72024857	72025442	585	292.0	
48388	chr9	72038881	72039426	545	272.0	
48389	chr9	72041831	72042926	1095	548.0	
48390	chr9	72166035	72166532	497	248.0	
48391	chr9	72173047	72173579	532	266.0	
48392	chr9	72271853	72272267	414	207.0	
48393	chr9	72280862	72281377	515	258.0	
48394	chr9	72292134	72293326	1192	596.0	
48395	chr9	72294318	72295291	973	486.0	
48396	chr9	72300827	72301331	504	252.0	
48397	chr9	72304542	72305912	1370	685.0	
48398	chr9	72306534	72307213	679	340.0	
48399	chr9	72312374	72312838	464	232.0	
48400	chr9	72326567	72326959	392	196.0	
48401	chr9	72341858	72341945	87	44.0	
48402	chr9	72346919	72348518	1599	800.0	
48403	chr9	72349489	72366484	16995	8498.0	
48404	chr9	72387146	72387633	487	244.0	
48405	chr9	72393846	72394457	611	306.0	
48406	chr9	72396540	72397239	699	350.0	
48407	chr9	72412461	72412965	504	252.0	
48408	chr9	72420740	72421235	495	248.0	
48409	chr9	72423931	72424608	677	338.0	
48410	chr9	72440031	72440874	843	422.0	
48411	chr9	72443214	72444416	1202	601.0	
48412	chr9	72445291	72446687	1396	698.0	
48413	chr9	72464675	72465381	706	353.0	
48414	chr9	72473497	72473879	382	191.0	
48415	chr9	72478107	72478550	443	222.0	
48416	chr9	72525118	72525638	520	260.0	
48417	chr9	72526835	72528281	1446	723.0	
48418	chr9	72564614	72565030	416	208.0	
48419	chr9	72585390	72587396	2006	1003.0	
48420	chr9	72589657	72590151	494	247.0	
48421	chr9	72590784	72591255	471	236.0	
48422	chr9	72592518	72593469	951	476.0	
48423	chr9	72594644	72595186	542	271.0	
48424	chr9	72634155	72634350	195	98.0	
48425	chr9	72635221	72635532	311	156.0	
48426	chr9	72648639	72649257	618	309.0	
48427	chr9	72734529	72735175	646	323.0	
48428	chr9	72822355	72822775	420	210.0	
48429	chr9	72857129	72857237	108	54.0	
48430	chr9	72925201	72926288	1087	544.0	
48431	chr9	72948147	72948548	401	200.0	
48432	chr9	72951651	72952185	534	267.0	
48433	chr9	72952866	72953380	514	257.0	
48434	chr9	72955707	72956166	459	230.0	
48435	chr9	72960397	72960786	389	194.0	
48436	chr9	73022920	73023550	630	315.0	
48437	chr9	73082009	73082407	398	199.0	
48438	chr9	73107434	73107948	514	257.0	
48439	chr9	73130270	73130671	401	200.0	
48440	chr9	73131733	73133018	1285	642.0	
48441	chr9	73143878	73144348	470	235.0	
48442	chr9	73147559	73148275	716	358.0	
48443	chr9	73149195	73149951	756	378.0	
48444	chr9	73151337	73159346	8009	4004.0	
48445	chr9	73161802	73162262	460	230.0	
48446	chr9	73162901	73163866	965	482.0	
48447	chr9	73164979	73169149	4170	2085.0	
48448	chr9	73171070	73171150	80	40.0	
48449	chr9	73171732	73177834	6102	3051.0	
48450	chr9	73184013	73184261	248	124.0	
48451	chr9	73200702	73201113	411	206.0	
48452	chr9	73202958	73203312	354	177.0	
48453	chr9	73214334	73214719	385	192.0	
48454	chr9	73219790	73220850	1060	530.0	
48455	chr9	73237113	73237565	452	226.0	
48456	chr9	73270958	73271516	558	279.0	
48457	chr9	73869297	73869639	342	171.0	
48458	chr9	74245802	74246285	483	242.0	
48459	chr9	74277487	74277926	439	220.0	
48460	chr9	74322850	74323245	395	198.0	
48461	chr9	74496653	74498621	1968	984.0	
48462	chr9	74557461	74558001	540	270.0	
48463	chr9	74770900	74771328	428	214.0	
48464	chr9	74773836	74774328	492	246.0	
48465	chr9	74776991	74777464	473	236.0	
48466	chr9	74886937	74887753	816	408.0	
48467	chr9	74942777	74943233	456	228.0	
48468	chr9	74951374	74953848	2474	1237.0	
48469	chr9	74960549	74960950	401	200.0	
48470	chr9	75001939	75002627	688	344.0	
48471	chr9	75010536	75010940	404	202.0	
48472	chr9	75013737	75014159	422	211.0	
48473	chr9	75020266	75021017	751	376.0	
48474	chr9	75023652	75024013	361	180.0	
48475	chr9	75026871	75029203	2332	1166.0	
48476	chr9	75071682	75072156	474	237.0	
48477	chr9	75077094	75077576	482	241.0	
48478	chr9	75083112	75083781	669	334.0	
48479	chr9	75085398	75086028	630	315.0	
48480	chr9	75086736	75092425	5689	2844.0	
48481	chr9	75095595	75095921	326	163.0	
48482	chr9	75102508	75102792	284	142.0	
48483	chr9	75105046	75105234	188	94.0	
48484	chr9	75108588	75109046	458	229.0	
48485	chr9	75111074	75111636	562	281.0	
48486	chr9	75121862	75122341	479	240.0	
48487	chr9	75132260	75132616	356	178.0	
48488	chr9	75138728	75139587	859	430.0	
48489	chr9	75142104	75142844	740	370.0	
48490	chr9	75147490	75148959	1469	734.0	
48491	chr9	75149752	75153057	3305	1652.0	
48492	chr9	75156947	75157217	270	135.0	
48493	chr9	75185598	75186009	411	206.0	
48494	chr9	75186761	75187171	410	205.0	
48495	chr9	75200873	75201302	429	214.0	
48496	chr9	75238274	75239646	1372	686.0	
48497	chr9	75265484	75265886	402	201.0	
48498	chr9	75455624	75456060	436	218.0	
48499	chr9	75500466	75500856	390	195.0	
48500	chr9	75504832	75505070	238	119.0	
48501	chr9	75505676	75506005	329	164.0	
48502	chr9	75604537	75605132	595	298.0	
48503	chr9	75625341	75625420	79	40.0	
48504	chr9	75812208	75812475	267	134.0	
48505	chr9	75866258	75866700	442	221.0	
48506	chr9	75869093	75869722	629	314.0	
48507	chr9	75873642	75874147	505	252.0	
48508	chr9	75889550	75893565	4015	2008.0	
48509	chr9	76023549	76024662	1113	556.0	
48510	chr9	76027377	76027767	390	195.0	
48511	chr9	76181086	76181186	100	50.0	
48512	chr9	76216396	76216485	89	44.0	
48513	chr9	76245577	76245904	327	164.0	
48514	chr9	76256150	76256428	278	139.0	
48515	chr9	76302945	76303302	357	178.0	
48516	chr9	76350946	76352466	1520	760.0	
48517	chr9	76358748	76359742	994	497.0	
48518	chr9	76375371	76375437	66	33.0	
48519	chr9	76393368	76395903	2535	1268.0	
48520	chr9	76399934	76400243	309	154.0	
48521	chr9	76403192	76403941	749	374.0	
48522	chr9	76414756	76414902	146	73.0	
48523	chr9	76419769	76420185	416	208.0	
48524	chr9	76447257	76448062	805	402.0	
48525	chr9	76456156	76456675	519	260.0	
48526	chr9	76458621	76460754	2133	1066.0	
48527	chr9	76472047	76472662	615	308.0	
48528	chr9	76475541	76476179	638	319.0	
48529	chr9	76491002	76491556	554	277.0	
48530	chr9	76529709	76530113	404	202.0	
48531	chr9	76530712	76530883	171	86.0	
48532	chr9	76553105	76553215	110	55.0	
48533	chr9	76562381	76562977	596	298.0	
48534	chr9	76570837	76572100	1263	632.0	
48535	chr9	76574074	76574781	707	354.0	
48536	chr9	76576143	76578327	2184	1092.0	
48537	chr9	76585396	76585994	598	299.0	
48538	chr9	76588307	76588693	386	193.0	
48539	chr9	76591462	76591945	483	242.0	
48540	chr9	76595493	76596891	1398	699.0	
48541	chr9	76603691	76603950	259	130.0	
48542	chr9	76605301	76605727	426	213.0	
48543	chr9	76609898	76610370	472	236.0	
48544	chr9	76615019	76615702	683	342.0	
48545	chr9	76618805	76619619	814	407.0	
48546	chr9	76643485	76644193	708	354.0	
48547	chr9	76650862	76651800	938	469.0	
48548	chr9	76652930	76653307	377	188.0	
48549	chr9	76654985	76655694	709	354.0	
48550	chr9	76658486	76659113	627	314.0	
48551	chr9	76687959	76688699	740	370.0	
48552	chr9	76704536	76705059	523	262.0	
48553	chr9	76717571	76717924	353	176.0	
48554	chr9	76755650	76755995	345	172.0	
48555	chr9	76759843	76759904	61	30.0	
48556	chr9	77011877	77012334	457	228.0	
48557	chr9	77150761	77151182	421	210.0	
48558	chr9	77167351	77168010	659	330.0	
48559	chr9	77175470	77179464	3994	1997.0	
48560	chr9	77417425	77417940	515	258.0	
48561	chr9	77433633	77434099	466	233.0	
48562	chr9	77453780	77454475	695	348.0	
48563	chr9	77455262	77455701	439	220.0	
48564	chr9	77456767	77457273	506	253.0	
48565	chr9	77457935	77458526	591	296.0	
48566	chr9	77476129	77476598	469	234.0	
48567	chr9	77647924	77649578	1654	827.0	
48568	chr9	77679027	77679518	491	246.0	
48569	chr9	77705857	77705953	96	48.0	
48570	chr9	77709227	77710052	825	412.0	
48571	chr9	77731234	77731386	152	76.0	
48572	chr9	77751444	77751976	532	266.0	
48573	chr9	77769190	77769724	534	267.0	
48574	chr9	77807274	77807630	356	178.0	
48575	chr9	77819656	77820041	385	192.0	
48576	chr9	77827386	77827723	337	168.0	
48577	chr9	77842038	77842531	493	246.0	
48578	chr9	77848878	77849333	455	228.0	
48579	chr9	77852256	77852318	62	31.0	
48580	chr9	77864499	77865088	589	294.0	
48581	chr9	77892059	77892466	407	204.0	
48582	chr9	77909156	77910424	1268	634.0	
48583	chr9	77934894	77936458	1564	782.0	
48584	chr9	77944459	77946366	1907	954.0	
48585	chr9	77946890	77947237	347	174.0	
48586	chr9	77977097	77978568	1471	736.0	
48587	chr9	77981302	77981788	486	243.0	
48588	chr9	77987026	77987225	199	100.0	
48589	chr9	77988736	77988857	121	60.0	
48590	chr9	78004455	78005132	677	338.0	
48591	chr9	78010438	78011382	944	472.0	
48592	chr9	78014979	78015603	624	312.0	
48593	chr9	78021683	78022090	407	204.0	
48594	chr9	78022813	78023636	823	412.0	
48595	chr9	78029513	78034101	4588	2294.0	
48596	chr9	78034928	78035901	973	486.0	
48597	chr9	78054121	78054684	563	282.0	
48598	chr9	78074615	78075290	675	338.0	
48599	chr9	78097174	78097987	813	406.0	
48600	chr9	78101447	78101567	120	60.0	
48601	chr9	78103737	78104623	886	443.0	
48602	chr9	78108055	78108396	341	170.0	
48603	chr9	78115084	78115514	430	215.0	
48604	chr9	78118899	78119613	714	357.0	
48605	chr9	78121457	78121923	466	233.0	
48606	chr9	78132496	78133139	643	322.0	
48607	chr9	78187779	78188418	639	320.0	
48608	chr9	78189317	78189797	480	240.0	
48609	chr9	78196216	78196650	434	217.0	
48610	chr9	78200753	78201770	1017	508.0	
48611	chr9	78210618	78211472	854	427.0	
48612	chr9	78213625	78214144	519	260.0	
48613	chr9	78235276	78237019	1743	872.0	
48614	chr9	78237954	78239021	1067	534.0	
48615	chr9	78248722	78248794	72	36.0	
48616	chr9	78261389	78261762	373	186.0	
48617	chr9	78296257	78298442	2185	1092.0	
48618	chr9	78369651	78370030	379	190.0	
48619	chr9	78439427	78439871	444	222.0	enhancer
48620	chr9	78663364	78663765	401	200.0	
48621	chr9	78694904	78695849	945	472.0	
48622	chr9	78698624	78698662	38	19.0	
48623	chr9	78707478	78707712	234	117.0	
48624	chr9	79135738	79136338	600	300.0	
48625	chr9	79264819	79265220	401	200.0	
48626	chr9	79357576	79358066	490	245.0	
48627	chr9	79478501	79478743	242	121.0	
48628	chr9	79544306	79544833	527	264.0	
48629	chr9	79568316	79569272	956	478.0	
48630	chr9	79569952	79574249	4297	2148.0	
48631	chr9	79574835	79574980	145	72.0	
48632	chr9	79575895	79575899	4	2.0	
48633	chr9	79577962	79578470	508	254.0	
48634	chr9	79581350	79585039	3689	1844.0	
48635	chr9	79587825	79588226	401	200.0	
48636	chr9	79588807	79589181	374	187.0	
48637	chr9	79591120	79593651	2531	1266.0	
48638	chr9	79594181	79594551	370	185.0	
48639	chr9	79598027	79599319	1292	646.0	
48640	chr9	79600557	79600933	376	188.0	
48641	chr9	79602138	79602255	117	58.0	
48642	chr9	79603782	79606714	2932	1466.0	
48643	chr9	79610236	79611811	1575	788.0	enhancer
48644	chr9	79613154	79613894	740	370.0	
48645	chr9	79615987	79616481	494	247.0	
48646	chr9	79619533	79619536	3	2.0	
48647	chr9	79623675	79624910	1235	618.0	
48648	chr9	79630865	79631407	542	271.0	
48649	chr9	79633616	79633970	354	177.0	
48650	chr9	79651061	79651818	757	378.0	
48651	chr9	79687021	79687537	516	258.0	
48652	chr9	79695768	79696230	462	231.0	
48653	chr9	79701571	79702378	807	404.0	
48654	chr9	79812438	79813253	815	408.0	
48655	chr9	79834557	79834952	395	198.0	
48656	chr9	79858388	79859070	682	341.0	
48657	chr9	79867151	79867535	384	192.0	
48658	chr9	79868410	79869417	1007	504.0	
48659	chr9	79878152	79878692	540	270.0	
48660	chr9	79882996	79883671	675	338.0	
48661	chr9	79884536	79884814	278	139.0	
48662	chr9	79955359	79955474	115	58.0	
48663	chr9	80134493	80134933	440	220.0	
48664	chr9	80231805	80232166	361	180.0	
48665	chr9	81113218	81113970	752	376.0	enhancer
48666	chr9	81375668	81375801	133	66.0	
48667	chr9	81408876	81409479	603	302.0	
48668	chr9	81522929	81523552	623	312.0	
48669	chr9	81593021	81593110	89	44.0	
48670	chr9	81596833	81597703	870	435.0	
48671	chr9	81599934	81600161	227	114.0	
48672	chr9	81610305	81610754	449	224.0	
48673	chr9	81619631	81620318	687	344.0	
48674	chr9	81655262	81656441	1179	590.0	
48675	chr9	81682475	81683230	755	378.0	
48676	chr9	81686944	81690645	3701	1850.0	
48677	chr9	81727984	81729637	1653	826.0	
48678	chr9	81737796	81738124	328	164.0	
48679	chr9	81814908	81815442	534	267.0	
48680	chr9	81821539	81821930	391	196.0	
48681	chr9	82127948	82128482	534	267.0	
48682	chr9	82184646	82184758	112	56.0	
48683	chr9	82247316	82247780	464	232.0	
48684	chr9	83219134	83220029	895	448.0	
48685	chr9	83239155	83239641	486	243.0	
48686	chr9	83334202	83334732	530	265.0	
48687	chr9	83406875	83407989	1114	557.0	
48688	chr9	83465875	83466067	192	96.0	
48689	chr9	83471118	83471695	577	288.0	
48690	chr9	83472644	83474052	1408	704.0	
48691	chr9	83507995	83508508	513	256.0	
48692	chr9	83510931	83511564	633	316.0	
48693	chr9	83521070	83522028	958	479.0	
48694	chr9	83537639	83539096	1457	728.0	
48695	chr9	83544335	83544834	499	250.0	
48696	chr9	83569476	83569651	175	88.0	
48697	chr9	83596900	83597297	397	198.0	
48698	chr9	83598470	83598966	496	248.0	
48699	chr9	83607686	83608014	328	164.0	
48700	chr9	83620638	83621384	746	373.0	
48701	chr9	83622394	83624550	2156	1078.0	
48702	chr9	83649040	83649727	687	344.0	
48703	chr9	83665579	83666049	470	235.0	
48704	chr9	83705134	83706081	947	474.0	
48705	chr9	83706617	83709234	2617	1308.0	
48706	chr9	83714282	83714741	459	230.0	
48707	chr9	83816825	83818582	1757	878.0	
48708	chr9	83819116	83819818	702	351.0	
48709	chr9	83912162	83912605	443	222.0	
48710	chr9	83920357	83922198	1841	920.0	
48711	chr9	83933460	83935024	1564	782.0	
48712	chr9	83937639	83938329	690	345.0	
48713	chr9	83955899	83958013	2114	1057.0	
48714	chr9	83959403	83959761	358	179.0	
48715	chr9	83964033	83967761	3728	1864.0	
48716	chr9	83972571	83972607	36	18.0	
48717	chr9	83975459	83975691	232	116.0	
48718	chr9	83977286	83977610	324	162.0	
48719	chr9	83978189	83981979	3790	1895.0	
48720	chr9	83987089	83987443	354	177.0	
48721	chr9	84001580	84002774	1194	597.0	
48722	chr9	84139283	84139543	260	130.0	
48723	chr9	84140558	84140997	439	220.0	
48724	chr9	84173057	84173509	452	226.0	
48725	chr9	84174428	84174839	411	206.0	
48726	chr9	84261067	84261565	498	249.0	
48727	chr9	84266075	84266522	447	224.0	
48728	chr9	84271247	84271929	682	341.0	
48729	chr9	84293098	84293896	798	399.0	
48730	chr9	84296136	84296840	704	352.0	
48731	chr9	84301771	84302347	576	288.0	
48732	chr9	84315238	84315700	462	231.0	
48733	chr9	84323770	84324325	555	278.0	
48734	chr9	84364905	84365276	371	186.0	
48735	chr9	84371672	84372321	649	324.0	
48736	chr9	84373980	84374401	421	210.0	
48737	chr9	84394259	84394478	219	110.0	
48738	chr9	84397031	84397525	494	247.0	
48739	chr9	84597113	84597558	445	222.0	
48740	chr9	84668241	84668622	381	190.0	
48741	chr9	84709658	84710058	400	200.0	
48742	chr9	85289992	85290457	465	232.0	
48743	chr9	85522359	85523224	865	432.0	
48744	chr9	85534294	85534782	488	244.0	
48745	chr9	85600640	85601103	463	232.0	
48746	chr9	85609845	85610867	1022	511.0	
48747	chr9	85646195	85646644	449	224.0	
48748	chr9	85647631	85647946	315	158.0	
48749	chr9	85662674	85663004	330	165.0	
48750	chr9	85694322	85694522	200	100.0	
48751	chr9	85698279	85698870	591	296.0	
48752	chr9	85700387	85700707	320	160.0	
48753	chr9	85702920	85703267	347	174.0	
48754	chr9	85715208	85717608	2400	1200.0	
48755	chr9	85722886	85723756	870	435.0	
48756	chr9	85729761	85731710	1949	974.0	
48757	chr9	85740651	85744792	4141	2070.0	
48758	chr9	85803053	85806253	3200	1600.0	
48759	chr9	85818931	85819379	448	224.0	
48760	chr9	85870963	85871363	400	200.0	
48761	chr9	85900515	85900911	396	198.0	
48762	chr9	85937276	85937835	559	280.0	
48763	chr9	85940404	85942265	1861	930.0	
48764	chr9	86052888	86053286	398	199.0	
48765	chr9	86060412	86061058	646	323.0	
48766	chr9	86063243	86063342	99	50.0	
48767	chr9	86069122	86069801	679	340.0	
48768	chr9	86093999	86094138	139	70.0	
48769	chr9	86098736	86100429	1693	846.0	
48770	chr9	86106672	86107435	763	382.0	
48771	chr9	86200584	86201084	500	250.0	
48772	chr9	86202236	86202688	452	226.0	
48773	chr9	86277295	86277420	125	62.0	
48774	chr9	86279972	86280762	790	395.0	
48775	chr9	86281378	86283655	2277	1138.0	
48776	chr9	86284159	86284532	373	186.0	
48777	chr9	86285374	86285676	302	151.0	
48778	chr9	86287011	86287385	374	187.0	
48779	chr9	86337261	86339071	1810	905.0	
48780	chr9	86348061	86348939	878	439.0	
48781	chr9	86350340	86351289	949	474.0	
48782	chr9	86352309	86355415	3106	1553.0	
48783	chr9	86359065	86359910	845	422.0	
48784	chr9	86368812	86369685	873	436.0	
48785	chr9	86414516	86414598	82	41.0	
48786	chr9	86434043	86434227	184	92.0	
48787	chr9	86485411	86485718	307	154.0	
48788	chr9	86723379	86723607	228	114.0	
48789	chr9	86763712	86764709	997	498.0	
48790	chr9	86766035	86767456	1421	710.0	
48791	chr9	86783879	86784167	288	144.0	
48792	chr9	86945514	86949091	3577	1788.0	
48793	chr9	87276354	87277150	796	398.0	
48794	chr9	87324604	87324992	388	194.0	
48795	chr9	87326933	87327232	299	150.0	
48796	chr9	87336870	87337256	386	193.0	
48797	chr9	87382872	87383278	406	203.0	
48798	chr9	87405503	87407013	1510	755.0	
48799	chr9	87425018	87425699	681	340.0	
48800	chr9	87445571	87446128	557	278.0	
48801	chr9	87478354	87478563	209	104.0	
48802	chr9	87479599	87480374	775	388.0	
48803	chr9	87493478	87493846	368	184.0	
48804	chr9	87494999	87495290	291	146.0	
48805	chr9	87497390	87499309	1919	960.0	
48806	chr9	87500696	87500997	301	150.0	
48807	chr9	87502191	87503156	965	482.0	
48808	chr9	87516082	87517178	1096	548.0	
48809	chr9	87517872	87517895	23	12.0	
48810	chr9	87518740	87519289	549	274.0	
48811	chr9	87529722	87530645	923	462.0	
48812	chr9	87554487	87555609	1122	561.0	
48813	chr9	87556750	87557346	596	298.0	
48814	chr9	87560205	87560754	549	274.0	
48815	chr9	87580015	87580484	469	234.0	
48816	chr9	87593351	87593925	574	287.0	
48817	chr9	87601064	87601786	722	361.0	
48818	chr9	87607707	87608322	615	308.0	
48819	chr9	87611830	87612092	262	131.0	
48820	chr9	87613617	87614903	1286	643.0	
48821	chr9	87615761	87615964	203	102.0	
48822	chr9	87662884	87663250	366	183.0	
48823	chr9	87678691	87679026	335	168.0	
48824	chr9	87685766	87686490	724	362.0	
48825	chr9	87708201	87708384	183	92.0	
48826	chr9	87709248	87709330	82	41.0	
48827	chr9	87711915	87712191	276	138.0	
48828	chr9	87713127	87714062	935	468.0	
48829	chr9	87722210	87723106	896	448.0	
48830	chr9	87725603	87726817	1214	607.0	
48831	chr9	87783229	87783525	296	148.0	
48832	chr9	87792400	87793878	1478	739.0	
48833	chr9	87796069	87796731	662	331.0	
48834	chr9	87812770	87813258	488	244.0	
48835	chr9	87840093	87840557	464	232.0	
48836	chr9	87950792	87951187	395	198.0	
48837	chr9	87972952	87975418	2466	1233.0	
48838	chr9	88007196	88007520	324	162.0	
48839	chr9	88049276	88049469	193	96.0	
48840	chr9	88076333	88077030	697	348.0	
48841	chr9	88173366	88173769	403	202.0	
48842	chr9	88178915	88179500	585	292.0	
48843	chr9	88322647	88323563	916	458.0	
48844	chr9	88339304	88339349	45	22.0	
48845	chr9	88387145	88389534	2389	1194.0	
48846	chr9	88391665	88392304	639	320.0	
48847	chr9	88425452	88425934	482	241.0	
48848	chr9	88533906	88535748	1842	921.0	
48849	chr9	88537680	88538250	570	285.0	
48850	chr9	88578423	88578930	507	254.0	
48851	chr9	88593767	88594211	444	222.0	
48852	chr9	88777855	88778412	557	278.0	
48853	chr9	88831677	88831970	293	146.0	
48854	chr9	88835067	88835622	555	278.0	
48855	chr9	88886751	88887051	300	150.0	
48856	chr9	88891054	88891361	307	154.0	
48857	chr9	88921968	88922598	630	315.0	
48858	chr9	88923186	88924405	1219	610.0	
48859	chr9	88926857	88928028	1171	586.0	
48860	chr9	88936065	88937191	1126	563.0	
48861	chr9	88950186	88950847	661	330.0	
48862	chr9	88951641	88952122	481	240.0	
48863	chr9	88953335	88953950	615	308.0	
48864	chr9	88988846	88990165	1319	660.0	
48865	chr9	88990897	88992047	1150	575.0	
48866	chr9	89000883	89001424	541	270.0	
48867	chr9	89008673	89009229	556	278.0	
48868	chr9	89023783	89023849	66	33.0	
48869	chr9	89026768	89027269	501	250.0	
48870	chr9	89036256	89037405	1149	574.0	
48871	chr9	89153624	89153962	338	169.0	
48872	chr9	89154598	89154978	380	190.0	
48873	chr9	89179971	89180610	639	320.0	
48874	chr9	89277430	89277815	385	192.0	
48875	chr9	89278990	89279403	413	206.0	
48876	chr9	89282299	89282685	386	193.0	
48877	chr9	89309513	89312886	3373	1686.0	
48878	chr9	89317242	89319934	2692	1346.0	
48879	chr9	89323438	89323741	303	152.0	
48880	chr9	89351687	89352835	1148	574.0	
48881	chr9	89362174	89363085	911	456.0	
48882	chr9	89367425	89367426	1	0.0	
48883	chr9	89369879	89377070	7191	3596.0	
48884	chr9	89378912	89380327	1415	708.0	
48885	chr9	89381509	89382649	1140	570.0	
48886	chr9	89383458	89383562	104	52.0	
48887	chr9	89387903	89389070	1167	584.0	
48888	chr9	89399928	89401148	1220	610.0	
48889	chr9	89401650	89402072	422	211.0	
48890	chr9	89405701	89406884	1183	592.0	
48891	chr9	89408418	89411130	2712	1356.0	
48892	chr9	89418100	89423985	5885	2942.0	
48893	chr9	89424939	89430045	5106	2553.0	
48894	chr9	89432365	89433029	664	332.0	
48895	chr9	89435696	89435739	43	22.0	
48896	chr9	89436868	89438361	1493	746.0	
48897	chr9	89439988	89446092	6104	3052.0	
48898	chr9	89446642	89446874	232	116.0	
48899	chr9	89448304	89449646	1342	671.0	
48900	chr9	89450238	89450590	352	176.0	
48901	chr9	89454519	89457832	3313	1656.0	
48902	chr9	89458714	89459880	1166	583.0	
48903	chr9	89462766	89468004	5238	2619.0	
48904	chr9	89468534	89471058	2524	1262.0	
48905	chr9	89477122	89479993	2871	1436.0	
48906	chr9	89480996	89482706	1710	855.0	
48907	chr9	89483528	89487016	3488	1744.0	
48908	chr9	89489409	89494575	5166	2583.0	
48909	chr9	89495424	89500207	4783	2392.0	
48910	chr9	89501356	89503232	1876	938.0	
48911	chr9	89507394	89508062	668	334.0	
48912	chr9	89508863	89509669	806	403.0	
48913	chr9	89511012	89511126	114	57.0	
48914	chr9	89518649	89519819	1170	585.0	
48915	chr9	89521881	89524474	2593	1296.0	
48916	chr9	89525522	89526231	709	354.0	
48917	chr9	89526792	89527602	810	405.0	
48918	chr9	89529646	89530076	430	215.0	
48919	chr9	89532455	89532931	476	238.0	
48920	chr9	89535092	89537235	2143	1072.0	
48921	chr9	89538998	89539252	254	127.0	
48922	chr9	89548781	89549523	742	371.0	
48923	chr9	89550415	89550602	187	94.0	
48924	chr9	89555844	89557223	1379	690.0	
48925	chr9	89564597	89564767	170	85.0	
48926	chr9	89576346	89576685	339	170.0	
48927	chr9	89579093	89580477	1384	692.0	
48928	chr9	89593775	89594259	484	242.0	
48929	chr9	89598036	89598542	506	253.0	
48930	chr9	89602891	89607090	4199	2100.0	
48931	chr9	89623981	89624447	466	233.0	
48932	chr9	89640309	89640892	583	292.0	
48933	chr9	89659919	89660676	757	378.0	
48934	chr9	89661454	89662414	960	480.0	
48935	chr9	89663139	89663352	213	106.0	
48936	chr9	89701133	89701859	726	363.0	
48937	chr9	89710949	89711004	55	28.0	
48938	chr9	89721286	89721600	314	157.0	
48939	chr9	89742979	89744425	1446	723.0	
48940	chr9	89770701	89771082	381	190.0	
48941	chr9	89781834	89782325	491	246.0	
48942	chr9	89786600	89787135	535	268.0	
48943	chr9	89815753	89816364	611	306.0	
48944	chr9	89919278	89919755	477	238.0	
48945	chr9	89924134	89924473	339	170.0	
48946	chr9	89930227	89930507	280	140.0	
48947	chr9	89944364	89944836	472	236.0	
48948	chr9	89953208	89953789	581	290.0	
48949	chr9	89961710	89962670	960	480.0	
48950	chr9	89964657	89964935	278	139.0	
48951	chr9	89989042	89989543	501	250.0	
48952	chr9	89993838	89994790	952	476.0	
48953	chr9	89999313	90000348	1035	518.0	
48954	chr9	90009408	90009924	516	258.0	
48955	chr9	90024028	90025054	1026	513.0	
48956	chr9	90079146	90079474	328	164.0	
48957	chr9	90086056	90086469	413	206.0	
48958	chr9	90102144	90102910	766	383.0	
48959	chr9	90107928	90108039	111	56.0	
48960	chr9	90141773	90142969	1196	598.0	
48961	chr9	90180648	90180689	41	20.0	
48962	chr9	90189241	90189726	485	242.0	
48963	chr9	90192504	90192922	418	209.0	
48964	chr9	90212995	90213383	388	194.0	
48965	chr9	90219458	90219928	470	235.0	
48966	chr9	90226717	90227150	433	216.0	
48967	chr9	90698781	90699230	449	224.0	
48968	chr9	90702414	90703092	678	339.0	
48969	chr9	90725172	90725175	3	2.0	
48970	chr9	90755690	90756211	521	260.0	
48971	chr9	90770125	90770812	687	344.0	
48972	chr9	90772346	90772914	568	284.0	
48973	chr9	90773643	90775137	1494	747.0	
48974	chr9	90795716	90796552	836	418.0	
48975	chr9	90799355	90800457	1102	551.0	
48976	chr9	90801094	90803013	1919	960.0	
48977	chr9	90804112	90804501	389	194.0	
48978	chr9	90808581	90809369	788	394.0	
48979	chr9	90815215	90816215	1000	500.0	
48980	chr9	90826614	90827913	1299	650.0	
48981	chr9	90831033	90831491	458	229.0	
48982	chr9	90835096	90835226	130	65.0	
48983	chr9	90842940	90843654	714	357.0	
48984	chr9	90860526	90861352	826	413.0	
48985	chr9	90870516	90871425	909	454.0	
48986	chr9	90881573	90881944	371	186.0	
48987	chr9	90914775	90915356	581	290.0	
48988	chr9	91033741	91034168	427	214.0	
48989	chr9	91037002	91037696	694	347.0	
48990	chr9	91047502	91048084	582	291.0	
48991	chr9	91060565	91061108	543	272.0	
48992	chr9	91071187	91071529	342	171.0	
48993	chr9	91085060	91086035	975	488.0	
48994	chr9	91099805	91102511	2706	1353.0	
48995	chr9	91117907	91118574	667	334.0	
48996	chr9	91131328	91131992	664	332.0	
48997	chr9	91146456	91146968	512	256.0	
48998	chr9	91147579	91148212	633	316.0	
48999	chr9	91150583	91151898	1315	658.0	
49000	chr9	91156680	91157358	678	339.0	
49001	chr9	91162212	91165333	3121	1560.0	
49002	chr9	91174728	91175197	469	234.0	
49003	chr9	91177524	91178284	760	380.0	
49004	chr9	91186866	91187153	287	144.0	
49005	chr9	91191036	91192162	1126	563.0	
49006	chr9	91192785	91194581	1796	898.0	
49007	chr9	91197024	91198258	1234	617.0	
49008	chr9	91199727	91200254	527	264.0	
49009	chr9	91207540	91209401	1861	930.0	
49010	chr9	91211470	91212498	1028	514.0	
49011	chr9	91245391	91245838	447	224.0	
49012	chr9	91253412	91253915	503	252.0	
49013	chr9	91258396	91258919	523	262.0	
49014	chr9	91261541	91261687	146	73.0	
49015	chr9	91298245	91298752	507	254.0	
49016	chr9	91302680	91303391	711	356.0	
49017	chr9	91305781	91306109	328	164.0	
49018	chr9	91346903	91346946	43	22.0	
49019	chr9	91360602	91362543	1941	970.0	
49020	chr9	91394936	91396223	1287	644.0	
49021	chr9	91407860	91408300	440	220.0	
49022	chr9	91410934	91411629	695	348.0	
49023	chr9	91415138	91415876	738	369.0	
49024	chr9	91419083	91420262	1179	590.0	
49025	chr9	91420986	91426715	5729	2864.0	
49026	chr9	91428614	91429221	607	304.0	
49027	chr9	91433148	91433557	409	204.0	
49028	chr9	91503514	91504295	781	390.0	
49029	chr9	91516755	91517195	440	220.0	
49030	chr9	91679108	91679319	211	106.0	
49031	chr9	91681598	91682139	541	270.0	
49032	chr9	91694001	91694942	941	470.0	
49033	chr9	91711608	91712671	1063	532.0	
49034	chr9	91714386	91714841	455	228.0	
49035	chr9	91720762	91721267	505	252.0	
49036	chr9	91727252	91727723	471	236.0	
49037	chr9	91734304	91734775	471	236.0	
49038	chr9	91758599	91758744	145	72.0	
49039	chr9	91775408	91775850	442	221.0	
49040	chr9	91796389	91796950	561	280.0	
49041	chr9	91798128	91799348	1220	610.0	
49042	chr9	91844262	91844534	272	136.0	
49043	chr9	91905827	91906617	790	395.0	
49044	chr9	91948835	91949107	272	136.0	
49045	chr9	91949917	91950747	830	415.0	
49046	chr9	92097990	92098312	322	161.0	
49047	chr9	92114747	92116298	1551	776.0	
49048	chr9	92119472	92120271	799	400.0	
49049	chr9	92132455	92134662	2207	1104.0	
49050	chr9	92137971	92138697	726	363.0	
49051	chr9	92140023	92141569	1546	773.0	
49052	chr9	92147147	92147700	553	276.0	
49053	chr9	92165479	92165870	391	196.0	
49054	chr9	92293262	92294597	1335	668.0	
49055	chr9	92297740	92298022	282	141.0	
49056	chr9	92324438	92326568	2130	1065.0	
49057	chr9	92353076	92353386	310	155.0	
49058	chr9	92406463	92407088	625	312.0	
49059	chr9	92440503	92441129	626	313.0	
49060	chr9	92534809	92534981	172	86.0	
49061	chr9	92537383	92537934	551	276.0	
49062	chr9	92634628	92635290	662	331.0	
49063	chr9	92664381	92665230	849	424.0	
49064	chr9	92668791	92671606	2815	1408.0	
49065	chr9	92706456	92706907	451	226.0	
49066	chr9	92711871	92712344	473	236.0	
49067	chr9	92716410	92717133	723	362.0	
49068	chr9	92728924	92729805	881	440.0	
49069	chr9	92734849	92735159	310	155.0	
49070	chr9	92739944	92741143	1199	600.0	
49071	chr9	92749972	92750273	301	150.0	
49072	chr9	92754205	92754801	596	298.0	
49073	chr9	92762219	92766429	4210	2105.0	
49074	chr9	92769315	92771065	1750	875.0	
49075	chr9	92775410	92775893	483	242.0	
49076	chr9	92780220	92780551	331	166.0	
49077	chr9	92790524	92791395	871	436.0	
49078	chr9	92807408	92810016	2608	1304.0	
49079	chr9	92877378	92878587	1209	604.0	
49080	chr9	92887156	92888371	1215	608.0	
49081	chr9	92917131	92917744	613	306.0	
49082	chr9	92946874	92948146	1272	636.0	
49083	chr9	92953812	92954982	1170	585.0	
49084	chr9	92956782	92957668	886	443.0	
49085	chr9	92961523	92962652	1129	564.0	
49086	chr9	92963518	92971376	7858	3929.0	
49087	chr9	92972562	92973431	869	434.0	
49088	chr9	92978495	92978785	290	145.0	
49089	chr9	92980258	92980682	424	212.0	
49090	chr9	92985892	92986773	881	440.0	
49091	chr9	92989714	92989723	9	4.0	
49092	chr9	92992839	92992883	44	22.0	
49093	chr9	93000960	93001703	743	372.0	
49094	chr9	93003440	93004460	1020	510.0	
49095	chr9	93020630	93021564	934	467.0	
49096	chr9	93022498	93022508	10	5.0	
49097	chr9	93024268	93026132	1864	932.0	
49098	chr9	93026807	93030164	3357	1678.0	
49099	chr9	93031225	93041846	10621	5310.0	
49100	chr9	93042847	93043682	835	418.0	
49101	chr9	93045257	93046002	745	372.0	
49102	chr9	93052939	93053505	566	283.0	
49103	chr9	93054525	93062744	8219	4110.0	
49104	chr9	93063656	93065773	2117	1058.0	
49105	chr9	93071524	93071956	432	216.0	
49106	chr9	93082936	93084247	1311	656.0	
49107	chr9	93091422	93091914	492	246.0	
49108	chr9	93092922	93100288	7366	3683.0	
49109	chr9	93108077	93125025	16948	8474.0	
49110	chr9	93125739	93135358	9619	4810.0	
49111	chr9	93136095	93136415	320	160.0	
49112	chr9	93136935	93136943	8	4.0	
49113	chr9	93138100	93138561	461	230.0	
49114	chr9	93143663	93144799	1136	568.0	
49115	chr9	93146655	93147055	400	200.0	
49116	chr9	93148836	93149010	174	87.0	
49117	chr9	93154235	93154734	499	250.0	
49118	chr9	93159683	93160526	843	422.0	
49119	chr9	93173673	93174153	480	240.0	
49120	chr9	93183662	93185257	1595	798.0	
49121	chr9	93231267	93231851	584	292.0	
49122	chr9	93236789	93237127	338	169.0	
49123	chr9	93237644	93237646	2	1.0	
49124	chr9	93268511	93269395	884	442.0	
49125	chr9	93302472	93303113	641	320.0	
49126	chr9	93315172	93315421	249	124.0	
49127	chr9	93450381	93454312	3931	1966.0	
49128	chr9	93456402	93456961	559	280.0	
49129	chr9	93458857	93459158	301	150.0	
49130	chr9	93463864	93465245	1381	690.0	
49131	chr9	93468967	93469563	596	298.0	
49132	chr9	93500897	93501884	987	494.0	
49133	chr9	93504535	93506134	1599	800.0	
49134	chr9	93510069	93510430	361	180.0	
49135	chr9	93512125	93512632	507	254.0	
49136	chr9	93520535	93520948	413	206.0	
49137	chr9	93565773	93567718	1945	972.0	
49138	chr9	93569607	93570017	410	205.0	
49139	chr9	93574929	93579116	4187	2094.0	
49140	chr9	93624485	93624934	449	224.0	
49141	chr9	93669651	93671065	1414	707.0	
49142	chr9	93673251	93673562	311	156.0	
49143	chr9	93681930	93682577	647	324.0	
49144	chr9	93827368	93827814	446	223.0	
49145	chr9	93945253	93945982	729	364.0	
49146	chr9	93950990	93952115	1125	562.0	
49147	chr9	93953051	93953259	208	104.0	
49148	chr9	93955279	93956000	721	360.0	
49149	chr9	93958368	93959684	1316	658.0	
49150	chr9	93960250	93960743	493	246.0	
49151	chr9	93962744	93963568	824	412.0	
49152	chr9	94002600	94002726	126	63.0	
49153	chr9	94011143	94011264	121	60.0	
49154	chr9	94030062	94031421	1359	680.0	
49155	chr9	94065427	94065893	466	233.0	
49156	chr9	94153905	94154239	334	167.0	
49157	chr9	94156919	94157429	510	255.0	
49158	chr9	94164722	94168258	3536	1768.0	"enhancer	sequence_feature"
49159	chr9	94172798	94173152	354	177.0	
49160	chr9	94173841	94173920	79	40.0	
49161	chr9	94175574	94176126	552	276.0	
49162	chr9	94179027	94179091	64	32.0	
49163	chr9	94213407	94214164	757	378.0	
49164	chr9	94250616	94250637	21	10.0	
49165	chr9	94258720	94260210	1490	745.0	
49166	chr9	94332183	94332734	551	276.0	
49167	chr9	94346953	94347319	366	183.0	
49168	chr9	94373903	94375747	1844	922.0	
49169	chr9	94380140	94380448	308	154.0	
49170	chr9	94554444	94554737	293	146.0	
49171	chr9	94586282	94586697	415	208.0	
49172	chr9	94603228	94603777	549	274.0	
49173	chr9	94623297	94623661	364	182.0	
49174	chr9	94638317	94640332	2015	1008.0	
49175	chr9	94642922	94643911	989	494.0	
49176	chr9	94648858	94649860	1002	501.0	
49177	chr9	94651745	94652459	714	357.0	
49178	chr9	94654016	94655093	1077	538.0	
49179	chr9	94655715	94656934	1219	610.0	
49180	chr9	94668771	94669940	1169	584.0	
49181	chr9	94681352	94681904	552	276.0	
49182	chr9	94726085	94727444	1359	680.0	
49183	chr9	94734205	94734436	231	116.0	
49184	chr9	94783088	94783374	286	143.0	
49185	chr9	94860525	94862040	1515	758.0	
49186	chr9	94870784	94871828	1044	522.0	
49187	chr9	94918069	94918473	404	202.0	
49188	chr9	94952408	94952959	551	276.0	
49189	chr9	95004372	95005548	1176	588.0	
49190	chr9	95048115	95049132	1017	508.0	
49191	chr9	95127551	95128038	487	244.0	
49192	chr9	95131333	95131765	432	216.0	
49193	chr9	95167945	95168334	389	194.0	
49194	chr9	95189268	95189728	460	230.0	
49195	chr9	95273607	95274039	432	216.0	
49196	chr9	95316621	95318204	1583	792.0	
49197	chr9	95336314	95336686	372	186.0	
49198	chr9	95426560	95427221	661	330.0	
49199	chr9	95462131	95463611	1480	740.0	
49200	chr9	95491893	95492299	406	203.0	
49201	chr9	95493993	95495766	1773	886.0	enhancer
49202	chr9	95504542	95504828	286	143.0	
49203	chr9	95505520	95512306	6786	3393.0	enhancer
49204	chr9	95515513	95517520	2007	1004.0	
49205	chr9	95553211	95553665	454	227.0	
49206	chr9	95574138	95574522	384	192.0	
49207	chr9	95626956	95627264	308	154.0	
49208	chr9	95724107	95725448	1341	670.0	
49209	chr9	95726775	95727151	376	188.0	
49210	chr9	95750762	95751109	347	174.0	
49211	chr9	95772789	95773195	406	203.0	
49212	chr9	95874535	95876920	2385	1192.0	
49213	chr9	95887848	95888479	631	316.0	
49214	chr9	95919989	95920408	419	210.0	
49215	chr9	95980499	95980797	298	149.0	
49216	chr9	95981704	95982139	435	218.0	
49217	chr9	96008517	96010539	2022	1011.0	
49218	chr9	96013912	96014828	916	458.0	
49219	chr9	96015831	96016899	1068	534.0	
49220	chr9	96020596	96024319	3723	1862.0	
49221	chr9	96026115	96028257	2142	1071.0	
49222	chr9	96057407	96057415	8	4.0	
49223	chr9	96061108	96062449	1341	670.0	
49224	chr9	96071540	96071871	331	166.0	
49225	chr9	96137259	96137958	699	350.0	
49226	chr9	96139568	96139876	308	154.0	
49227	chr9	96141625	96142102	477	238.0	
49228	chr9	96143638	96143895	257	128.0	
49229	chr9	96146917	96147531	614	307.0	
49230	chr9	96150131	96150888	757	378.0	
49231	chr9	96159136	96159367	231	116.0	
49232	chr9	96203822	96204272	450	225.0	
49233	chr9	96217708	96218826	1118	559.0	
49234	chr9	96219349	96220081	732	366.0	
49235	chr9	96232407	96232817	410	205.0	
49236	chr9	96241274	96241768	494	247.0	
49237	chr9	96317321	96317733	412	206.0	
49238	chr9	96319135	96319641	506	253.0	
49239	chr9	96327664	96328169	505	252.0	
49240	chr9	96383033	96384222	1189	594.0	
49241	chr9	96398593	96399601	1008	504.0	
49242	chr9	96408958	96409032	74	37.0	
49243	chr9	96413288	96414371	1083	542.0	
49244	chr9	96416638	96419817	3179	1590.0	
49245	chr9	96420418	96421396	978	489.0	
49246	chr9	96425417	96426392	975	488.0	
49247	chr9	96436113	96436523	410	205.0	
49248	chr9	96441823	96442920	1097	548.0	
49249	chr9	96449321	96451682	2361	1180.0	
49250	chr9	96522500	96522628	128	64.0	
49251	chr9	96565967	96567623	1656	828.0	
49252	chr9	96618511	96620215	1704	852.0	
49253	chr9	96646090	96647088	998	499.0	
49254	chr9	96651571	96652011	440	220.0	
49255	chr9	96654014	96655873	1859	930.0	
49256	chr9	96666605	96667201	596	298.0	
49257	chr9	96686448	96687508	1060	530.0	
49258	chr9	96777121	96778813	1692	846.0	
49259	chr9	96853392	96854957	1565	782.0	
49260	chr9	96856578	96857482	904	452.0	
49261	chr9	96874800	96876168	1368	684.0	
49262	chr9	97012502	97014170	1668	834.0	
49263	chr9	97038532	97039816	1284	642.0	
49264	chr9	97042511	97043356	845	422.0	
49265	chr9	97221153	97222317	1164	582.0	
49266	chr9	97237845	97239057	1212	606.0	
49267	chr9	97366995	97367276	281	140.0	
49268	chr9	97386758	97387699	941	470.0	
49269	chr9	97388513	97389407	894	447.0	
49270	chr9	97398893	97399733	840	420.0	
49271	chr9	97411305	97413467	2162	1081.0	
49272	chr9	97417961	97418318	357	178.0	
49273	chr9	97447020	97447383	363	182.0	
49274	chr9	97468562	97469005	443	222.0	
49275	chr9	97487875	97488321	446	223.0	
49276	chr9	97501075	97502985	1910	955.0	
49277	chr9	97557584	97558198	614	307.0	
49278	chr9	97574607	97576071	1464	732.0	
49279	chr9	97598441	97599130	689	344.0	
49280	chr9	97615434	97615925	491	246.0	
49281	chr9	97631968	97634808	2840	1420.0	
49282	chr9	97638685	97638760	75	38.0	
49283	chr9	97660329	97660730	401	200.0	
49284	chr9	97666956	97667324	368	184.0	
49285	chr9	97696040	97698099	2059	1030.0	
49286	chr9	97699389	97699701	312	156.0	
49287	chr9	97705478	97706017	539	270.0	
49288	chr9	97710349	97711440	1091	546.0	
49289	chr9	97741223	97741621	398	199.0	
49290	chr9	97803079	97804364	1285	642.0	
49291	chr9	97832142	97832783	641	320.0	
49292	chr9	97848474	97849579	1105	552.0	
49293	chr9	97852063	97854769	2706	1353.0	
49294	chr9	97858199	97858509	310	155.0	
49295	chr9	97867148	97867150	2	1.0	
49296	chr9	97876592	97877274	682	341.0	enhancer
49297	chr9	97889866	97890583	717	358.0	
49298	chr9	97895863	97896318	455	228.0	
49299	chr9	97900932	97901449	517	258.0	
49300	chr9	97904573	97909371	4798	2399.0	
49301	chr9	97910185	97910765	580	290.0	
49302	chr9	97918398	97924913	6515	3258.0	
49303	chr9	97930963	97931335	372	186.0	
49304	chr9	97937986	97938780	794	397.0	
49305	chr9	97954465	97955011	546	273.0	
49306	chr9	97982321	97986080	3759	1880.0	
49307	chr9	97986637	97986849	212	106.0	
49308	chr9	97990046	97990617	571	286.0	
49309	chr9	97992930	97993435	505	252.0	
49310	chr9	98010337	98010896	559	280.0	
49311	chr9	98034460	98035358	898	449.0	
49312	chr9	98045003	98046042	1039	520.0	
49313	chr9	98055956	98057909	1953	976.0	
49314	chr9	98067297	98067447	150	75.0	
49315	chr9	98071771	98072603	832	416.0	
49316	chr9	98074111	98076520	2409	1204.0	
49317	chr9	98083244	98083593	349	174.0	
49318	chr9	98087254	98088376	1122	561.0	
49319	chr9	98092341	98093056	715	358.0	
49320	chr9	98097813	98098214	401	200.0	
49321	chr9	98099475	98100251	776	388.0	
49322	chr9	98101140	98102875	1735	868.0	
49323	chr9	98103737	98105038	1301	650.0	
49324	chr9	98107770	98109529	1759	880.0	
49325	chr9	98112214	98112953	739	370.0	
49326	chr9	98117655	98122187	4532	2266.0	
49327	chr9	98129055	98130023	968	484.0	
49328	chr9	98142264	98142800	536	268.0	
49329	chr9	98146042	98146712	670	335.0	
49330	chr9	98168925	98169562	637	318.0	
49331	chr9	98185201	98185954	753	376.0	
49332	chr9	98191103	98193777	2674	1337.0	
49333	chr9	98205447	98206347	900	450.0	
49334	chr9	98240385	98240724	339	170.0	
49335	chr9	98241353	98241785	432	216.0	
49336	chr9	98248004	98249434	1430	715.0	
49337	chr9	98250465	98251519	1054	527.0	
49338	chr9	98253565	98257280	3715	1858.0	
49339	chr9	98263623	98264205	582	291.0	
49340	chr9	98314425	98314686	261	130.0	
49341	chr9	98315463	98316100	637	318.0	
49342	chr9	98575629	98576115	486	243.0	
49343	chr9	98726697	98727212	515	258.0	
49344	chr9	98750465	98751044	579	290.0	
49345	chr9	98766577	98767129	552	276.0	
49346	chr9	98774798	98775205	407	204.0	
49347	chr9	98775852	98776249	397	198.0	
49348	chr9	98790987	98791617	630	315.0	
49349	chr9	98795841	98797250	1409	704.0	
49350	chr9	98807057	98808928	1871	936.0	
49351	chr9	98811187	98811458	271	136.0	
49352	chr9	98848486	98848994	508	254.0	
49353	chr9	98862335	98862355	20	10.0	
49354	chr9	98867457	98868058	601	300.0	
49355	chr9	98922809	98923271	462	231.0	
49356	chr9	98974689	98975569	880	440.0	
49357	chr9	98989361	98989467	106	53.0	
49358	chr9	98993304	98994849	1545	772.0	
49359	chr9	98998782	98999438	656	328.0	
49360	chr9	99000369	99001226	857	428.0	
49361	chr9	99012962	99014095	1133	566.0	
49362	chr9	99039442	99040193	751	376.0	
49363	chr9	99040926	99041828	902	451.0	
49364	chr9	99052840	99053528	688	344.0	
49365	chr9	99056821	99060117	3296	1648.0	
49366	chr9	99069318	99069323	5	2.0	
49367	chr9	99076323	99077289	966	483.0	
49368	chr9	99085931	99086696	765	382.0	
49369	chr9	99092608	99093282	674	337.0	
49370	chr9	99099861	99099930	69	34.0	
49371	chr9	99100864	99101293	429	214.0	
49372	chr9	99103607	99110045	6438	3219.0	
49373	chr9	99111367	99112141	774	387.0	
49374	chr9	99112704	99113843	1139	570.0	
49375	chr9	99118791	99120388	1597	798.0	
49376	chr9	99121666	99121874	208	104.0	
49377	chr9	99129970	99130554	584	292.0	
49378	chr9	99134765	99135988	1223	612.0	
49379	chr9	99136983	99137769	786	393.0	
49380	chr9	99140484	99141151	667	334.0	
49381	chr9	99150445	99151017	572	286.0	
49382	chr9	99162795	99163214	419	210.0	
49383	chr9	99181485	99182119	634	317.0	
49384	chr9	99184234	99185203	969	484.0	
49385	chr9	99187295	99187656	361	180.0	
49386	chr9	99213276	99213591	315	158.0	
49387	chr9	99221072	99223168	2096	1048.0	
49388	chr9	99231730	99232151	421	210.0	
49389	chr9	99235750	99236487	737	368.0	
49390	chr9	99244908	99245308	400	200.0	
49391	chr9	99253702	99254444	742	371.0	
49392	chr9	99259121	99260052	931	466.0	
49393	chr9	99264297	99264404	107	54.0	
49394	chr9	99266384	99267112	728	364.0	
49395	chr9	99296371	99297078	707	354.0	
49396	chr9	99368365	99368838	473	236.0	
49397	chr9	99430101	99430696	595	298.0	
49398	chr9	99433336	99434048	712	356.0	
49399	chr9	99491880	99492157	277	138.0	
49400	chr9	99513754	99514000	246	123.0	
49401	chr9	99515142	99515417	275	138.0	
49402	chr9	99579878	99580488	610	305.0	
49403	chr9	99590613	99591329	716	358.0	
49404	chr9	99593730	99593800	70	35.0	
49405	chr9	99595653	99596381	728	364.0	
49406	chr9	99628896	99629250	354	177.0	
49407	chr9	99634181	99634596	415	208.0	
49408	chr9	99637692	99638018	326	163.0	
49409	chr9	99659950	99660779	829	414.0	
49410	chr9	99682897	99683177	280	140.0	
49411	chr9	99720453	99721084	631	316.0	
49412	chr9	99722843	99723244	401	200.0	
49413	chr9	99732681	99733017	336	168.0	
49414	chr9	99748357	99748970	613	306.0	
49415	chr9	99762277	99762941	664	332.0	
49416	chr9	99782993	99783370	377	188.0	
49417	chr9	99787588	99787905	317	158.0	
49418	chr9	99807024	99807880	856	428.0	
49419	chr9	99811619	99812025	406	203.0	
49420	chr9	99818641	99831883	13242	6621.0	
49421	chr9	99832468	99837047	4579	2290.0	
49422	chr9	99837600	99853029	15429	7714.0	
49423	chr9	99855635	99855883	248	124.0	
49424	chr9	99876224	99876556	332	166.0	
49425	chr9	99905883	99907776	1893	946.0	
49426	chr9	100011033	100011488	455	228.0	
49427	chr9	100028049	100028700	651	326.0	
49428	chr9	100052429	100052736	307	154.0	
49429	chr9	100058713	100059114	401	200.0	
49430	chr9	100066496	100066994	498	249.0	
49431	chr9	100079226	100079657	431	216.0	
49432	chr9	100083562	100085146	1584	792.0	
49433	chr9	100087202	100087578	376	188.0	
49434	chr9	100097922	100100223	2301	1150.0	
49435	chr9	100209556	100210485	929	464.0	
49436	chr9	100216111	100216639	528	264.0	
49437	chr9	100322907	100323343	436	218.0	
49438	chr9	100350455	100350485	30	15.0	
49439	chr9	100351776	100354668	2892	1446.0	
49440	chr9	100394859	100395205	346	173.0	
49441	chr9	100410444	100412314	1870	935.0	
49442	chr9	100426220	100428158	1938	969.0	
49443	chr9	100437797	100438341	544	272.0	
49444	chr9	100472771	100474120	1349	674.0	
49445	chr9	100595384	100596071	687	344.0	
49446	chr9	100598179	100599318	1139	570.0	
49447	chr9	100601143	100601548	405	202.0	
49448	chr9	100890295	100890743	448	224.0	
49449	chr9	101311710	101312062	352	176.0	
49450	chr9	101387746	101388202	456	228.0	
49451	chr9	101397715	101400367	2652	1326.0	
49452	chr9	101449010	101449681	671	336.0	
49453	chr9	101458959	101459435	476	238.0	
49454	chr9	101529867	101530564	697	348.0	
49455	chr9	101533017	101534581	1564	782.0	
49456	chr9	101567324	101567486	162	81.0	
49457	chr9	101569854	101570817	963	482.0	
49458	chr9	101578341	101578888	547	274.0	
49459	chr9	101579732	101580438	706	353.0	
49460	chr9	101585525	101587056	1531	766.0	
49461	chr9	101602115	101602586	471	236.0	
49462	chr9	101626327	101626675	348	174.0	
49463	chr9	101629626	101630030	404	202.0	
49464	chr9	101705231	101705508	277	138.0	
49465	chr9	104082158	104082566	408	204.0	
49466	chr9	104091091	104092184	1093	546.0	
49467	chr9	104093008	104095173	2165	1082.0	
49468	chr9	104743324	104744019	695	348.0	
49469	chr9	104746964	104749056	2092	1046.0	
49470	chr9	104750336	104750872	536	268.0	
49471	chr9	104763454	104764852	1398	699.0	
49472	chr9	104765359	104765697	338	169.0	
49473	chr9	104769931	104770084	153	76.0	
49474	chr9	104775191	104776059	868	434.0	
49475	chr9	104780154	104781208	1054	527.0	
49476	chr9	104784050	104784566	516	258.0	
49477	chr9	104795096	104795496	400	200.0	
49478	chr9	104829929	104830389	460	230.0	
49479	chr9	104835367	104835427	60	30.0	
49480	chr9	104850899	104851230	331	166.0	
49481	chr9	104860342	104860751	409	204.0	
49482	chr9	104861359	104861791	432	216.0	
49483	chr9	104863170	104863850	680	340.0	
49484	chr9	104866138	104866660	522	261.0	
49485	chr9	104868529	104869787	1258	629.0	
49486	chr9	104872878	104873883	1005	502.0	
49487	chr9	104909498	104910378	880	440.0	
49488	chr9	104914498	104914853	355	178.0	
49489	chr9	104923779	104924180	401	200.0	
49490	chr9	104926168	104928694	2526	1263.0	
49491	chr9	104961129	104961740	611	306.0	
49492	chr9	104967757	104968990	1233	616.0	
49493	chr9	104974251	104974532	281	140.0	
49494	chr9	104989543	104990113	570	285.0	
49495	chr9	104990715	104994102	3387	1694.0	
49496	chr9	105003423	105004043	620	310.0	
49497	chr9	105006544	105007729	1185	592.0	
49498	chr9	105040559	105041175	616	308.0	
49499	chr9	105051888	105053780	1892	946.0	
49500	chr9	105063474	105065349	1875	938.0	
49501	chr9	105066248	105066859	611	306.0	
49502	chr9	105114908	105115961	1053	526.0	
49503	chr9	105124542	105125032	490	245.0	
49504	chr9	105127494	105128440	946	473.0	
49505	chr9	105129176	105129222	46	23.0	
49506	chr9	105141218	105143403	2185	1092.0	
49507	chr9	105144015	105144490	475	238.0	
49508	chr9	105154593	105155459	866	433.0	
49509	chr9	105156974	105157698	724	362.0	
49510	chr9	105159659	105160094	435	218.0	
49511	chr9	105187821	105188064	243	122.0	
49512	chr9	105191360	105192270	910	455.0	
49513	chr9	105243619	105246192	2573	1286.0	
49514	chr9	105255576	105255737	161	80.0	
49515	chr9	105264534	105264586	52	26.0	
49516	chr9	105296885	105297115	230	115.0	
49517	chr9	105299514	105299808	294	147.0	
49518	chr9	105341878	105342009	131	66.0	
49519	chr9	105385286	105385979	693	346.0	
49520	chr9	105405307	105406173	866	433.0	
49521	chr9	105415204	105415846	642	321.0	
49522	chr9	105447458	105448885	1427	714.0	
49523	chr9	105500140	105500911	771	386.0	
49524	chr9	105557466	105558725	1259	630.0	
49525	chr9	105608975	105609374	399	200.0	
49526	chr9	105656022	105656690	668	334.0	
49527	chr9	105662277	105662503	226	113.0	
49528	chr9	105672937	105673220	283	142.0	
49529	chr9	105693279	105695797	2518	1259.0	
49530	chr9	105708726	105708732	6	3.0	
49531	chr9	105718465	105718813	348	174.0	
49532	chr9	105858637	105858659	22	11.0	
49533	chr9	105859516	105860149	633	316.0	
49534	chr9	105881663	105882098	435	218.0	
49535	chr9	106310822	106311117	295	148.0	
49536	chr9	106753463	106753500	37	18.0	
49537	chr9	106921336	106921824	488	244.0	
49538	chr9	106964340	106964654	314	157.0	
49539	chr9	107172205	107172526	321	160.0	
49540	chr9	107213403	107213999	596	298.0	
49541	chr9	107218884	107219058	174	87.0	
49542	chr9	107239547	107239851	304	152.0	
49543	chr9	107246273	107246605	332	166.0	
49544	chr9	107260387	107260909	522	261.0	
49545	chr9	107274123	107274513	390	195.0	
49546	chr9	107281190	107281506	316	158.0	
49547	chr9	107282103	107284981	2878	1439.0	
49548	chr9	107299480	107299650	170	85.0	
49549	chr9	107309196	107309749	553	276.0	
49550	chr9	107317011	107317135	124	62.0	
49551	chr9	107324122	107324178	56	28.0	
49552	chr9	107340954	107341768	814	407.0	
49553	chr9	107422183	107422590	407	204.0	
49554	chr9	107424995	107425645	650	325.0	
49555	chr9	107465384	107466393	1009	504.0	
49556	chr9	107478812	107479248	436	218.0	
49557	chr9	107480275	107481404	1129	564.0	
49558	chr9	107481991	107482375	384	192.0	
49559	chr9	107483042	107484592	1550	775.0	
49560	chr9	107485160	107491727	6567	3284.0	
49561	chr9	107492334	107492684	350	175.0	
49562	chr9	107493994	107494411	417	208.0	
49563	chr9	107502200	107502481	281	140.0	
49564	chr9	107504847	107505224	377	188.0	
49565	chr9	107513264	107514167	903	452.0	
49566	chr9	107530652	107531110	458	229.0	
49567	chr9	107548065	107548940	875	438.0	
49568	chr9	107587101	107588105	1004	502.0	
49569	chr9	107594888	107595488	600	300.0	
49570	chr9	107603633	107604067	434	217.0	
49571	chr9	107611992	107612792	800	400.0	
49572	chr9	107615154	107615871	717	358.0	
49573	chr9	107630116	107630594	478	239.0	
49574	chr9	107635761	107636169	408	204.0	
49575	chr9	107636757	107639436	2679	1340.0	
49576	chr9	107644724	107645631	907	454.0	
49577	chr9	107674672	107676528	1856	928.0	
49578	chr9	107683477	107684553	1076	538.0	
49579	chr9	107711731	107711790	59	30.0	
49580	chr9	107712383	107712871	488	244.0	
49581	chr9	107749696	107752256	2560	1280.0	
49582	chr9	107755103	107755628	525	262.0	
49583	chr9	107760509	107761433	924	462.0	
49584	chr9	107774062	107774512	450	225.0	
49585	chr9	107841019	107841543	524	262.0	
49586	chr9	107848555	107849646	1091	546.0	
49587	chr9	107862326	107863721	1395	698.0	
49588	chr9	107866826	107867406	580	290.0	
49589	chr9	107868109	107868656	547	274.0	
49590	chr9	107874518	107875462	944	472.0	
49591	chr9	107878383	107878915	532	266.0	
49592	chr9	107883657	107884222	565	282.0	
49593	chr9	107929018	107929950	932	466.0	
49594	chr9	107942708	107943316	608	304.0	
49595	chr9	107946735	107947136	401	200.0	
49596	chr9	107954304	107954733	429	214.0	
49597	chr9	107976650	107977293	643	322.0	
49598	chr9	107982064	107983420	1356	678.0	
49599	chr9	107989199	107990106	907	454.0	
49600	chr9	108002647	108003030	383	192.0	
49601	chr9	108021152	108021462	310	155.0	
49602	chr9	108056147	108056441	294	147.0	
49603	chr9	108057369	108057984	615	308.0	
49604	chr9	108070002	108070402	400	200.0	
49605	chr9	108073875	108074233	358	179.0	
49606	chr9	108083931	108084323	392	196.0	
49607	chr9	108113620	108113933	313	156.0	
49608	chr9	108156535	108156989	454	227.0	
49609	chr9	108158688	108158697	9	4.0	
49610	chr9	108181467	108181829	362	181.0	
49611	chr9	108182896	108183347	451	226.0	
49612	chr9	108213546	108213902	356	178.0	
49613	chr9	108272000	108272922	922	461.0	
49614	chr9	108296934	108297689	755	378.0	
49615	chr9	108300271	108301337	1066	533.0	
49616	chr9	108316624	108317013	389	194.0	
49617	chr9	108469485	108470165	680	340.0	
49618	chr9	108565732	108566188	456	228.0	
49619	chr9	108579938	108580430	492	246.0	
49620	chr9	108586728	108586747	19	10.0	
49621	chr9	108615215	108615516	301	150.0	
49622	chr9	108622128	108622912	784	392.0	
49623	chr9	108631794	108632366	572	286.0	
49624	chr9	108642945	108643244	299	150.0	
49625	chr9	108761811	108762176	365	182.0	
49626	chr9	108816110	108816555	445	222.0	
49627	chr9	108818404	108818896	492	246.0	
49628	chr9	108933131	108935238	2107	1054.0	
49629	chr9	108953987	108954386	399	200.0	
49630	chr9	108994631	108995128	497	248.0	
49631	chr9	109010613	109011303	690	345.0	
49632	chr9	109011984	109014996	3012	1506.0	
49633	chr9	109017569	109017890	321	160.0	
49634	chr9	109020670	109020911	241	120.0	
49635	chr9	109086185	109086632	447	224.0	
49636	chr9	109097246	109097248	2	1.0	
49637	chr9	109101297	109102260	963	482.0	
49638	chr9	109107626	109108031	405	202.0	
49639	chr9	109110253	109111126	873	436.0	
49640	chr9	109117794	109120657	2863	1432.0	
49641	chr9	109122551	109123517	966	483.0	
49642	chr9	109143950	109144285	335	168.0	
49643	chr9	109181308	109181563	255	128.0	
49644	chr9	109244477	109244886	409	204.0	
49645	chr9	109320658	109321456	798	399.0	
49646	chr9	109440681	109441117	436	218.0	
49647	chr9	109469651	109470009	358	179.0	
49648	chr9	109880499	109880894	395	198.0	
49649	chr9	109903491	109903960	469	234.0	
49650	chr9	109914463	109914740	277	138.0	
49651	chr9	109918356	109918785	429	214.0	
49652	chr9	109926433	109926733	300	150.0	
49653	chr9	109966942	109968657	1715	858.0	
49654	chr9	109972052	109972846	794	397.0	
49655	chr9	109974220	109974918	698	349.0	
49656	chr9	110021792	110022411	619	310.0	
49657	chr9	110029343	110030471	1128	564.0	
49658	chr9	110047589	110050228	2639	1320.0	
49659	chr9	110050798	110051477	679	340.0	
49660	chr9	110058313	110058805	492	246.0	
49661	chr9	110064668	110066129	1461	730.0	
49662	chr9	110069583	110070285	702	351.0	
49663	chr9	110126507	110126822	315	158.0	
49664	chr9	110127381	110127844	463	232.0	
49665	chr9	110128470	110129362	892	446.0	
49666	chr9	110131944	110132368	424	212.0	
49667	chr9	110143200	110144430	1230	615.0	
49668	chr9	110148168	110149222	1054	527.0	
49669	chr9	110152748	110153388	640	320.0	
49670	chr9	110156349	110157633	1284	642.0	
49671	chr9	110183190	110183638	448	224.0	
49672	chr9	110188996	110189405	409	204.0	
49673	chr9	110252469	110252912	443	222.0	
49674	chr9	110253799	110258182	4383	2192.0	
49675	chr9	110303105	110303516	411	206.0	
49676	chr9	110316467	110316621	154	77.0	
49677	chr9	110317952	110318238	286	143.0	
49678	chr9	110329817	110330217	400	200.0	
49679	chr9	110603983	110604835	852	426.0	
49680	chr9	110802465	110802932	467	234.0	
49681	chr9	110875134	110875750	616	308.0	
49682	chr9	110919694	110920105	411	206.0	
49683	chr9	111023294	111023422	128	64.0	
49684	chr9	111034524	111035195	671	336.0	
49685	chr9	111036414	111036881	467	234.0	
49686	chr9	111037478	111039390	1912	956.0	
49687	chr9	111065473	111065773	300	150.0	
49688	chr9	111068713	111069294	581	290.0	
49689	chr9	111074298	111074823	525	262.0	
49690	chr9	111076025	111077009	984	492.0	
49691	chr9	111078170	111079214	1044	522.0	
49692	chr9	111094346	111095040	694	347.0	
49693	chr9	111108851	111109418	567	284.0	
49694	chr9	111148610	111149319	709	354.0	
49695	chr9	111163592	111164415	823	412.0	enhancer
49696	chr9	111253916	111254479	563	282.0	
49697	chr9	111284715	111285116	401	200.0	
49698	chr9	111299301	111299705	404	202.0	
49699	chr9	111476626	111476811	185	92.0	
49700	chr9	111482191	111484938	2747	1374.0	
49701	chr9	111524795	111526324	1529	764.0	
49702	chr9	111597684	111599994	2310	1155.0	
49703	chr9	111621867	111623061	1194	597.0	
49704	chr9	111630467	111632483	2016	1008.0	
49705	chr9	111660939	111663492	2553	1276.0	
49706	chr9	111759967	111760498	531	266.0	
49707	chr9	111839393	111839652	259	130.0	
49708	chr9	111891915	111892525	610	305.0	
49709	chr9	111896012	111898752	2740	1370.0	
49710	chr9	111909360	111909834	474	237.0	
49711	chr9	111913186	111913383	197	98.0	
49712	chr9	111914931	111915310	379	190.0	
49713	chr9	111916209	111916596	387	194.0	
49714	chr9	111926250	111927225	975	488.0	
49715	chr9	111937412	111938791	1379	690.0	
49716	chr9	111945137	111945535	398	199.0	
49717	chr9	111953556	111953570	14	7.0	
49718	chr9	111958010	111958645	635	318.0	
49719	chr9	111959697	111959954	257	128.0	
49720	chr9	111975764	111976043	279	140.0	
49721	chr9	111983409	111983997	588	294.0	
49722	chr9	111986906	111987019	113	56.0	
49723	chr9	112002685	112002807	122	61.0	
49724	chr9	112012289	112013717	1428	714.0	
49725	chr9	112031552	112032384	832	416.0	
49726	chr9	112036153	112036172	19	10.0	
49727	chr9	112037496	112038486	990	495.0	
49728	chr9	112059354	112059685	331	166.0	
49729	chr9	112060993	112061833	840	420.0	
49730	chr9	112064393	112064713	320	160.0	
49731	chr9	112069236	112070146	910	455.0	
49732	chr9	112074451	112075213	762	381.0	
49733	chr9	112078498	112078908	410	205.0	
49734	chr9	112097498	112098373	875	438.0	
49735	chr9	112104866	112105367	501	250.0	
49736	chr9	112113007	112113143	136	68.0	
49737	chr9	112140530	112140886	356	178.0	
49738	chr9	112162514	112163174	660	330.0	
49739	chr9	112174019	112177342	3323	1662.0	
49740	chr9	112178339	112179060	721	360.0	
49741	chr9	112180213	112181766	1553	776.0	
49742	chr9	112218889	112219340	451	226.0	
49743	chr9	112317097	112317801	704	352.0	
49744	chr9	112328057	112328346	289	144.0	
49745	chr9	112330905	112334985	4080	2040.0	
49746	chr9	112348310	112349225	915	458.0	
49747	chr9	112355541	112355543	2	1.0	
49748	chr9	112361499	112362136	637	318.0	
49749	chr9	112377191	112377493	302	151.0	
49750	chr9	112378549	112381335	2786	1393.0	
49751	chr9	112384660	112385126	466	233.0	
49752	chr9	112408252	112408583	331	166.0	
49753	chr9	112443226	112443593	367	184.0	
49754	chr9	112485980	112488041	2061	1030.0	
49755	chr9	112495572	112496771	1199	600.0	
49756	chr9	112546203	112546493	290	145.0	
49757	chr9	112549190	112549693	503	252.0	
49758	chr9	112621330	112621409	79	40.0	
49759	chr9	112717100	112718920	1820	910.0	
49760	chr9	112726440	112727556	1116	558.0	
49761	chr9	112734957	112735256	299	150.0	
49762	chr9	112743400	112743808	408	204.0	
49763	chr9	112747968	112748359	391	196.0	
49764	chr9	112749402	112752181	2779	1390.0	
49765	chr9	112752855	112753132	277	138.0	
49766	chr9	112753656	112755547	1891	946.0	
49767	chr9	112758001	112758006	5	2.0	
49768	chr9	112771714	112772473	759	380.0	
49769	chr9	112787169	112787473	304	152.0	
49770	chr9	112793107	112793678	571	286.0	
49771	chr9	112809215	112810140	925	462.0	
49772	chr9	112819955	112820011	56	28.0	
49773	chr9	112831174	112831560	386	193.0	
49774	chr9	112839246	112839752	506	253.0	
49775	chr9	112841362	112841607	245	122.0	
49776	chr9	112844582	112845115	533	266.0	
49777	chr9	112849605	112849818	213	106.0	
49778	chr9	112858227	112859298	1071	536.0	
49779	chr9	112860452	112864663	4211	2106.0	
49780	chr9	112867259	112868122	863	432.0	
49781	chr9	112887289	112887903	614	307.0	
49782	chr9	112890375	112891318	943	472.0	
49783	chr9	112894053	112895182	1129	564.0	
49784	chr9	112898850	112899454	604	302.0	
49785	chr9	112903025	112903621	596	298.0	
49786	chr9	112921481	112921822	341	170.0	
49787	chr9	113012068	113012289	221	110.0	
49788	chr9	113056146	113057218	1072	536.0	
49789	chr9	113059440	113059699	259	130.0	
49790	chr9	113111452	113113158	1706	853.0	
49791	chr9	113125289	113125924	635	318.0	
49792	chr9	113149075	113149753	678	339.0	
49793	chr9	113150461	113153109	2648	1324.0	
49794	chr9	113154396	113156543	2147	1074.0	
49795	chr9	113161600	113161914	314	157.0	
49796	chr9	113169301	113169655	354	177.0	
49797	chr9	113176832	113177128	296	148.0	
49798	chr9	113187659	113188842	1183	592.0	
49799	chr9	113205800	113206854	1054	527.0	
49800	chr9	113215084	113215550	466	233.0	
49801	chr9	113218910	113222958	4048	2024.0	
49802	chr9	113227410	113227723	313	156.0	
49803	chr9	113228224	113228407	183	92.0	
49804	chr9	113232603	113233686	1083	542.0	
49805	chr9	113255437	113255870	433	216.0	
49806	chr9	113274166	113276470	2304	1152.0	
49807	chr9	113299906	113300422	516	258.0	
49808	chr9	113309236	113309559	323	162.0	
49809	chr9	113339621	113340864	1243	622.0	
49810	chr9	113347819	113348304	485	242.0	
49811	chr9	113349240	113351479	2239	1120.0	
49812	chr9	113365636	113366088	452	226.0	
49813	chr9	113376187	113377783	1596	798.0	
49814	chr9	113386627	113387014	387	194.0	
49815	chr9	113400678	113402114	1436	718.0	
49816	chr9	113403605	113404018	413	206.0	
49817	chr9	113406686	113407372	686	343.0	
49818	chr9	113409498	113411773	2275	1138.0	
49819	chr9	113416304	113416821	517	258.0	
49820	chr9	113417602	113417741	139	70.0	
49821	chr9	113446241	113446680	439	220.0	
49822	chr9	113479181	113479547	366	183.0	
49823	chr9	113502628	113503357	729	364.0	
49824	chr9	113511452	113512990	1538	769.0	
49825	chr9	113513734	113513889	155	78.0	
49826	chr9	113516760	113518699	1939	970.0	
49827	chr9	113519297	113520881	1584	792.0	
49828	chr9	113522899	113525226	2327	1164.0	
49829	chr9	113526188	113526596	408	204.0	
49830	chr9	113548113	113549181	1068	534.0	
49831	chr9	113564480	113565789	1309	654.0	
49832	chr9	113577890	113582662	4772	2386.0	
49833	chr9	113586347	113586719	372	186.0	
49834	chr9	113587747	113587980	233	116.0	
49835	chr9	113589251	113590323	1072	536.0	
49836	chr9	113591585	113592208	623	312.0	
49837	chr9	113593699	113594263	564	282.0	
49838	chr9	113602086	113602421	335	168.0	
49839	chr9	113615313	113615575	262	131.0	
49840	chr9	113623009	113623262	253	126.0	
49841	chr9	113655332	113655822	490	245.0	
49842	chr9	113657683	113658600	917	458.0	
49843	chr9	113682214	113682810	596	298.0	
49844	chr9	113705357	113705758	401	200.0	
49845	chr9	113737706	113737761	55	28.0	
49846	chr9	113739011	113739360	349	174.0	
49847	chr9	113807341	113807863	522	261.0	
49848	chr9	113857885	113858369	484	242.0	
49849	chr9	113875842	113876955	1113	556.0	
49850	chr9	113884716	113885139	423	212.0	
49851	chr9	113886422	113887317	895	448.0	
49852	chr9	113963059	113963369	310	155.0	
49853	chr9	113992779	113993363	584	292.0	
49854	chr9	114004296	114004675	379	190.0	
49855	chr9	114082460	114082871	411	206.0	
49856	chr9	114098303	114098859	556	278.0	
49857	chr9	114107943	114108296	353	176.0	
49858	chr9	114155160	114157087	1927	964.0	
49859	chr9	114283067	114283295	228	114.0	
49860	chr9	114290948	114291397	449	224.0	
49861	chr9	114305768	114306231	463	232.0	
49862	chr9	114317876	114318096	220	110.0	
49863	chr9	114327634	114328252	618	309.0	
49864	chr9	114330946	114332923	1977	988.0	
49865	chr9	114335652	114337356	1704	852.0	
49866	chr9	114338471	114342416	3945	1972.0	
49867	chr9	114348393	114349952	1559	780.0	
49868	chr9	114363128	114365114	1986	993.0	
49869	chr9	114366048	114376085	10037	5018.0	
49870	chr9	114379186	114379461	275	138.0	
49871	chr9	114380746	114391159	10413	5206.0	
49872	chr9	114392729	114393566	837	418.0	
49873	chr9	114394798	114395564	766	383.0	
49874	chr9	114397101	114399240	2139	1070.0	
49875	chr9	114405279	114406225	946	473.0	
49876	chr9	114409373	114409864	491	246.0	
49877	chr9	114416275	114416760	485	242.0	
49878	chr9	114451363	114453124	1761	880.0	
49879	chr9	114475480	114475788	308	154.0	
49880	chr9	114480838	114481135	297	148.0	
49881	chr9	114482419	114482774	355	178.0	
49882	chr9	114484757	114485481	724	362.0	
49883	chr9	114487317	114488200	883	442.0	
49884	chr9	114493902	114494295	393	196.0	
49885	chr9	114495070	114495536	466	233.0	
49886	chr9	114496282	114496947	665	332.0	
49887	chr9	114497672	114498133	461	230.0	
49888	chr9	114500654	114501184	530	265.0	
49889	chr9	114501687	114506226	4539	2270.0	
49890	chr9	114507642	114508344	702	351.0	
49891	chr9	114513246	114513957	711	356.0	
49892	chr9	114518454	114519027	573	286.0	
49893	chr9	114538193	114538674	481	240.0	
49894	chr9	114549732	114549903	171	86.0	
49895	chr9	114551916	114552311	395	198.0	
49896	chr9	114556845	114557845	1000	500.0	
49897	chr9	114560035	114560537	502	251.0	
49898	chr9	114566485	114566998	513	256.0	
49899	chr9	114586907	114589362	2455	1228.0	
49900	chr9	114591179	114593183	2004	1002.0	
49901	chr9	114607936	114608007	71	36.0	
49902	chr9	114610764	114612830	2066	1033.0	
49903	chr9	114616564	114617575	1011	506.0	
49904	chr9	114619054	114619906	852	426.0	
49905	chr9	114641954	114642397	443	222.0	
49906	chr9	114653220	114654017	797	398.0	
49907	chr9	114662035	114662873	838	419.0	
49908	chr9	114681448	114682508	1060	530.0	
49909	chr9	114685984	114686323	339	170.0	
49910	chr9	114690913	114691752	839	420.0	
49911	chr9	114696913	114697652	739	370.0	
49912	chr9	114718672	114719408	736	368.0	
49913	chr9	114735155	114736094	939	470.0	
49914	chr9	114737242	114737447	205	102.0	
49915	chr9	114738496	114739437	941	470.0	
49916	chr9	114745308	114745666	358	179.0	
49917	chr9	114754466	114755120	654	327.0	
49918	chr9	114774805	114774833	28	14.0	
49919	chr9	114784801	114785088	287	144.0	
49920	chr9	114805689	114806791	1102	551.0	
49921	chr9	114820713	114821274	561	280.0	
49922	chr9	114851440	114852576	1136	568.0	
49923	chr9	114869971	114870228	257	128.0	
49924	chr9	114880245	114880882	637	318.0	
49925	chr9	114883613	114884197	584	292.0	
49926	chr9	114889702	114890266	564	282.0	
49927	chr9	114893226	114894145	919	460.0	
49928	chr9	114894742	114895607	865	432.0	
49929	chr9	114898293	114899446	1153	576.0	
49930	chr9	114906916	114907560	644	322.0	
49931	chr9	114908343	114910070	1727	864.0	
49932	chr9	114910613	114911569	956	478.0	
49933	chr9	114927869	114931300	3431	1716.0	
49934	chr9	114936550	114937837	1287	644.0	
49935	chr9	114939025	114939404	379	190.0	
49936	chr9	114945676	114945945	269	134.0	
49937	chr9	114953648	114954425	777	388.0	
49938	chr9	114955182	114955644	462	231.0	
49939	chr9	114957791	114959189	1398	699.0	
49940	chr9	114968466	114969234	768	384.0	
49941	chr9	114988826	114990233	1407	704.0	
49942	chr9	114995504	114996376	872	436.0	
49943	chr9	115006563	115007152	589	294.0	
49944	chr9	115008525	115009020	495	248.0	
49945	chr9	115013738	115014466	728	364.0	
49946	chr9	115015110	115015390	280	140.0	
49947	chr9	115016303	115016749	446	223.0	
49948	chr9	115035743	115036242	499	250.0	
49949	chr9	115043036	115043451	415	208.0	
49950	chr9	116450496	116450753	257	128.0	
49951	chr9	116504909	116505177	268	134.0	
49952	chr9	116549175	116549763	588	294.0	
49953	chr9	116572167	116572503	336	168.0	
49954	chr9	116661041	116661440	399	200.0	
49955	chr9	116686287	116688214	1927	964.0	
49956	chr9	116737096	116737293	197	98.0	
49957	chr9	116935459	116935948	489	244.0	
49958	chr9	116943984	116944385	401	200.0	
49959	chr9	116945649	116946450	801	400.0	
49960	chr9	116949291	116949692	401	200.0	
49961	chr9	116958973	116959304	331	166.0	
49962	chr9	116986085	116986397	312	156.0	
49963	chr9	116987798	116988480	682	341.0	
49964	chr9	116990661	116990869	208	104.0	
49965	chr9	116992899	116993244	345	172.0	
49966	chr9	117487493	117487922	429	214.0	
49967	chr9	117546827	117547315	488	244.0	
49968	chr9	117644274	117645499	1225	612.0	
49969	chr9	117677684	117677850	166	83.0	
49970	chr9	117682001	117682205	204	102.0	
49971	chr9	117696077	117696597	520	260.0	
49972	chr9	117697128	117697153	25	12.0	
49973	chr9	117703533	117704976	1443	722.0	
49974	chr9	117706719	117706737	18	9.0	
49975	chr9	117715728	117715733	5	2.0	
49976	chr9	117717979	117718721	742	371.0	
49977	chr9	117723981	117724633	652	326.0	
49978	chr9	117725228	117726039	811	406.0	
49979	chr9	117734003	117734033	30	15.0	
49980	chr9	117744362	117745317	955	478.0	
49981	chr9	117777806	117778227	421	210.0	
49982	chr9	117782676	117784438	1762	881.0	
49983	chr9	117787685	117788109	424	212.0	
49984	chr9	117815453	117815664	211	106.0	
49985	chr9	117822054	117822263	209	104.0	
49986	chr9	117825681	117827237	1556	778.0	
49987	chr9	117936172	117936554	382	191.0	
49988	chr9	119556085	119556417	332	166.0	
49989	chr9	119969038	119969481	443	222.0	
49990	chr9	120403024	120403792	768	384.0	
49991	chr9	120431218	120431718	500	250.0	
49992	chr9	120436959	120437304	345	172.0	
49993	chr9	120446040	120446382	342	171.0	
49994	chr9	120474501	120475253	752	376.0	
49995	chr9	120477389	120478651	1262	631.0	
49996	chr9	120481797	120482295	498	249.0	
49997	chr9	120490828	120491374	546	273.0	
49998	chr9	120555813	120556298	485	242.0	
49999	chr9	120579429	120580911	1482	741.0	
50000	chr9	120583813	120584556	743	372.0	
50001	chr9	120619683	120620358	675	338.0	
50002	chr9	120663257	120663746	489	244.0	
50003	chr9	120676733	120677249	516	258.0	
50004	chr9	120682529	120682670	141	70.0	
50005	chr9	120684462	120684806	344	172.0	
50006	chr9	120692533	120693608	1075	538.0	
50007	chr9	120709963	120710786	823	412.0	
50008	chr9	120711669	120715639	3970	1985.0	
50009	chr9	120729581	120730181	600	300.0	
50010	chr9	120735035	120736138	1103	552.0	
50011	chr9	120736826	120738058	1232	616.0	
50012	chr9	120742898	120743346	448	224.0	
50013	chr9	120753297	120753659	362	181.0	
50014	chr9	120755598	120756427	829	414.0	
50015	chr9	120757139	120757647	508	254.0	
50016	chr9	120771032	120771321	289	144.0	
50017	chr9	120783650	120784197	547	274.0	
50018	chr9	120792118	120794460	2342	1171.0	
50019	chr9	120842293	120843974	1681	840.0	
50020	chr9	120844603	120844945	342	171.0	
50021	chr9	120846196	120847384	1188	594.0	
50022	chr9	120867957	120870666	2709	1354.0	
50023	chr9	120872819	120873890	1071	536.0	
50024	chr9	120874749	120879820	5071	2536.0	
50025	chr9	120890281	120893358	3077	1538.0	
50026	chr9	120896895	120897639	744	372.0	
50027	chr9	120901782	120901982	200	100.0	
50028	chr9	120902872	120906417	3545	1772.0	
50029	chr9	120909722	120910434	712	356.0	
50030	chr9	120913773	120914177	404	202.0	
50031	chr9	120915822	120916508	686	343.0	
50032	chr9	120918885	120922215	3330	1665.0	
50033	chr9	120923397	120930093	6696	3348.0	
50034	chr9	120931023	120932644	1621	810.0	
50035	chr9	120934253	120937128	2875	1438.0	
50036	chr9	120944312	120944918	606	303.0	
50037	chr9	120981601	120982097	496	248.0	
50038	chr9	121055657	121055989	332	166.0	
50039	chr9	121060004	121060450	446	223.0	
50040	chr9	121071417	121073298	1881	940.0	
50041	chr9	121073964	121075948	1984	992.0	
50042	chr9	121088596	121088913	317	158.0	
50043	chr9	121098836	121099171	335	168.0	
50044	chr9	121105507	121105727	220	110.0	
50045	chr9	121107045	121107385	340	170.0	
50046	chr9	121121198	121122853	1655	828.0	
50047	chr9	121132839	121133763	924	462.0	
50048	chr9	121156239	121156887	648	324.0	
50049	chr9	121159665	121160431	766	383.0	
50050	chr9	121169003	121169675	672	336.0	
50051	chr9	121185109	121186239	1130	565.0	
50052	chr9	121197479	121197492	13	6.0	
50053	chr9	121199868	121202668	2800	1400.0	
50054	chr9	121204186	121204318	132	66.0	
50055	chr9	121207279	121208048	769	384.0	
50056	chr9	121213084	121213675	591	296.0	
50057	chr9	121220876	121221458	582	291.0	
50058	chr9	121222670	121222819	149	74.0	
50059	chr9	121234133	121234656	523	262.0	
50060	chr9	121249404	121250226	822	411.0	
50061	chr9	121251961	121252492	531	266.0	
50062	chr9	121253688	121254578	890	445.0	
50063	chr9	121267662	121269559	1897	948.0	
50064	chr9	121271860	121272509	649	324.0	
50065	chr9	121278659	121279167	508	254.0	
50066	chr9	121281956	121283286	1330	665.0	
50067	chr9	121285732	121287540	1808	904.0	
50068	chr9	121288652	121289850	1198	599.0	
50069	chr9	121297403	121297797	394	197.0	
50070	chr9	121299364	121300124	760	380.0	
50071	chr9	121319812	121321420	1608	804.0	
50072	chr9	121351271	121351471	200	100.0	
50073	chr9	121353225	121354460	1235	618.0	
50074	chr9	121357003	121357138	135	68.0	
50075	chr9	121358406	121359570	1164	582.0	
50076	chr9	121362786	121363701	915	458.0	
50077	chr9	121367910	121371858	3948	1974.0	
50078	chr9	121399915	121400564	649	324.0	
50079	chr9	121463031	121463408	377	188.0	
50080	chr9	121485369	121486404	1035	518.0	
50081	chr9	121492928	121493411	483	242.0	
50082	chr9	121494153	121494736	583	292.0	
50083	chr9	121498062	121500205	2143	1072.0	
50084	chr9	121502665	121503867	1202	601.0	
50085	chr9	121545869	121546472	603	302.0	
50086	chr9	121550394	121550911	517	258.0	
50087	chr9	121551897	121552958	1061	530.0	
50088	chr9	121557801	121558591	790	395.0	
50089	chr9	121559194	121559546	352	176.0	
50090	chr9	121562402	121562509	107	54.0	
50091	chr9	121599374	121599786	412	206.0	
50092	chr9	121601132	121601718	586	293.0	
50093	chr9	121604181	121604670	489	244.0	
50094	chr9	121612681	121612793	112	56.0	
50095	chr9	121621311	121621340	29	14.0	
50096	chr9	121650298	121650435	137	68.0	
50097	chr9	121684378	121684651	273	136.0	
50098	chr9	121686844	121687280	436	218.0	
50099	chr9	121698667	121700595	1928	964.0	
50100	chr9	121708070	121708378	308	154.0	
50101	chr9	121732632	121733281	649	324.0	
50102	chr9	121735051	121735355	304	152.0	
50103	chr9	121748115	121748374	259	130.0	
50104	chr9	121912887	121913168	281	140.0	
50105	chr9	121992574	121993008	434	217.0	
50106	chr9	122066694	122066970	276	138.0	
50107	chr9	122092336	122094015	1679	840.0	
50108	chr9	122094980	122095843	863	432.0	
50109	chr9	122099194	122099911	717	358.0	
50110	chr9	122122614	122123460	846	423.0	
50111	chr9	122124910	122125808	898	449.0	
50112	chr9	122128364	122128836	472	236.0	
50113	chr9	122158205	122160367	2162	1081.0	
50114	chr9	122213514	122214451	937	468.0	
50115	chr9	122219410	122219500	90	45.0	
50116	chr9	122263687	122266024	2337	1168.0	
50117	chr9	122297532	122297883	351	176.0	
50118	chr9	122346673	122347694	1021	510.0	
50119	chr9	122350491	122351164	673	336.0	
50120	chr9	122354822	122355169	347	174.0	
50121	chr9	122370270	122371788	1518	759.0	
50122	chr9	122376397	122376774	377	188.0	
50123	chr9	122389644	122390231	587	294.0	
50124	chr9	122405642	122406705	1063	532.0	
50125	chr9	122453086	122453568	482	241.0	
50126	chr9	122463786	122465454	1668	834.0	
50127	chr9	122498823	122499114	291	146.0	
50128	chr9	122529727	122530153	426	213.0	
50129	chr9	122810089	122810908	819	410.0	
50130	chr9	122815977	122816782	805	402.0	
50131	chr9	122821452	122821972	520	260.0	
50132	chr9	122827625	122829156	1531	766.0	
50133	chr9	122835299	122835800	501	250.0	
50134	chr9	122846448	122846876	428	214.0	
50135	chr9	122900750	122901463	713	356.0	
50136	chr9	122903385	122906062	2677	1338.0	
50137	chr9	122912592	122914163	1571	786.0	
50138	chr9	122929808	122932822	3014	1507.0	
50139	chr9	122939690	122941962	2272	1136.0	
50140	chr9	122991315	122991881	566	283.0	
50141	chr9	123081824	123082099	275	138.0	
50142	chr9	123112042	123112232	190	95.0	
50143	chr9	123174787	123175300	513	256.0	
50144	chr9	123225230	123225874	644	322.0	
50145	chr9	123234099	123234315	216	108.0	
50146	chr9	123265916	123266340	424	212.0	
50147	chr9	123267001	123269703	2702	1351.0	
50148	chr9	123302752	123302791	39	20.0	
50149	chr9	123304600	123305448	848	424.0	
50150	chr9	123322409	123323495	1086	543.0	
50151	chr9	123326489	123327204	715	358.0	
50152	chr9	123329233	123329721	488	244.0	
50153	chr9	123335325	123335375	50	25.0	
50154	chr9	123337985	123340951	2966	1483.0	
50155	chr9	123343327	123344335	1008	504.0	
50156	chr9	123349597	123350472	875	438.0	
50157	chr9	123353979	123354498	519	260.0	
50158	chr9	123375472	123376512	1040	520.0	
50159	chr9	123385199	123385824	625	312.0	
50160	chr9	123387770	123388016	246	123.0	
50161	chr9	123389041	123389528	487	244.0	
50162	chr9	123426517	123426831	314	157.0	
50163	chr9	123470194	123470738	544	272.0	
50164	chr9	123528097	123528338	241	120.0	
50165	chr9	123549014	123549582	568	284.0	
50166	chr9	123563090	123563413	323	162.0	
50167	chr9	123608158	123608597	439	220.0	
50168	chr9	123637610	123638638	1028	514.0	
50169	chr9	123640926	123641139	213	106.0	
50170	chr9	123658954	123659093	139	70.0	
50171	chr9	123662337	123662838	501	250.0	
50172	chr9	123679366	123679866	500	250.0	
50173	chr9	123687275	123687773	498	249.0	
50174	chr9	123733662	123733735	73	36.0	
50175	chr9	123741391	123741791	400	200.0	
50176	chr9	123749574	123750094	520	260.0	
50177	chr9	123775896	123776098	202	101.0	enhancer
50178	chr9	123820254	123820500	246	123.0	
50179	chr9	123832908	123833250	342	171.0	
50180	chr9	123835053	123835829	776	388.0	
50181	chr9	123865557	123865946	389	194.0	
50182	chr9	123866525	123868461	1936	968.0	
50183	chr9	123927541	123930879	3338	1669.0	
50184	chr9	123996577	123998300	1723	862.0	
50185	chr9	123999004	124000167	1163	582.0	
50186	chr9	124006630	124007125	495	248.0	
50187	chr9	124008439	124008922	483	242.0	
50188	chr9	124011422	124011816	394	197.0	
50189	chr9	124012492	124012893	401	200.0	
50190	chr9	124016856	124017697	841	420.0	
50191	chr9	124040761	124041579	818	409.0	
50192	chr9	124110329	124110700	371	186.0	
50193	chr9	124126762	124127248	486	243.0	
50194	chr9	124133729	124134112	383	192.0	
50195	chr9	124141315	124141552	237	118.0	
50196	chr9	124143862	124144335	473	236.0	
50197	chr9	124174347	124174844	497	248.0	
50198	chr9	124197060	124198108	1048	524.0	
50199	chr9	124202058	124203288	1230	615.0	
50200	chr9	124208476	124209117	641	320.0	
50201	chr9	124210880	124211056	176	88.0	
50202	chr9	124213997	124214612	615	308.0	
50203	chr9	124216377	124219530	3153	1576.0	
50204	chr9	124221579	124222131	552	276.0	
50205	chr9	124222958	124223909	951	476.0	
50206	chr9	124238578	124240053	1475	738.0	
50207	chr9	124242434	124243365	931	466.0	
50208	chr9	124254211	124254634	423	212.0	
50209	chr9	124257329	124260192	2863	1432.0	
50210	chr9	124260812	124262456	1644	822.0	
50211	chr9	124264704	124265377	673	336.0	
50212	chr9	124267109	124267989	880	440.0	
50213	chr9	124271078	124271255	177	88.0	
50214	chr9	124278135	124278433	298	149.0	
50215	chr9	124281756	124282547	791	396.0	
50216	chr9	124283212	124283298	86	43.0	
50217	chr9	124285819	124287084	1265	632.0	
50218	chr9	124289870	124292382	2512	1256.0	
50219	chr9	124293789	124294476	687	344.0	
50220	chr9	124306338	124306744	406	203.0	
50221	chr9	124320236	124320720	484	242.0	
50222	chr9	124322575	124322973	398	199.0	
50223	chr9	124381370	124381440	70	35.0	
50224	chr9	124387305	124387595	290	145.0	
50225	chr9	124392165	124393176	1011	506.0	
50226	chr9	124394106	124394552	446	223.0	
50227	chr9	124414854	124416154	1300	650.0	
50228	chr9	124419336	124420146	810	405.0	
50229	chr9	124421055	124421315	260	130.0	
50230	chr9	124536730	124537129	399	200.0	
50231	chr9	124617428	124617923	495	248.0	
50232	chr9	124621885	124622414	529	264.0	
50233	chr9	124625068	124625469	401	200.0	
50234	chr9	124657957	124659792	1835	918.0	
50235	chr9	124660439	124660691	252	126.0	
50236	chr9	124711635	124712537	902	451.0	
50237	chr9	124758055	124758646	591	296.0	
50238	chr9	124764797	124765210	413	206.0	
50239	chr9	124769035	124772595	3560	1780.0	
50240	chr9	124774135	124775399	1264	632.0	
50241	chr9	124776812	124777921	1109	554.0	
50242	chr9	124800365	124801087	722	361.0	
50243	chr9	124839639	124840005	366	183.0	
50244	chr9	124840594	124840865	271	136.0	
50245	chr9	124852588	124854324	1736	868.0	
50246	chr9	124854909	124856421	1512	756.0	
50247	chr9	124858521	124858856	335	168.0	
50248	chr9	124860126	124862914	2788	1394.0	
50249	chr9	124863489	124863685	196	98.0	
50250	chr9	124868194	124871688	3494	1747.0	
50251	chr9	124872290	124874201	1911	956.0	
50252	chr9	124894551	124895445	894	447.0	
50253	chr9	124934285	124934716	431	216.0	
50254	chr9	124940204	124942490	2286	1143.0	
50255	chr9	124964093	124964166	73	36.0	
50256	chr9	124965544	124966430	886	443.0	
50257	chr9	125119919	125120082	163	82.0	
50258	chr9	125125776	125126865	1089	544.0	
50259	chr9	125142575	125144245	1670	835.0	
50260	chr9	125188907	125190967	2060	1030.0	
50261	chr9	125194560	125196153	1593	796.0	
50262	chr9	125199523	125201326	1803	902.0	
50263	chr9	125233713	125233956	243	122.0	
50264	chr9	125234850	125236794	1944	972.0	
50265	chr9	125237305	125242423	5118	2559.0	
50266	chr9	125243222	125243701	479	240.0	
50267	chr9	125259007	125259630	623	312.0	
50268	chr9	125261085	125262783	1698	849.0	
50269	chr9	125263934	125264474	540	270.0	
50270	chr9	125272808	125273115	307	154.0	
50271	chr9	125332567	125332627	60	30.0	
50272	chr9	125374389	125375171	782	391.0	
50273	chr9	125407702	125408847	1145	572.0	
50274	chr9	125410017	125410783	766	383.0	
50275	chr9	125436761	125437062	301	150.0	
50276	chr9	125446711	125447242	531	266.0	
50277	chr9	125513637	125513864	227	114.0	
50278	chr9	125521635	125522227	592	296.0	
50279	chr9	125530051	125530794	743	372.0	
50280	chr9	125558417	125558862	445	222.0	
50281	chr9	125628949	125629865	916	458.0	
50282	chr9	125631275	125633523	2248	1124.0	
50283	chr9	125646156	125647155	999	500.0	
50284	chr9	125649033	125650874	1841	920.0	
50285	chr9	125663176	125663498	322	161.0	
50286	chr9	125690293	125691042	749	374.0	
50287	chr9	125700912	125701011	99	50.0	
50288	chr9	125706478	125707906	1428	714.0	
50289	chr9	125745440	125749028	3588	1794.0	
50290	chr9	125758936	125759968	1032	516.0	enhancer
50291	chr9	125761848	125762417	569	284.0	enhancer
50292	chr9	125785379	125785780	401	200.0	
50293	chr9	125823688	125824713	1025	512.0	
50294	chr9	125829599	125830305	706	353.0	
50295	chr9	125839506	125839593	87	44.0	
50296	chr9	125889161	125890168	1007	504.0	
50297	chr9	125904354	125904995	641	320.0	
50298	chr9	125961098	125961382	284	142.0	
50299	chr9	126146497	126146531	34	17.0	
50300	chr9	126205375	126205616	241	120.0	
50301	chr9	126228800	126229281	481	240.0	
50302	chr9	126301961	126302436	475	238.0	
50303	chr9	126317501	126317978	477	238.0	
50304	chr9	126320511	126320839	328	164.0	
50305	chr9	126326028	126328472	2444	1222.0	
50306	chr9	126329506	126330885	1379	690.0	
50307	chr9	126336828	126337391	563	282.0	
50308	chr9	126347094	126347509	415	208.0	
50309	chr9	126375390	126375794	404	202.0	
50310	chr9	126389830	126390600	770	385.0	
50311	chr9	126396713	126397657	944	472.0	
50312	chr9	126398397	126398944	547	274.0	
50313	chr9	126411237	126412257	1020	510.0	
50314	chr9	126413074	126413757	683	342.0	
50315	chr9	126423358	126423589	231	116.0	
50316	chr9	126428652	126428903	251	126.0	
50317	chr9	126468463	126471972	3509	1754.0	
50318	chr9	126472870	126473356	486	243.0	
50319	chr9	126480381	126480680	299	150.0	
50320	chr9	126482676	126482854	178	89.0	
50321	chr9	126483763	126483945	182	91.0	
50322	chr9	126490235	126490714	479	240.0	
50323	chr9	126491218	126491739	521	260.0	
50324	chr9	126497865	126501489	3624	1812.0	
50325	chr9	126513746	126514809	1063	532.0	
50326	chr9	126516753	126518125	1372	686.0	
50327	chr9	126519569	126520011	442	221.0	
50328	chr9	126523569	126524290	721	360.0	
50329	chr9	126525342	126525992	650	325.0	
50330	chr9	126532303	126532528	225	112.0	
50331	chr9	126533276	126534191	915	458.0	
50332	chr9	126557935	126558485	550	275.0	
50333	chr9	126561638	126561970	332	166.0	
50334	chr9	126611313	126613376	2063	1032.0	
50335	chr9	126613928	126614403	475	238.0	
50336	chr9	126615097	126615755	658	329.0	
50337	chr9	126625714	126626469	755	378.0	
50338	chr9	126635699	126638057	2358	1179.0	
50339	chr9	126690352	126690791	439	220.0	
50340	chr9	126702407	126702864	457	228.0	
50341	chr9	126704827	126706924	2097	1048.0	
50342	chr9	126718991	126724473	5482	2741.0	
50343	chr9	126781559	126782248	689	344.0	
50344	chr9	126804361	126806652	2291	1146.0	
50345	chr9	126819405	126819440	35	18.0	
50346	chr9	126843253	126843628	375	188.0	
50347	chr9	126859799	126863008	3209	1604.0	
50348	chr9	126877564	126877776	212	106.0	
50349	chr9	126914091	126916021	1930	965.0	
50350	chr9	126917031	126917066	35	18.0	
50351	chr9	126940378	126941132	754	377.0	
50352	chr9	126965802	126966218	416	208.0	
50353	chr9	126981976	126982886	910	455.0	
50354	chr9	126985531	126987055	1524	762.0	
50355	chr9	127005105	127005854	749	374.0	
50356	chr9	127048962	127049526	564	282.0	
50357	chr9	127122630	127123147	517	258.0	
50358	chr9	127131251	127131652	401	200.0	
50359	chr9	127166757	127167263	506	253.0	
50360	chr9	127198885	127199821	936	468.0	
50361	chr9	127214343	127215010	667	334.0	
50362	chr9	127219538	127219813	275	138.0	
50363	chr9	127221693	127222081	388	194.0	
50364	chr9	127223634	127226266	2632	1316.0	
50365	chr9	127244726	127245895	1169	584.0	
50366	chr9	127361664	127362013	349	174.0	
50367	chr9	127388033	127389020	987	494.0	
50368	chr9	127396179	127398602	2423	1212.0	
50369	chr9	127411101	127411483	382	191.0	
50370	chr9	127412002	127412279	277	138.0	
50371	chr9	127417936	127418510	574	287.0	
50372	chr9	127423580	127425324	1744	872.0	
50373	chr9	127426858	127427108	250	125.0	
50374	chr9	127437397	127438318	921	460.0	
50375	chr9	127443980	127446650	2670	1335.0	
50376	chr9	127447237	127452815	5578	2789.0	
50377	chr9	127455208	127456167	959	480.0	
50378	chr9	127503751	127504819	1068	534.0	
50379	chr9	127505789	127506241	452	226.0	
50380	chr9	127519065	127519860	795	398.0	
50381	chr9	127523697	127523774	77	38.0	
50382	chr9	127525767	127526230	463	232.0	
50383	chr9	127548614	127548824	210	105.0	
50384	chr9	127555727	127556751	1024	512.0	
50385	chr9	127557326	127557897	571	286.0	
50386	chr9	127561524	127563206	1682	841.0	
50387	chr9	127567113	127570554	3441	1720.0	"enhancer	sequence_feature"
50388	chr9	127574905	127575451	546	273.0	
50389	chr9	127578587	127580772	2185	1092.0	
50390	chr9	127586222	127587084	862	431.0	
50391	chr9	127589785	127590273	488	244.0	
50392	chr9	127595681	127595827	146	73.0	
50393	chr9	127607278	127609064	1786	893.0	
50394	chr9	127611539	127613722	2183	1092.0	
50395	chr9	127698889	127699974	1085	542.0	
50396	chr9	127706765	127708145	1380	690.0	
50397	chr9	127711067	127711468	401	200.0	
50398	chr9	127714765	127716629	1864	932.0	
50399	chr9	127719280	127721947	2667	1334.0	
50400	chr9	127733655	127736183	2528	1264.0	
50401	chr9	127737360	127737669	309	154.0	
50402	chr9	127740559	127741231	672	336.0	
50403	chr9	127746878	127747353	475	238.0	
50404	chr9	127762194	127762751	557	278.0	
50405	chr9	127763986	127764555	569	284.0	
50406	chr9	127767402	127767825	423	212.0	
50407	chr9	127769717	127772489	2772	1386.0	
50408	chr9	127776064	127781530	5466	2733.0	
50409	chr9	127782544	127787208	4664	2332.0	
50410	chr9	127788654	127789055	401	200.0	
50411	chr9	127796461	127797546	1085	542.0	
50412	chr9	127801810	127804325	2515	1258.0	
50413	chr9	127805664	127806004	340	170.0	
50414	chr9	127828269	127828906	637	318.0	
50415	chr9	127833455	127834129	674	337.0	
50416	chr9	127835444	127836575	1131	566.0	
50417	chr9	127838371	127839236	865	432.0	
50418	chr9	127851731	127852005	274	137.0	
50419	chr9	127853453	127855024	1571	786.0	
50420	chr9	127861820	127863727	1907	954.0	
50421	chr9	127864817	127866056	1239	620.0	
50422	chr9	127866736	127867251	515	258.0	
50423	chr9	127869506	127870532	1026	513.0	
50424	chr9	127877286	127878066	780	390.0	
50425	chr9	127882568	127883141	573	286.0	
50426	chr9	127896951	127897916	965	482.0	
50427	chr9	127898501	127900170	1669	834.0	
50428	chr9	127903273	127907416	4143	2072.0	
50429	chr9	127910708	127911689	981	490.0	
50430	chr9	127914757	127919999	5242	2621.0	
50431	chr9	127921142	127922417	1275	638.0	
50432	chr9	127926591	127932237	5646	2823.0	
50433	chr9	127935117	127939367	4250	2125.0	
50434	chr9	127942372	127944627	2255	1128.0	
50435	chr9	127946084	127946867	783	392.0	
50436	chr9	127949349	127950415	1066	533.0	
50437	chr9	127952054	127952215	161	80.0	
50438	chr9	127953628	127956207	2579	1290.0	
50439	chr9	127957973	127958139	166	83.0	
50440	chr9	127959169	127961049	1880	940.0	
50441	chr9	127961857	127962172	315	158.0	
50442	chr9	127963148	127963790	642	321.0	
50443	chr9	127964301	127968601	4300	2150.0	
50444	chr9	127969585	127978361	8776	4388.0	
50445	chr9	127978989	127982102	3113	1556.0	enhancer
50446	chr9	127982967	127983157	190	95.0	
50447	chr9	127983726	127984433	707	354.0	
50448	chr9	127991185	127992026	841	420.0	
50449	chr9	128001822	128002077	255	128.0	
50450	chr9	128005941	128006264	323	162.0	
50451	chr9	128007251	128008642	1391	696.0	
50452	chr9	128011059	128011536	477	238.0	
50453	chr9	128020907	128021076	169	84.0	
50454	chr9	128021803	128023071	1268	634.0	
50455	chr9	128023703	128024058	355	178.0	
50456	chr9	128024657	128027735	3078	1539.0	
50457	chr9	128028290	128029117	827	414.0	
50458	chr9	128030651	128031909	1258	629.0	
50459	chr9	128032971	128033688	717	358.0	
50460	chr9	128034748	128035772	1024	512.0	
50461	chr9	128053341	128054550	1209	604.0	
50462	chr9	128055423	128056009	586	293.0	
50463	chr9	128061046	128061870	824	412.0	
50464	chr9	128062518	128063332	814	407.0	
50465	chr9	128065030	128065078	48	24.0	
50466	chr9	128066569	128070158	3589	1794.0	
50467	chr9	128070841	128073306	2465	1232.0	
50468	chr9	128078207	128079314	1107	554.0	
50469	chr9	128083654	128084318	664	332.0	
50470	chr9	128088524	128088919	395	198.0	
50471	chr9	128092983	128095026	2043	1022.0	
50472	chr9	128097732	128099004	1272	636.0	
50473	chr9	128103314	128103955	641	320.0	
50474	chr9	128115491	128116218	727	364.0	
50475	chr9	128117307	128118470	1163	582.0	
50476	chr9	128124910	128126371	1461	730.0	
50477	chr9	128127094	128130387	3293	1646.0	
50478	chr9	128142117	128142235	118	59.0	
50479	chr9	128150585	128150990	405	202.0	
50480	chr9	128159040	128161133	2093	1046.0	
50481	chr9	128190684	128193286	2602	1301.0	
50482	chr9	128202654	128204731	2077	1038.0	
50483	chr9	128217569	128219530	1961	980.0	
50484	chr9	128226503	128226813	310	155.0	
50485	chr9	128244045	128244081	36	18.0	
50486	chr9	128244730	128246287	1557	778.0	
50487	chr9	128249570	128251662	2092	1046.0	
50488	chr9	128255143	128255866	723	362.0	
50489	chr9	128274973	128277143	2170	1085.0	
50490	chr9	128295265	128295818	553	276.0	
50491	chr9	128321835	128323601	1766	883.0	
50492	chr9	128339696	128341870	2174	1087.0	
50493	chr9	128361657	128362719	1062	531.0	
50494	chr9	128364619	128365512	893	446.0	
50495	chr9	128370400	128372299	1899	950.0	
50496	chr9	128396992	128397491	499	250.0	
50497	chr9	128412352	128412803	451	226.0	
50498	chr9	128419081	128422033	2952	1476.0	
50499	chr9	128438360	128439591	1231	616.0	
50500	chr9	128455327	128457507	2180	1090.0	
50501	chr9	128494437	128494604	167	84.0	
50502	chr9	128504127	128505621	1494	747.0	
50503	chr9	128511991	128512462	471	236.0	
50504	chr9	128549377	128555071	5694	2847.0	
50505	chr9	128556841	128557404	563	282.0	
50506	chr9	128558312	128559525	1213	606.0	
50507	chr9	128560291	128560352	61	30.0	
50508	chr9	128562256	128562521	265	132.0	
50509	chr9	128563342	128564199	857	428.0	
50510	chr9	128564827	128566486	1659	830.0	
50511	chr9	128586728	128587813	1085	542.0	
50512	chr9	128634468	128634515	47	24.0	
50513	chr9	128643747	128643756	9	4.0	
50514	chr9	128648168	128648750	582	291.0	
50515	chr9	128655672	128657486	1814	907.0	
50516	chr9	128682523	128686833	4310	2155.0	
50517	chr9	128688070	128690944	2874	1437.0	
50518	chr9	128702028	128703935	1907	954.0	
50519	chr9	128705875	128706238	363	182.0	
50520	chr9	128721931	128725464	3533	1766.0	
50521	chr9	128727126	128727884	758	379.0	
50522	chr9	128733149	128733690	541	270.0	
50523	chr9	128770915	128772712	1797	898.0	
50524	chr9	128781257	128781579	322	161.0	
50525	chr9	128783448	128783931	483	242.0	
50526	chr9	128786592	128787996	1404	702.0	
50527	chr9	128817731	128820038	2307	1154.0	
50528	chr9	128824238	128824240	2	1.0	
50529	chr9	128826341	128826723	382	191.0	
50530	chr9	128828791	128830620	1829	914.0	
50531	chr9	128852046	128852418	372	186.0	
50532	chr9	128863451	128864198	747	374.0	
50533	chr9	128874427	128874901	474	237.0	
50534	chr9	128879308	128879602	294	147.0	
50535	chr9	128880745	128884080	3335	1668.0	
50536	chr9	128884666	128885161	495	248.0	
50537	chr9	128891957	128893012	1055	528.0	
50538	chr9	128894691	128895717	1026	513.0	
50539	chr9	128898408	128900679	2271	1136.0	
50540	chr9	128901300	128904314	3014	1507.0	
50541	chr9	128911198	128911485	287	144.0	
50542	chr9	128912656	128912948	292	146.0	
50543	chr9	128922093	128922942	849	424.0	
50544	chr9	128927330	128928515	1185	592.0	
50545	chr9	128946620	128948807	2187	1094.0	
50546	chr9	128999796	129000181	385	192.0	
50547	chr9	129006665	129007199	534	267.0	
50548	chr9	129021113	129021507	394	197.0	
50549	chr9	129027323	129029701	2378	1189.0	
50550	chr9	129035822	129037543	1721	860.0	
50551	chr9	129058091	129058665	574	287.0	
50552	chr9	129068538	129070054	1516	758.0	
50553	chr9	129071688	129072128	440	220.0	
50554	chr9	129073284	129073967	683	342.0	
50555	chr9	129080200	129082048	1848	924.0	
50556	chr9	129103056	129103457	401	200.0	
50557	chr9	129109422	129112270	2848	1424.0	
50558	chr9	129113654	129114316	662	331.0	
50559	chr9	129131283	129132306	1023	512.0	
50560	chr9	129138851	129142009	3158	1579.0	
50561	chr9	129142712	129143536	824	412.0	
50562	chr9	129162576	129162690	114	57.0	
50563	chr9	129166821	129168447	1626	813.0	
50564	chr9	129170118	129170582	464	232.0	
50565	chr9	129173597	129178965	5368	2684.0	
50566	chr9	129182562	129182982	420	210.0	
50567	chr9	129198376	129198828	452	226.0	
50568	chr9	129202360	129203679	1319	660.0	
50569	chr9	129206796	129207462	666	333.0	
50570	chr9	129208354	129208961	607	304.0	
50571	chr9	129220815	129221672	857	428.0	
50572	chr9	129225715	129226310	595	298.0	
50573	chr9	129233710	129233857	147	74.0	
50574	chr9	129235485	129237816	2331	1166.0	
50575	chr9	129257924	129259367	1443	722.0	
50576	chr9	129261091	129262295	1204	602.0	
50577	chr9	129270158	129271267	1109	554.0	
50578	chr9	129282199	129282634	435	218.0	
50579	chr9	129283169	129283526	357	178.0	
50580	chr9	129317532	129317896	364	182.0	
50581	chr9	129320249	129321620	1371	686.0	
50582	chr9	129333615	129335842	2227	1114.0	
50583	chr9	129336368	129337480	1112	556.0	
50584	chr9	129339050	129339490	440	220.0	
50585	chr9	129341126	129341259	133	66.0	
50586	chr9	129343564	129345397	1833	916.0	
50587	chr9	129346532	129348220	1688	844.0	
50588	chr9	129351429	129352700	1271	636.0	
50589	chr9	129382943	129384541	1598	799.0	
50590	chr9	129385441	129385442	1	0.0	
50591	chr9	129406335	129406746	411	206.0	
50592	chr9	129410071	129410812	741	370.0	
50593	chr9	129412593	129415254	2661	1330.0	
50594	chr9	129416402	129417190	788	394.0	
50595	chr9	129422685	129423441	756	378.0	
50596	chr9	129436602	129439029	2427	1214.0	
50597	chr9	129454334	129454957	623	312.0	
50598	chr9	129457904	129461354	3450	1725.0	
50599	chr9	129465098	129465244	146	73.0	
50600	chr9	129470282	129471026	744	372.0	
50601	chr9	129481750	129484648	2898	1449.0	
50602	chr9	129485501	129491944	6443	3222.0	
50603	chr9	129494451	129494454	3	2.0	
50604	chr9	129495403	129498857	3454	1727.0	
50605	chr9	129504763	129504796	33	16.0	
50606	chr9	129550100	129550719	619	310.0	
50607	chr9	129559153	129559382	229	114.0	
50608	chr9	129567830	129569968	2138	1069.0	
50609	chr9	129570607	129571013	406	203.0	
50610	chr9	129575124	129575557	433	216.0	
50611	chr9	129580103	129580576	473	236.0	
50612	chr9	129583013	129584951	1938	969.0	
50613	chr9	129586178	129587168	990	495.0	
50614	chr9	129595234	129596332	1098	549.0	
50615	chr9	129597006	129598433	1427	714.0	
50616	chr9	129602786	129603240	454	227.0	
50617	chr9	129604725	129605178	453	226.0	
50618	chr9	129607172	129611711	4539	2270.0	
50619	chr9	129617261	129617655	394	197.0	
50620	chr9	129619702	129621222	1520	760.0	
50621	chr9	129623277	129628132	4855	2428.0	
50622	chr9	129635857	129635860	3	2.0	
50623	chr9	129637171	129638025	854	427.0	
50624	chr9	129641120	129642887	1767	884.0	
50625	chr9	129664873	129666182	1309	654.0	
50626	chr9	129726519	129727197	678	339.0	
50627	chr9	129737196	129738630	1434	717.0	
50628	chr9	129746573	129746712	139	70.0	
50629	chr9	129752825	129753359	534	267.0	
50630	chr9	129756906	129757908	1002	501.0	
50631	chr9	129762136	129763433	1297	648.0	
50632	chr9	129773255	129774252	997	498.0	
50633	chr9	129776689	129778111	1422	711.0	
50634	chr9	129783517	129784370	853	426.0	
50635	chr9	129790058	129790857	799	400.0	
50636	chr9	129802577	129804073	1496	748.0	
50637	chr9	129805907	129806677	770	385.0	
50638	chr9	129810338	129810352	14	7.0	
50639	chr9	129816825	129817623	798	399.0	
50640	chr9	129822796	129824699	1903	952.0	
50641	chr9	129834391	129837005	2614	1307.0	
50642	chr9	129838884	129839047	163	82.0	
50643	chr9	129840029	129840468	439	220.0	
50644	chr9	129845383	129845485	102	51.0	
50645	chr9	129854582	129854966	384	192.0	
50646	chr9	129862913	129863775	862	431.0	
50647	chr9	129866193	129870571	4378	2189.0	
50648	chr9	129875250	129875646	396	198.0	
50649	chr9	129876675	129877445	770	385.0	
50650	chr9	129878974	129879512	538	269.0	
50651	chr9	129881576	129882754	1178	589.0	
50652	chr9	129883740	129892671	8931	4466.0	
50653	chr9	129893610	129896598	2988	1494.0	
50654	chr9	129898238	129898618	380	190.0	
50655	chr9	129900688	129901171	483	242.0	
50656	chr9	129910532	129911016	484	242.0	
50657	chr9	129919810	129920289	479	240.0	
50658	chr9	129930758	129931145	387	194.0	
50659	chr9	129932002	129932931	929	464.0	
50660	chr9	129935007	129935293	286	143.0	
50661	chr9	129939393	129939626	233	116.0	
50662	chr9	129943941	129945867	1926	963.0	
50663	chr9	129946391	129947024	633	316.0	
50664	chr9	129954671	129955486	815	408.0	
50665	chr9	129956517	129957317	800	400.0	
50666	chr9	129958713	129959266	553	276.0	
50667	chr9	129961530	129964580	3050	1525.0	
50668	chr9	129987174	129987200	26	13.0	
50669	chr9	129988869	129989653	784	392.0	
50670	chr9	129990224	129991289	1065	532.0	
50671	chr9	129992010	129992520	510	255.0	
50672	chr9	129995319	129996996	1677	838.0	
50673	chr9	129998570	129999218	648	324.0	
50674	chr9	130001236	130001443	207	104.0	
50675	chr9	130003692	130004325	633	316.0	
50676	chr9	130007190	130008793	1603	802.0	
50677	chr9	130009921	130011168	1247	624.0	
50678	chr9	130016616	130017123	507	254.0	
50679	chr9	130022619	130023826	1207	604.0	
50680	chr9	130026477	130027467	990	495.0	
50681	chr9	130028241	130029893	1652	826.0	
50682	chr9	130030406	130031711	1305	652.0	
50683	chr9	130033615	130035368	1753	876.0	
50684	chr9	130036071	130044065	7994	3997.0	
50685	chr9	130044638	130046169	1531	766.0	
50686	chr9	130053250	130054869	1619	810.0	
50687	chr9	130058205	130058494	289	144.0	
50688	chr9	130061327	130062239	912	456.0	
50689	chr9	130068511	130069077	566	283.0	
50690	chr9	130073368	130073900	532	266.0	
50691	chr9	130099656	130100128	472	236.0	
50692	chr9	130106868	130108059	1191	596.0	
50693	chr9	130127837	130129848	2011	1006.0	
50694	chr9	130130929	130131931	1002	501.0	
50695	chr9	130138132	130138649	517	258.0	
50696	chr9	130140938	130141102	164	82.0	
50697	chr9	130143962	130144216	254	127.0	
50698	chr9	130171955	130173566	1611	806.0	
50699	chr9	130235928	130236719	791	396.0	
50700	chr9	130239622	130241234	1612	806.0	
50701	chr9	130242773	130243772	999	500.0	
50702	chr9	130254084	130254419	335	168.0	
50703	chr9	130268837	130269154	317	158.0	
50704	chr9	130433224	130433571	347	174.0	
50705	chr9	130444578	130445113	535	268.0	
50706	chr9	130461102	130461729	627	314.0	
50707	chr9	130578701	130580425	1724	862.0	
50708	chr9	130663109	130663823	714	357.0	
50709	chr9	130680813	130682950	2137	1068.0	
50710	chr9	130683966	130684502	536	268.0	
50711	chr9	130690153	130690249	96	48.0	
50712	chr9	130693014	130694601	1587	794.0	
50713	chr9	130700988	130701525	537	268.0	
50714	chr9	130707081	130707756	675	338.0	
50715	chr9	130712166	130713997	1831	916.0	"recombination_feature	recombination_feature"
50716	chr9	130768309	130768620	311	156.0	"recombination_feature	recombination_feature	recombination_feature"
50717	chr9	130770936	130771368	432	216.0	"recombination_feature	recombination_feature	recombination_feature"
50718	chr9	130834320	130836086	1766	883.0	"recombination_feature	recombination_feature	recombination_feature"
50719	chr9	130860839	130861121	282	141.0	
50720	chr9	130863566	130863996	430	215.0	
50721	chr9	130866362	130866882	520	260.0	
50722	chr9	130893273	130894113	840	420.0	
50723	chr9	130940967	130941522	555	278.0	
50724	chr9	130981033	130981424	391	196.0	
50725	chr9	130993506	130993586	80	40.0	
50726	chr9	130995326	130995889	563	282.0	
50727	chr9	130998281	130998688	407	204.0	
50728	chr9	131043121	131043232	111	56.0	
50729	chr9	131046588	131047176	588	294.0	insulator
50730	chr9	131057761	131058244	483	242.0	insulator
50731	chr9	131096285	131096788	503	252.0	
50732	chr9	131124802	131126438	1636	818.0	
50733	chr9	131178006	131178889	883	442.0	insulator
50734	chr9	131179895	131179961	66	33.0	
50735	chr9	131203455	131203800	345	172.0	
50736	chr9	131227391	131228582	1191	596.0	
50737	chr9	131233208	131234574	1366	683.0	
50738	chr9	131237395	131239259	1864	932.0	enhancer
50739	chr9	131251993	131258412	6419	3210.0	
50740	chr9	131262534	131263223	689	344.0	
50741	chr9	131263764	131264952	1188	594.0	
50742	chr9	131265852	131280666	14814	7407.0	
50743	chr9	131282480	131283414	934	467.0	
50744	chr9	131289497	131289903	406	203.0	
50745	chr9	131310613	131311360	747	374.0	
50746	chr9	131336036	131336860	824	412.0	
50747	chr9	131349760	131350708	948	474.0	
50748	chr9	131356242	131357023	781	390.0	
50749	chr9	131358394	131358853	459	230.0	
50750	chr9	131360760	131361704	944	472.0	
50751	chr9	131372521	131374447	1926	963.0	
50752	chr9	131386481	131386617	136	68.0	
50753	chr9	131392927	131396077	3150	1575.0	
50754	chr9	131396677	131399104	2427	1214.0	
50755	chr9	131404657	131408391	3734	1867.0	
50756	chr9	131409735	131410642	907	454.0	
50757	chr9	131417242	131417525	283	142.0	
50758	chr9	131422518	131422858	340	170.0	
50759	chr9	131441399	131441857	458	229.0	
50760	chr9	131478339	131478818	479	240.0	
50761	chr9	131499137	131501698	2561	1280.0	
50762	chr9	131502262	131504608	2346	1173.0	
50763	chr9	131515708	131516622	914	457.0	
50764	chr9	131530186	131531934	1748	874.0	
50765	chr9	131534598	131535009	411	206.0	
50766	chr9	131539556	131539891	335	168.0	
50767	chr9	131545997	131547173	1176	588.0	
50768	chr9	131554793	131555134	341	170.0	
50769	chr9	131578470	131579855	1385	692.0	
50770	chr9	131584841	131586293	1452	726.0	
50771	chr9	131587966	131588094	128	64.0	
50772	chr9	131590266	131592127	1861	930.0	
50773	chr9	131593212	131593601	389	194.0	
50774	chr9	131597803	131598903	1100	550.0	
50775	chr9	131603210	131603686	476	238.0	
50776	chr9	131620809	131623051	2242	1121.0	
50777	chr9	131624108	131625114	1006	503.0	
50778	chr9	131625745	131626227	482	241.0	
50779	chr9	131627397	131630976	3579	1790.0	
50780	chr9	131634980	131636388	1408	704.0	
50781	chr9	131644954	131645866	912	456.0	
50782	chr9	131650114	131650853	739	370.0	
50783	chr9	131651490	131652044	554	277.0	
50784	chr9	131655176	131658901	3725	1862.0	
50785	chr9	131661929	131662426	497	248.0	
50786	chr9	131666677	131670778	4101	2050.0	
50787	chr9	131674883	131679367	4484	2242.0	
50788	chr9	131691141	131691599	458	229.0	
50789	chr9	131697719	131699032	1313	656.0	
50790	chr9	131700976	131701594	618	309.0	
50791	chr9	131705654	131706541	887	444.0	
50792	chr9	131707645	131708749	1104	552.0	
50793	chr9	131709717	131710745	1028	514.0	
50794	chr9	131719112	131720669	1557	778.0	
50795	chr9	131724790	131725800	1010	505.0	
50796	chr9	131727327	131730272	2945	1472.0	
50797	chr9	131731055	131736898	5843	2922.0	
50798	chr9	131738600	131740701	2101	1050.0	
50799	chr9	131743956	131745056	1100	550.0	
50800	chr9	131747229	131747811	582	291.0	
50801	chr9	131755427	131756113	686	343.0	
50802	chr9	131762201	131762919	718	359.0	
50803	chr9	131799181	131799516	335	168.0	
50804	chr9	131839187	131840575	1388	694.0	
50805	chr9	131854343	131854727	384	192.0	
50806	chr9	132078348	132080373	2025	1012.0	
50807	chr9	132114114	132114481	367	184.0	
50808	chr9	132147544	132147618	74	37.0	
50809	chr9	132161032	132163877	2845	1422.0	
50810	chr9	132169694	132170220	526	263.0	
50811	chr9	132217166	132217817	651	326.0	
50812	chr9	132218776	132219247	471	236.0	
50813	chr9	132223360	132224416	1056	528.0	
50814	chr9	132236129	132236993	864	432.0	
50815	chr9	132238967	132243059	4092	2046.0	
50816	chr9	132252349	132253028	679	340.0	
50817	chr9	132258883	132259812	929	464.0	
50818	chr9	132268679	132269349	670	335.0	
50819	chr9	132293163	132293593	430	215.0	
50820	chr9	132350114	132352159	2045	1022.0	
50821	chr9	132353678	132356065	2387	1194.0	
50822	chr9	132361077	132361468	391	196.0	
50823	chr9	132366016	132366920	904	452.0	
50824	chr9	132370817	132371109	292	146.0	
50825	chr9	132372297	132373272	975	488.0	
50826	chr9	132381896	132382647	751	376.0	
50827	chr9	132383448	132384724	1276	638.0	
50828	chr9	132404213	132404940	727	364.0	
50829	chr9	132406024	132407529	1505	752.0	
50830	chr9	132409679	132412506	2827	1414.0	
50831	chr9	132451105	132451773	668	334.0	
50832	chr9	132486672	132488011	1339	670.0	
50833	chr9	132507207	132508047	840	420.0	
50834	chr9	132574964	132575482	518	259.0	
50835	chr9	132581709	132582692	983	492.0	
50836	chr9	132586128	132586717	589	294.0	
50837	chr9	132669290	132671529	2239	1120.0	
50838	chr9	132673315	132673715	400	200.0	
50839	chr9	132694182	132694568	386	193.0	
50840	chr9	132768621	132771023	2402	1201.0	
50841	chr9	132799889	132800613	724	362.0	
50842	chr9	132804570	132805057	487	244.0	
50843	chr9	132848639	132849073	434	217.0	
50844	chr9	132877742	132879216	1474	737.0	
50845	chr9	132879720	132880157	437	218.0	
50846	chr9	132888604	132889394	790	395.0	
50847	chr9	132901601	132902414	813	406.0	
50848	chr9	132908444	132909168	724	362.0	
50849	chr9	132943839	132945575	1736	868.0	
50850	chr9	132972358	132973022	664	332.0	
50851	chr9	132973743	132974096	353	176.0	
50852	chr9	132977579	132978128	549	274.0	
50853	chr9	132978774	132978815	41	20.0	
50854	chr9	132981917	132982865	948	474.0	
50855	chr9	132994670	132994694	24	12.0	
50856	chr9	133004410	133004773	363	182.0	
50857	chr9	133008862	133009081	219	110.0	
50858	chr9	133022103	133023515	1412	706.0	
50859	chr9	133029800	133031488	1688	844.0	
50860	chr9	133040889	133041316	427	214.0	
50861	chr9	133048536	133048915	379	190.0	
50862	chr9	133057189	133057321	132	66.0	
50863	chr9	133060436	133060704	268	134.0	
50864	chr9	133089360	133089673	313	156.0	
50865	chr9	133100885	133100898	13	6.0	
50866	chr9	133102913	133104314	1401	700.0	
50867	chr9	133104866	133105482	616	308.0	
50868	chr9	133108431	133108485	54	27.0	
50869	chr9	133110210	133110282	72	36.0	
50870	chr9	133111360	133111378	18	9.0	
50871	chr9	133112075	133116297	4222	2111.0	
50872	chr9	133117610	133118200	590	295.0	
50873	chr9	133118711	133119489	778	389.0	
50874	chr9	133120075	133123730	3655	1828.0	
50875	chr9	133124237	133125087	850	425.0	
50876	chr9	133125668	133136058	10390	5195.0	
50877	chr9	133137679	133138028	349	174.0	
50878	chr9	133141330	133145530	4200	2100.0	
50879	chr9	133146813	133150208	3395	1698.0	
50880	chr9	133160740	133161437	697	348.0	
50881	chr9	133163414	133164363	949	474.0	
50882	chr9	133179878	133180363	485	242.0	
50883	chr9	133184276	133186518	2242	1121.0	
50884	chr9	133199981	133200460	479	240.0	
50885	chr9	133238336	133239520	1184	592.0	
50886	chr9	133275145	133275376	231	116.0	
50887	chr9	133282470	133282860	390	195.0	
50888	chr9	133329393	133329582	189	94.0	
50889	chr9	133335327	133336881	1554	777.0	
50890	chr9	133340142	133340902	760	380.0	
50891	chr9	133341660	133342391	731	366.0	
50892	chr9	133346820	133349165	2345	1172.0	
50893	chr9	133351875	133352470	595	298.0	
50894	chr9	133355667	133357487	1820	910.0	
50895	chr9	133358929	133359841	912	456.0	
50896	chr9	133360718	133360934	216	108.0	
50897	chr9	133369260	133372585	3325	1662.0	
50898	chr9	133374516	133376970	2454	1227.0	
50899	chr9	133403774	133404300	526	263.0	
50900	chr9	133406626	133407478	852	426.0	
50901	chr9	133416663	133418801	2138	1069.0	
50902	chr9	133420334	133420890	556	278.0	
50903	chr9	133421656	133422003	347	174.0	
50904	chr9	133428642	133429012	370	185.0	
50905	chr9	133429526	133429907	381	190.0	
50906	chr9	133440788	133441357	569	284.0	
50907	chr9	133458526	133461257	2731	1366.0	
50908	chr9	133463340	133463448	108	54.0	
50909	chr9	133470466	133471475	1009	504.0	
50910	chr9	133474212	133474617	405	202.0	
50911	chr9	133476185	133479882	3697	1848.0	
50912	chr9	133485862	133486923	1061	530.0	
50913	chr9	133509177	133509578	401	200.0	
50914	chr9	133532970	133533466	496	248.0	
50915	chr9	133534445	133534997	552	276.0	
50916	chr9	133540311	133540717	406	203.0	
50917	chr9	133609217	133609689	472	236.0	
50918	chr9	133619743	133620188	445	222.0	
50919	chr9	133656510	133656878	368	184.0	
50920	chr9	133676939	133677684	745	372.0	enhancer
50921	chr9	133683277	133684290	1013	506.0	
50922	chr9	133700772	133703929	3157	1578.0	
50923	chr9	133709060	133709807	747	374.0	
50924	chr9	133715788	133716136	348	174.0	
50925	chr9	133726408	133727505	1097	548.0	
50926	chr9	133737905	133738813	908	454.0	
50927	chr9	133742895	133743431	536	268.0	
50928	chr9	133782127	133782605	478	239.0	
50929	chr9	133786122	133788088	1966	983.0	
50930	chr9	133788984	133789588	604	302.0	
50931	chr9	133792713	133793664	951	476.0	
50932	chr9	133822226	133824092	1866	933.0	
50933	chr9	133825797	133826167	370	185.0	
50934	chr9	133839784	133840140	356	178.0	
50935	chr9	133844285	133846222	1937	968.0	
50936	chr9	133855365	133856617	1252	626.0	
50937	chr9	133862370	133863534	1164	582.0	
50938	chr9	133869648	133869775	127	64.0	
50939	chr9	133945197	133945839	642	321.0	
50940	chr9	133954861	133956142	1281	640.0	
50941	chr9	133960339	133960907	568	284.0	
50942	chr9	133979627	133979987	360	180.0	
50943	chr9	133990893	133994988	4095	2048.0	
50944	chr9	134024170	134026528	2358	1179.0	
50945	chr9	134059560	134060685	1125	562.0	
50946	chr9	134065260	134069472	4212	2106.0	
50947	chr9	134098954	134099592	638	319.0	
50948	chr9	134122773	134123546	773	386.0	
50949	chr9	134134948	134137028	2080	1040.0	
50950	chr9	134162904	134165894	2990	1495.0	
50951	chr9	134170502	134171379	877	438.0	
50952	chr9	134171902	134172380	478	239.0	
50953	chr9	134173984	134174560	576	288.0	
50954	chr9	134175141	134175632	491	246.0	
50955	chr9	134243637	134244476	839	420.0	
50956	chr9	134245223	134245304	81	40.0	
50957	chr9	134268098	134269099	1001	500.0	
50958	chr9	134276165	134277106	941	470.0	
50959	chr9	134293793	134294265	472	236.0	
50960	chr9	134301618	134302280	662	331.0	
50961	chr9	134324148	134327960	3812	1906.0	
50962	chr9	134329970	134329971	1	0.0	
50963	chr9	134340448	134341827	1379	690.0	
50964	chr9	134343567	134345055	1488	744.0	
50965	chr9	134346017	134346430	413	206.0	
50966	chr9	134357003	134357280	277	138.0	
50967	chr9	134358967	134360571	1604	802.0	
50968	chr9	134365729	134367018	1289	644.0	
50969	chr9	134369741	134370377	636	318.0	
50970	chr9	134371222	134378524	7302	3651.0	"sequence_feature	enhancer"
50971	chr9	134380814	134382977	2163	1082.0	
50972	chr9	134384445	134386360	1915	958.0	
50973	chr9	134390258	134394353	4095	2048.0	
50974	chr9	134395233	134397787	2554	1277.0	
50975	chr9	134399431	134400245	814	407.0	
50976	chr9	134403314	134410650	7336	3668.0	
50977	chr9	134413181	134413299	118	59.0	
50978	chr9	134440231	134444430	4199	2100.0	
50979	chr9	134449056	134450412	1356	678.0	
50980	chr9	134454330	134457342	3012	1506.0	
50981	chr9	134458606	134459759	1153	576.0	
50982	chr9	134472288	134472601	313	156.0	
50983	chr9	134474872	134475655	783	392.0	
50984	chr9	134476240	134476635	395	198.0	
50985	chr9	134641261	134642330	1069	534.0	
50986	chr9	134648874	134649576	702	351.0	
50987	chr9	134689528	134689898	370	185.0	
50988	chr9	134739082	134739483	401	200.0	
50989	chr9	134875372	134875640	268	134.0	
50990	chr9	134891170	134891513	343	172.0	
50991	chr9	134917700	134918235	535	268.0	
50992	chr9	134919233	134919729	496	248.0	
50993	chr9	134922305	134923306	1001	500.0	
50994	chr9	134924828	134925613	785	392.0	
50995	chr9	134928698	134929889	1191	596.0	
50996	chr9	134930524	134930731	207	104.0	
50997	chr9	134934694	134935070	376	188.0	
50998	chr9	134936424	134937459	1035	518.0	
50999	chr9	134965342	134965847	505	252.0	
51000	chr9	135053156	135053534	378	189.0	
51001	chr9	135086225	135086376	151	76.0	
51002	chr9	135087388	135087796	408	204.0	
51003	chr9	135344018	135344126	108	54.0	
51004	chr9	135412514	135412975	461	230.0	
51005	chr9	135468921	135469251	330	165.0	
51006	chr9	135474985	135475251	266	133.0	
51007	chr9	135478692	135481108	2416	1208.0	
51008	chr9	135499145	135501576	2431	1216.0	
51009	chr9	135504559	135505081	522	261.0	
51010	chr9	135602700	135603108	408	204.0	
51011	chr9	135604025	135604224	199	100.0	
51012	chr9	135701515	135702276	761	380.0	
51013	chr9	135777014	135777170	156	78.0	
51014	chr9	135864401	135865039	638	319.0	
51015	chr9	135885136	135885377	241	120.0	
51016	chr9	135887086	135888247	1161	580.0	
51017	chr9	135904977	135908611	3634	1817.0	
51018	chr9	135910201	135910599	398	199.0	
51019	chr9	135926658	135927519	861	430.0	
51020	chr9	135939209	135939751	542	271.0	
51021	chr9	135958365	135958924	559	280.0	
51022	chr9	135960268	135961894	1626	813.0	
51023	chr9	135962409	135963043	634	317.0	
51024	chr9	135967146	135968278	1132	566.0	
51025	chr9	135969087	135969982	895	448.0	
51026	chr9	135971906	135972360	454	227.0	
51027	chr9	135973250	135973710	460	230.0	
51028	chr9	135978569	135979637	1068	534.0	
51029	chr9	135989736	135991414	1678	839.0	
51030	chr9	135992408	135993492	1084	542.0	
51031	chr9	136055577	136056201	624	312.0	
51032	chr9	136059811	136060557	746	373.0	
51033	chr9	136067035	136067655	620	310.0	
51034	chr9	136068262	136068800	538	269.0	
51035	chr9	136075503	136077602	2099	1050.0	
51036	chr9	136079275	136080256	981	490.0	
51037	chr9	136088610	136090650	2040	1020.0	
51038	chr9	136092975	136093114	139	70.0	
51039	chr9	136093724	136096168	2444	1222.0	
51040	chr9	136098810	136099452	642	321.0	
51041	chr9	136105618	136111187	5569	2784.0	
51042	chr9	136112987	136113821	834	417.0	
51043	chr9	136117482	136119944	2462	1231.0	
51044	chr9	136122506	136123504	998	499.0	
51045	chr9	136133006	136133830	824	412.0	
51046	chr9	136170243	136170697	454	227.0	
51047	chr9	136204904	136205372	468	234.0	
51048	chr9	136220303	136220636	333	166.0	
51049	chr9	136225038	136226564	1526	763.0	
51050	chr9	136231617	136232514	897	448.0	
51051	chr9	136239798	136240345	547	274.0	
51052	chr9	136243217	136243265	48	24.0	
51053	chr9	136244215	136246577	2362	1181.0	
51054	chr9	136266788	136268094	1306	653.0	
51055	chr9	136270279	136270737	458	229.0	
51056	chr9	136326098	136326306	208	104.0	
51057	chr9	136326888	136328650	1762	881.0	
51058	chr9	136339136	136339643	507	254.0	
51059	chr9	136342480	136343450	970	485.0	
51060	chr9	136345845	136345853	8	4.0	
51061	chr9	136351851	136352560	709	354.0	
51062	chr9	136353955	136353964	9	4.0	
51063	chr9	136362238	136364454	2216	1108.0	
51064	chr9	136365243	136366308	1065	532.0	
51065	chr9	136372350	136374028	1678	839.0	
51066	chr9	136377183	136377603	420	210.0	
51067	chr9	136385013	136385409	396	198.0	
51068	chr9	136386047	136386325	278	139.0	
51069	chr9	136399211	136400911	1700	850.0	
51070	chr9	136403369	136405194	1825	912.0	
51071	chr9	136408838	136411438	2600	1300.0	
51072	chr9	136438175	136440382	2207	1104.0	
51073	chr9	136481555	136485946	4391	2196.0	
51074	chr9	136488271	136489237	966	483.0	
51075	chr9	136493708	136494105	397	198.0	
51076	chr9	136512665	136513222	557	278.0	
51077	chr9	136521259	136522974	1715	858.0	
51078	chr9	136526784	136526860	76	38.0	
51079	chr9	136527692	136531390	3698	1849.0	
51080	chr9	136532302	136535434	3132	1566.0	
51081	chr9	136537073	136541562	4489	2244.0	
51082	chr9	136543245	136543651	406	203.0	
51083	chr9	136544177	136547590	3413	1706.0	
51084	chr9	136551306	136552825	1519	760.0	
51085	chr9	136557718	136559107	1389	694.0	
51086	chr9	136560564	136561008	444	222.0	
51087	chr9	136563025	136563475	450	225.0	
51088	chr9	136564300	136565308	1008	504.0	
51089	chr9	136572264	136573205	941	470.0	enhancer
51090	chr9	136576223	136576700	477	238.0	
51091	chr9	136578618	136579711	1093	546.0	
51092	chr9	136586825	136587593	768	384.0	
51093	chr9	136588366	136588765	399	200.0	
51094	chr9	136590924	136591200	276	138.0	
51095	chr9	136603812	136604351	539	270.0	
51096	chr9	136615602	136616041	439	220.0	
51097	chr9	136618113	136620398	2285	1142.0	
51098	chr9	136625205	136625610	405	202.0	
51099	chr9	136630135	136632248	2113	1056.0	
51100	chr9	136643701	136646810	3109	1554.0	
51101	chr9	136648856	136649247	391	196.0	
51102	chr9	136650716	136651014	298	149.0	
51103	chr9	136655354	136657255	1901	950.0	
51104	chr9	136658344	136659648	1304	652.0	
51105	chr9	136661184	136661629	445	222.0	
51106	chr9	136665062	136667340	2278	1139.0	
51107	chr9	136668146	136669444	1298	649.0	
51108	chr9	136671545	136672062	517	258.0	
51109	chr9	136678565	136680068	1503	752.0	
51110	chr9	136685997	136689123	3126	1563.0	
51111	chr9	136693760	136694657	897	448.0	
51112	chr9	136696013	136696803	790	395.0	
51113	chr9	136697443	136698609	1166	583.0	
51114	chr9	136700426	136702097	1671	836.0	
51115	chr9	136703082	136703824	742	371.0	
51116	chr9	136705277	136706016	739	370.0	
51117	chr9	136709706	136709893	187	94.0	
51118	chr9	136711567	136715331	3764	1882.0	
51119	chr9	136717306	136723798	6492	3246.0	
51120	chr9	136726413	136729538	3125	1562.0	
51121	chr9	136741497	136742664	1167	584.0	
51122	chr9	136749670	136750238	568	284.0	
51123	chr9	136754379	136754426	47	24.0	
51124	chr9	136758111	136758796	685	342.0	
51125	chr9	136760852	136761238	386	193.0	
51126	chr9	136762972	136763474	502	251.0	
51127	chr9	136765723	136767267	1544	772.0	
51128	chr9	136769861	136770355	494	247.0	
51129	chr9	136773649	136774159	510	255.0	
51130	chr9	136784170	136785399	1229	614.0	
51131	chr9	136787377	136788279	902	451.0	
51132	chr9	136790323	136792635	2312	1156.0	
51133	chr9	136794868	136795371	503	252.0	
51134	chr9	136796143	136796203	60	30.0	
51135	chr9	136799292	136801591	2299	1150.0	
51136	chr9	136806973	136809077	2104	1052.0	
51137	chr9	136821185	136821663	478	239.0	
51138	chr9	136841851	136845606	3755	1878.0	
51139	chr9	136846376	136850457	4081	2040.0	
51140	chr9	136851390	136853689	2299	1150.0	
51141	chr9	136854766	136859984	5218	2609.0	
51142	chr9	136860741	136861746	1005	502.0	
51143	chr9	136865275	136867062	1787	894.0	
51144	chr9	136880769	136880870	101	50.0	
51145	chr9	136881540	136883213	1673	836.0	
51146	chr9	136885656	136887715	2059	1030.0	
51147	chr9	136901262	136903307	2045	1022.0	
51148	chr9	136928590	136929081	491	246.0	
51149	chr9	136932063	136932473	410	205.0	
51150	chr9	136943564	136946542	2978	1489.0	
51151	chr9	136947796	136948464	668	334.0	
51152	chr9	136949149	136951203	2054	1027.0	
51153	chr9	136959772	136961277	1505	752.0	
51154	chr9	136965482	136966692	1210	605.0	
51155	chr9	136974781	136976505	1724	862.0	
51156	chr9	136977687	136979988	2301	1150.0	
51157	chr9	136984741	136985730	989	494.0	
51158	chr9	136991147	136993385	2238	1119.0	
51159	chr9	136994154	136994193	39	20.0	
51160	chr9	136994938	136995245	307	154.0	
51161	chr9	136995828	136998761	2933	1466.0	
51162	chr9	136999322	137000951	1629	814.0	
51163	chr9	137004252	137004716	464	232.0	
51164	chr9	137006243	137006642	399	200.0	
51165	chr9	137021508	137022969	1461	730.0	
51166	chr9	137023957	137024476	519	260.0	
51167	chr9	137025560	137035864	10304	5152.0	
51168	chr9	137044603	137047141	2538	1269.0	
51169	chr9	137049616	137050223	607	304.0	
51170	chr9	137053498	137054555	1057	528.0	
51171	chr9	137063838	137064698	860	430.0	
51172	chr9	137067478	137068548	1070	535.0	
51173	chr9	137069558	137071604	2046	1023.0	
51174	chr9	137073205	137073770	565	282.0	
51175	chr9	137074914	137075636	722	361.0	
51176	chr9	137076757	137078496	1739	870.0	
51177	chr9	137079473	137079774	301	150.0	
51178	chr9	137085010	137087921	2911	1456.0	
51179	chr9	137095453	137096976	1523	762.0	
51180	chr9	137113584	137115704	2120	1060.0	
51181	chr9	137118616	137119296	680	340.0	
51182	chr9	137121593	137121987	394	197.0	
51183	chr9	137126881	137130570	3689	1844.0	
51184	chr9	137138872	137139521	649	324.0	
51185	chr9	137150540	137151921	1381	690.0	
51186	chr9	137156470	137157558	1088	544.0	
51187	chr9	137161493	137161715	222	111.0	
51188	chr9	137162765	137163135	370	185.0	
51189	chr9	137168380	137169615	1235	618.0	
51190	chr9	137173492	137173784	292	146.0	
51191	chr9	137176606	137176909	303	152.0	
51192	chr9	137187941	137189844	1903	952.0	
51193	chr9	137198757	137198784	27	14.0	
51194	chr9	137199593	137201858	2265	1132.0	
51195	chr9	137204838	137206278	1440	720.0	
51196	chr9	137221626	137225147	3521	1760.0	
51197	chr9	137226909	137228286	1377	688.0	
51198	chr9	137234769	137235098	329	164.0	
51199	chr9	137235885	137237588	1703	852.0	
51200	chr9	137238408	137238615	207	104.0	
51201	chr9	137239848	137246640	6792	3396.0	
51202	chr9	137247305	137248657	1352	676.0	
51203	chr9	137250667	137256162	5495	2748.0	
51204	chr9	137268056	137268811	755	378.0	
51205	chr9	137271214	137271829	615	308.0	
51206	chr9	137274886	137274902	16	8.0	
51207	chr9	137275825	137278651	2826	1413.0	
51208	chr9	137280790	137281284	494	247.0	
51209	chr9	137282879	137283151	272	136.0	
51210	chr9	137284979	137285179	200	100.0	
51211	chr9	137286282	137287319	1037	518.0	recombination_feature
51212	chr9	137294205	137297471	3266	1633.0	
51213	chr9	137300747	137304688	3941	1970.0	
51214	chr9	137305307	137307816	2509	1254.0	
51215	chr9	137311495	137311598	103	52.0	
51216	chr9	137315986	137317033	1047	524.0	
51217	chr9	137320416	137321292	876	438.0	
51218	chr9	137326284	137327392	1108	554.0	
51219	chr9	137387378	137387870	492	246.0	
51220	chr9	137399798	137400379	581	290.0	
51221	chr9	137406718	137407588	870	435.0	
51222	chr9	137411465	137412405	940	470.0	
51223	chr9	137417180	137417955	775	388.0	
51224	chr9	137422293	137425341	3048	1524.0	
51225	chr9	137430282	137430540	258	129.0	
51226	chr9	137434582	137434949	367	184.0	
51227	chr9	137441220	137442087	867	434.0	
51228	chr9	137444902	137446171	1269	634.0	
51229	chr9	137446811	137455186	8375	4188.0	
51230	chr9	137457394	137463081	5687	2844.0	
51231	chr9	137470872	137471056	184	92.0	
51232	chr9	137482106	137482668	562	281.0	
51233	chr9	137492437	137492863	426	213.0	
51234	chr9	137494044	137494503	459	230.0	
51235	chr9	137502375	137502412	37	18.0	recombination_feature
51236	chr9	137534773	137535258	485	242.0	
51237	chr9	137545791	137546000	209	104.0	
51238	chr9	137549797	137552727	2930	1465.0	
51239	chr9	137553404	137553409	5	2.0	
51240	chr9	137578257	137579614	1357	678.0	
51241	chr9	137582207	137582574	367	184.0	
51242	chr9	137589557	137591604	2047	1024.0	
51243	chr9	137592832	137593206	374	187.0	
51244	chr9	137602091	137603421	1330	665.0	
51245	chr9	137604338	137609047	4709	2354.0	
51246	chr9	137611735	137612480	745	372.0	
51247	chr9	137617918	137620213	2295	1148.0	
51248	chr9	137621313	137621800	487	244.0	
51249	chr9	137625468	137625623	155	78.0	
51250	chr9	137628365	137629215	850	425.0	
51251	chr9	137630474	137631039	565	282.0	
51252	chr9	137631966	137632290	324	162.0	
51253	chr9	137639220	137640019	799	400.0	
51254	chr9	137647109	137648176	1067	534.0	
51255	chr9	137672740	137673451	711	356.0	
51256	chr9	137676522	137677021	499	250.0	
51257	chr9	137688745	137689163	418	209.0	
51258	chr9	137691547	137692145	598	299.0	
51259	chr9	137695147	137695621	474	237.0	
51260	chr9	137705398	137706134	736	368.0	
51261	chr9	137715347	137716870	1523	762.0	
51262	chr9	137721527	137724320	2793	1396.0	
51263	chr9	137738097	137738734	637	318.0	
51264	chr9	137744918	137746074	1156	578.0	
51265	chr9	137757492	137758109	617	308.0	
51266	chr9	137759031	137759475	444	222.0	
51267	chr9	137760009	137760279	270	135.0	
51268	chr9	137760957	137761358	401	200.0	
51269	chr9	137762375	137762873	498	249.0	
51270	chr9	137825556	137826086	530	265.0	
51271	chr9	137878562	137878883	321	160.0	
51272	chr9	137883189	137883326	137	68.0	
51273	chr9	137884195	137885170	975	488.0	
51274	chr9	137890488	137890540	52	26.0	
51275	chr9	138126168	138126493	325	162.0	
51276	chr9	138147612	138147924	312	156.0	
51277	chr9	138149879	138150530	651	326.0	
51278	chr9	138213663	138214235	572	286.0	
51279	chr10	73989	74407	418	209.0	
51280	chr10	76263	76780	517	258.0	
51281	chr10	127747	128481	734	367.0	
51282	chr10	129889	130273	384	192.0	
51283	chr10	134025	137571	3546	1773.0	
51284	chr10	312046	312447	401	200.0	
51285	chr10	317140	317723	583	292.0	
51286	chr10	323821	324945	1124	562.0	
51287	chr10	329379	329762	383	192.0	
51288	chr10	333287	334386	1099	550.0	
51289	chr10	381652	382320	668	334.0	
51290	chr10	394305	395233	928	464.0	
51291	chr10	437213	437595	382	191.0	
51292	chr10	450472	451889	1417	708.0	
51293	chr10	470142	471127	985	492.0	enhancer
51294	chr10	484392	485593	1201	600.0	
51295	chr10	510940	511486	546	273.0	
51296	chr10	620429	620818	389	194.0	
51297	chr10	662940	663024	84	42.0	
51298	chr10	788984	789530	546	273.0	
51299	chr10	804320	805252	932	466.0	
51300	chr10	808158	808229	71	36.0	
51301	chr10	822999	823300	301	150.0	
51302	chr10	851870	852331	461	230.0	
51303	chr10	921786	922351	565	282.0	
51304	chr10	929788	932566	2778	1389.0	
51305	chr10	939303	939334	31	16.0	
51306	chr10	944212	945053	841	420.0	
51307	chr10	971156	971571	415	208.0	
51308	chr10	987471	989378	1907	954.0	
51309	chr10	1036002	1038623	2621	1310.0	
51310	chr10	1043236	1046611	3375	1688.0	
51311	chr10	1047469	1051025	3556	1778.0	
51312	chr10	1055488	1058298	2810	1405.0	
51313	chr10	1061702	1064497	2795	1398.0	
51314	chr10	1069047	1069072	25	12.0	
51315	chr10	1069657	1070132	475	238.0	
51316	chr10	1074060	1074369	309	154.0	
51317	chr10	1074960	1075346	386	193.0	
51318	chr10	1109815	1110892	1077	538.0	
51319	chr10	1142852	1142922	70	35.0	
51320	chr10	1149692	1150197	505	252.0	
51321	chr10	1209321	1209694	373	186.0	
51322	chr10	1240270	1240952	682	341.0	
51323	chr10	1253706	1254389	683	342.0	
51324	chr10	1255183	1255289	106	53.0	
51325	chr10	1256402	1256466	64	32.0	
51326	chr10	1287960	1288484	524	262.0	
51327	chr10	1359214	1359761	547	274.0	
51328	chr10	1368825	1369233	408	204.0	
51329	chr10	1412615	1412925	310	155.0	
51330	chr10	1420787	1421335	548	274.0	
51331	chr10	1425844	1426258	414	207.0	
51332	chr10	1454401	1454909	508	254.0	
51333	chr10	1489048	1489566	518	259.0	
51334	chr10	1661830	1662958	1128	564.0	
51335	chr10	1680034	1680555	521	260.0	
51336	chr10	1706709	1707115	406	203.0	
51337	chr10	1737407	1737821	414	207.0	
51338	chr10	1897232	1897833	601	300.0	
51339	chr10	1923854	1923867	13	6.0	
51340	chr10	1932532	1933077	545	272.0	
51341	chr10	1938193	1939672	1479	740.0	
51342	chr10	2020839	2021176	337	168.0	
51343	chr10	2893320	2893410	90	45.0	
51344	chr10	2908946	2909030	84	42.0	
51345	chr10	2928204	2928618	414	207.0	
51346	chr10	2986446	2986784	338	169.0	
51347	chr10	3036061	3036671	610	305.0	
51348	chr10	3040163	3040181	18	9.0	
51349	chr10	3043496	3044150	654	327.0	
51350	chr10	3057942	3058405	463	232.0	
51351	chr10	3064623	3064638	15	8.0	
51352	chr10	3066268	3069428	3160	1580.0	
51353	chr10	3070101	3070140	39	20.0	
51354	chr10	3071507	3071779	272	136.0	
51355	chr10	3092963	3093874	911	456.0	
51356	chr10	3095281	3096683	1402	701.0	
51357	chr10	3099277	3099740	463	232.0	
51358	chr10	3171512	3174591	3079	1540.0	
51359	chr10	3178113	3178188	75	38.0	
51360	chr10	3186434	3186686	252	126.0	
51361	chr10	3192805	3193466	661	330.0	
51362	chr10	3197281	3198176	895	448.0	
51363	chr10	3199464	3199773	309	154.0	
51364	chr10	3208559	3209714	1155	578.0	
51365	chr10	3221951	3222673	722	361.0	
51366	chr10	3227648	3228542	894	447.0	
51367	chr10	3239538	3240085	547	274.0	
51368	chr10	3313800	3315003	1203	602.0	
51369	chr10	3330620	3331194	574	287.0	
51370	chr10	3419981	3420289	308	154.0	
51371	chr10	3421792	3422331	539	270.0	
51372	chr10	3424392	3424850	458	229.0	
51373	chr10	3438650	3438953	303	152.0	
51374	chr10	3465417	3465730	313	156.0	
51375	chr10	3467401	3469609	2208	1104.0	
51376	chr10	3471458	3471722	264	132.0	
51377	chr10	3472224	3473130	906	453.0	
51378	chr10	3477868	3477993	125	62.0	
51379	chr10	3482281	3482747	466	233.0	
51380	chr10	3484146	3485864	1718	859.0	
51381	chr10	3554171	3554395	224	112.0	
51382	chr10	3592504	3592772	268	134.0	
51383	chr10	3655431	3655956	525	262.0	
51384	chr10	3666617	3667392	775	388.0	
51385	chr10	3668270	3669415	1145	572.0	
51386	chr10	3671282	3671995	713	356.0	
51387	chr10	3714916	3715461	545	272.0	
51388	chr10	3720225	3721267	1042	521.0	
51389	chr10	3735143	3735435	292	146.0	
51390	chr10	3740025	3740966	941	470.0	
51391	chr10	3741715	3742546	831	416.0	
51392	chr10	3749518	3750429	911	456.0	
51393	chr10	3757183	3758788	1605	802.0	
51394	chr10	3760829	3761802	973	486.0	
51395	chr10	3764273	3767066	2793	1396.0	
51396	chr10	3767941	3767993	52	26.0	
51397	chr10	3769410	3771041	1631	816.0	
51398	chr10	3772361	3788357	15996	7998.0	
51399	chr10	3800685	3800968	283	142.0	
51400	chr10	3803149	3812304	9155	4578.0	enhancer
51401	chr10	3814942	3815213	271	136.0	
51402	chr10	3828267	3829831	1564	782.0	
51403	chr10	3834421	3834674	253	126.0	
51404	chr10	3835717	3836845	1128	564.0	
51405	chr10	3850887	3853003	2116	1058.0	
51406	chr10	3873449	3877962	4513	2256.0	
51407	chr10	3886853	3888633	1780	890.0	
51408	chr10	3892019	3893291	1272	636.0	
51409	chr10	3893817	3894317	500	250.0	
51410	chr10	3902095	3903112	1017	508.0	enhancer
51411	chr10	3904541	3904937	396	198.0	
51412	chr10	3934980	3935708	728	364.0	
51413	chr10	3945645	3946515	870	435.0	
51414	chr10	3948680	3949448	768	384.0	
51415	chr10	3950732	3951317	585	292.0	
51416	chr10	3961021	3961614	593	296.0	
51417	chr10	3969943	3970502	559	280.0	
51418	chr10	3972583	3973403	820	410.0	
51419	chr10	3980610	3980974	364	182.0	
51420	chr10	4006109	4006351	242	121.0	
51421	chr10	4034797	4035751	954	477.0	
51422	chr10	4051267	4052058	791	396.0	
51423	chr10	4053942	4054477	535	268.0	
51424	chr10	4059724	4060218	494	247.0	
51425	chr10	4067430	4068264	834	417.0	
51426	chr10	4107285	4107752	467	234.0	
51427	chr10	4120543	4120785	242	121.0	
51428	chr10	4121519	4122091	572	286.0	
51429	chr10	4127632	4128414	782	391.0	
51430	chr10	4129466	4129573	107	54.0	
51431	chr10	4130461	4132596	2135	1068.0	
51432	chr10	4136117	4136153	36	18.0	
51433	chr10	4234469	4235262	793	396.0	
51434	chr10	4266427	4266882	455	228.0	
51435	chr10	4270117	4270590	473	236.0	
51436	chr10	4332720	4334526	1806	903.0	
51437	chr10	4407813	4408228	415	208.0	
51438	chr10	4514208	4515049	841	420.0	
51439	chr10	4519992	4520458	466	233.0	
51440	chr10	4643516	4643750	234	117.0	
51441	chr10	4656562	4656978	416	208.0	
51442	chr10	4704108	4704527	419	210.0	
51443	chr10	4770658	4771251	593	296.0	
51444	chr10	4812005	4812495	490	245.0	
51445	chr10	4813170	4813361	191	96.0	
51446	chr10	4814773	4815670	897	448.0	
51447	chr10	4820713	4821236	523	262.0	
51448	chr10	4825481	4827217	1736	868.0	
51449	chr10	4847584	4847931	347	174.0	
51450	chr10	4848505	4850295	1790	895.0	
51451	chr10	4963201	4963532	331	166.0	
51452	chr10	5089826	5090300	474	237.0	
51453	chr10	5094149	5095110	961	480.0	
51454	chr10	5159224	5159479	255	128.0	
51455	chr10	5210378	5210574	196	98.0	
51456	chr10	5234004	5234937	933	466.0	
51457	chr10	5274704	5275242	538	269.0	
51458	chr10	5283233	5285061	1828	914.0	
51459	chr10	5291327	5294679	3352	1676.0	
51460	chr10	5297196	5298143	947	474.0	
51461	chr10	5317591	5318265	674	337.0	
51462	chr10	5334201	5334388	187	94.0	
51463	chr10	5343561	5343944	383	192.0	
51464	chr10	5383931	5384433	502	251.0	
51465	chr10	5412150	5413511	1361	680.0	
51466	chr10	5433967	5434800	833	416.0	
51467	chr10	5442048	5442497	449	224.0	
51468	chr10	5446260	5448040	1780	890.0	
51469	chr10	5449763	5450177	414	207.0	
51470	chr10	5457738	5458114	376	188.0	
51471	chr10	5547993	5549394	1401	700.0	
51472	chr10	5564053	5565001	948	474.0	
51473	chr10	5622987	5623668	681	340.0	
51474	chr10	5629747	5630448	701	350.0	
51475	chr10	5659715	5660485	770	385.0	
51476	chr10	5665627	5667205	1578	789.0	
51477	chr10	5683979	5686312	2333	1166.0	
51478	chr10	5692322	5693457	1135	568.0	
51479	chr10	5710937	5711828	891	446.0	
51480	chr10	5775377	5776391	1014	507.0	
51481	chr10	5805719	5805897	178	89.0	
51482	chr10	5809126	5810359	1233	616.0	
51483	chr10	5811292	5814894	3602	1801.0	
51484	chr10	5816116	5816614	498	249.0	
51485	chr10	5817287	5817757	470	235.0	
51486	chr10	5818906	5819358	452	226.0	
51487	chr10	5840194	5841445	1251	626.0	
51488	chr10	5846223	5846373	150	75.0	
51489	chr10	5851946	5853577	1631	816.0	
51490	chr10	5860106	5860260	154	77.0	
51491	chr10	5862396	5862549	153	76.0	
51492	chr10	5866286	5867308	1022	511.0	
51493	chr10	5873249	5874165	916	458.0	
51494	chr10	5888235	5891052	2817	1408.0	
51495	chr10	5895773	5896176	403	202.0	
51496	chr10	5942399	5943063	664	332.0	
51497	chr10	5945368	5946310	942	471.0	
51498	chr10	5949402	5949544	142	71.0	
51499	chr10	5951024	5951601	577	288.0	
51500	chr10	5971184	5971957	773	386.0	
51501	chr10	5975555	5978541	2986	1493.0	
51502	chr10	5987827	5988248	421	210.0	
51503	chr10	6013939	6014994	1055	528.0	
51504	chr10	6033981	6034370	389	194.0	
51505	chr10	6036959	6038818	1859	930.0	
51506	chr10	6044122	6044460	338	169.0	
51507	chr10	6045128	6045732	604	302.0	
51508	chr10	6050022	6054647	4625	2312.0	
51509	chr10	6057099	6057271	172	86.0	
51510	chr10	6060847	6062896	2049	1024.0	
51511	chr10	6065813	6066339	526	263.0	
51512	chr10	6068103	6069785	1682	841.0	
51513	chr10	6070565	6073102	2537	1268.0	
51514	chr10	6083649	6084238	589	294.0	
51515	chr10	6086118	6087237	1119	560.0	
51516	chr10	6088402	6090317	1915	958.0	
51517	chr10	6091632	6092067	435	218.0	
51518	chr10	6092961	6093269	308	154.0	
51519	chr10	6108504	6109865	1361	680.0	
51520	chr10	6123411	6123993	582	291.0	
51521	chr10	6124724	6125087	363	182.0	
51522	chr10	6129051	6130740	1689	844.0	
51523	chr10	6134768	6135397	629	314.0	
51524	chr10	6136195	6136954	759	380.0	
51525	chr10	6140319	6142525	2206	1103.0	
51526	chr10	6143618	6146376	2758	1379.0	
51527	chr10	6147757	6149142	1385	692.0	
51528	chr10	6150786	6152116	1330	665.0	
51529	chr10	6153850	6154242	392	196.0	
51530	chr10	6163024	6165450	2426	1213.0	
51531	chr10	6171702	6173831	2129	1064.0	
51532	chr10	6185423	6185788	365	182.0	
51533	chr10	6188336	6189073	737	368.0	
51534	chr10	6192084	6192934	850	425.0	
51535	chr10	6195602	6196631	1029	514.0	
51536	chr10	6197190	6197956	766	383.0	
51537	chr10	6200339	6205250	4911	2456.0	
51538	chr10	6207562	6209305	1743	872.0	
51539	chr10	6211734	6212370	636	318.0	
51540	chr10	6213082	6213613	531	266.0	
51541	chr10	6215397	6217861	2464	1232.0	
51542	chr10	6218963	6219396	433	216.0	
51543	chr10	6220350	6226532	6182	3091.0	
51544	chr10	6227165	6230830	3665	1832.0	
51545	chr10	6231501	6235077	3576	1788.0	
51546	chr10	6236369	6237961	1592	796.0	
51547	chr10	6238737	6239980	1243	622.0	
51548	chr10	6244091	6244541	450	225.0	
51549	chr10	6248926	6249281	355	178.0	
51550	chr10	6254155	6254807	652	326.0	
51551	chr10	6267016	6267883	867	434.0	
51552	chr10	6269426	6271288	1862	931.0	
51553	chr10	6273956	6275984	2028	1014.0	
51554	chr10	6291342	6292404	1062	531.0	
51555	chr10	6292907	6293231	324	162.0	
51556	chr10	6295592	6295961	369	184.0	
51557	chr10	6298008	6298506	498	249.0	
51558	chr10	6299883	6300988	1105	552.0	
51559	chr10	6320319	6320745	426	213.0	
51560	chr10	6328450	6329202	752	376.0	
51561	chr10	6347302	6348952	1650	825.0	
51562	chr10	6351483	6351667	184	92.0	
51563	chr10	6381995	6382630	635	318.0	
51564	chr10	6386310	6386703	393	196.0	
51565	chr10	6390487	6390873	386	193.0	
51566	chr10	6396308	6397247	939	470.0	
51567	chr10	6398406	6402447	4041	2020.0	
51568	chr10	6406188	6406652	464	232.0	
51569	chr10	6409782	6411784	2002	1001.0	
51570	chr10	6416819	6417409	590	295.0	
51571	chr10	6445656	6446358	702	351.0	
51572	chr10	6472379	6474551	2172	1086.0	
51573	chr10	6482668	6483422	754	377.0	
51574	chr10	6484031	6484124	93	46.0	
51575	chr10	6491380	6495839	4459	2230.0	
51576	chr10	6498350	6499458	1108	554.0	
51577	chr10	6504239	6504633	394	197.0	
51578	chr10	6507302	6507791	489	244.0	
51579	chr10	6513403	6513970	567	284.0	
51580	chr10	6515042	6515568	526	263.0	
51581	chr10	6516874	6517306	432	216.0	
51582	chr10	6529769	6531251	1482	741.0	
51583	chr10	6537634	6538237	603	302.0	
51584	chr10	6542769	6544216	1447	724.0	
51585	chr10	6558197	6559211	1014	507.0	
51586	chr10	6562537	6564739	2202	1101.0	
51587	chr10	6574701	6575468	767	384.0	
51588	chr10	6576266	6576865	599	300.0	
51589	chr10	6577872	6584235	6363	3182.0	
51590	chr10	6586507	6586866	359	180.0	
51591	chr10	6589960	6590017	57	28.0	
51592	chr10	6591673	6593525	1852	926.0	
51593	chr10	6595648	6595717	69	34.0	
51594	chr10	6600244	6601834	1590	795.0	
51595	chr10	6607052	6607653	601	300.0	
51596	chr10	6612224	6612701	477	238.0	
51597	chr10	6647683	6648510	827	414.0	
51598	chr10	6665797	6666303	506	253.0	
51599	chr10	6667668	6668076	408	204.0	
51600	chr10	6669266	6669631	365	182.0	
51601	chr10	6678140	6678628	488	244.0	
51602	chr10	6916537	6917591	1054	527.0	
51603	chr10	6918269	6918788	519	260.0	
51604	chr10	6919856	6920564	708	354.0	
51605	chr10	6926958	6929780	2822	1411.0	enhancer
51606	chr10	6958214	6959106	892	446.0	
51607	chr10	6973945	6974366	421	210.0	
51608	chr10	6988634	6988989	355	178.0	
51609	chr10	6995906	6996182	276	138.0	
51610	chr10	7028233	7028966	733	366.0	
51611	chr10	7030000	7030968	968	484.0	
51612	chr10	7046022	7047030	1008	504.0	
51613	chr10	7120961	7121671	710	355.0	
51614	chr10	7157114	7157532	418	209.0	
51615	chr10	7180371	7180630	259	130.0	
51616	chr10	7184065	7185820	1755	878.0	
51617	chr10	7186568	7187290	722	361.0	
51618	chr10	7188365	7188786	421	210.0	
51619	chr10	7192604	7193952	1348	674.0	
51620	chr10	7196390	7196437	47	24.0	
51621	chr10	7206312	7207096	784	392.0	
51622	chr10	7239317	7239721	404	202.0	
51623	chr10	7243091	7244490	1399	700.0	
51624	chr10	7252181	7252238	57	28.0	
51625	chr10	7255577	7255807	230	115.0	
51626	chr10	7256856	7257573	717	358.0	
51627	chr10	7258822	7261015	2193	1096.0	
51628	chr10	7265251	7265670	419	210.0	
51629	chr10	7269088	7270063	975	488.0	
51630	chr10	7271688	7272491	803	402.0	
51631	chr10	7287607	7287826	219	110.0	
51632	chr10	7306095	7306481	386	193.0	
51633	chr10	7319075	7319146	71	36.0	
51634	chr10	7320125	7320363	238	119.0	
51635	chr10	7337366	7337781	415	208.0	
51636	chr10	7388600	7389039	439	220.0	
51637	chr10	7405702	7406081	379	190.0	
51638	chr10	7407320	7413321	6001	3000.0	
51639	chr10	7416842	7418226	1384	692.0	
51640	chr10	7424341	7424542	201	100.0	
51641	chr10	7444615	7444837	222	111.0	
51642	chr10	7445463	7446205	742	371.0	
51643	chr10	7457382	7458085	703	352.0	
51644	chr10	7471553	7472511	958	479.0	
51645	chr10	7480799	7481845	1046	523.0	
51646	chr10	7483549	7485778	2229	1114.0	
51647	chr10	7501424	7501527	103	52.0	
51648	chr10	7502116	7502560	444	222.0	
51649	chr10	7507855	7508103	248	124.0	
51650	chr10	7525324	7525844	520	260.0	
51651	chr10	7666766	7666879	113	56.0	
51652	chr10	7667425	7668068	643	322.0	
51653	chr10	7687154	7687726	572	286.0	
51654	chr10	7786429	7789224	2795	1398.0	
51655	chr10	7817828	7819692	1864	932.0	
51656	chr10	7871973	7872462	489	244.0	
51657	chr10	7956529	7956935	406	203.0	
51658	chr10	8034182	8035067	885	442.0	
51659	chr10	8035726	8036211	485	242.0	
51660	chr10	8037884	8038285	401	200.0	
51661	chr10	8039642	8039991	349	174.0	
51662	chr10	8041984	8062443	20459	10230.0	
51663	chr10	8088360	8088976	616	308.0	
51664	chr10	8133170	8133473	303	152.0	
51665	chr10	8137151	8138131	980	490.0	
51666	chr10	8182981	8183949	968	484.0	
51667	chr10	8239060	8239081	21	10.0	
51668	chr10	8245034	8245835	801	400.0	
51669	chr10	8331206	8333312	2106	1053.0	
51670	chr10	8360346	8360773	427	214.0	
51671	chr10	8365888	8366455	567	284.0	
51672	chr10	8402445	8403378	933	466.0	
51673	chr10	8404038	8405421	1383	692.0	
51674	chr10	8415932	8417264	1332	666.0	
51675	chr10	8438526	8439032	506	253.0	
51676	chr10	8444598	8445049	451	226.0	
51677	chr10	8473205	8473601	396	198.0	
51678	chr10	9010000	9010579	579	290.0	
51679	chr10	9096216	9096727	511	256.0	
51680	chr10	9097342	9098069	727	364.0	
51681	chr10	9209142	9209607	465	232.0	
51682	chr10	9302130	9302536	406	203.0	
51683	chr10	9331558	9331877	319	160.0	
51684	chr10	9957336	9957745	409	204.0	
51685	chr10	10392623	10392884	261	130.0	
51686	chr10	10393665	10394066	401	200.0	
51687	chr10	10418415	10418819	404	202.0	
51688	chr10	10460502	10460808	306	153.0	
51689	chr10	10499806	10500197	391	196.0	
51690	chr10	10520735	10521135	400	200.0	
51691	chr10	10662395	10663410	1015	508.0	
51692	chr10	10677486	10677861	375	188.0	
51693	chr10	10699393	10699888	495	248.0	
51694	chr10	10785997	10786842	845	422.0	
51695	chr10	11017342	11018868	1526	763.0	
51696	chr10	11113125	11113946	821	410.0	
51697	chr10	11141490	11141845	355	178.0	
51698	chr10	11142748	11143624	876	438.0	
51699	chr10	11144756	11147050	2294	1147.0	
51700	chr10	11147631	11151350	3719	1860.0	
51701	chr10	11156412	11157011	599	300.0	
51702	chr10	11157516	11158126	610	305.0	
51703	chr10	11161015	11161561	546	273.0	
51704	chr10	11162453	11171972	9519	4760.0	
51705	chr10	11172834	11173475	641	320.0	
51706	chr10	11175420	11183485	8065	4032.0	
51707	chr10	11184127	11184487	360	180.0	
51708	chr10	11186308	11186822	514	257.0	
51709	chr10	11191450	11191528	78	39.0	
51710	chr10	11192248	11192649	401	200.0	
51711	chr10	11193286	11193435	149	74.0	
51712	chr10	11194893	11195649	756	378.0	
51713	chr10	11196943	11198016	1073	536.0	
51714	chr10	11199204	11199207	3	2.0	
51715	chr10	11199944	11200010	66	33.0	
51716	chr10	11202740	11203062	322	161.0	
51717	chr10	11204122	11204841	719	360.0	
51718	chr10	11205446	11205766	320	160.0	
51719	chr10	11207976	11213395	5419	2710.0	
51720	chr10	11214429	11215917	1488	744.0	
51721	chr10	11218532	11218651	119	60.0	
51722	chr10	11220738	11221122	384	192.0	
51723	chr10	11225516	11227976	2460	1230.0	
51724	chr10	11229975	11230244	269	134.0	
51725	chr10	11234090	11236670	2580	1290.0	
51726	chr10	11237207	11238185	978	489.0	
51727	chr10	11240277	11240598	321	160.0	
51728	chr10	11242138	11247801	5663	2832.0	
51729	chr10	11250404	11250738	334	167.0	
51730	chr10	11255233	11256475	1242	621.0	
51731	chr10	11257923	11259258	1335	668.0	
51732	chr10	11261318	11261953	635	318.0	
51733	chr10	11269830	11271093	1263	632.0	
51734	chr10	11281909	11283033	1124	562.0	
51735	chr10	11285407	11287201	1794	897.0	
51736	chr10	11293434	11293594	160	80.0	
51737	chr10	11300066	11300572	506	253.0	
51738	chr10	11301787	11302032	245	122.0	
51739	chr10	11305465	11306326	861	430.0	
51740	chr10	11307116	11307117	1	0.0	
51741	chr10	11309808	11310375	567	284.0	
51742	chr10	11318395	11318543	148	74.0	
51743	chr10	11319230	11321539	2309	1154.0	
51744	chr10	11322845	11323069	224	112.0	
51745	chr10	11328496	11329399	903	452.0	
51746	chr10	11335086	11336126	1040	520.0	
51747	chr10	11336794	11339062	2268	1134.0	
51748	chr10	11341335	11341936	601	300.0	
51749	chr10	11344697	11345073	376	188.0	
51750	chr10	11345601	11346205	604	302.0	
51751	chr10	11401368	11402159	791	396.0	
51752	chr10	11402846	11403682	836	418.0	
51753	chr10	11448459	11448752	293	146.0	
51754	chr10	11472092	11472591	499	250.0	
51755	chr10	11515551	11516051	500	250.0	
51756	chr10	11533451	11533792	341	170.0	
51757	chr10	11535378	11535744	366	183.0	
51758	chr10	11548746	11549037	291	146.0	
51759	chr10	11552082	11552676	594	297.0	
51760	chr10	11553995	11554475	480	240.0	
51761	chr10	11560301	11560807	506	253.0	
51762	chr10	11573498	11573977	479	240.0	
51763	chr10	11586022	11586375	353	176.0	
51764	chr10	11594921	11595292	371	186.0	
51765	chr10	11604759	11605413	654	327.0	
51766	chr10	11610499	11613182	2683	1342.0	
51767	chr10	11624873	11625683	810	405.0	
51768	chr10	11632103	11632742	639	320.0	
51769	chr10	11662432	11662938	506	253.0	
51770	chr10	11664102	11664411	309	154.0	
51771	chr10	11665123	11665235	112	56.0	
51772	chr10	11673662	11673681	19	10.0	
51773	chr10	11677958	11678510	552	276.0	
51774	chr10	11682342	11682681	339	170.0	
51775	chr10	11683605	11686314	2709	1354.0	
51776	chr10	11697907	11698143	236	118.0	
51777	chr10	11698782	11699621	839	420.0	
51778	chr10	11710605	11711237	632	316.0	
51779	chr10	11717889	11718584	695	348.0	
51780	chr10	11720061	11720731	670	335.0	
51781	chr10	11725153	11725604	451	226.0	
51782	chr10	11741848	11743138	1290	645.0	
51783	chr10	11746935	11747627	692	346.0	
51784	chr10	11757788	11758527	739	370.0	
51785	chr10	11782784	11783230	446	223.0	
51786	chr10	11814339	11814513	174	87.0	
51787	chr10	11819793	11820223	430	215.0	
51788	chr10	11823055	11824121	1066	533.0	
51789	chr10	11849594	11850501	907	454.0	
51790	chr10	11863239	11864299	1060	530.0	
51791	chr10	11874599	11875238	639	320.0	
51792	chr10	11986563	11987106	543	272.0	
51793	chr10	12022589	12022963	374	187.0	
51794	chr10	12041539	12044460	2921	1460.0	
51795	chr10	12051211	12051667	456	228.0	
51796	chr10	12053402	12054495	1093	546.0	
51797	chr10	12068153	12069870	1717	858.0	
51798	chr10	12075019	12075529	510	255.0	
51799	chr10	12077796	12078352	556	278.0	
51800	chr10	12100019	12100082	63	32.0	
51801	chr10	12112696	12113268	572	286.0	
51802	chr10	12122492	12123069	577	288.0	
51803	chr10	12128877	12130757	1880	940.0	
51804	chr10	12158113	12158617	504	252.0	
51805	chr10	12181051	12181915	864	432.0	
51806	chr10	12194684	12196874	2190	1095.0	
51807	chr10	12214644	12215323	679	340.0	
51808	chr10	12220472	12220719	247	124.0	
51809	chr10	12241735	12242520	785	392.0	
51810	chr10	12243331	12244329	998	499.0	
51811	chr10	12252865	12253266	401	200.0	
51812	chr10	12262459	12266352	3893	1946.0	
51813	chr10	12270617	12271535	918	459.0	
51814	chr10	12277929	12278148	219	110.0	
51815	chr10	12307490	12307844	354	177.0	
51816	chr10	12333249	12334329	1080	540.0	
51817	chr10	12347350	12347688	338	169.0	
51818	chr10	12348311	12351840	3529	1764.0	
51819	chr10	12353409	12354212	803	402.0	
51820	chr10	12358998	12359665	667	334.0	
51821	chr10	12365824	12366722	898	449.0	
51822	chr10	12412936	12413700	764	382.0	
51823	chr10	12419644	12419768	124	62.0	
51824	chr10	12448373	12449621	1248	624.0	
51825	chr10	12485339	12485448	109	54.0	
51826	chr10	12514090	12514643	553	276.0	
51827	chr10	12547492	12547893	401	200.0	
51828	chr10	12588074	12588828	754	377.0	
51829	chr10	12594238	12595104	866	433.0	
51830	chr10	12605225	12606603	1378	689.0	
51831	chr10	12656274	12656926	652	326.0	
51832	chr10	12710950	12711521	571	286.0	
51833	chr10	12742692	12743189	497	248.0	
51834	chr10	13098868	13101314	2446	1223.0	"mobile_genetic_element	recombination_feature"
51835	chr10	13102230	13102492	262	131.0	
51836	chr10	13105313	13105570	257	128.0	
51837	chr10	13106418	13106789	371	186.0	
51838	chr10	13107618	13108611	993	496.0	mobile_genetic_element
51839	chr10	13115887	13117089	1202	601.0	
51840	chr10	13117594	13118588	994	497.0	
51841	chr10	13158364	13158778	414	207.0	
51842	chr10	13160886	13162222	1336	668.0	
51843	chr10	13271471	13271972	501	250.0	
51844	chr10	13288324	13288520	196	98.0	
51845	chr10	13299045	13300733	1688	844.0	
51846	chr10	13301622	13303044	1422	711.0	
51847	chr10	13340231	13341071	840	420.0	
51848	chr10	13346870	13350616	3746	1873.0	
51849	chr10	13351506	13352881	1375	688.0	
51850	chr10	13371766	13372339	573	286.0	
51851	chr10	13391167	13391438	271	136.0	
51852	chr10	13439789	13440906	1117	558.0	
51853	chr10	13453849	13454371	522	261.0	
51854	chr10	13528288	13529367	1079	540.0	
51855	chr10	13536798	13537060	262	131.0	
51856	chr10	13556969	13557406	437	218.0	
51857	chr10	13566885	13567473	588	294.0	
51858	chr10	13586373	13587880	1507	754.0	
51859	chr10	13659263	13660475	1212	606.0	
51860	chr10	13707306	13707865	559	280.0	
51861	chr10	13712586	13713635	1049	524.0	
51862	chr10	13718051	13718845	794	397.0	
51863	chr10	13743332	13743686	354	177.0	
51864	chr10	13757316	13757920	604	302.0	
51865	chr10	13777104	13777181	77	38.0	
51866	chr10	13777726	13778602	876	438.0	
51867	chr10	13783980	13784489	509	254.0	
51868	chr10	13786579	13789498	2919	1460.0	
51869	chr10	13795592	13796070	478	239.0	
51870	chr10	13799318	13799800	482	241.0	
51871	chr10	13820216	13820336	120	60.0	
51872	chr10	13831566	13832195	629	314.0	
51873	chr10	13854030	13854331	301	150.0	
51874	chr10	13862608	13862972	364	182.0	
51875	chr10	13873211	13874517	1306	653.0	
51876	chr10	13881912	13882871	959	480.0	
51877	chr10	13890660	13890977	317	158.0	
51878	chr10	13891522	13892078	556	278.0	
51879	chr10	13909797	13910485	688	344.0	
51880	chr10	13913987	13914130	143	72.0	
51881	chr10	13993911	13993944	33	16.0	
51882	chr10	14003520	14003898	378	189.0	
51883	chr10	14008029	14010311	2282	1141.0	
51884	chr10	14015873	14016568	695	348.0	
51885	chr10	14024384	14024761	377	188.0	
51886	chr10	14032402	14032809	407	204.0	
51887	chr10	14041027	14041674	647	324.0	
51888	chr10	14173514	14174498	984	492.0	
51889	chr10	14184659	14186848	2189	1094.0	
51890	chr10	14196841	14197332	491	246.0	
51891	chr10	14382097	14382509	412	206.0	
51892	chr10	14498810	14499663	853	426.0	
51893	chr10	14506952	14507691	739	370.0	enhancer
51894	chr10	14508437	14508454	17	8.0	
51895	chr10	14528352	14528893	541	270.0	
51896	chr10	14536855	14537592	737	368.0	
51897	chr10	14542969	14544304	1335	668.0	
51898	chr10	14545911	14546338	427	214.0	
51899	chr10	14550385	14551159	774	387.0	
51900	chr10	14551923	14552473	550	275.0	
51901	chr10	14553329	14555165	1836	918.0	
51902	chr10	14555719	14557140	1421	710.0	
51903	chr10	14558993	14562907	3914	1957.0	
51904	chr10	14564091	14566724	2633	1316.0	
51905	chr10	14569250	14573353	4103	2052.0	
51906	chr10	14578181	14580346	2165	1082.0	
51907	chr10	14582137	14589277	7140	3570.0	
51908	chr10	14592096	14592793	697	348.0	
51909	chr10	14594246	14596981	2735	1368.0	
51910	chr10	14598058	14600355	2297	1148.0	
51911	chr10	14601118	14605962	4844	2422.0	
51912	chr10	14608340	14609130	790	395.0	
51913	chr10	14613272	14613872	600	300.0	
51914	chr10	14617206	14619261	2055	1028.0	
51915	chr10	14625771	14626140	369	184.0	
51916	chr10	14635310	14635410	100	50.0	
51917	chr10	14645185	14645588	403	202.0	
51918	chr10	14647562	14649627	2065	1032.0	
51919	chr10	14653303	14654129	826	413.0	
51920	chr10	14656393	14657183	790	395.0	
51921	chr10	14658119	14661337	3218	1609.0	
51922	chr10	14665378	14665619	241	120.0	
51923	chr10	14669696	14669743	47	24.0	
51924	chr10	14673551	14673564	13	6.0	
51925	chr10	14695920	14696246	326	163.0	
51926	chr10	14705506	14705986	480	240.0	
51927	chr10	14723165	14723743	578	289.0	
51928	chr10	14736723	14737089	366	183.0	
51929	chr10	14740621	14741120	499	250.0	
51930	chr10	14742686	14743207	521	260.0	
51931	chr10	14749108	14749606	498	249.0	
51932	chr10	14750860	14752046	1186	593.0	
51933	chr10	14757435	14757825	390	195.0	
51934	chr10	14812273	14812793	520	260.0	
51935	chr10	14823130	14823556	426	213.0	
51936	chr10	14825873	14826674	801	400.0	
51937	chr10	14837204	14839705	2501	1250.0	
51938	chr10	14877308	14880325	3017	1508.0	
51939	chr10	14904218	14904656	438	219.0	
51940	chr10	14938924	14939445	521	260.0	
51941	chr10	14951168	14952230	1062	531.0	
51942	chr10	14952848	14954882	2034	1017.0	
51943	chr10	14958877	14960773	1896	948.0	
51944	chr10	14971844	14972331	487	244.0	
51945	chr10	14975882	14976234	352	176.0	
51946	chr10	14991366	14991765	399	200.0	
51947	chr10	15021076	15021302	226	113.0	
51948	chr10	15035172	15035929	757	378.0	
51949	chr10	15084387	15085072	685	342.0	
51950	chr10	15088238	15089192	954	477.0	
51951	chr10	15096341	15098395	2054	1027.0	
51952	chr10	15106184	15107023	839	420.0	
51953	chr10	15141119	15141675	556	278.0	
51954	chr10	15163481	15163939	458	229.0	
51955	chr10	15167293	15170542	3249	1624.0	
51956	chr10	15185441	15185749	308	154.0	
51957	chr10	15189478	15189858	380	190.0	
51958	chr10	15195955	15196421	466	233.0	
51959	chr10	15208140	15210508	2368	1184.0	
51960	chr10	15245577	15245848	271	136.0	
51961	chr10	15254706	15255102	396	198.0	
51962	chr10	15370208	15371819	1611	806.0	
51963	chr10	15434106	15434355	249	124.0	
51964	chr10	15831377	15832110	733	366.0	
51965	chr10	15859540	15861064	1524	762.0	
51966	chr10	15879048	15879332	284	142.0	
51967	chr10	15902573	15902972	399	200.0	
51968	chr10	16195278	16195581	303	152.0	
51969	chr10	16436134	16438089	1955	978.0	
51970	chr10	16470778	16471179	401	200.0	
51971	chr10	16520503	16521766	1263	632.0	
51972	chr10	16770672	16771047	375	188.0	
51973	chr10	16777354	16777997	643	322.0	
51974	chr10	16779433	16779876	443	222.0	
51975	chr10	16787004	16788673	1669	834.0	
51976	chr10	16809253	16809727	474	237.0	
51977	chr10	16816261	16818459	2198	1099.0	
51978	chr10	16827936	16828783	847	424.0	
51979	chr10	16835236	16835645	409	204.0	
51980	chr10	16843183	16843745	562	281.0	
51981	chr10	16891194	16892101	907	454.0	
51982	chr10	16910053	16911272	1219	610.0	
51983	chr10	16915385	16915671	286	143.0	
51984	chr10	16948259	16948837	578	289.0	
51985	chr10	16966786	16967337	551	276.0	
51986	chr10	16968622	16969110	488	244.0	
51987	chr10	16996171	16996531	360	180.0	
51988	chr10	17001871	17003662	1791	896.0	
51989	chr10	17013306	17013853	547	274.0	
51990	chr10	17023038	17024499	1461	730.0	
51991	chr10	17025392	17027512	2120	1060.0	
51992	chr10	17029116	17030328	1212	606.0	
51993	chr10	17032021	17032709	688	344.0	
51994	chr10	17033484	17034265	781	390.0	
51995	chr10	17075427	17076013	586	293.0	
51996	chr10	17084998	17085160	162	81.0	
51997	chr10	17128248	17128787	539	270.0	
51998	chr10	17175513	17175949	436	218.0	
51999	chr10	17200316	17202287	1971	986.0	
52000	chr10	17205873	17206912	1039	520.0	
52001	chr10	17212628	17213514	886	443.0	
52002	chr10	17214833	17215360	527	264.0	
52003	chr10	17215957	17217536	1579	790.0	
52004	chr10	17222319	17222703	384	192.0	
52005	chr10	17226389	17235620	9231	4616.0	
52006	chr10	17236180	17237103	923	462.0	
52007	chr10	17237772	17242315	4543	2272.0	
52008	chr10	17249796	17250139	343	172.0	
52009	chr10	17255539	17255849	310	155.0	
52010	chr10	17257444	17258152	708	354.0	
52011	chr10	17290265	17290526	261	130.0	
52012	chr10	17409151	17409652	501	250.0	
52013	chr10	17425875	17426408	533	266.0	
52014	chr10	17428034	17429555	1521	760.0	
52015	chr10	17430646	17431217	571	286.0	
52016	chr10	17443887	17444735	848	424.0	
52017	chr10	17452235	17455300	3065	1532.0	
52018	chr10	17472785	17473782	997	498.0	
52019	chr10	17476018	17476520	502	251.0	
52020	chr10	17506678	17507538	860	430.0	
52021	chr10	17508949	17509594	645	322.0	
52022	chr10	17510212	17511944	1732	866.0	
52023	chr10	17526577	17526944	367	184.0	
52024	chr10	17585127	17585208	81	40.0	
52025	chr10	17586749	17587366	617	308.0	
52026	chr10	17599129	17599459	330	165.0	
52027	chr10	17607436	17607977	541	270.0	
52028	chr10	17616336	17618060	1724	862.0	
52029	chr10	17643279	17645078	1799	900.0	
52030	chr10	17645739	17646364	625	312.0	
52031	chr10	17647281	17649112	1831	916.0	
52032	chr10	17650945	17651242	297	148.0	
52033	chr10	17655338	17656068	730	365.0	
52034	chr10	17662869	17662870	1	0.0	
52035	chr10	17669447	17670060	613	306.0	
52036	chr10	18104280	18104492	212	106.0	
52037	chr10	18214981	18215335	354	177.0	
52038	chr10	18279051	18279658	607	304.0	
52039	chr10	18304051	18304841	790	395.0	
52040	chr10	18312715	18313151	436	218.0	
52041	chr10	18418553	18419052	499	250.0	
52042	chr10	18627337	18628194	857	428.0	
52043	chr10	18650813	18652659	1846	923.0	
52044	chr10	18658116	18660709	2593	1296.0	
52045	chr10	18661571	18662398	827	414.0	
52046	chr10	18662919	18662952	33	16.0	
52047	chr10	18663816	18664064	248	124.0	
52048	chr10	18664812	18665958	1146	573.0	
52049	chr10	18671349	18671831	482	241.0	
52050	chr10	18680952	18681115	163	82.0	
52051	chr10	18682624	18686101	3477	1738.0	
52052	chr10	18700370	18700999	629	314.0	
52053	chr10	19491212	19491505	293	146.0	
52054	chr10	19629591	19629890	299	150.0	
52055	chr10	19638468	19639264	796	398.0	
52056	chr10	19775153	19775966	813	406.0	
52057	chr10	19788106	19788490	384	192.0	
52058	chr10	19811679	19811823	144	72.0	
52059	chr10	19815407	19818629	3222	1611.0	
52060	chr10	19819348	19819868	520	260.0	
52061	chr10	19824447	19827170	2723	1362.0	
52062	chr10	19828438	19829006	568	284.0	
52063	chr10	19832592	19833498	906	453.0	
52064	chr10	19974106	19974536	430	215.0	
52065	chr10	19983873	19984290	417	208.0	
52066	chr10	20002020	20002527	507	254.0	
52067	chr10	20003354	20004893	1539	770.0	
52068	chr10	20100151	20100721	570	285.0	
52069	chr10	20128695	20129341	646	323.0	
52070	chr10	20200757	20201170	413	206.0	
52071	chr10	20202182	20202765	583	292.0	
52072	chr10	20616836	20617579	743	372.0	
52073	chr10	20622581	20623091	510	255.0	
52074	chr10	21022834	21023226	392	196.0	
52075	chr10	21030008	21030581	573	286.0	
52076	chr10	21078770	21079015	245	122.0	
52077	chr10	21172907	21174783	1876	938.0	
52078	chr10	21194432	21194913	481	240.0	
52079	chr10	21209797	21210262	465	232.0	
52080	chr10	21211401	21212879	1478	739.0	
52081	chr10	21251769	21252286	517	258.0	
52082	chr10	21278654	21279134	480	240.0	
52083	chr10	21300490	21300989	499	250.0	
52084	chr10	21372817	21373458	641	320.0	
52085	chr10	21406894	21406992	98	49.0	
52086	chr10	21493833	21497609	3776	1888.0	
52087	chr10	21499933	21501289	1356	678.0	
52088	chr10	21515955	21519295	3340	1670.0	
52089	chr10	21519827	21520540	713	356.0	
52090	chr10	21524595	21527802	3207	1604.0	
52091	chr10	21533163	21535709	2546	1273.0	
52092	chr10	21613982	21614356	374	187.0	
52093	chr10	21675103	21675588	485	242.0	
52094	chr10	21702531	21703244	713	356.0	
52095	chr10	21710627	21711210	583	292.0	
52096	chr10	21724620	21725421	801	400.0	
52097	chr10	21732142	21732596	454	227.0	
52098	chr10	21740803	21741457	654	327.0	
52099	chr10	21746078	21746472	394	197.0	
52100	chr10	21764847	21765140	293	146.0	
52101	chr10	21797889	21798459	570	285.0	
52102	chr10	21813705	21814459	754	377.0	
52103	chr10	21889228	21889263	35	18.0	
52104	chr10	21943560	21944059	499	250.0	
52105	chr10	21953584	21954581	997	498.0	
52106	chr10	21989526	21989995	469	234.0	
52107	chr10	21993326	21993854	528	264.0	
52108	chr10	21997432	21997631	199	100.0	
52109	chr10	22002161	22004574	2413	1206.0	
52110	chr10	22010925	22011367	442	221.0	
52111	chr10	22014911	22015304	393	196.0	
52112	chr10	22022241	22023432	1191	596.0	enhancer
52113	chr10	22029604	22029692	88	44.0	
52114	chr10	22133868	22134569	701	350.0	
52115	chr10	22228812	22231220	2408	1204.0	
52116	chr10	22246554	22247403	849	424.0	
52117	chr10	22251133	22254004	2871	1436.0	
52118	chr10	22259290	22259696	406	203.0	
52119	chr10	22315231	22317374	2143	1072.0	
52120	chr10	22319884	22322684	2800	1400.0	
52121	chr10	22324569	22326576	2007	1004.0	
52122	chr10	22332905	22337269	4364	2182.0	
52123	chr10	22339909	22341788	1879	940.0	
52124	chr10	22344929	22346053	1124	562.0	
52125	chr10	22365246	22365612	366	183.0	
52126	chr10	22369322	22370484	1162	581.0	
52127	chr10	22374722	22375070	348	174.0	
52128	chr10	22421093	22421552	459	230.0	
52129	chr10	22424809	22425078	269	134.0	
52130	chr10	22433956	22434248	292	146.0	
52131	chr10	22435388	22438992	3604	1802.0	
52132	chr10	22475673	22476582	909	454.0	
52133	chr10	22491863	22492408	545	272.0	
52134	chr10	22503805	22504134	329	164.0	
52135	chr10	22505810	22506681	871	436.0	
52136	chr10	22550347	22551204	857	428.0	
52137	chr10	22564056	22564457	401	200.0	
52138	chr10	22570256	22571273	1017	508.0	
52139	chr10	22573635	22574393	758	379.0	
52140	chr10	22581480	22581907	427	214.0	
52141	chr10	22586181	22586671	490	245.0	
52142	chr10	22596642	22597779	1137	568.0	
52143	chr10	22599218	22599492	274	137.0	
52144	chr10	22600821	22602030	1209	604.0	
52145	chr10	22604595	22607638	3043	1522.0	
52146	chr10	22608264	22608273	9	4.0	
52147	chr10	22609845	22610546	701	350.0	
52148	chr10	22611158	22613039	1881	940.0	
52149	chr10	22613622	22614168	546	273.0	
52150	chr10	22615061	22616630	1569	784.0	
52151	chr10	22617478	22618888	1410	705.0	
52152	chr10	22620550	22620572	22	11.0	
52153	chr10	22623425	22624863	1438	719.0	
52154	chr10	22625543	22625994	451	226.0	
52155	chr10	22627513	22627859	346	173.0	
52156	chr10	22628521	22629009	488	244.0	
52157	chr10	22629695	22632470	2775	1388.0	
52158	chr10	22633155	22636481	3326	1663.0	
52159	chr10	22642744	22644138	1394	697.0	
52160	chr10	22645912	22647712	1800	900.0	
52161	chr10	22648517	22652249	3732	1866.0	
52162	chr10	22652786	22653738	952	476.0	
52163	chr10	22654661	22656423	1762	881.0	
52164	chr10	22657625	22658223	598	299.0	
52165	chr10	22659945	22660263	318	159.0	
52166	chr10	22666187	22668231	2044	1022.0	
52167	chr10	22669101	22669758	657	328.0	
52168	chr10	22672791	22673171	380	190.0	
52169	chr10	22676452	22677581	1129	564.0	
52170	chr10	22679565	22680060	495	248.0	
52171	chr10	22680892	22684310	3418	1709.0	
52172	chr10	22684854	22684901	47	24.0	
52173	chr10	22690552	22691540	988	494.0	
52174	chr10	22693310	22694318	1008	504.0	enhancer
52175	chr10	22701118	22701541	423	212.0	
52176	chr10	22704356	22705971	1615	808.0	
52177	chr10	22710223	22715439	5216	2608.0	
52178	chr10	22723055	22723804	749	374.0	
52179	chr10	22727215	22727218	3	2.0	
52180	chr10	22728623	22728895	272	136.0	
52181	chr10	22742622	22743259	637	318.0	
52182	chr10	22754297	22754697	400	200.0	
52183	chr10	22765102	22765231	129	64.0	
52184	chr10	22766113	22766600	487	244.0	
52185	chr10	22816467	22817389	922	461.0	
52186	chr10	22825749	22826145	396	198.0	
52187	chr10	22912921	22913960	1039	520.0	
52188	chr10	22927478	22928434	956	478.0	
52189	chr10	22987223	22987479	256	128.0	
52190	chr10	22988598	22989356	758	379.0	
52191	chr10	23015156	23015342	186	93.0	
52192	chr10	23068089	23068596	507	254.0	
52193	chr10	23093726	23097480	3754	1877.0	
52194	chr10	23158111	23158732	621	310.0	
52195	chr10	23314760	23315192	432	216.0	
52196	chr10	23331782	23332363	581	290.0	
52197	chr10	23341061	23341366	305	152.0	
52198	chr10	23343741	23344780	1039	520.0	
52199	chr10	23363135	23364067	932	466.0	
52200	chr10	23368781	23369214	433	216.0	
52201	chr10	23376135	23376631	496	248.0	
52202	chr10	23379729	23380048	319	160.0	
52203	chr10	23406448	23406849	401	200.0	
52204	chr10	23412103	23414372	2269	1134.0	
52205	chr10	23432137	23434154	2017	1008.0	enhancer
52206	chr10	23437022	23441016	3994	1997.0	
52207	chr10	23442254	23443066	812	406.0	
52208	chr10	23448497	23450123	1626	813.0	
52209	chr10	23451426	23452477	1051	526.0	
52210	chr10	23457846	23458301	455	228.0	
52211	chr10	23512349	23512889	540	270.0	
52212	chr10	23517451	23517823	372	186.0	
52213	chr10	23521788	23522407	619	310.0	
52214	chr10	23525449	23525765	316	158.0	
52215	chr10	23540346	23540801	455	228.0	
52216	chr10	23543965	23544420	455	228.0	
52217	chr10	23643048	23644224	1176	588.0	
52218	chr10	23656785	23657065	280	140.0	
52219	chr10	23702866	23703333	467	234.0	
52220	chr10	23742450	23742728	278	139.0	
52221	chr10	24464165	24464549	384	192.0	
52222	chr10	24519929	24520348	419	210.0	
52223	chr10	24617698	24618202	504	252.0	
52224	chr10	24622119	24623379	1260	630.0	
52225	chr10	24642807	24643337	530	265.0	
52226	chr10	24701479	24701871	392	196.0	
52227	chr10	24706405	24706855	450	225.0	
52228	chr10	24721714	24725433	3719	1860.0	
52229	chr10	24867238	24867534	296	148.0	
52230	chr10	24873065	24873787	722	361.0	
52231	chr10	24882051	24882768	717	358.0	
52232	chr10	24883444	24883515	71	36.0	
52233	chr10	24887220	24888444	1224	612.0	
52234	chr10	24894325	24895193	868	434.0	
52235	chr10	24900929	24902137	1208	604.0	
52236	chr10	24908986	24909438	452	226.0	
52237	chr10	24912139	24912716	577	288.0	
52238	chr10	24921225	24921777	552	276.0	
52239	chr10	24951733	24953372	1639	820.0	
52240	chr10	25015697	25017683	1986	993.0	
52241	chr10	25062366	25063011	645	322.0	
52242	chr10	25080904	25081377	473	236.0	
52243	chr10	25174420	25174877	457	228.0	
52244	chr10	25725957	25726267	310	155.0	
52245	chr10	25753427	25754270	843	422.0	
52246	chr10	25755094	25755274	180	90.0	
52247	chr10	25820845	25821523	678	339.0	
52248	chr10	25875570	25875928	358	179.0	
52249	chr10	26089955	26090354	399	200.0	
52250	chr10	26334917	26336044	1127	564.0	
52251	chr10	26362019	26362105	86	43.0	
52252	chr10	26367817	26368200	383	192.0	
52253	chr10	26374425	26374819	394	197.0	
52254	chr10	26378936	26379408	472	236.0	
52255	chr10	26380965	26381036	71	36.0	
52256	chr10	26386767	26387233	466	233.0	
52257	chr10	26391933	26392903	970	485.0	
52258	chr10	26407387	26407783	396	198.0	
52259	chr10	26423701	26424089	388	194.0	
52260	chr10	26430493	26431370	877	438.0	
52261	chr10	26432875	26433460	585	292.0	
52262	chr10	26437450	26440213	2763	1382.0	
52263	chr10	26441449	26442567	1118	559.0	
52264	chr10	26445345	26450132	4787	2394.0	
52265	chr10	26455767	26456028	261	130.0	
52266	chr10	26456999	26457722	723	362.0	
52267	chr10	26467469	26469490	2021	1010.0	
52268	chr10	26470739	26471354	615	308.0	
52269	chr10	26473798	26475984	2186	1093.0	
52270	chr10	26478585	26478619	34	17.0	
52271	chr10	26479656	26482775	3119	1560.0	
52272	chr10	26483636	26483708	72	36.0	
52273	chr10	26486856	26487965	1109	554.0	
52274	chr10	26490399	26490718	319	160.0	
52275	chr10	26491427	26491943	516	258.0	
52276	chr10	26503032	26503317	285	142.0	
52277	chr10	26529005	26529393	388	194.0	
52278	chr10	26540613	26541024	411	206.0	
52279	chr10	26555887	26557513	1626	813.0	
52280	chr10	26573759	26573993	234	117.0	
52281	chr10	26574716	26575273	557	278.0	
52282	chr10	26606313	26606728	415	208.0	
52283	chr10	26621955	26622843	888	444.0	
52284	chr10	26681954	26682296	342	171.0	
52285	chr10	26682889	26683372	483	242.0	
52286	chr10	26684592	26685136	544	272.0	
52287	chr10	26690757	26691135	378	189.0	
52288	chr10	26696626	26698487	1861	930.0	
52289	chr10	26706122	26706676	554	277.0	
52290	chr10	26721388	26722170	782	391.0	
52291	chr10	26725888	26726554	666	333.0	
52292	chr10	26737499	26738227	728	364.0	
52293	chr10	26738989	26739747	758	379.0	
52294	chr10	26755552	26756037	485	242.0	
52295	chr10	26779166	26779584	418	209.0	
52296	chr10	26780411	26781993	1582	791.0	
52297	chr10	26829881	26830271	390	195.0	
52298	chr10	26837100	26837596	496	248.0	
52299	chr10	26841747	26842321	574	287.0	
52300	chr10	26855378	26855417	39	20.0	
52301	chr10	26857204	26861854	4650	2325.0	
52302	chr10	26863403	26863768	365	182.0	
52303	chr10	26869338	26869820	482	241.0	
52304	chr10	26881964	26882448	484	242.0	
52305	chr10	26890866	26891298	432	216.0	
52306	chr10	26912072	26912145	73	36.0	
52307	chr10	26931267	26931517	250	125.0	
52308	chr10	27099654	27101977	2323	1162.0	
52309	chr10	27104981	27105322	341	170.0	
52310	chr10	27134361	27134714	353	176.0	
52311	chr10	27141418	27141526	108	54.0	
52312	chr10	27143437	27143519	82	41.0	
52313	chr10	27146065	27146279	214	107.0	
52314	chr10	27147670	27147688	18	9.0	
52315	chr10	27150282	27151608	1326	663.0	
52316	chr10	27152453	27153055	602	301.0	
52317	chr10	27153570	27157222	3652	1826.0	
52318	chr10	27223875	27226593	2718	1359.0	
52319	chr10	27239672	27244040	4368	2184.0	
52320	chr10	27252119	27253172	1053	526.0	
52321	chr10	27257020	27259771	2751	1376.0	
52322	chr10	27285048	27285502	454	227.0	
52323	chr10	27298142	27298867	725	362.0	
52324	chr10	27315206	27315388	182	91.0	
52325	chr10	27319602	27320536	934	467.0	
52326	chr10	27345511	27345880	369	184.0	
52327	chr10	27354467	27355102	635	318.0	
52328	chr10	27360501	27361018	517	258.0	
52329	chr10	27446024	27446708	684	342.0	
52330	chr10	27447560	27447934	374	187.0	
52331	chr10	27448806	27449304	498	249.0	
52332	chr10	27452859	27453391	532	266.0	
52333	chr10	27458008	27458396	388	194.0	
52334	chr10	27464563	27465635	1072	536.0	
52335	chr10	27481290	27481992	702	351.0	
52336	chr10	27503395	27505306	1911	956.0	
52337	chr10	27506518	27506619	101	50.0	
52338	chr10	27513758	27514143	385	192.0	
52339	chr10	27531284	27531737	453	226.0	
52340	chr10	27541620	27542318	698	349.0	
52341	chr10	27558475	27558969	494	247.0	
52342	chr10	27564315	27564824	509	254.0	
52343	chr10	27568450	27568955	505	252.0	
52344	chr10	27622635	27623035	400	200.0	
52345	chr10	27654950	27655195	245	122.0	
52346	chr10	27656548	27657109	561	280.0	
52347	chr10	27660230	27661117	887	444.0	
52348	chr10	27663815	27664864	1049	524.0	
52349	chr10	27741439	27747315	5876	2938.0	
52350	chr10	27783633	27784058	425	212.0	
52351	chr10	27816308	27816655	347	174.0	
52352	chr10	27844265	27844525	260	130.0	
52353	chr10	27998345	27999123	778	389.0	
52354	chr10	28087954	28088362	408	204.0	
52355	chr10	28177888	28179931	2043	1022.0	
52356	chr10	28241715	28243240	1525	762.0	
52357	chr10	28248009	28248647	638	319.0	
52358	chr10	28250769	28251104	335	168.0	
52359	chr10	28253270	28253876	606	303.0	
52360	chr10	28266420	28266848	428	214.0	
52361	chr10	28300026	28300427	401	200.0	
52362	chr10	28302054	28304536	2482	1241.0	
52363	chr10	28305572	28305964	392	196.0	
52364	chr10	28326633	28327173	540	270.0	
52365	chr10	28330135	28335671	5536	2768.0	
52366	chr10	28336515	28337251	736	368.0	
52367	chr10	28344290	28344483	193	96.0	
52368	chr10	28345026	28345289	263	132.0	
52369	chr10	28367459	28369279	1820	910.0	
52370	chr10	28376740	28377092	352	176.0	
52371	chr10	28380251	28380704	453	226.0	
52372	chr10	28381452	28382489	1037	518.0	
52373	chr10	28393884	28394579	695	348.0	
52374	chr10	28399127	28399425	298	149.0	
52375	chr10	28400123	28401293	1170	585.0	
52376	chr10	28402163	28403416	1253	626.0	
52377	chr10	28405245	28405571	326	163.0	
52378	chr10	28411615	28412201	586	293.0	
52379	chr10	28432080	28432654	574	287.0	
52380	chr10	28478782	28478978	196	98.0	
52381	chr10	28481278	28481774	496	248.0	
52382	chr10	28490524	28490804	280	140.0	
52383	chr10	28491867	28492976	1109	554.0	
52384	chr10	28530640	28531092	452	226.0	
52385	chr10	28531668	28534533	2865	1432.0	
52386	chr10	28535926	28536201	275	138.0	
52387	chr10	28538633	28538750	117	58.0	
52388	chr10	28541774	28542257	483	242.0	
52389	chr10	28545999	28546407	408	204.0	
52390	chr10	28558223	28559548	1325	662.0	
52391	chr10	28587172	28588402	1230	615.0	
52392	chr10	28592910	28593322	412	206.0	
52393	chr10	28594346	28594818	472	236.0	
52394	chr10	28619701	28620659	958	479.0	
52395	chr10	28628059	28628888	829	414.0	
52396	chr10	28663769	28664271	502	251.0	
52397	chr10	28668585	28669169	584	292.0	
52398	chr10	28676510	28680675	4165	2082.0	
52399	chr10	28984407	28984714	307	154.0	
52400	chr10	29386341	29386736	395	198.0	
52401	chr10	29392398	29392815	417	208.0	
52402	chr10	29409029	29410347	1318	659.0	
52403	chr10	29445430	29445792	362	181.0	
52404	chr10	29448928	29449456	528	264.0	
52405	chr10	29496326	29496792	466	233.0	
52406	chr10	29513037	29513357	320	160.0	
52407	chr10	29555034	29555477	443	222.0	
52408	chr10	29563583	29564098	515	258.0	
52409	chr10	29590142	29591264	1122	561.0	
52410	chr10	29630376	29631119	743	372.0	
52411	chr10	29633101	29633738	637	318.0	
52412	chr10	29635625	29636747	1122	561.0	
52413	chr10	29646515	29646892	377	188.0	
52414	chr10	29648207	29648400	193	96.0	
52415	chr10	29657431	29659987	2556	1278.0	
52416	chr10	29680873	29682746	1873	936.0	
52417	chr10	29687404	29689528	2124	1062.0	
52418	chr10	29702295	29703009	714	357.0	
52419	chr10	29725162	29725869	707	354.0	
52420	chr10	29734554	29737328	2774	1387.0	
52421	chr10	29751363	29752111	748	374.0	
52422	chr10	29812175	29812488	313	156.0	
52423	chr10	29828565	29828863	298	149.0	
52424	chr10	29998248	29998759	511	256.0	
52425	chr10	30002378	30002805	427	214.0	
52426	chr10	30026619	30028435	1816	908.0	
52427	chr10	30048155	30048548	393	196.0	
52428	chr10	30049107	30049507	400	200.0	
52429	chr10	30058799	30059921	1122	561.0	
52430	chr10	30241118	30241426	308	154.0	
52431	chr10	30247707	30248106	399	200.0	
52432	chr10	30284860	30285670	810	405.0	
52433	chr10	30348560	30349803	1243	622.0	
52434	chr10	30359399	30360308	909	454.0	
52435	chr10	30373856	30373943	87	44.0	
52436	chr10	30378418	30378813	395	198.0	
52437	chr10	30387156	30387525	369	184.0	
52438	chr10	30392266	30393124	858	429.0	
52439	chr10	30396256	30396713	457	228.0	
52440	chr10	30398116	30398548	432	216.0	
52441	chr10	30413772	30414504	732	366.0	
52442	chr10	30415514	30416052	538	269.0	
52443	chr10	30418292	30419198	906	453.0	
52444	chr10	30421016	30421149	133	66.0	
52445	chr10	30423312	30423857	545	272.0	
52446	chr10	30427147	30428139	992	496.0	
52447	chr10	30431334	30431736	402	201.0	
52448	chr10	30432633	30438757	6124	3062.0	
52449	chr10	30441895	30442400	505	252.0	
52450	chr10	30443036	30443419	383	192.0	
52451	chr10	30447211	30447402	191	96.0	
52452	chr10	30455626	30456722	1096	548.0	
52453	chr10	30459159	30459824	665	332.0	
52454	chr10	30467715	30468424	709	354.0	
52455	chr10	30488208	30489708	1500	750.0	
52456	chr10	30491129	30492512	1383	692.0	
52457	chr10	30493045	30494989	1944	972.0	
52458	chr10	30497684	30498138	454	227.0	
52459	chr10	30501983	30503119	1136	568.0	
52460	chr10	30505133	30506162	1029	514.0	
52461	chr10	30510543	30510961	418	209.0	
52462	chr10	30522670	30523200	530	265.0	
52463	chr10	30525324	30526489	1165	582.0	
52464	chr10	30527581	30528209	628	314.0	
52465	chr10	30529087	30530504	1417	708.0	
52466	chr10	30532115	30532739	624	312.0	
52467	chr10	30534276	30535138	862	431.0	
52468	chr10	30540263	30540715	452	226.0	
52469	chr10	30542268	30543156	888	444.0	
52470	chr10	30546601	30546709	108	54.0	
52471	chr10	30549128	30549529	401	200.0	
52472	chr10	30553883	30554534	651	326.0	
52473	chr10	30555984	30556650	666	333.0	
52474	chr10	30557773	30558343	570	285.0	
52475	chr10	30573777	30574432	655	328.0	
52476	chr10	30581759	30582196	437	218.0	
52477	chr10	30583535	30584380	845	422.0	
52478	chr10	30587273	30588079	806	403.0	
52479	chr10	30589542	30589787	245	122.0	
52480	chr10	30591146	30591653	507	254.0	
52481	chr10	30599782	30600473	691	346.0	
52482	chr10	30630588	30631082	494	247.0	
52483	chr10	30639900	30640341	441	220.0	
52484	chr10	30662803	30663784	981	490.0	
52485	chr10	30670949	30671462	513	256.0	
52486	chr10	30682420	30682689	269	134.0	
52487	chr10	30683759	30683821	62	31.0	
52488	chr10	30687581	30688132	551	276.0	
52489	chr10	30695719	30696354	635	318.0	
52490	chr10	30697242	30697650	408	204.0	
52491	chr10	30701154	30702320	1166	583.0	
52492	chr10	30704270	30706272	2002	1001.0	
52493	chr10	30718274	30718735	461	230.0	
52494	chr10	30726562	30727431	869	434.0	
52495	chr10	30763937	30764333	396	198.0	
52496	chr10	30782642	30785801	3159	1580.0	
52497	chr10	30811684	30812017	333	166.0	
52498	chr10	30817941	30818355	414	207.0	
52499	chr10	30857782	30858089	307	154.0	
52500	chr10	30897258	30897394	136	68.0	
52501	chr10	30975067	30975310	243	122.0	
52502	chr10	30991583	30991994	411	206.0	
52503	chr10	30995373	30995810	437	218.0	
52504	chr10	30998251	30999848	1597	798.0	
52505	chr10	31000378	31001367	989	494.0	
52506	chr10	31004608	31005217	609	304.0	
52507	chr10	31021892	31022421	529	264.0	
52508	chr10	31031026	31033055	2029	1014.0	
52509	chr10	31038930	31039393	463	232.0	
52510	chr10	31083625	31084180	555	278.0	
52511	chr10	31090937	31091227	290	145.0	
52512	chr10	31133216	31134980	1764	882.0	
52513	chr10	31137018	31137469	451	226.0	
52514	chr10	31214986	31215554	568	284.0	
52515	chr10	31243027	31243331	304	152.0	
52516	chr10	31318002	31323071	5069	2534.0	
52517	chr10	31348455	31348476	21	10.0	
52518	chr10	31353602	31353931	329	164.0	
52519	chr10	31491110	31491506	396	198.0	
52520	chr10	31526733	31527098	365	182.0	
52521	chr10	31549815	31550293	478	239.0	
52522	chr10	31580738	31581007	269	134.0	
52523	chr10	31581704	31583206	1502	751.0	
52524	chr10	31586641	31587186	545	272.0	
52525	chr10	31589970	31590428	458	229.0	
52526	chr10	31600290	31600324	34	17.0	
52527	chr10	31603092	31604079	987	494.0	
52528	chr10	31687849	31687989	140	70.0	
52529	chr10	31693551	31693823	272	136.0	
52530	chr10	31697327	31698485	1158	579.0	
52531	chr10	31701466	31702507	1041	520.0	
52532	chr10	31706749	31708183	1434	717.0	
52533	chr10	31745650	31745951	301	150.0	
52534	chr10	31750958	31752113	1155	578.0	
52535	chr10	31754078	31754649	571	286.0	
52536	chr10	31758980	31761162	2182	1091.0	
52537	chr10	31770234	31770745	511	256.0	
52538	chr10	31789557	31789929	372	186.0	
52539	chr10	31808376	31809085	709	354.0	
52540	chr10	31836643	31836974	331	166.0	
52541	chr10	31862225	31862871	646	323.0	
52542	chr10	31926112	31930914	4802	2401.0	
52543	chr10	31948988	31949807	819	410.0	
52544	chr10	31959790	31960105	315	158.0	
52545	chr10	31961508	31962189	681	340.0	
52546	chr10	31964542	31964739	197	98.0	
52547	chr10	31967132	31967440	308	154.0	
52548	chr10	31972585	31973118	533	266.0	
52549	chr10	31977232	31978330	1098	549.0	
52550	chr10	32004389	32005584	1195	598.0	
52551	chr10	32041526	32041909	383	192.0	
52552	chr10	32053978	32057585	3607	1804.0	
52553	chr10	32060389	32060646	257	128.0	
52554	chr10	32065801	32066358	557	278.0	
52555	chr10	32139255	32139984	729	364.0	
52556	chr10	32189343	32189795	452	226.0	
52557	chr10	32190629	32191350	721	360.0	
52558	chr10	32199690	32200514	824	412.0	
52559	chr10	32207418	32207893	475	238.0	
52560	chr10	32210730	32211097	367	184.0	
52561	chr10	32256555	32257438	883	442.0	
52562	chr10	32273321	32273722	401	200.0	
52563	chr10	32307930	32308560	630	315.0	
52564	chr10	32317603	32319325	1722	861.0	
52565	chr10	32320548	32320857	309	154.0	
52566	chr10	32321648	32321755	107	54.0	
52567	chr10	32326327	32327817	1490	745.0	
52568	chr10	32328441	32329252	811	406.0	
52569	chr10	32330049	32330400	351	176.0	
52570	chr10	32332080	32333029	949	474.0	
52571	chr10	32334925	32335630	705	352.0	
52572	chr10	32338161	32338375	214	107.0	
52573	chr10	32340546	32341202	656	328.0	
52574	chr10	32343601	32343670	69	34.0	
52575	chr10	32344751	32348691	3940	1970.0	
52576	chr10	32352520	32353038	518	259.0	
52577	chr10	32356940	32357903	963	482.0	
52578	chr10	32367586	32368611	1025	512.0	
52579	chr10	32377320	32380382	3062	1531.0	
52580	chr10	32387085	32387087	2	1.0	
52581	chr10	32445461	32447376	1915	958.0	
52582	chr10	32459108	32459902	794	397.0	
52583	chr10	32650176	32650596	420	210.0	
52584	chr10	32795604	32796008	404	202.0	
52585	chr10	32937886	32938903	1017	508.0	
52586	chr10	32940735	32941007	272	136.0	
52587	chr10	32948306	32948845	539	270.0	
52588	chr10	32951229	32951560	331	166.0	
52589	chr10	32953399	32954511	1112	556.0	
52590	chr10	32955347	32955376	29	14.0	
52591	chr10	32956383	32960449	4066	2033.0	
52592	chr10	32961392	32962372	980	490.0	
52593	chr10	32980096	32983659	3563	1782.0	
52594	chr10	32985560	32986429	869	434.0	
52595	chr10	32995680	32996050	370	185.0	
52596	chr10	33005126	33006154	1028	514.0	
52597	chr10	33008514	33010917	2403	1202.0	
52598	chr10	33025044	33025570	526	263.0	
52599	chr10	33028550	33028888	338	169.0	
52600	chr10	33050219	33050836	617	308.0	
52601	chr10	33087169	33087517	348	174.0	
52602	chr10	33099328	33099693	365	182.0	
52603	chr10	33109524	33110867	1343	672.0	
52604	chr10	33114288	33115102	814	407.0	
52605	chr10	33115603	33118637	3034	1517.0	
52606	chr10	33125912	33127212	1300	650.0	
52607	chr10	33132375	33133234	859	430.0	
52608	chr10	33133891	33134817	926	463.0	
52609	chr10	33136158	33136698	540	270.0	
52610	chr10	33138712	33140050	1338	669.0	
52611	chr10	33143310	33143705	395	198.0	
52612	chr10	33150879	33151280	401	200.0	
52613	chr10	33153798	33154334	536	268.0	
52614	chr10	33155584	33156271	687	344.0	
52615	chr10	33193295	33193797	502	251.0	
52616	chr10	33248569	33249103	534	267.0	
52617	chr10	33330440	33330918	478	239.0	
52618	chr10	33333652	33337200	3548	1774.0	
52619	chr10	33355186	33355744	558	279.0	
52620	chr10	33365547	33366337	790	395.0	
52621	chr10	33412627	33413069	442	221.0	
52622	chr10	33435187	33435311	124	62.0	
52623	chr10	33487044	33487348	304	152.0	
52624	chr10	33506768	33508414	1646	823.0	
52625	chr10	33509070	33509753	683	342.0	
52626	chr10	33570341	33570972	631	316.0	
52627	chr10	33612408	33613148	740	370.0	
52628	chr10	33620917	33621556	639	320.0	
52629	chr10	33650130	33650578	448	224.0	
52630	chr10	33661625	33662696	1071	536.0	
52631	chr10	33666808	33667271	463	232.0	
52632	chr10	33715372	33715583	211	106.0	
52633	chr10	33743591	33743851	260	130.0	
52634	chr10	33772975	33773461	486	243.0	
52635	chr10	34205492	34205855	363	182.0	
52636	chr10	34348961	34349325	364	182.0	
52637	chr10	34374729	34375378	649	324.0	
52638	chr10	34396682	34397465	783	392.0	
52639	chr10	34430641	34431089	448	224.0	
52640	chr10	34637448	34638854	1406	703.0	
52641	chr10	34994464	34995075	611	306.0	
52642	chr10	34996724	34997301	577	288.0	
52643	chr10	35011765	35012236	471	236.0	
52644	chr10	35089494	35091270	1776	888.0	
52645	chr10	35092869	35093197	328	164.0	
52646	chr10	35120170	35120959	789	394.0	
52647	chr10	35124124	35125188	1064	532.0	
52648	chr10	35125967	35129271	3304	1652.0	
52649	chr10	35130732	35130969	237	118.0	
52650	chr10	35131683	35132709	1026	513.0	
52651	chr10	35135806	35136892	1086	543.0	
52652	chr10	35149047	35150123	1076	538.0	
52653	chr10	35165057	35165444	387	194.0	
52654	chr10	35184516	35184952	436	218.0	
52655	chr10	35191454	35192039	585	292.0	
52656	chr10	35194808	35197253	2445	1222.0	
52657	chr10	35208443	35209442	999	500.0	
52658	chr10	35211551	35211560	9	4.0	
52659	chr10	35212874	35213208	334	167.0	
52660	chr10	35214731	35215021	290	145.0	
52661	chr10	35216224	35216991	767	384.0	
52662	chr10	35218168	35219642	1474	737.0	
52663	chr10	35225090	35225616	526	263.0	
52664	chr10	35240004	35240391	387	194.0	
52665	chr10	35291415	35291666	251	126.0	
52666	chr10	35299979	35300634	655	328.0	
52667	chr10	35335604	35337908	2304	1152.0	
52668	chr10	35340057	35340306	249	124.0	
52669	chr10	35341282	35342039	757	378.0	
52670	chr10	35352650	35352965	315	158.0	
52671	chr10	35368668	35369571	903	452.0	
52672	chr10	35372194	35372820	626	313.0	
52673	chr10	35378660	35379899	1239	620.0	
52674	chr10	35404161	35404373	212	106.0	
52675	chr10	35409294	35409587	293	146.0	
52676	chr10	35416840	35416990	150	75.0	
52677	chr10	35435654	35436366	712	356.0	
52678	chr10	35447556	35448523	967	484.0	
52679	chr10	35449250	35450412	1162	581.0	
52680	chr10	35450955	35451963	1008	504.0	
52681	chr10	35453778	35454434	656	328.0	
52682	chr10	35459503	35459725	222	111.0	
52683	chr10	35462451	35463237	786	393.0	
52684	chr10	35463796	35464102	306	153.0	
52685	chr10	35486317	35488054	1737	868.0	
52686	chr10	35495575	35496251	676	338.0	
52687	chr10	35517544	35517995	451	226.0	
52688	chr10	35523657	35524120	463	232.0	
52689	chr10	35563246	35563701	455	228.0	
52690	chr10	35564438	35565083	645	322.0	
52691	chr10	35635438	35635943	505	252.0	
52692	chr10	35639904	35644343	4439	2220.0	
52693	chr10	36534493	36535102	609	304.0	
52694	chr10	37856774	37858614	1840	920.0	
52695	chr10	37865907	37866304	397	198.0	
52696	chr10	37975181	37977401	2220	1110.0	
52697	chr10	37988465	37988865	400	200.0	
52698	chr10	38007889	38008452	563	282.0	
52699	chr10	38009834	38011894	2060	1030.0	
52700	chr10	38025286	38025675	389	194.0	
52701	chr10	38032869	38033338	469	234.0	
52702	chr10	38038126	38039029	903	452.0	
52703	chr10	38093522	38095501	1979	990.0	
52704	chr10	38355800	38356991	1191	596.0	
52705	chr10	38365942	38366326	384	192.0	
52706	chr10	38390684	38391103	419	210.0	
52707	chr10	38401926	38403815	1889	944.0	
52708	chr10	38487409	38487765	356	178.0	
52709	chr10	38515203	38515574	371	186.0	
52710	chr10	38526907	38529737	2830	1415.0	
52711	chr10	38578842	38579215	373	186.0	
52712	chr10	38788292	38788410	118	59.0	
52713	chr10	38789017	38789056	39	20.0	
52714	chr10	38790185	38790443	258	129.0	
52715	chr10	38792595	38793291	696	348.0	
52716	chr10	38795047	38795349	302	151.0	
52717	chr10	38800166	38801434	1268	634.0	
52718	chr10	38805954	38806194	240	120.0	
52719	chr10	38813032	38814466	1434	717.0	
52720	chr10	38815400	38815805	405	202.0	
52721	chr10	38816456	38817310	854	427.0	
52722	chr10	38818768	38819064	296	148.0	
52723	chr10	38820518	38821231	713	356.0	
52724	chr10	38822456	38822458	2	1.0	
52725	chr10	38827272	38827293	21	10.0	
52726	chr10	38828090	38828681	591	296.0	
52727	chr10	38830266	38830671	405	202.0	
52728	chr10	38832220	38832721	501	250.0	
52729	chr10	38835542	38835938	396	198.0	
52730	chr10	38840088	38840635	547	274.0	
52731	chr10	38842574	38842596	22	11.0	
52732	chr10	38843316	38843780	464	232.0	
52733	chr10	38844334	38845946	1612	806.0	
52734	chr10	38846984	38847285	301	150.0	
52735	chr10	38855791	38856192	401	200.0	
52736	chr10	38856728	38856906	178	89.0	
52737	chr10	38857815	38858251	436	218.0	
52738	chr10	38859734	38859735	1	0.0	
52739	chr10	38861467	38861693	226	113.0	
52740	chr10	41883514	41885021	1507	754.0	
52741	chr10	41880373	41882602	2229	1114.0	
52742	chr10	41878891	41879630	739	370.0	
52743	chr10	41874411	41875667	1256	628.0	
52744	chr10	41870674	41871387	713	356.0	
52745	chr10	41864127	41864471	344	172.0	
52746	chr10	41859309	41861127	1818	909.0	
52747	chr10	41858139	41858695	556	278.0	
52748	chr10	41850528	41856618	6090	3045.0	
52749	chr10	41845084	41850021	4937	2468.0	
52750	chr10	41839117	41844575	5458	2729.0	
52751	chr10	41837706	41838585	879	440.0	
52752	chr10	41835392	41836025	633	316.0	
52753	chr10	41833223	41833833	610	305.0	
52754	chr10	41831680	41832138	458	229.0	
52755	chr10	41711880	41713120	1240	620.0	
52756	chr10	41706519	41711139	4620	2310.0	
52757	chr10	41704822	41705795	973	486.0	
52758	chr10	41702093	41702476	383	192.0	
52759	chr10	42103468	42105130	1662	831.0	
52760	chr10	42301637	42302071	434	217.0	
52761	chr10	42321729	42322727	998	499.0	
52762	chr10	42367713	42368299	586	293.0	
52763	chr10	42551693	42553760	2067	1034.0	
52764	chr10	42630649	42630920	271	136.0	
52765	chr10	42637562	42639285	1723	862.0	
52766	chr10	42753021	42755389	2368	1184.0	
52767	chr10	42781931	42783598	1667	834.0	
52768	chr10	42866233	42867118	885	442.0	
52769	chr10	42932606	42934579	1973	986.0	
52770	chr10	42963257	42963808	551	276.0	
52771	chr10	42970835	42971141	306	153.0	
52772	chr10	43076722	43077198	476	238.0	"promoter	protein_binding_site	promoter	protein_binding_site	protein_binding_site"
52773	chr10	43091786	43092326	540	270.0	
52774	chr10	43104489	43106797	2308	1154.0	
52775	chr10	43120432	43121908	1476	738.0	
52776	chr10	43126528	43127443	915	458.0	
52777	chr10	43129017	43129962	945	472.0	
52778	chr10	43137364	43142043	4679	2340.0	
52779	chr10	43146159	43146378	219	110.0	
52780	chr10	43151560	43152149	589	294.0	
52781	chr10	43160508	43161223	715	358.0	
52782	chr10	43161759	43161827	68	34.0	
52783	chr10	43162534	43163004	470	235.0	
52784	chr10	43171478	43171999	521	260.0	
52785	chr10	43172691	43173061	370	185.0	
52786	chr10	43197926	43198366	440	220.0	
52787	chr10	43201761	43205636	3875	1938.0	
52788	chr10	43221128	43221740	612	306.0	
52789	chr10	43225667	43226234	567	284.0	
52790	chr10	43227993	43230259	2266	1133.0	
52791	chr10	43230854	43232231	1377	688.0	
52792	chr10	43254260	43254953	693	346.0	
52793	chr10	43255480	43256322	842	421.0	
52794	chr10	43265826	43267350	1524	762.0	
52795	chr10	43287075	43288007	932	466.0	
52796	chr10	43292978	43295188	2210	1105.0	
52797	chr10	43299481	43300209	728	364.0	
52798	chr10	43304545	43305271	726	363.0	
52799	chr10	43322468	43323439	971	486.0	
52800	chr10	43331917	43332767	850	425.0	
52801	chr10	43347999	43349097	1098	549.0	
52802	chr10	43361260	43363173	1913	956.0	
52803	chr10	43366695	43367444	749	374.0	
52804	chr10	43384388	43384543	155	78.0	
52805	chr10	43390657	43391179	522	261.0	
52806	chr10	43393556	43400165	6609	3304.0	
52807	chr10	43400850	43401923	1073	536.0	
52808	chr10	43402971	43410602	7631	3816.0	
52809	chr10	43417066	43419075	2009	1004.0	
52810	chr10	43419894	43421448	1554	777.0	
52811	chr10	43427065	43427824	759	380.0	
52812	chr10	43432276	43432787	511	256.0	
52813	chr10	43435712	43438213	2501	1250.0	
52814	chr10	43439468	43441141	1673	836.0	
52815	chr10	43451609	43452793	1184	592.0	
52816	chr10	43453359	43453763	404	202.0	
52817	chr10	43454653	43456621	1968	984.0	
52818	chr10	43461802	43462381	579	290.0	
52819	chr10	43571293	43571401	108	54.0	
52820	chr10	43572755	43575225	2470	1235.0	
52821	chr10	43576035	43576513	478	239.0	
52822	chr10	43594927	43596355	1428	714.0	
52823	chr10	43605982	43607214	1232	616.0	
52824	chr10	43623270	43623789	519	260.0	
52825	chr10	43648011	43649665	1654	827.0	
52826	chr10	43667197	43667571	374	187.0	
52827	chr10	43671588	43672093	505	252.0	
52828	chr10	43683486	43683869	383	192.0	
52829	chr10	43689366	43690859	1493	746.0	
52830	chr10	43781907	43782353	446	223.0	
52831	chr10	43816038	43816849	811	406.0	
52832	chr10	43846362	43846818	456	228.0	
52833	chr10	43978089	43978485	396	198.0	
52834	chr10	43981187	43981664	477	238.0	
52835	chr10	44004857	44005376	519	260.0	
52836	chr10	44013920	44014360	440	220.0	
52837	chr10	44015337	44015483	146	73.0	
52838	chr10	44017194	44017456	262	131.0	
52839	chr10	44030229	44030521	292	146.0	
52840	chr10	44310072	44311736	1664	832.0	
52841	chr10	44316352	44316873	521	260.0	
52842	chr10	44386554	44386902	348	174.0	
52843	chr10	44416796	44416852	56	28.0	
52844	chr10	44438176	44439153	977	488.0	
52845	chr10	44479370	44479766	396	198.0	
52846	chr10	44725320	44725857	537	268.0	
52847	chr10	44857693	44858178	485	242.0	
52848	chr10	44864065	44865352	1287	644.0	
52849	chr10	44878513	44879492	979	490.0	
52850	chr10	44913270	44914169	899	450.0	
52851	chr10	44932441	44933466	1025	512.0	
52852	chr10	44935870	44936307	437	218.0	
52853	chr10	44939202	44939220	18	9.0	
52854	chr10	44940078	44940444	366	183.0	
52855	chr10	44946124	44946655	531	266.0	
52856	chr10	44947626	44949209	1583	792.0	
52857	chr10	44958122	44961336	3214	1607.0	
52858	chr10	44963162	44964426	1264	632.0	
52859	chr10	44966051	44966560	509	254.0	
52860	chr10	44967522	44969414	1892	946.0	
52861	chr10	44971536	44971924	388	194.0	
52862	chr10	44973447	44975567	2120	1060.0	
52863	chr10	44978703	44979037	334	167.0	
52864	chr10	44995530	44996371	841	420.0	
52865	chr10	45000161	45001987	1826	913.0	
52866	chr10	45008362	45009091	729	364.0	
52867	chr10	45058651	45059021	370	185.0	
52868	chr10	45076846	45077244	398	199.0	
52869	chr10	45235134	45235687	553	276.0	
52870	chr10	45249988	45251118	1130	565.0	
52871	chr10	45253400	45253605	205	102.0	
52872	chr10	45308791	45309136	345	172.0	
52873	chr10	45354239	45354607	368	184.0	
52874	chr10	45373088	45376800	3712	1856.0	
52875	chr10	45379107	45381617	2510	1255.0	
52876	chr10	45383679	45384372	693	346.0	
52877	chr10	45395484	45395975	491	246.0	
52878	chr10	45403941	45404682	741	370.0	
52879	chr10	45408999	45409312	313	156.0	
52880	chr10	45418303	45421869	3566	1783.0	
52881	chr10	45425047	45425434	387	194.0	
52882	chr10	45438007	45438265	258	129.0	
52883	chr10	45460216	45461353	1137	568.0	
52884	chr10	45462191	45463305	1114	557.0	
52885	chr10	45464741	45465623	882	441.0	
52886	chr10	45466799	45467234	435	218.0	
52887	chr10	45470100	45470699	599	300.0	
52888	chr10	45557428	45557942	514	257.0	enhancer
52889	chr10	45580188	45582091	1903	952.0	
52890	chr10	45592424	45593392	968	484.0	
52891	chr10	45594038	45595506	1468	734.0	
52892	chr10	45600923	45601033	110	55.0	
52893	chr10	45657233	45657475	242	121.0	
52894	chr10	45671781	45673582	1801	900.0	
52895	chr10	45710428	45710563	135	68.0	
52896	chr10	45726703	45727824	1121	560.0	
52897	chr10	46635704	46635927	223	112.0	
52898	chr10	46600425	46600965	540	270.0	
52899	chr10	46596630	46598601	1971	986.0	
52900	chr10	46586507	46587450	943	472.0	
52901	chr10	46584847	46585681	834	417.0	
52902	chr10	46582575	46583219	644	322.0	
52903	chr10	46581459	46581645	186	93.0	
52904	chr10	46578563	46579670	1107	554.0	
52905	chr10	46575001	46575205	204	102.0	
52906	chr10	46572771	46572865	94	47.0	
52907	chr10	46565469	46566274	805	402.0	
52908	chr10	46553905	46554337	432	216.0	
52909	chr10	46546869	46547338	469	234.0	
52910	chr10	46545076	46545453	377	188.0	
52911	chr10	46497791	46498217	426	213.0	
52912	chr10	46470169	46470589	420	210.0	
52913	chr10	46468372	46468420	48	24.0	
52914	chr10	46441015	46441265	250	125.0	
52915	chr10	46436703	46437262	559	280.0	
52916	chr10	47705762	47706215	453	226.0	
52917	chr10	46228471	46229652	1181	590.0	
52918	chr10	46255839	46256502	663	332.0	
52919	chr10	46266138	46270698	4560	2280.0	
52920	chr10	46282526	46285648	3122	1561.0	
52921	chr10	46287166	46287311	145	72.0	
52922	chr10	46298931	46300454	1523	762.0	
52923	chr10	47383867	47385081	1214	607.0	
52924	chr10	47377574	47377765	191	96.0	
52925	chr10	47361240	47361566	326	163.0	
52926	chr10	47340143	47340969	826	413.0	
52927	chr10	47311149	47312703	1554	777.0	
52928	chr10	47299995	47300735	740	370.0	
52929	chr10	47286493	47286752	259	130.0	
52930	chr10	47264891	47265397	506	253.0	
52931	chr10	47260838	47261686	848	424.0	
52932	chr10	47256574	47258378	1804	902.0	
52933	chr10	47254707	47255680	973	486.0	
52934	chr10	47230662	47230666	4	2.0	
52935	chr10	47206639	47207670	1031	516.0	
52936	chr10	47179111	47179648	537	268.0	
52937	chr10	47165264	47167724	2460	1230.0	
52938	chr10	47160764	47161487	723	362.0	
52939	chr10	47153010	47153380	370	185.0	
52940	chr10	47146598	47146821	223	112.0	
52941	chr10	47133887	47134851	964	482.0	
52942	chr10	47104754	47105263	509	254.0	
52943	chr10	48199645	48199991	346	173.0	
52944	chr10	48215565	48215841	276	138.0	
52945	chr10	48289575	48290286	711	356.0	
52946	chr10	48303058	48303546	488	244.0	
52947	chr10	48305770	48307955	2185	1092.0	
52948	chr10	48309694	48310263	569	284.0	
52949	chr10	48363536	48363906	370	185.0	
52950	chr10	48404731	48404925	194	97.0	
52951	chr10	48456377	48456897	520	260.0	
52952	chr10	48493385	48493903	518	259.0	
52953	chr10	48501934	48502588	654	327.0	
52954	chr10	48505702	48506463	761	380.0	
52955	chr10	48511772	48512536	764	382.0	
52956	chr10	48517611	48518498	887	444.0	
52957	chr10	48524230	48524390	160	80.0	
52958	chr10	48551786	48552461	675	338.0	
52959	chr10	48574166	48574857	691	346.0	
52960	chr10	48576955	48577792	837	418.0	
52961	chr10	48604380	48605407	1027	514.0	
52962	chr10	48606610	48608552	1942	971.0	
52963	chr10	48623578	48624118	540	270.0	
52964	chr10	48624965	48625399	434	217.0	
52965	chr10	48633905	48635115	1210	605.0	
52966	chr10	48654969	48657090	2121	1060.0	
52967	chr10	48658205	48658810	605	302.0	
52968	chr10	48667844	48668719	875	438.0	
52969	chr10	48671137	48673059	1922	961.0	
52970	chr10	48677994	48678464	470	235.0	
52971	chr10	48683848	48685906	2058	1029.0	
52972	chr10	48701676	48701752	76	38.0	
52973	chr10	48713961	48714644	683	342.0	
52974	chr10	48743447	48743917	470	235.0	
52975	chr10	48748517	48748967	450	225.0	
52976	chr10	48770576	48770920	344	172.0	
52977	chr10	48787153	48787224	71	36.0	
52978	chr10	48789970	48790583	613	306.0	
52979	chr10	48799520	48801527	2007	1004.0	
52980	chr10	48802449	48803054	605	302.0	
52981	chr10	48804735	48805085	350	175.0	
52982	chr10	48900261	48900798	537	268.0	
52983	chr10	48981296	48982271	975	488.0	
52984	chr10	49010492	49010503	11	6.0	
52985	chr10	49115250	49115793	543	272.0	
52986	chr10	49135611	49136308	697	348.0	
52987	chr10	49157294	49157462	168	84.0	
52988	chr10	49164490	49164986	496	248.0	
52989	chr10	49168788	49169433	645	322.0	
52990	chr10	49173878	49174734	856	428.0	
52991	chr10	49176076	49176121	45	22.0	
52992	chr10	49176946	49178182	1236	618.0	
52993	chr10	49180216	49180705	489	244.0	
52994	chr10	49183567	49185214	1647	824.0	
52995	chr10	49186920	49188914	1994	997.0	
52996	chr10	49189840	49191361	1521	760.0	
52997	chr10	49194164	49194798	634	317.0	
52998	chr10	49240990	49241316	326	163.0	
52999	chr10	49253366	49253696	330	165.0	
53000	chr10	49254463	49255231	768	384.0	
53001	chr10	49256974	49257569	595	298.0	
53002	chr10	49263666	49263964	298	149.0	
53003	chr10	49272507	49273401	894	447.0	
53004	chr10	49277944	49278301	357	178.0	
53005	chr10	49279915	49280573	658	329.0	
53006	chr10	49282857	49283603	746	373.0	
53007	chr10	49285008	49285973	965	482.0	
53008	chr10	49309587	49312334	2747	1374.0	
53009	chr10	49319245	49320196	951	476.0	
53010	chr10	49324741	49325158	417	208.0	
53011	chr10	49335436	49335814	378	189.0	
53012	chr10	49360075	49360605	530	265.0	
53013	chr10	49362353	49363307	954	477.0	
53014	chr10	49397613	49398589	976	488.0	
53015	chr10	49407468	49408003	535	268.0	
53016	chr10	49441584	49441868	284	142.0	
53017	chr10	49508175	49508761	586	293.0	
53018	chr10	49512189	49512593	404	202.0	
53019	chr10	49518951	49519424	473	236.0	
53020	chr10	49526614	49527026	412	206.0	
53021	chr10	49534888	49535539	651	326.0	
53022	chr10	49538160	49540104	1944	972.0	
53023	chr10	49592984	49593475	491	246.0	
53024	chr10	49594744	49594883	139	70.0	
53025	chr10	49606876	49607377	501	250.0	
53026	chr10	49762075	49762596	521	260.0	
53027	chr10	49827274	49827729	455	228.0	
53028	chr10	46106068	46107060	992	496.0	
53029	chr10	46096933	46097386	453	226.0	
53030	chr10	46093856	46094402	546	273.0	
53031	chr10	46091239	46093092	1853	926.0	
53032	chr10	46079815	46080353	538	269.0	
53033	chr10	46077171	46078283	1112	556.0	
53034	chr10	46028512	46031268	2756	1378.0	
53035	chr10	46024940	46025277	337	168.0	
53036	chr10	46022869	46024017	1148	574.0	
53037	chr10	46018625	46021646	3021	1510.0	
53038	chr10	50014027	50014421	394	197.0	
53039	chr10	50067303	50068622	1319	660.0	
53040	chr10	50260638	50261214	576	288.0	
53041	chr10	50275728	50276046	318	159.0	
53042	chr10	50310837	50311174	337	168.0	
53043	chr10	50322073	50323628	1555	778.0	
53044	chr10	50325416	50325789	373	186.0	
53045	chr10	50347599	50347737	138	69.0	
53046	chr10	50362506	50363087	581	290.0	
53047	chr10	50367779	50368158	379	190.0	
53048	chr10	50374867	50375378	511	256.0	
53049	chr10	50387723	50388000	277	138.0	
53050	chr10	50394701	50397633	2932	1466.0	
53051	chr10	50410441	50410874	433	216.0	
53052	chr10	50417426	50418926	1500	750.0	
53053	chr10	50421191	50422745	1554	777.0	
53054	chr10	50431146	50431475	329	164.0	
53055	chr10	50458281	50458927	646	323.0	
53056	chr10	50464096	50464516	420	210.0	
53057	chr10	50508192	50508886	694	347.0	
53058	chr10	50512760	50513561	801	400.0	
53059	chr10	50527407	50527942	535	268.0	
53060	chr10	50540505	50540900	395	198.0	
53061	chr10	50552769	50553302	533	266.0	
53062	chr10	50561767	50562070	303	152.0	
53063	chr10	50577582	50578085	503	252.0	
53064	chr10	50603928	50604535	607	304.0	
53065	chr10	50605219	50605817	598	299.0	
53066	chr10	50614498	50614938	440	220.0	
53067	chr10	50621650	50626116	4466	2233.0	
53068	chr10	50636440	50637681	1241	620.0	
53069	chr10	50648291	50648753	462	231.0	
53070	chr10	50653151	50653893	742	371.0	
53071	chr10	50659979	50660648	669	334.0	
53072	chr10	50672071	50672641	570	285.0	
53073	chr10	50739304	50740746	1442	721.0	
53074	chr10	51011145	51011235	90	45.0	
53075	chr10	51273606	51273935	329	164.0	
53076	chr10	51698831	51700493	1662	831.0	
53077	chr10	52215760	52216161	401	200.0	
53078	chr10	52216803	52217278	475	238.0	
53079	chr10	52232733	52232843	110	55.0	
53080	chr10	52308414	52308564	150	75.0	
53081	chr10	52314400	52314762	362	181.0	
53082	chr10	52437184	52437477	293	146.0	
53083	chr10	52755376	52755763	387	194.0	
53084	chr10	52780099	52780484	385	192.0	
53085	chr10	52884291	52884596	305	152.0	
53086	chr10	52951814	52952224	410	205.0	
53087	chr10	52965908	52966372	464	232.0	
53088	chr10	53012900	53013622	722	361.0	
53089	chr10	53030371	53030943	572	286.0	
53090	chr10	54065187	54065441	254	127.0	
53091	chr10	56360367	56362324	1957	978.0	
53092	chr10	56622432	56622680	248	124.0	
53093	chr10	56634095	56634512	417	208.0	
53094	chr10	58177404	58177729	325	162.0	
53095	chr10	58262856	58263242	386	193.0	
53096	chr10	58265897	58270024	4127	2064.0	
53097	chr10	58282252	58283214	962	481.0	
53098	chr10	58291349	58292031	682	341.0	
53099	chr10	58299397	58300078	681	340.0	
53100	chr10	58322269	58323127	858	429.0	
53101	chr10	58330383	58330810	427	214.0	
53102	chr10	58331583	58332091	508	254.0	
53103	chr10	58334515	58336222	1707	854.0	
53104	chr10	58350527	58351252	725	362.0	
53105	chr10	58358456	58360265	1809	904.0	
53106	chr10	58367039	58367440	401	200.0	
53107	chr10	58372681	58373447	766	383.0	
53108	chr10	58383880	58386222	2342	1171.0	
53109	chr10	58512414	58514040	1626	813.0	
53110	chr10	58531037	58531510	473	236.0	
53111	chr10	58543111	58543590	479	240.0	
53112	chr10	58577272	58577800	528	264.0	
53113	chr10	58585528	58585555	27	14.0	
53114	chr10	58592768	58593517	749	374.0	
53115	chr10	58662320	58662716	396	198.0	
53116	chr10	58665923	58666544	621	310.0	
53117	chr10	58723963	58724491	528	264.0	
53118	chr10	58782149	58782158	9	4.0	
53119	chr10	59625939	59626449	510	255.0	
53120	chr10	59709631	59709956	325	162.0	
53121	chr10	59803528	59804131	603	302.0	
53122	chr10	59809324	59809767	443	222.0	
53123	chr10	59830629	59831004	375	188.0	
53124	chr10	59834569	59834805	236	118.0	
53125	chr10	59864721	59865556	835	418.0	
53126	chr10	59873131	59873210	79	40.0	
53127	chr10	59873933	59874236	303	152.0	
53128	chr10	59879467	59879791	324	162.0	
53129	chr10	59880662	59881506	844	422.0	
53130	chr10	59885343	59886140	797	398.0	
53131	chr10	59887245	59887267	22	11.0	
53132	chr10	59887987	59888388	401	200.0	
53133	chr10	59890171	59890236	65	32.0	
53134	chr10	59891593	59893193	1600	800.0	
53135	chr10	59900042	59900495	453	226.0	
53136	chr10	59903898	59908894	4996	2498.0	
53137	chr10	59970642	59970745	103	52.0	
53138	chr10	59991558	59992235	677	338.0	
53139	chr10	60031497	60033241	1744	872.0	
53140	chr10	60100119	60100571	452	226.0	
53141	chr10	60114862	60114940	78	39.0	
53142	chr10	60210348	60210594	246	123.0	
53143	chr10	60236677	60237746	1069	534.0	
53144	chr10	60238502	60238838	336	168.0	
53145	chr10	60271659	60272069	410	205.0	
53146	chr10	60282724	60283253	529	264.0	
53147	chr10	60351186	60351683	497	248.0	
53148	chr10	60434497	60434749	252	126.0	
53149	chr10	60446884	60447174	290	145.0	
53150	chr10	60461779	60462097	318	159.0	
53151	chr10	60513383	60513593	210	105.0	
53152	chr10	60572705	60573060	355	178.0	
53153	chr10	60606562	60607096	534	267.0	
53154	chr10	60646993	60647606	613	306.0	
53155	chr10	60663257	60663618	361	180.0	
53156	chr10	60666056	60666725	669	334.0	
53157	chr10	60727709	60728833	1124	562.0	
53158	chr10	60731213	60733887	2674	1337.0	
53159	chr10	60768783	60769447	664	332.0	
53160	chr10	60777833	60779494	1661	830.0	
53161	chr10	60784383	60785069	686	343.0	
53162	chr10	60809125	60809602	477	238.0	
53163	chr10	60816500	60816979	479	240.0	
53164	chr10	60942683	60945004	2321	1160.0	
53165	chr10	60964111	60964550	439	220.0	
53166	chr10	61135381	61135778	397	198.0	
53167	chr10	61141023	61141071	48	24.0	
53168	chr10	61284239	61284647	408	204.0	
53169	chr10	61286538	61287159	621	310.0	
53170	chr10	61389007	61391306	2299	1150.0	
53171	chr10	61397072	61398154	1082	541.0	
53172	chr10	61464570	61466421	1851	926.0	
53173	chr10	61486637	61487319	682	341.0	
53174	chr10	61750886	61751399	513	256.0	
53175	chr10	61765733	61765877	144	72.0	
53176	chr10	61780096	61780252	156	78.0	
53177	chr10	61867290	61868562	1272	636.0	
53178	chr10	61896664	61898135	1471	736.0	
53179	chr10	61899003	61905185	6182	3091.0	
53180	chr10	61933774	61934466	692	346.0	
53181	chr10	61937779	61937960	181	90.0	
53182	chr10	61938979	61939369	390	195.0	
53183	chr10	61940932	61944093	3161	1580.0	
53184	chr10	61961199	61962200	1001	500.0	
53185	chr10	61966023	61966359	336	168.0	
53186	chr10	61978885	61979421	536	268.0	
53187	chr10	61987621	61988620	999	500.0	
53188	chr10	61991207	61994579	3372	1686.0	
53189	chr10	61999928	62000716	788	394.0	
53190	chr10	62016603	62017629	1026	513.0	
53191	chr10	62038383	62039275	892	446.0	
53192	chr10	62043507	62043672	165	82.0	
53193	chr10	62044577	62044649	72	36.0	
53194	chr10	62045197	62051573	6376	3188.0	
53195	chr10	62054361	62055342	981	490.0	
53196	chr10	62058715	62059938	1223	612.0	
53197	chr10	62076842	62077165	323	162.0	
53198	chr10	62080085	62080700	615	308.0	
53199	chr10	62082437	62083865	1428	714.0	
53200	chr10	62105213	62105547	334	167.0	
53201	chr10	62109064	62110554	1490	745.0	
53202	chr10	62153141	62153672	531	266.0	
53203	chr10	62166728	62167257	529	264.0	
53204	chr10	62183236	62184263	1027	514.0	
53205	chr10	62243191	62243914	723	362.0	
53206	chr10	62244794	62245438	644	322.0	
53207	chr10	62250003	62250091	88	44.0	
53208	chr10	62264569	62265166	597	298.0	
53209	chr10	62268073	62269396	1323	662.0	
53210	chr10	62306759	62307061	302	151.0	
53211	chr10	62368923	62369309	386	193.0	
53212	chr10	62373650	62375483	1833	916.0	
53213	chr10	62383446	62384914	1468	734.0	
53214	chr10	62433148	62433519	371	186.0	
53215	chr10	62437590	62438066	476	238.0	
53216	chr10	62456465	62457981	1516	758.0	
53217	chr10	62473250	62473599	349	174.0	
53218	chr10	62481075	62481243	168	84.0	
53219	chr10	62492217	62493043	826	413.0	
53220	chr10	62493903	62494354	451	226.0	
53221	chr10	62501468	62501983	515	258.0	
53222	chr10	62503104	62503694	590	295.0	
53223	chr10	62506351	62506747	396	198.0	
53224	chr10	62527150	62529157	2007	1004.0	
53225	chr10	62538541	62538984	443	222.0	
53226	chr10	62540263	62540796	533	266.0	
53227	chr10	62541655	62542310	655	328.0	
53228	chr10	62545313	62546393	1080	540.0	
53229	chr10	62554614	62555030	416	208.0	
53230	chr10	62593928	62594643	715	358.0	
53231	chr10	62610559	62611254	695	348.0	
53232	chr10	62614637	62615104	467	234.0	
53233	chr10	62617275	62619759	2484	1242.0	
53234	chr10	62620293	62621403	1110	555.0	
53235	chr10	62631319	62633329	2010	1005.0	
53236	chr10	62634600	62635257	657	328.0	
53237	chr10	62636765	62638665	1900	950.0	
53238	chr10	62640336	62640876	540	270.0	
53239	chr10	62647686	62647711	25	12.0	
53240	chr10	62653116	62653713	597	298.0	
53241	chr10	62666225	62666696	471	236.0	
53242	chr10	62669400	62669755	355	178.0	
53243	chr10	62681018	62682016	998	499.0	
53244	chr10	62689280	62691961	2681	1340.0	
53245	chr10	62694508	62695047	539	270.0	
53246	chr10	62696851	62697130	279	140.0	
53247	chr10	62708772	62708855	83	42.0	
53248	chr10	62710158	62710634	476	238.0	
53249	chr10	62728441	62728938	497	248.0	
53250	chr10	62732751	62733998	1247	624.0	
53251	chr10	62735671	62736105	434	217.0	
53252	chr10	62742419	62743125	706	353.0	
53253	chr10	62745596	62745960	364	182.0	
53254	chr10	62759809	62760849	1040	520.0	
53255	chr10	62778984	62780076	1092	546.0	
53256	chr10	62803875	62806396	2521	1260.0	
53257	chr10	62811255	62819562	8307	4154.0	
53258	chr10	62830724	62831108	384	192.0	
53259	chr10	62839608	62839963	355	178.0	
53260	chr10	62850688	62850948	260	130.0	
53261	chr10	62852889	62854185	1296	648.0	
53262	chr10	62855852	62856545	693	346.0	
53263	chr10	63068141	63068666	525	262.0	
53264	chr10	63083843	63084378	535	268.0	
53265	chr10	63113975	63114376	401	200.0	
53266	chr10	63132484	63134771	2287	1144.0	
53267	chr10	63137414	63137743	329	164.0	
53268	chr10	63143939	63144670	731	366.0	
53269	chr10	63155196	63156094	898	449.0	
53270	chr10	63157848	63158711	863	432.0	
53271	chr10	63164103	63164703	600	300.0	
53272	chr10	63165859	63165976	117	58.0	
53273	chr10	63166697	63167261	564	282.0	
53274	chr10	63173734	63174725	991	496.0	
53275	chr10	63204550	63206054	1504	752.0	
53276	chr10	63206581	63207742	1161	580.0	
53277	chr10	63213825	63215016	1191	596.0	
53278	chr10	63216839	63217735	896	448.0	
53279	chr10	63219711	63220573	862	431.0	
53280	chr10	63221470	63222588	1118	559.0	
53281	chr10	63225305	63228635	3330	1665.0	
53282	chr10	63236290	63237050	760	380.0	
53283	chr10	63237969	63238190	221	110.0	
53284	chr10	63239312	63239541	229	114.0	
53285	chr10	63241629	63242649	1020	510.0	
53286	chr10	63243753	63244940	1187	594.0	
53287	chr10	63247480	63248236	756	378.0	
53288	chr10	63248877	63249791	914	457.0	
53289	chr10	63250322	63251084	762	381.0	
53290	chr10	63251777	63253669	1892	946.0	
53291	chr10	63254586	63255337	751	376.0	
53292	chr10	63256093	63261955	5862	2931.0	
53293	chr10	63262813	63262883	70	35.0	
53294	chr10	63263710	63263899	189	94.0	
53295	chr10	63264897	63265820	923	462.0	
53296	chr10	63266601	63269692	3091	1546.0	
53297	chr10	63270499	63270910	411	206.0	
53298	chr10	63273304	63274076	772	386.0	
53299	chr10	63376783	63377528	745	372.0	
53300	chr10	63388337	63389110	773	386.0	
53301	chr10	63391823	63392199	376	188.0	
53302	chr10	63421388	63422084	696	348.0	
53303	chr10	63437090	63437528	438	219.0	
53304	chr10	63464723	63466798	2075	1038.0	
53305	chr10	63515406	63515655	249	124.0	
53306	chr10	63520578	63522890	2312	1156.0	
53307	chr10	63554642	63555153	511	256.0	
53308	chr10	63592915	63592993	78	39.0	
53309	chr10	63628390	63631561	3171	1586.0	
53310	chr10	63692290	63692536	246	123.0	
53311	chr10	63698428	63698826	398	199.0	
53312	chr10	63700069	63701222	1153	576.0	
53313	chr10	63702953	63703777	824	412.0	
53314	chr10	63707138	63707856	718	359.0	
53315	chr10	63712479	63712880	401	200.0	
53316	chr10	63716168	63716604	436	218.0	
53317	chr10	63718041	63718449	408	204.0	
53318	chr10	63719970	63720986	1016	508.0	
53319	chr10	63866398	63867171	773	386.0	
53320	chr10	64033707	64034112	405	202.0	
53321	chr10	64040692	64041955	1263	632.0	
53322	chr10	64112979	64113115	136	68.0	
53323	chr10	66180680	66181114	434	217.0	
53324	chr10	67520953	67521285	332	166.0	
53325	chr10	67612661	67613704	1043	522.0	
53326	chr10	67666504	67666817	313	156.0	
53327	chr10	67697630	67698081	451	226.0	
53328	chr10	67761664	67762648	984	492.0	
53329	chr10	67763228	67765808	2580	1290.0	
53330	chr10	67770633	67770916	283	142.0	
53331	chr10	67772739	67773596	857	428.0	
53332	chr10	67779487	67780520	1033	516.0	
53333	chr10	67783510	67784260	750	375.0	
53334	chr10	67788349	67788902	553	276.0	
53335	chr10	67790982	67791302	320	160.0	
53336	chr10	67837958	67838429	471	236.0	
53337	chr10	67849172	67850398	1226	613.0	
53338	chr10	67855326	67856047	721	360.0	
53339	chr10	67864509	67865068	559	280.0	
53340	chr10	67883682	67886583	2901	1450.0	"promoter	promoter	promoter	protein_binding_site	promoter	protein_binding_site"
53341	chr10	67889639	67890016	377	188.0	
53342	chr10	67892818	67892832	14	7.0	
53343	chr10	67896720	67897393	673	336.0	
53344	chr10	67899868	67899913	45	22.0	
53345	chr10	67901296	67901425	129	64.0	
53346	chr10	67902961	67903900	939	470.0	
53347	chr10	67918747	67918850	103	52.0	
53348	chr10	67934359	67934722	363	182.0	
53349	chr10	68052456	68052820	364	182.0	
53350	chr10	68073993	68076050	2057	1028.0	
53351	chr10	68156348	68156818	470	235.0	
53352	chr10	68202540	68203310	770	385.0	
53353	chr10	68212740	68213136	396	198.0	
53354	chr10	68231145	68231823	678	339.0	
53355	chr10	68300627	68301145	518	259.0	
53356	chr10	68302146	68302633	487	244.0	
53357	chr10	68314275	68314823	548	274.0	
53358	chr10	68328206	68328763	557	278.0	
53359	chr10	68330543	68336267	5724	2862.0	
53360	chr10	68336920	68337292	372	186.0	
53361	chr10	68348192	68349071	879	440.0	
53362	chr10	68406202	68408001	1799	900.0	
53363	chr10	68423609	68423856	247	124.0	
53364	chr10	68436056	68436157	101	50.0	
53365	chr10	68471337	68472395	1058	529.0	
53366	chr10	68489803	68490219	416	208.0	
53367	chr10	68492194	68492476	282	141.0	
53368	chr10	68526791	68528551	1760	880.0	
53369	chr10	68550708	68551217	509	254.0	
53370	chr10	68559840	68561603	1763	882.0	
53371	chr10	68600071	68600905	834	417.0	
53372	chr10	68684414	68684843	429	214.0	
53373	chr10	68720511	68722699	2188	1094.0	
53374	chr10	68782210	68782492	282	141.0	
53375	chr10	68826998	68828710	1712	856.0	
53376	chr10	68897394	68897879	485	242.0	
53377	chr10	68900291	68902138	1847	924.0	
53378	chr10	68955270	68957865	2595	1298.0	
53379	chr10	68958588	68959460	872	436.0	
53380	chr10	68981095	68981322	227	114.0	
53381	chr10	68987276	68987307	31	16.0	
53382	chr10	68987970	68989726	1756	878.0	
53383	chr10	68991465	68991774	309	154.0	
53384	chr10	68997257	68997653	396	198.0	
53385	chr10	69004758	69005267	509	254.0	
53386	chr10	69012861	69013148	287	144.0	
53387	chr10	69027499	69028030	531	266.0	
53388	chr10	69043824	69046346	2522	1261.0	
53389	chr10	69047485	69050013	2528	1264.0	
53390	chr10	69051169	69052532	1363	682.0	
53391	chr10	69054112	69054645	533	266.0	
53392	chr10	69055990	69058217	2227	1114.0	
53393	chr10	69061115	69062463	1348	674.0	
53394	chr10	69065225	69066542	1317	658.0	
53395	chr10	69068606	69069086	480	240.0	
53396	chr10	69072958	69073514	556	278.0	
53397	chr10	69080284	69080591	307	154.0	
53398	chr10	69086025	69094406	8381	4190.0	
53399	chr10	69095287	69103420	8133	4066.0	
53400	chr10	69103975	69104123	148	74.0	
53401	chr10	69104753	69112560	7807	3904.0	
53402	chr10	69123120	69125564	2444	1222.0	
53403	chr10	69179162	69181329	2167	1084.0	
53404	chr10	69182645	69183025	380	190.0	
53405	chr10	69204020	69204564	544	272.0	
53406	chr10	69214629	69215772	1143	572.0	
53407	chr10	69221797	69223236	1439	720.0	
53408	chr10	69228629	69230084	1455	728.0	
53409	chr10	69232658	69233188	530	265.0	
53410	chr10	69237473	69238215	742	371.0	
53411	chr10	69279146	69279470	324	162.0	
53412	chr10	69317162	69321505	4343	2172.0	
53413	chr10	69327607	69328791	1184	592.0	
53414	chr10	69334108	69335947	1839	920.0	
53415	chr10	69337093	69338290	1197	598.0	
53416	chr10	69339183	69339401	218	109.0	
53417	chr10	69344471	69345569	1098	549.0	
53418	chr10	69346866	69347267	401	200.0	
53419	chr10	69348714	69349508	794	397.0	
53420	chr10	69359004	69360250	1246	623.0	
53421	chr10	69392052	69393135	1083	542.0	
53422	chr10	69406102	69410439	4337	2168.0	
53423	chr10	69413203	69413875	672	336.0	
53424	chr10	69422114	69422173	59	30.0	
53425	chr10	69423940	69424657	717	358.0	
53426	chr10	69425461	69427644	2183	1092.0	
53427	chr10	69438600	69438909	309	154.0	
53428	chr10	69439674	69440146	472	236.0	
53429	chr10	69449709	69452205	2496	1248.0	
53430	chr10	69464921	69465857	936	468.0	
53431	chr10	69507223	69508502	1279	640.0	
53432	chr10	69515548	69516636	1088	544.0	
53433	chr10	69558502	69558992	490	245.0	
53434	chr10	69572500	69573897	1397	698.0	
53435	chr10	69624353	69624835	482	241.0	
53436	chr10	69629595	69631154	1559	780.0	
53437	chr10	69636910	69637376	466	233.0	
53438	chr10	69639044	69639674	630	315.0	
53439	chr10	69651012	69651295	283	142.0	
53440	chr10	69716942	69717321	379	190.0	
53441	chr10	69801101	69801469	368	184.0	
53442	chr10	69816594	69817676	1082	541.0	
53443	chr10	69820892	69820935	43	22.0	
53444	chr10	69914635	69915038	403	202.0	
53445	chr10	69953895	69954274	379	190.0	
53446	chr10	69957315	69957340	25	12.0	
53447	chr10	69958266	69958691	425	212.0	
53448	chr10	69959791	69960448	657	328.0	
53449	chr10	69961887	69962079	192	96.0	
53450	chr10	69994289	69994661	372	186.0	
53451	chr10	70091954	70093882	1928	964.0	
53452	chr10	70107223	70107624	401	200.0	
53453	chr10	70116076	70116841	765	382.0	
53454	chr10	70131990	70133383	1393	696.0	
53455	chr10	70144981	70147585	2604	1302.0	
53456	chr10	70162072	70163469	1397	698.0	
53457	chr10	70164151	70164611	460	230.0	
53458	chr10	70168659	70171406	2747	1374.0	
53459	chr10	70173858	70174865	1007	504.0	
53460	chr10	70188854	70188865	11	6.0	
53461	chr10	70192051	70192424	373	186.0	
53462	chr10	70197190	70197810	620	310.0	
53463	chr10	70221206	70222067	861	430.0	
53464	chr10	70231970	70234277	2307	1154.0	
53465	chr10	70255027	70256189	1162	581.0	
53466	chr10	70267413	70267901	488	244.0	
53467	chr10	70272718	70273430	712	356.0	
53468	chr10	70274772	70275024	252	126.0	
53469	chr10	70280101	70280447	346	173.0	
53470	chr10	70283860	70284123	263	132.0	
53471	chr10	70295902	70296959	1057	528.0	
53472	chr10	70302006	70302780	774	387.0	
53473	chr10	70306052	70306711	659	330.0	
53474	chr10	70323037	70323585	548	274.0	
53475	chr10	70330844	70332352	1508	754.0	
53476	chr10	70341012	70341402	390	195.0	
53477	chr10	70348436	70348851	415	208.0	
53478	chr10	70354988	70356096	1108	554.0	
53479	chr10	70357606	70358118	512	256.0	
53480	chr10	70362319	70362800	481	240.0	
53481	chr10	70363898	70365118	1220	610.0	
53482	chr10	70379531	70379977	446	223.0	
53483	chr10	70381470	70383610	2140	1070.0	
53484	chr10	70387285	70387966	681	340.0	
53485	chr10	70403459	70406280	2821	1410.0	
53486	chr10	70441008	70441677	669	334.0	
53487	chr10	70458325	70458874	549	274.0	
53488	chr10	70461328	70461796	468	234.0	
53489	chr10	70476344	70476672	328	164.0	
53490	chr10	70477424	70479364	1940	970.0	
53491	chr10	70480070	70481002	932	466.0	
53492	chr10	70490848	70491116	268	134.0	
53493	chr10	70493148	70495481	2333	1166.0	
53494	chr10	70529083	70529103	20	10.0	
53495	chr10	70540492	70540854	362	181.0	
53496	chr10	70549632	70550484	852	426.0	
53497	chr10	70558833	70559900	1067	534.0	
53498	chr10	70565550	70565995	445	222.0	
53499	chr10	70575382	70577025	1643	822.0	
53500	chr10	70578079	70578984	905	452.0	
53501	chr10	70579523	70580190	667	334.0	
53502	chr10	70592912	70593278	366	183.0	
53503	chr10	70594066	70595090	1024	512.0	
53504	chr10	70598756	70604476	5720	2860.0	
53505	chr10	70610177	70611498	1321	660.0	
53506	chr10	70616112	70617454	1342	671.0	
53507	chr10	70672077	70672802	725	362.0	
53508	chr10	70715894	70716508	614	307.0	
53509	chr10	70742568	70742983	415	208.0	
53510	chr10	70745048	70745092	44	22.0	
53511	chr10	70758960	70760217	1257	628.0	
53512	chr10	70779948	70780407	459	230.0	
53513	chr10	70785195	70785571	376	188.0	
53514	chr10	70815241	70817038	1797	898.0	
53515	chr10	70832949	70833668	719	360.0	
53516	chr10	70834559	70834561	2	1.0	
53517	chr10	70866468	70866814	346	173.0	
53518	chr10	70879926	70880631	705	352.0	
53519	chr10	70887502	70888931	1429	714.0	
53520	chr10	70903271	70903688	417	208.0	
53521	chr10	70925612	70926074	462	231.0	
53522	chr10	70982417	70982823	406	203.0	
53523	chr10	70985976	70986041	65	32.0	
53524	chr10	71045459	71045808	349	174.0	
53525	chr10	71106096	71106579	483	242.0	
53526	chr10	71108092	71108414	322	161.0	
53527	chr10	71208886	71209488	602	301.0	
53528	chr10	71212091	71213117	1026	513.0	
53529	chr10	71217129	71217933	804	402.0	
53530	chr10	71233864	71234390	526	263.0	
53531	chr10	71235495	71235681	186	93.0	
53532	chr10	71244119	71244339	220	110.0	
53533	chr10	71270315	71270656	341	170.0	
53534	chr10	71285063	71285426	363	182.0	
53535	chr10	71299380	71299791	411	206.0	
53536	chr10	71303202	71303716	514	257.0	
53537	chr10	71314049	71314894	845	422.0	
53538	chr10	71316256	71316826	570	285.0	
53539	chr10	71318573	71320284	1711	856.0	
53540	chr10	71323274	71323836	562	281.0	
53541	chr10	71333263	71333978	715	358.0	
53542	chr10	71343256	71343780	524	262.0	
53543	chr10	71351925	71352345	420	210.0	
53544	chr10	71359007	71360125	1118	559.0	
53545	chr10	71364339	71365187	848	424.0	
53546	chr10	71366775	71367716	941	470.0	
53547	chr10	71371411	71373481	2070	1035.0	
53548	chr10	71376884	71379740	2856	1428.0	
53549	chr10	71382832	71383132	300	150.0	
53550	chr10	71383968	71384834	866	433.0	
53551	chr10	71396162	71398010	1848	924.0	
53552	chr10	71434401	71434877	476	238.0	
53553	chr10	71475109	71475628	519	260.0	
53554	chr10	71476225	71476650	425	212.0	
53555	chr10	71487724	71488178	454	227.0	
53556	chr10	71495062	71495520	458	229.0	
53557	chr10	71526923	71526928	5	2.0	
53558	chr10	71548670	71548766	96	48.0	
53559	chr10	71554738	71555438	700	350.0	
53560	chr10	71569957	71570450	493	246.0	
53561	chr10	71597773	71599091	1318	659.0	
53562	chr10	71609148	71609616	468	234.0	
53563	chr10	71613311	71613794	483	242.0	
53564	chr10	71623365	71623760	395	198.0	
53565	chr10	71627932	71628456	524	262.0	
53566	chr10	71635874	71636265	391	196.0	
53567	chr10	71637684	71639154	1470	735.0	
53568	chr10	71660396	71660686	290	145.0	
53569	chr10	71664009	71664295	286	143.0	
53570	chr10	71667167	71667778	611	306.0	
53571	chr10	71684333	71684693	360	180.0	
53572	chr10	71693934	71699194	5260	2630.0	
53573	chr10	71701434	71701928	494	247.0	
53574	chr10	71707813	71708938	1125	562.0	
53575	chr10	71712337	71714576	2239	1120.0	
53576	chr10	71725554	71729757	4203	2102.0	
53577	chr10	71730328	71730889	561	280.0	
53578	chr10	71731770	71732141	371	186.0	
53579	chr10	71735420	71738670	3250	1625.0	
53580	chr10	71739454	71743735	4281	2140.0	
53581	chr10	71745605	71751273	5668	2834.0	
53582	chr10	71752257	71755081	2824	1412.0	
53583	chr10	71756381	71758574	2193	1096.0	
53584	chr10	71760486	71762166	1680	840.0	
53585	chr10	71764811	71777007	12196	6098.0	
53586	chr10	71778391	71778857	466	233.0	
53587	chr10	71782639	71783516	877	438.0	
53588	chr10	71795247	71795610	363	182.0	
53589	chr10	71797417	71798279	862	431.0	
53590	chr10	71801367	71801834	467	234.0	
53591	chr10	71803985	71804621	636	318.0	
53592	chr10	71805392	71806662	1270	635.0	
53593	chr10	71811598	71813127	1529	764.0	
53594	chr10	71817423	71818964	1541	770.0	
53595	chr10	71822127	71822685	558	279.0	
53596	chr10	71828791	71829733	942	471.0	
53597	chr10	71832863	71833442	579	290.0	
53598	chr10	71835867	71837548	1681	840.0	
53599	chr10	71842703	71842723	20	10.0	
53600	chr10	71845408	71847257	1849	924.0	
53601	chr10	71847945	71848753	808	404.0	
53602	chr10	71850300	71853006	2706	1353.0	
53603	chr10	71858153	71858574	421	210.0	
53604	chr10	71860267	71861133	866	433.0	
53605	chr10	71868082	71868765	683	342.0	
53606	chr10	71871094	71871798	704	352.0	
53607	chr10	71873636	71874032	396	198.0	
53608	chr10	71878538	71879071	533	266.0	
53609	chr10	71880966	71881457	491	246.0	
53610	chr10	71883514	71883853	339	170.0	
53611	chr10	71887906	71890799	2893	1446.0	
53612	chr10	71896318	71897005	687	344.0	
53613	chr10	71933634	71933990	356	178.0	
53614	chr10	71956279	71956431	152	76.0	
53615	chr10	71964336	71964612	276	138.0	
53616	chr10	71985601	71986069	468	234.0	
53617	chr10	72048284	72049178	894	447.0	
53618	chr10	72054772	72055290	518	259.0	
53619	chr10	72056114	72064374	8260	4130.0	
53620	chr10	72065427	72066148	721	360.0	
53621	chr10	72066854	72070979	4125	2062.0	
53622	chr10	72073021	72077884	4863	2432.0	
53623	chr10	72078765	72090275	11510	5755.0	
53624	chr10	72106675	72108329	1654	827.0	
53625	chr10	72109493	72110047	554	277.0	
53626	chr10	72126207	72126558	351	176.0	
53627	chr10	72132372	72132508	136	68.0	
53628	chr10	72133474	72133990	516	258.0	
53629	chr10	72135009	72135682	673	336.0	
53630	chr10	72162885	72163355	470	235.0	
53631	chr10	72164619	72165030	411	206.0	
53632	chr10	72186352	72187141	789	394.0	
53633	chr10	72215167	72217303	2136	1068.0	
53634	chr10	72218301	72219183	882	441.0	
53635	chr10	72222771	72224212	1441	720.0	
53636	chr10	72232805	72233146	341	170.0	
53637	chr10	72244031	72244369	338	169.0	
53638	chr10	72247705	72249524	1819	910.0	
53639	chr10	72254665	72255699	1034	517.0	
53640	chr10	72256901	72257725	824	412.0	
53641	chr10	72259566	72262121	2555	1278.0	
53642	chr10	72263553	72264147	594	297.0	
53643	chr10	72264741	72264783	42	21.0	
53644	chr10	72270843	72271120	277	138.0	
53645	chr10	72272449	72279042	6593	3296.0	
53646	chr10	72282646	72282949	303	152.0	
53647	chr10	72285086	72285779	693	346.0	
53648	chr10	72290883	72291485	602	301.0	
53649	chr10	72292384	72300463	8079	4040.0	
53650	chr10	72301100	72301701	601	300.0	
53651	chr10	72305454	72306189	735	368.0	
53652	chr10	72308357	72308970	613	306.0	
53653	chr10	72309521	72311143	1622	811.0	
53654	chr10	72311961	72312089	128	64.0	
53655	chr10	72315506	72317506	2000	1000.0	
53656	chr10	72318215	72324252	6037	3018.0	
53657	chr10	72326486	72327501	1015	508.0	
53658	chr10	72328023	72330220	2197	1098.0	
53659	chr10	72330794	72337754	6960	3480.0	
53660	chr10	72340277	72341429	1152	576.0	
53661	chr10	72353304	72355806	2502	1251.0	
53662	chr10	72358506	72358525	19	10.0	
53663	chr10	72364015	72365110	1095	548.0	
53664	chr10	72369830	72370991	1161	580.0	
53665	chr10	72456965	72457396	431	216.0	
53666	chr10	72470598	72471369	771	386.0	
53667	chr10	72483553	72483975	422	211.0	
53668	chr10	72491110	72491138	28	14.0	
53669	chr10	72502615	72503711	1096	548.0	
53670	chr10	72509910	72510329	419	210.0	
53671	chr10	72511340	72512838	1498	749.0	
53672	chr10	72552920	72553364	444	222.0	
53673	chr10	72561927	72561929	2	1.0	
53674	chr10	72563180	72563932	752	376.0	
53675	chr10	72567911	72568120	209	104.0	
53676	chr10	72593935	72594366	431	216.0	
53677	chr10	72625317	72626775	1458	729.0	
53678	chr10	72637351	72637859	508	254.0	
53679	chr10	72676630	72676704	74	37.0	
53680	chr10	72691429	72693682	2253	1126.0	
53681	chr10	72694489	72695566	1077	538.0	
53682	chr10	72753868	72754333	465	232.0	
53683	chr10	72834177	72834617	440	220.0	
53684	chr10	72847715	72848210	495	248.0	
53685	chr10	72887164	72887350	186	93.0	
53686	chr10	72941669	72942188	519	260.0	
53687	chr10	73061082	73061440	358	179.0	
53688	chr10	73076787	73077236	449	224.0	
53689	chr10	73091026	73091198	172	86.0	
53690	chr10	73094262	73094523	261	130.0	
53691	chr10	73095069	73097761	2692	1346.0	
53692	chr10	73110034	73111254	1220	610.0	
53693	chr10	73158999	73159665	666	333.0	
53694	chr10	73167259	73168910	1651	826.0	
53695	chr10	73229597	73229981	384	192.0	
53696	chr10	73246482	73248042	1560	780.0	
53697	chr10	73251811	73253588	1777	888.0	
53698	chr10	73358112	73359305	1193	596.0	
53699	chr10	73412684	73414961	2277	1138.0	
53700	chr10	73494864	73496699	1835	918.0	
53701	chr10	73501629	73502030	401	200.0	
53702	chr10	73529293	73529841	548	274.0	
53703	chr10	73591211	73592059	848	424.0	
53704	chr10	73624944	73626850	1906	953.0	
53705	chr10	73643884	73644616	732	366.0	
53706	chr10	73645214	73645650	436	218.0	
53707	chr10	73647355	73648125	770	385.0	
53708	chr10	73650448	73651034	586	293.0	
53709	chr10	73717529	73718053	524	262.0	
53710	chr10	73729633	73731206	1573	786.0	
53711	chr10	73743551	73745138	1587	794.0	
53712	chr10	73758681	73760342	1661	830.0	
53713	chr10	73763013	73763962	949	474.0	
53714	chr10	73768590	73769747	1157	578.0	
53715	chr10	73770927	73773960	3033	1516.0	
53716	chr10	73774508	73775134	626	313.0	
53717	chr10	73781134	73782852	1718	859.0	
53718	chr10	73784837	73786762	1925	962.0	
53719	chr10	73796919	73797223	304	152.0	
53720	chr10	73798064	73798069	5	2.0	
53721	chr10	73798628	73801650	3022	1511.0	
53722	chr10	73802871	73802872	1	0.0	
53723	chr10	73803857	73804344	487	244.0	
53724	chr10	73809367	73809731	364	182.0	
53725	chr10	73810244	73813442	3198	1599.0	
53726	chr10	73814954	73816701	1747	874.0	
53727	chr10	73818288	73819405	1117	558.0	
53728	chr10	73819928	73820163	235	118.0	
53729	chr10	73843220	73843733	513	256.0	
53730	chr10	73848794	73849944	1150	575.0	
53731	chr10	73859349	73859973	624	312.0	
53732	chr10	73862044	73862494	450	225.0	
53733	chr10	73865030	73866696	1666	833.0	
53734	chr10	73868134	73868224	90	45.0	
53735	chr10	73873430	73876627	3197	1598.0	
53736	chr10	73878728	73880474	1746	873.0	
53737	chr10	73885827	73886694	867	434.0	
53738	chr10	73888886	73889574	688	344.0	
53739	chr10	73894486	73894825	339	170.0	
53740	chr10	73899590	73900457	867	434.0	
53741	chr10	73902345	73902778	433	216.0	
53742	chr10	73905517	73907026	1509	754.0	
53743	chr10	73907567	73909771	2204	1102.0	
53744	chr10	73910462	73912180	1718	859.0	
53745	chr10	73916760	73917535	775	388.0	
53746	chr10	73920040	73920499	459	230.0	
53747	chr10	73921891	73922640	749	374.0	
53748	chr10	73926073	73926961	888	444.0	
53749	chr10	73932240	73933089	849	424.0	
53750	chr10	73940472	73941228	756	378.0	
53751	chr10	73953683	73954074	391	196.0	
53752	chr10	73956278	73957790	1512	756.0	
53753	chr10	73958369	73960950	2581	1290.0	
53754	chr10	73966220	73966359	139	70.0	enhancer
53755	chr10	73968183	73968746	563	282.0	
53756	chr10	73969333	73969931	598	299.0	
53757	chr10	73974301	73974859	558	279.0	
53758	chr10	73978683	73980328	1645	822.0	
53759	chr10	73983686	73984205	519	260.0	
53760	chr10	73991479	73993514	2035	1018.0	
53761	chr10	73997288	74000172	2884	1442.0	
53762	chr10	74011062	74012045	983	492.0	
53763	chr10	74033234	74033608	374	187.0	
53764	chr10	74034324	74034725	401	200.0	
53765	chr10	74039507	74040548	1041	520.0	
53766	chr10	74047354	74048263	909	454.0	
53767	chr10	74055831	74056252	421	210.0	
53768	chr10	74057996	74059074	1078	539.0	
53769	chr10	74078172	74078481	309	154.0	
53770	chr10	74081175	74081637	462	231.0	
53771	chr10	74096859	74097108	249	124.0	
53772	chr10	74127117	74127376	259	130.0	
53773	chr10	74150095	74152184	2089	1044.0	
53774	chr10	74166245	74167161	916	458.0	
53775	chr10	74168892	74169400	508	254.0	
53776	chr10	74175847	74178433	2586	1293.0	
53777	chr10	74189885	74190913	1028	514.0	
53778	chr10	74193696	74193931	235	118.0	
53779	chr10	74194579	74194901	322	161.0	
53780	chr10	74206825	74207173	348	174.0	
53781	chr10	74213536	74213985	449	224.0	
53782	chr10	74227702	74228470	768	384.0	
53783	chr10	74244119	74244484	365	182.0	
53784	chr10	74255262	74256200	938	469.0	
53785	chr10	74265937	74266645	708	354.0	
53786	chr10	74300599	74300975	376	188.0	
53787	chr10	74328277	74328937	660	330.0	
53788	chr10	74419907	74420240	333	166.0	
53789	chr10	74585186	74586570	1384	692.0	
53790	chr10	74589040	74589878	838	419.0	
53791	chr10	74738870	74739512	642	321.0	
53792	chr10	74750841	74751148	307	154.0	
53793	chr10	74752665	74752975	310	155.0	
53794	chr10	74799840	74799893	53	26.0	
53795	chr10	74822388	74822970	582	291.0	
53796	chr10	74823945	74828549	4604	2302.0	
53797	chr10	74829067	74829401	334	167.0	
53798	chr10	74836286	74836396	110	55.0	
53799	chr10	74842222	74843174	952	476.0	
53800	chr10	74853857	74854463	606	303.0	
53801	chr10	74887850	74888068	218	109.0	
53802	chr10	74898196	74898405	209	104.0	
53803	chr10	74900231	74900688	457	228.0	
53804	chr10	74913606	74913751	145	72.0	
53805	chr10	74967757	74968389	632	316.0	
53806	chr10	74977858	74978434	576	288.0	
53807	chr10	74991455	74991857	402	201.0	
53808	chr10	75000676	75001134	458	229.0	
53809	chr10	75009130	75009219	89	44.0	
53810	chr10	75013935	75015164	1229	614.0	
53811	chr10	75019377	75019771	394	197.0	
53812	chr10	75022260	75022699	439	220.0	
53813	chr10	75043386	75044195	809	404.0	
53814	chr10	75062362	75062585	223	112.0	
53815	chr10	75099690	75100571	881	440.0	
53816	chr10	75104246	75104603	357	178.0	
53817	chr10	75108607	75109032	425	212.0	
53818	chr10	75110739	75113452	2713	1356.0	
53819	chr10	75127436	75127601	165	82.0	
53820	chr10	75129071	75129387	316	158.0	
53821	chr10	75138104	75138118	14	7.0	
53822	chr10	75144219	75144799	580	290.0	
53823	chr10	75166032	75166963	931	466.0	
53824	chr10	75187647	75188619	972	486.0	
53825	chr10	75191818	75192695	877	438.0	
53826	chr10	75209179	75211834	2655	1328.0	
53827	chr10	75226667	75226712	45	22.0	
53828	chr10	75230320	75231248	928	464.0	
53829	chr10	75232242	75236721	4479	2240.0	
53830	chr10	75294455	75296152	1697	848.0	
53831	chr10	75335924	75336378	454	227.0	
53832	chr10	75358889	75359568	679	340.0	
53833	chr10	75375674	75376480	806	403.0	
53834	chr10	75381207	75381329	122	61.0	
53835	chr10	75395263	75397123	1860	930.0	
53836	chr10	75399759	75403670	3911	1956.0	
53837	chr10	75407439	75409968	2529	1264.0	
53838	chr10	75428392	75428911	519	260.0	
53839	chr10	75430020	75432220	2200	1100.0	
53840	chr10	75434316	75434644	328	164.0	
53841	chr10	75469028	75469559	531	266.0	
53842	chr10	75499701	75500153	452	226.0	
53843	chr10	75516169	75516596	427	214.0	
53844	chr10	75528228	75528857	629	314.0	
53845	chr10	75532575	75532716	141	70.0	
53846	chr10	75553612	75553725	113	56.0	
53847	chr10	75611111	75611911	800	400.0	
53848	chr10	75612744	75613626	882	441.0	
53849	chr10	75614514	75614561	47	24.0	
53850	chr10	75617533	75617836	303	152.0	
53851	chr10	75649570	75649797	227	114.0	
53852	chr10	75696458	75697038	580	290.0	
53853	chr10	75772221	75772677	456	228.0	
53854	chr10	75926855	75926894	39	20.0	
53855	chr10	75956620	75957700	1080	540.0	
53856	chr10	75959959	75960244	285	142.0	
53857	chr10	76033659	76033907	248	124.0	
53858	chr10	76036318	76036760	442	221.0	enhancer
53859	chr10	76049920	76050457	537	268.0	
53860	chr10	76306919	76307185	266	133.0	
53861	chr10	76403774	76404900	1126	563.0	
53862	chr10	76405896	76406295	399	200.0	
53863	chr10	76547381	76547683	302	151.0	
53864	chr10	76882238	76882606	368	184.0	
53865	chr10	76883583	76883967	384	192.0	
53866	chr10	76984870	76985149	279	140.0	
53867	chr10	77027644	77027910	266	133.0	
53868	chr10	77032201	77032537	336	168.0	
53869	chr10	77041608	77041956	348	174.0	
53870	chr10	77079614	77080345	731	366.0	
53871	chr10	77111929	77112212	283	142.0	
53872	chr10	77163900	77164062	162	81.0	
53873	chr10	77165707	77166135	428	214.0	
53874	chr10	77173808	77174318	510	255.0	
53875	chr10	77223620	77223940	320	160.0	
53876	chr10	77244317	77244700	383	192.0	
53877	chr10	77245685	77247468	1783	892.0	
53878	chr10	77251275	77251631	356	178.0	
53879	chr10	77261196	77261616	420	210.0	
53880	chr10	77264069	77264571	502	251.0	
53881	chr10	77279287	77279694	407	204.0	
53882	chr10	77531647	77532064	417	208.0	
53883	chr10	77542728	77542958	230	115.0	
53884	chr10	77552090	77552674	584	292.0	
53885	chr10	77554870	77555314	444	222.0	
53886	chr10	77555845	77556349	504	252.0	
53887	chr10	77582682	77583169	487	244.0	
53888	chr10	77602874	77603773	899	450.0	
53889	chr10	77618857	77619195	338	169.0	
53890	chr10	77622740	77623340	600	300.0	
53891	chr10	77625280	77625864	584	292.0	
53892	chr10	77629742	77630182	440	220.0	
53893	chr10	77637524	77637774	250	125.0	
53894	chr10	77641773	77642169	396	198.0	
53895	chr10	77644000	77644401	401	200.0	
53896	chr10	77711009	77711881	872	436.0	
53897	chr10	77719510	77719960	450	225.0	
53898	chr10	77799187	77799750	563	282.0	
53899	chr10	77801313	77802186	873	436.0	
53900	chr10	77832060	77832792	732	366.0	
53901	chr10	77835865	77838235	2370	1185.0	
53902	chr10	77846535	77847195	660	330.0	
53903	chr10	77873429	77874394	965	482.0	
53904	chr10	77877493	77878696	1203	602.0	
53905	chr10	77925723	77927819	2096	1048.0	
53906	chr10	78028701	78030388	1687	844.0	
53907	chr10	78033240	78034756	1516	758.0	
53908	chr10	78041452	78041825	373	186.0	
53909	chr10	78045177	78045634	457	228.0	
53910	chr10	78047181	78047897	716	358.0	
53911	chr10	78062522	78062528	6	3.0	
53912	chr10	78232040	78232288	248	124.0	
53913	chr10	78250191	78250788	597	298.0	
53914	chr10	78255943	78256596	653	326.0	
53915	chr10	78259282	78259881	599	300.0	
53916	chr10	78292321	78292663	342	171.0	
53917	chr10	78299517	78300733	1216	608.0	
53918	chr10	78302494	78305778	3284	1642.0	
53919	chr10	78362460	78362785	325	162.0	
53920	chr10	78406925	78407424	499	250.0	
53921	chr10	78556890	78557015	125	62.0	
53922	chr10	78577725	78578107	382	191.0	
53923	chr10	78578795	78579404	609	304.0	
53924	chr10	78657571	78657922	351	176.0	
53925	chr10	78731315	78731595	280	140.0	
53926	chr10	78741875	78742255	380	190.0	
53927	chr10	78754309	78754593	284	142.0	
53928	chr10	78756422	78757581	1159	580.0	
53929	chr10	78764560	78764915	355	178.0	
53930	chr10	78768924	78769133	209	104.0	
53931	chr10	78852872	78853247	375	188.0	
53932	chr10	78937692	78938103	411	206.0	
53933	chr10	78960374	78960955	581	290.0	
53934	chr10	78972631	78975204	2573	1286.0	
53935	chr10	78977772	78978365	593	296.0	
53936	chr10	78981313	78982020	707	354.0	
53937	chr10	78998062	78998406	344	172.0	
53938	chr10	79001493	79001524	31	16.0	
53939	chr10	79022715	79022943	228	114.0	
53940	chr10	79024865	79026358	1493	746.0	
53941	chr10	79027088	79028462	1374	687.0	
53942	chr10	79046993	79048998	2005	1002.0	
53943	chr10	79052240	79052834	594	297.0	
53944	chr10	79062988	79063486	498	249.0	
53945	chr10	79064092	79064658	566	283.0	
53946	chr10	79065180	79065419	239	120.0	
53947	chr10	79066310	79072509	6199	3100.0	
53948	chr10	79073349	79074084	735	368.0	
53949	chr10	79076570	79077285	715	358.0	
53950	chr10	79079304	79080311	1007	504.0	
53951	chr10	79081226	79082327	1101	550.0	
53952	chr10	79083265	79085902	2637	1318.0	
53953	chr10	79093552	79094542	990	495.0	
53954	chr10	79098416	79099001	585	292.0	
53955	chr10	79101163	79102438	1275	638.0	
53956	chr10	79103095	79103883	788	394.0	
53957	chr10	79116278	79117255	977	488.0	
53958	chr10	79127098	79127917	819	410.0	
53959	chr10	79132115	79133097	982	491.0	
53960	chr10	79136197	79136902	705	352.0	
53961	chr10	79137403	79138438	1035	518.0	
53962	chr10	79139159	79139475	316	158.0	
53963	chr10	79146426	79147152	726	363.0	
53964	chr10	79148095	79150759	2664	1332.0	
53965	chr10	79151492	79152135	643	322.0	
53966	chr10	79155092	79155949	857	428.0	
53967	chr10	79187136	79187595	459	230.0	
53968	chr10	79195019	79195875	856	428.0	
53969	chr10	79196750	79197295	545	272.0	
53970	chr10	79202487	79202918	431	216.0	
53971	chr10	79239181	79239826	645	322.0	
53972	chr10	79241660	79250971	9311	4656.0	
53973	chr10	79255297	79255445	148	74.0	
53974	chr10	79265132	79265274	142	71.0	
53975	chr10	79265778	79268648	2870	1435.0	
53976	chr10	79270460	79271416	956	478.0	
53977	chr10	79274013	79274836	823	412.0	
53978	chr10	79283681	79284014	333	166.0	
53979	chr10	79285220	79287365	2145	1072.0	
53980	chr10	79292740	79294779	2039	1020.0	
53981	chr10	79295296	79296387	1091	546.0	
53982	chr10	79298578	79299196	618	309.0	
53983	chr10	79299886	79299994	108	54.0	
53984	chr10	79309364	79309760	396	198.0	
53985	chr10	79310761	79311237	476	238.0	
53986	chr10	79311798	79312191	393	196.0	
53987	chr10	79316603	79318704	2101	1050.0	
53988	chr10	79320665	79321834	1169	584.0	
53989	chr10	79322509	79324041	1532	766.0	
53990	chr10	79328648	79329312	664	332.0	
53991	chr10	79331103	79332465	1362	681.0	
53992	chr10	79344753	79345783	1030	515.0	
53993	chr10	79346624	79351061	4437	2218.0	
53994	chr10	79351996	79356788	4792	2396.0	
53995	chr10	79357326	79357528	202	101.0	
53996	chr10	79359772	79360229	457	228.0	
53997	chr10	79374319	79375037	718	359.0	
53998	chr10	79390572	79390974	402	201.0	
53999	chr10	79399477	79400889	1412	706.0	
54000	chr10	79404309	79404636	327	164.0	
54001	chr10	79413184	79413709	525	262.0	
54002	chr10	79417375	79417832	457	228.0	
54003	chr10	79419615	79420413	798	399.0	
54004	chr10	79443828	79447183	3355	1678.0	
54005	chr10	79448268	79448269	1	0.0	
54006	chr10	79449770	79449778	8	4.0	
54007	chr10	79467288	79468389	1101	550.0	
54008	chr10	79473566	79473577	11	6.0	
54009	chr10	79487546	79488014	468	234.0	
54010	chr10	79491217	79491407	190	95.0	
54011	chr10	79537324	79537478	154	77.0	
54012	chr10	79542710	79543015	305	152.0	
54013	chr10	79562107	79562872	765	382.0	
54014	chr10	79608794	79609098	304	152.0	
54015	chr10	79685108	79685471	363	182.0	
54016	chr10	79779301	79779748	447	224.0	
54017	chr10	79823379	79823749	370	185.0	
54018	chr10	79825472	79827360	1888	944.0	
54019	chr10	79889143	79889300	157	78.0	
54020	chr10	79904506	79905509	1003	502.0	
54021	chr10	79929354	79929961	607	304.0	
54022	chr10	79937224	79937600	376	188.0	
54023	chr10	79938388	79939602	1214	607.0	
54024	chr10	79948944	79949745	801	400.0	
54025	chr10	79981481	79982607	1126	563.0	
54026	chr10	80046828	80047321	493	246.0	
54027	chr10	80058793	80059186	393	196.0	
54028	chr10	80078087	80079744	1657	828.0	
54029	chr10	80143477	80145370	1893	946.0	
54030	chr10	80145960	80146453	493	246.0	
54031	chr10	80158596	80159067	471	236.0	
54032	chr10	80165596	80166734	1138	569.0	
54033	chr10	80169049	80169485	436	218.0	
54034	chr10	80186584	80188567	1983	992.0	
54035	chr10	80191536	80192216	680	340.0	
54036	chr10	80193537	80194384	847	424.0	
54037	chr10	80195942	80197254	1312	656.0	
54038	chr10	80197916	80198668	752	376.0	
54039	chr10	80199737	80200372	635	318.0	
54040	chr10	80201410	80202246	836	418.0	
54041	chr10	80202771	80206303	3532	1766.0	
54042	chr10	80222559	80223061	502	251.0	
54043	chr10	80260607	80261062	455	228.0	
54044	chr10	80356504	80357407	903	452.0	
54045	chr10	80378127	80378812	685	342.0	
54046	chr10	80382847	80383459	612	306.0	
54047	chr10	80388240	80388920	680	340.0	
54048	chr10	80392270	80392671	401	200.0	
54049	chr10	80407757	80409421	1664	832.0	
54050	chr10	80421623	80422010	387	194.0	
54051	chr10	80429635	80429996	361	180.0	
54052	chr10	80443560	80445501	1941	970.0	
54053	chr10	80448680	80449851	1171	586.0	
54054	chr10	80451456	80460042	8586	4293.0	
54055	chr10	80460657	80461869	1212	606.0	
54056	chr10	80462641	80469407	6766	3383.0	
54057	chr10	80470880	80474024	3144	1572.0	
54058	chr10	80483607	80488896	5289	2644.0	
54059	chr10	80491338	80492215	877	438.0	
54060	chr10	80493130	80494519	1389	694.0	
54061	chr10	80495025	80495831	806	403.0	
54062	chr10	80497474	80501097	3623	1812.0	
54063	chr10	80503849	80506096	2247	1124.0	
54064	chr10	80508645	80509006	361	180.0	
54065	chr10	80511268	80512052	784	392.0	
54066	chr10	80518640	80519338	698	349.0	
54067	chr10	80520738	80522025	1287	644.0	
54068	chr10	80522745	80524849	2104	1052.0	
54069	chr10	80525884	80527250	1366	683.0	
54070	chr10	80527940	80531185	3245	1622.0	
54071	chr10	80532778	80532810	32	16.0	
54072	chr10	80535376	80537082	1706	853.0	
54073	chr10	80539464	80539949	485	242.0	
54074	chr10	80540880	80541655	775	388.0	
54075	chr10	80596605	80597056	451	226.0	
54076	chr10	80597946	80598688	742	371.0	
54077	chr10	80599344	80599836	492	246.0	
54078	chr10	80660436	80661269	833	416.0	
54079	chr10	80662599	80663251	652	326.0	
54080	chr10	80664016	80664511	495	248.0	
54081	chr10	80684175	80684705	530	265.0	
54082	chr10	80699465	80699916	451	226.0	
54083	chr10	81021696	81021747	51	26.0	
54084	chr10	83680487	83680951	464	232.0	
54085	chr10	83871480	83871909	429	214.0	
54086	chr10	83990094	83990538	444	222.0	
54087	chr10	84138460	84140709	2249	1124.0	
54088	chr10	84147952	84148413	461	230.0	
54089	chr10	84156668	84157302	634	317.0	
54090	chr10	84177179	84178261	1082	541.0	
54091	chr10	84179040	84179826	786	393.0	
54092	chr10	84191010	84191563	553	276.0	
54093	chr10	84194148	84195304	1156	578.0	
54094	chr10	84205393	84206032	639	320.0	
54095	chr10	84214562	84214956	394	197.0	
54096	chr10	84257060	84257381	321	160.0	
54097	chr10	84264523	84265050	527	264.0	
54098	chr10	84267491	84267944	453	226.0	
54099	chr10	84308714	84309262	548	274.0	
54100	chr10	84327644	84331506	3862	1931.0	
54101	chr10	84333518	84335036	1518	759.0	
54102	chr10	84340817	84341915	1098	549.0	
54103	chr10	84342482	84343126	644	322.0	
54104	chr10	84351996	84352736	740	370.0	
54105	chr10	84355930	84356121	191	96.0	
54106	chr10	84356963	84357240	277	138.0	
54107	chr10	84361116	84361218	102	51.0	
54108	chr10	84374850	84375361	511	256.0	
54109	chr10	84424760	84425136	376	188.0	
54110	chr10	84429887	84430378	491	246.0	
54111	chr10	84537298	84537956	658	329.0	
54112	chr10	84540273	84541191	918	459.0	
54113	chr10	85603251	85603466	215	108.0	
54114	chr10	85612190	85613308	1118	559.0	
54115	chr10	85947019	85947319	300	150.0	
54116	chr10	86226897	86227106	209	104.0	
54117	chr10	86234116	86234303	187	94.0	
54118	chr10	86354739	86355961	1222	611.0	
54119	chr10	86357030	86357391	361	180.0	
54120	chr10	86363092	86363485	393	196.0	
54121	chr10	86365942	86367109	1167	584.0	
54122	chr10	86376975	86377833	858	429.0	
54123	chr10	86389308	86389861	553	276.0	
54124	chr10	86399518	86401998	2480	1240.0	
54125	chr10	86402510	86403092	582	291.0	
54126	chr10	86411411	86413929	2518	1259.0	
54127	chr10	86439396	86440307	911	456.0	
54128	chr10	86441176	86441618	442	221.0	
54129	chr10	86447046	86447648	602	301.0	
54130	chr10	86449887	86450379	492	246.0	
54131	chr10	86512905	86512961	56	28.0	
54132	chr10	86520607	86522901	2294	1147.0	
54133	chr10	86535314	86537156	1842	921.0	
54134	chr10	86538465	86539000	535	268.0	
54135	chr10	86580205	86580951	746	373.0	
54136	chr10	86585053	86585933	880	440.0	
54137	chr10	86600011	86600081	70	35.0	
54138	chr10	86688220	86689049	829	414.0	enhancer
54139	chr10	86693760	86694177	417	208.0	
54140	chr10	86710556	86712625	2069	1034.0	
54141	chr10	86753033	86753379	346	173.0	
54142	chr10	86755580	86757793	2213	1106.0	
54143	chr10	86872759	86873320	561	280.0	
54144	chr10	86876808	86876906	98	49.0	
54145	chr10	86888906	86889296	390	195.0	
54146	chr10	86899710	86900080	370	185.0	
54147	chr10	86939040	86940144	1104	552.0	
54148	chr10	86960307	86960839	532	266.0	
54149	chr10	86966137	86969181	3044	1522.0	
54150	chr10	86969996	86973017	3021	1510.0	
54151	chr10	87013539	87013947	408	204.0	
54152	chr10	87054557	87055315	758	379.0	
54153	chr10	87083637	87084806	1169	584.0	
54154	chr10	87092290	87096090	3800	1900.0	
54155	chr10	87184333	87184943	610	305.0	
54156	chr10	87200883	87201431	548	274.0	
54157	chr10	87203126	87205216	2090	1045.0	
54158	chr10	87214475	87215155	680	340.0	
54159	chr10	87216089	87216629	540	270.0	
54160	chr10	87342045	87343452	1407	704.0	
54161	chr10	87502358	87502779	421	210.0	
54162	chr10	87504280	87506013	1733	866.0	
54163	chr10	87533627	87534022	395	198.0	
54164	chr10	87546160	87546663	503	252.0	
54165	chr10	87596431	87596701	270	135.0	
54166	chr10	87635606	87636410	804	402.0	
54167	chr10	87656469	87658071	1602	801.0	
54168	chr10	87659466	87660572	1106	553.0	
54169	chr10	87668671	87669065	394	197.0	
54170	chr10	87735225	87735620	395	198.0	
54171	chr10	87740095	87740788	693	346.0	
54172	chr10	87743096	87743577	481	240.0	
54173	chr10	87760194	87760609	415	208.0	
54174	chr10	87771925	87772195	270	135.0	
54175	chr10	87775823	87776023	200	100.0	
54176	chr10	87816973	87819320	2347	1174.0	
54177	chr10	87837459	87837883	424	212.0	
54178	chr10	87850711	87851230	519	260.0	
54179	chr10	87860018	87865997	5979	2990.0	
54180	chr10	87929043	87929381	338	169.0	
54181	chr10	87944642	87944711	69	34.0	
54182	chr10	88026785	88028668	1883	942.0	
54183	chr10	88042738	88043251	513	256.0	
54184	chr10	88045473	88046195	722	361.0	
54185	chr10	88062682	88062830	148	74.0	
54186	chr10	88064514	88068198	3684	1842.0	
54187	chr10	88071806	88072373	567	284.0	
54188	chr10	88076069	88076579	510	255.0	
54189	chr10	88082715	88083285	570	285.0	
54190	chr10	88090503	88092277	1774	887.0	
54191	chr10	88093172	88093238	66	33.0	
54192	chr10	88097001	88098024	1023	512.0	
54193	chr10	88106287	88106846	559	280.0	
54194	chr10	88108030	88108743	713	356.0	
54195	chr10	88113226	88114799	1573	786.0	
54196	chr10	88117343	88118585	1242	621.0	
54197	chr10	88120075	88121033	958	479.0	
54198	chr10	88152806	88153150	344	172.0	
54199	chr10	88162873	88163160	287	144.0	
54200	chr10	88193964	88194707	743	372.0	
54201	chr10	88270811	88272276	1465	732.0	
54202	chr10	88322375	88322730	355	178.0	
54203	chr10	88333293	88333596	303	152.0	
54204	chr10	88385384	88387599	2215	1108.0	
54205	chr10	88389221	88389880	659	330.0	
54206	chr10	88392190	88392619	429	214.0	
54207	chr10	88408135	88408506	371	186.0	
54208	chr10	88553114	88553633	519	260.0	
54209	chr10	88555402	88555858	456	228.0	
54210	chr10	88565112	88565455	343	172.0	
54211	chr10	88582180	88583766	1586	793.0	
54212	chr10	88593030	88593039	9	4.0	
54213	chr10	88597877	88598518	641	320.0	
54214	chr10	88642968	88643445	477	238.0	
54215	chr10	88687870	88688254	384	192.0	
54216	chr10	88725740	88726271	531	266.0	
54217	chr10	88728415	88728746	331	166.0	
54218	chr10	88731264	88731701	437	218.0	
54219	chr10	88741977	88742243	266	133.0	
54220	chr10	88755667	88756182	515	258.0	
54221	chr10	88759342	88760410	1068	534.0	
54222	chr10	88765887	88766148	261	130.0	
54223	chr10	88791862	88793214	1352	676.0	
54224	chr10	88793768	88794135	367	184.0	
54225	chr10	88810118	88810865	747	374.0	
54226	chr10	88824949	88825760	811	406.0	
54227	chr10	88826435	88826686	251	126.0	
54228	chr10	88831641	88832144	503	252.0	
54229	chr10	88833622	88834170	548	274.0	
54230	chr10	88834993	88836366	1373	686.0	
54231	chr10	88840974	88841185	211	106.0	
54232	chr10	88848416	88848993	577	288.0	
54233	chr10	88851599	88852212	613	306.0	
54234	chr10	88852999	88853747	748	374.0	
54235	chr10	88865481	88865898	417	208.0	
54236	chr10	88879509	88881621	2112	1056.0	
54237	chr10	88883223	88883917	694	347.0	
54238	chr10	88897656	88897674	18	9.0	
54239	chr10	88901324	88902296	972	486.0	
54240	chr10	88932555	88933105	550	275.0	
54241	chr10	88934565	88936078	1513	756.0	
54242	chr10	88944885	88945120	235	118.0	
54243	chr10	88962331	88962786	455	228.0	
54244	chr10	88974703	88975765	1062	531.0	
54245	chr10	88979275	88979495	220	110.0	
54246	chr10	88986364	88987733	1369	684.0	
54247	chr10	88989401	88992365	2964	1482.0	
54248	chr10	88994006	88994427	421	210.0	
54249	chr10	88995139	88997440	2301	1150.0	
54250	chr10	88999529	89000030	501	250.0	
54251	chr10	89000671	89002798	2127	1064.0	
54252	chr10	89029738	89030278	540	270.0	
54253	chr10	89032007	89032719	712	356.0	
54254	chr10	89037065	89037526	461	230.0	
54255	chr10	89084136	89085551	1415	708.0	
54256	chr10	89086615	89087248	633	316.0	
54257	chr10	89091014	89091492	478	239.0	
54258	chr10	89116284	89116697	413	206.0	
54259	chr10	89121319	89121619	300	150.0	
54260	chr10	89122383	89124000	1617	808.0	
54261	chr10	89129810	89130324	514	257.0	
54262	chr10	89156076	89156927	851	426.0	
54263	chr10	89163326	89164686	1360	680.0	
54264	chr10	89206392	89208597	2205	1102.0	
54265	chr10	89213193	89213663	470	235.0	
54266	chr10	89216959	89218140	1181	590.0	
54267	chr10	89224885	89225545	660	330.0	
54268	chr10	89235096	89235959	863	432.0	
54269	chr10	89241718	89243555	1837	918.0	
54270	chr10	89248861	89249396	535	268.0	
54271	chr10	89250625	89252576	1951	976.0	
54272	chr10	89255309	89256836	1527	764.0	
54273	chr10	89260131	89261125	994	497.0	
54274	chr10	89293426	89293886	460	230.0	
54275	chr10	89295653	89297082	1429	714.0	
54276	chr10	89301140	89303129	1989	994.0	
54277	chr10	89310023	89310476	453	226.0	
54278	chr10	89327337	89328599	1262	631.0	
54279	chr10	89331843	89334607	2764	1382.0	
54280	chr10	89337546	89337947	401	200.0	
54281	chr10	89346345	89347040	695	348.0	
54282	chr10	89350790	89351410	620	310.0	
54283	chr10	89364586	89364873	287	144.0	
54284	chr10	89367401	89368042	641	320.0	
54285	chr10	89369479	89369887	408	204.0	
54286	chr10	89384492	89385400	908	454.0	
54287	chr10	89389296	89389624	328	164.0	
54288	chr10	89391803	89393431	1628	814.0	
54289	chr10	89411212	89411324	112	56.0	
54290	chr10	89412106	89412857	751	376.0	
54291	chr10	89413650	89415896	2246	1123.0	
54292	chr10	89419511	89419957	446	223.0	
54293	chr10	89426179	89426689	510	255.0	
54294	chr10	89466554	89466909	355	178.0	
54295	chr10	89563833	89564279	446	223.0	
54296	chr10	89637023	89637637	614	307.0	
54297	chr10	89643513	89645788	2275	1138.0	
54298	chr10	89652129	89652567	438	219.0	
54299	chr10	89684232	89685068	836	418.0	
54300	chr10	89700821	89702571	1750	875.0	
54301	chr10	89707641	89707734	93	46.0	
54302	chr10	89738745	89739234	489	244.0	
54303	chr10	89793599	89794051	452	226.0	
54304	chr10	89837022	89838295	1273	636.0	
54305	chr10	89860512	89861477	965	482.0	
54306	chr10	89887437	89890043	2606	1303.0	
54307	chr10	89909991	89910105	114	57.0	
54308	chr10	90047132	90047807	675	338.0	
54309	chr10	90751390	90751792	402	201.0	
54310	chr10	90775311	90775722	411	206.0	
54311	chr10	90777606	90778124	518	259.0	
54312	chr10	90787928	90788254	326	163.0	
54313	chr10	90788995	90789326	331	166.0	
54314	chr10	90847367	90847858	491	246.0	
54315	chr10	90856880	90859883	3003	1502.0	
54316	chr10	90862991	90863287	296	148.0	
54317	chr10	90865451	90865792	341	170.0	
54318	chr10	90871070	90872947	1877	938.0	
54319	chr10	90879979	90880684	705	352.0	
54320	chr10	90911483	90912002	519	260.0	
54321	chr10	90999583	90999888	305	152.0	
54322	chr10	91006191	91007402	1211	606.0	
54323	chr10	91033971	91034505	534	267.0	
54324	chr10	91088779	91089136	357	178.0	
54325	chr10	91161838	91165026	3188	1594.0	
54326	chr10	91166067	91166263	196	98.0	
54327	chr10	91190224	91191419	1195	598.0	
54328	chr10	91194969	91194989	20	10.0	
54329	chr10	91198158	91199612	1454	727.0	
54330	chr10	91200496	91202305	1809	904.0	
54331	chr10	91206457	91206903	446	223.0	
54332	chr10	91210337	91210811	474	237.0	
54333	chr10	91214889	91215334	445	222.0	
54334	chr10	91219909	91221745	1836	918.0	
54335	chr10	91251386	91251900	514	257.0	
54336	chr10	91298016	91298931	915	458.0	
54337	chr10	91378034	91378494	460	230.0	
54338	chr10	91389585	91390208	623	312.0	
54339	chr10	91409044	91411240	2196	1098.0	
54340	chr10	91632886	91633466	580	290.0	
54341	chr10	91758524	91758992	468	234.0	
54342	chr10	91796120	91799731	3611	1806.0	
54343	chr10	91804199	91804539	340	170.0	
54344	chr10	91887090	91888097	1007	504.0	
54345	chr10	91894328	91894722	394	197.0	
54346	chr10	91901538	91902708	1170	585.0	
54347	chr10	91907920	91909787	1867	934.0	
54348	chr10	91912734	91913486	752	376.0	
54349	chr10	91923068	91924993	1925	962.0	
54350	chr10	91926448	91927288	840	420.0	
54351	chr10	91932765	91933132	367	184.0	
54352	chr10	91934430	91934892	462	231.0	
54353	chr10	92048030	92048476	446	223.0	
54354	chr10	92059289	92059392	103	52.0	
54355	chr10	92082652	92083329	677	338.0	
54356	chr10	92087630	92088177	547	274.0	
54357	chr10	92101244	92101729	485	242.0	
54358	chr10	92114986	92115234	248	124.0	
54359	chr10	92141796	92143431	1635	818.0	
54360	chr10	92181757	92181814	57	28.0	
54361	chr10	92189558	92189964	406	203.0	
54362	chr10	92208315	92208824	509	254.0	
54363	chr10	92211149	92212460	1311	656.0	
54364	chr10	92238749	92241478	2729	1364.0	
54365	chr10	92243084	92243785	701	350.0	
54366	chr10	92268749	92269182	433	216.0	
54367	chr10	92284198	92284701	503	252.0	
54368	chr10	92290045	92292904	2859	1430.0	
54369	chr10	92434992	92435383	391	196.0	
54370	chr10	92486647	92487141	494	247.0	
54371	chr10	92516834	92517641	807	404.0	
54372	chr10	92544306	92544759	453	226.0	
54373	chr10	92572308	92576370	4062	2031.0	
54374	chr10	92590529	92594353	3824	1912.0	
54375	chr10	92602693	92603322	629	314.0	
54376	chr10	92644445	92644914	469	234.0	
54377	chr10	92688544	92692811	4267	2134.0	recombination_feature
54378	chr10	92697957	92698391	434	217.0	
54379	chr10	92699198	92700261	1063	532.0	
54380	chr10	92702208	92702792	584	292.0	
54381	chr10	92712194	92712946	752	376.0	
54382	chr10	92742128	92742927	799	400.0	
54383	chr10	92747563	92748121	558	279.0	
54384	chr10	92751000	92751279	279	140.0	
54385	chr10	92756108	92758103	1995	998.0	enhancer
54386	chr10	92760543	92761397	854	427.0	
54387	chr10	92789777	92790957	1180	590.0	
54388	chr10	92822012	92822342	330	165.0	
54389	chr10	92830667	92831532	865	432.0	
54390	chr10	92839080	92839509	429	214.0	
54391	chr10	92843007	92843576	569	284.0	
54392	chr10	92845830	92846683	853	426.0	
54393	chr10	92847279	92849612	2333	1166.0	
54394	chr10	92880228	92880672	444	222.0	
54395	chr10	92884918	92885273	355	178.0	
54396	chr10	92901634	92902441	807	404.0	
54397	chr10	92914456	92914887	431	216.0	
54398	chr10	93062122	93063043	921	460.0	
54399	chr10	93080231	93080684	453	226.0	
54400	chr10	93115519	93116407	888	444.0	
54401	chr10	93124586	93124972	386	193.0	
54402	chr10	93139156	93139732	576	288.0	
54403	chr10	93143137	93143676	539	270.0	
54404	chr10	93160821	93161383	562	281.0	
54405	chr10	93190310	93190820	510	255.0	
54406	chr10	93198788	93199605	817	408.0	
54407	chr10	93289035	93289462	427	214.0	
54408	chr10	93346557	93347183	626	313.0	
54409	chr10	93352620	93353074	454	227.0	
54410	chr10	93357688	93358056	368	184.0	
54411	chr10	93363840	93365148	1308	654.0	
54412	chr10	93376309	93377021	712	356.0	
54413	chr10	93379034	93380056	1022	511.0	
54414	chr10	93383626	93383868	242	121.0	
54415	chr10	93386585	93387684	1099	550.0	
54416	chr10	93390538	93391128	590	295.0	
54417	chr10	93412680	93413873	1193	596.0	
54418	chr10	93419005	93419430	425	212.0	
54419	chr10	93427143	93428210	1067	534.0	
54420	chr10	93433837	93434152	315	158.0	
54421	chr10	93436064	93437790	1726	863.0	
54422	chr10	93442230	93442703	473	236.0	
54423	chr10	93462902	93463454	552	276.0	
54424	chr10	93464071	93464887	816	408.0	
54425	chr10	93466416	93466570	154	77.0	
54426	chr10	93471071	93471691	620	310.0	
54427	chr10	93475976	93476658	682	341.0	
54428	chr10	93481774	93483445	1671	836.0	
54429	chr10	93495554	93497217	1663	832.0	
54430	chr10	93498053	93498400	347	174.0	
54431	chr10	93503032	93503464	432	216.0	
54432	chr10	93511259	93511736	477	238.0	
54433	chr10	93515394	93516495	1101	550.0	
54434	chr10	93541989	93542383	394	197.0	
54435	chr10	93554714	93555559	845	422.0	
54436	chr10	93556366	93556833	467	234.0	
54437	chr10	93565606	93565743	137	68.0	
54438	chr10	93566309	93567051	742	371.0	
54439	chr10	93572988	93573937	949	474.0	
54440	chr10	93591496	93591776	280	140.0	
54441	chr10	93615569	93616238	669	334.0	
54442	chr10	93680410	93680780	370	185.0	
54443	chr10	93701548	93703554	2006	1003.0	"sequence_feature	repeat_region"
54444	chr10	93715361	93715773	412	206.0	
54445	chr10	93719329	93719684	355	178.0	
54446	chr10	93742567	93743298	731	366.0	
54447	chr10	93745310	93745775	465	232.0	
54448	chr10	93747022	93747614	592	296.0	
54449	chr10	93751801	93752274	473	236.0	
54450	chr10	93813478	93813884	406	203.0	
54451	chr10	93816148	93816540	392	196.0	
54452	chr10	93893422	93894715	1293	646.0	
54453	chr10	93895892	93895895	3	2.0	
54454	chr10	94280040	94280472	432	216.0	
54455	chr10	94320285	94320682	397	198.0	
54456	chr10	94344891	94344953	62	31.0	
54457	chr10	94361187	94361606	419	210.0	
54458	chr10	94362133	94363554	1421	710.0	
54459	chr10	94402094	94404268	2174	1087.0	
54460	chr10	94444268	94444664	396	198.0	
54461	chr10	94544743	94546739	1996	998.0	
54462	chr10	95132946	95133358	412	206.0	
54463	chr10	95183268	95184390	1122	561.0	
54464	chr10	95230662	95231380	718	359.0	
54465	chr10	95236277	95236618	341	170.0	
54466	chr10	95246501	95246967	466	233.0	
54467	chr10	95266605	95267181	576	288.0	
54468	chr10	95290420	95291604	1184	592.0	
54469	chr10	95293120	95293452	332	166.0	
54470	chr10	95294932	95295839	907	454.0	
54471	chr10	95363262	95363708	446	223.0	
54472	chr10	95374583	95375023	440	220.0	
54473	chr10	95387261	95388141	880	440.0	
54474	chr10	95430311	95430794	483	242.0	
54475	chr10	95445892	95446271	379	190.0	
54476	chr10	95560247	95562608	2361	1180.0	
54477	chr10	95601122	95601523	401	200.0	
54478	chr10	95655690	95657429	1739	870.0	
54479	chr10	95693154	95694706	1552	776.0	
54480	chr10	95697233	95698108	875	438.0	
54481	chr10	95730363	95730463	100	50.0	
54482	chr10	95741797	95742344	547	274.0	
54483	chr10	95745538	95745820	282	141.0	
54484	chr10	95755235	95759029	3794	1897.0	
54485	chr10	95761944	95762332	388	194.0	
54486	chr10	95767736	95768510	774	387.0	
54487	chr10	95782143	95782846	703	352.0	
54488	chr10	95783746	95784973	1227	614.0	
54489	chr10	95792306	95794072	1766	883.0	
54490	chr10	95814137	95814683	546	273.0	
54491	chr10	95820368	95820779	411	206.0	
54492	chr10	95821717	95822229	512	256.0	
54493	chr10	95831567	95833007	1440	720.0	
54494	chr10	95834497	95834774	277	138.0	
54495	chr10	95837468	95838330	862	431.0	
54496	chr10	95841592	95842376	784	392.0	
54497	chr10	95864958	95865646	688	344.0	
54498	chr10	95896032	95896466	434	217.0	
54499	chr10	95906891	95908418	1527	764.0	
54500	chr10	95963716	95964117	401	200.0	
54501	chr10	95976403	95976416	13	6.0	
54502	chr10	96017170	96017661	491	246.0	
54503	chr10	96042904	96045208	2304	1152.0	
54504	chr10	96089423	96090854	1431	716.0	
54505	chr10	96124501	96124902	401	200.0	
54506	chr10	96129426	96131082	1656	828.0	
54507	chr10	96211811	96212178	367	184.0	
54508	chr10	96229461	96229985	524	262.0	
54509	chr10	96236133	96236556	423	212.0	
54510	chr10	96244328	96244873	545	272.0	
54511	chr10	96257923	96258324	401	200.0	
54512	chr10	96270585	96271984	1399	700.0	
54513	chr10	96273264	96274019	755	378.0	
54514	chr10	96287726	96288717	991	496.0	
54515	chr10	96293230	96293726	496	248.0	
54516	chr10	96299437	96299960	523	262.0	
54517	chr10	96306318	96306990	672	336.0	
54518	chr10	96333128	96333462	334	167.0	
54519	chr10	96340262	96340711	449	224.0	
54520	chr10	96370517	96370994	477	238.0	
54521	chr10	96374959	96375911	952	476.0	
54522	chr10	96380471	96381520	1049	524.0	
54523	chr10	96395869	96396375	506	253.0	
54524	chr10	96511214	96511603	389	194.0	
54525	chr10	96512605	96514637	2032	1016.0	
54526	chr10	96583451	96584438	987	494.0	
54527	chr10	96585280	96589350	4070	2035.0	
54528	chr10	96592212	96592274	62	31.0	
54529	chr10	96610724	96611135	411	206.0	
54530	chr10	96640766	96641509	743	372.0	
54531	chr10	96642869	96643456	587	294.0	
54532	chr10	96644985	96647364	2379	1190.0	
54533	chr10	96650964	96652944	1980	990.0	
54534	chr10	96655777	96657345	1568	784.0	
54535	chr10	96658297	96658392	95	48.0	
54536	chr10	96660513	96660665	152	76.0	
54537	chr10	96664575	96665010	435	218.0	
54538	chr10	96666774	96667154	380	190.0	
54539	chr10	96670640	96671952	1312	656.0	
54540	chr10	96673095	96674274	1179	590.0	
54541	chr10	96677539	96677618	79	40.0	
54542	chr10	96681527	96681847	320	160.0	
54543	chr10	96685393	96685650	257	128.0	
54544	chr10	96687561	96688002	441	220.0	
54545	chr10	96690721	96691164	443	222.0	
54546	chr10	96695277	96695790	513	256.0	
54547	chr10	96700209	96701239	1030	515.0	
54548	chr10	96703398	96703842	444	222.0	
54549	chr10	96708300	96709261	961	480.0	
54550	chr10	96716315	96721535	5220	2610.0	
54551	chr10	96726704	96727313	609	304.0	
54552	chr10	96737242	96737748	506	253.0	
54553	chr10	96740463	96741432	969	484.0	
54554	chr10	96744001	96744593	592	296.0	
54555	chr10	96747700	96748705	1005	502.0	
54556	chr10	96758381	96758886	505	252.0	
54557	chr10	96764318	96764667	349	174.0	
54558	chr10	96765434	96766258	824	412.0	
54559	chr10	96789394	96789980	586	293.0	
54560	chr10	96825649	96826640	991	496.0	
54561	chr10	96830148	96834106	3958	1979.0	
54562	chr10	96840875	96841405	530	265.0	
54563	chr10	96910507	96910918	411	206.0	
54564	chr10	96984368	96985216	848	424.0	
54565	chr10	97025608	97026039	431	216.0	
54566	chr10	97037255	97038261	1006	503.0	
54567	chr10	97069983	97070402	419	210.0	
54568	chr10	97072792	97073265	473	236.0	
54569	chr10	97081603	97082059	456	228.0	
54570	chr10	97095871	97097036	1165	582.0	
54571	chr10	97196050	97196992	942	471.0	
54572	chr10	97202251	97202518	267	134.0	
54573	chr10	97210451	97210921	470	235.0	
54574	chr10	97218038	97218192	154	77.0	
54575	chr10	97234609	97234714	105	52.0	
54576	chr10	97278453	97279726	1273	636.0	
54577	chr10	97291815	97293256	1441	720.0	
54578	chr10	97309024	97309262	238	119.0	
54579	chr10	97314534	97315036	502	251.0	
54580	chr10	97317629	97322606	4977	2488.0	
54581	chr10	97323480	97323694	214	107.0	
54582	chr10	97329568	97330462	894	447.0	
54583	chr10	97331388	97332287	899	450.0	
54584	chr10	97332898	97335789	2891	1446.0	
54585	chr10	97353810	97354716	906	453.0	
54586	chr10	97355415	97357196	1781	890.0	
54587	chr10	97357736	97358265	529	264.0	
54588	chr10	97358807	97359288	481	240.0	
54589	chr10	97360321	97361750	1429	714.0	
54590	chr10	97362252	97364138	1886	943.0	
54591	chr10	97365116	97367203	2087	1044.0	
54592	chr10	97369548	97375022	5474	2737.0	
54593	chr10	97376156	97377174	1018	509.0	
54594	chr10	97377968	97392068	14100	7050.0	
54595	chr10	97392910	97393734	824	412.0	
54596	chr10	97395624	97397250	1626	813.0	
54597	chr10	97399910	97401921	2011	1006.0	
54598	chr10	97405841	97409010	3169	1584.0	
54599	chr10	97411319	97411692	373	186.0	
54600	chr10	97413010	97415288	2278	1139.0	
54601	chr10	97418226	97419727	1501	750.0	
54602	chr10	97422884	97424109	1225	612.0	
54603	chr10	97425387	97429123	3736	1868.0	
54604	chr10	97445290	97446823	1533	766.0	
54605	chr10	97463520	97464229	709	354.0	
54606	chr10	97494879	97495477	598	299.0	
54607	chr10	97497547	97500502	2955	1478.0	
54608	chr10	97503506	97503801	295	148.0	
54609	chr10	97534794	97535068	274	137.0	
54610	chr10	97542112	97543620	1508	754.0	
54611	chr10	97553447	97553963	516	258.0	
54612	chr10	97572154	97572698	544	272.0	
54613	chr10	97590359	97590755	396	198.0	
54614	chr10	97632795	97634386	1591	796.0	
54615	chr10	97639875	97641854	1979	990.0	
54616	chr10	97647637	97647750	113	56.0	
54617	chr10	97648503	97649571	1068	534.0	
54618	chr10	97653249	97653528	279	140.0	
54619	chr10	97675423	97675770	347	174.0	
54620	chr10	97676618	97679017	2399	1200.0	
54621	chr10	97683523	97684360	837	418.0	
54622	chr10	97685451	97688595	3144	1572.0	
54623	chr10	97689405	97690181	776	388.0	
54624	chr10	97701323	97702057	734	367.0	
54625	chr10	97709445	97710092	647	324.0	
54626	chr10	97712119	97712606	487	244.0	
54627	chr10	97713215	97715232	2017	1008.0	
54628	chr10	97718018	97718728	710	355.0	
54629	chr10	97724274	97725041	767	384.0	
54630	chr10	97731525	97732223	698	349.0	
54631	chr10	97736255	97738167	1912	956.0	
54632	chr10	97759191	97759876	685	342.0	
54633	chr10	97764727	97765081	354	177.0	
54634	chr10	97771218	97772062	844	422.0	
54635	chr10	97781688	97782298	610	305.0	
54636	chr10	97791715	97792562	847	424.0	
54637	chr10	97796469	97797298	829	414.0	
54638	chr10	97848965	97850990	2025	1012.0	
54639	chr10	97851687	97852200	513	256.0	
54640	chr10	97858021	97858315	294	147.0	
54641	chr10	97869086	97870130	1044	522.0	
54642	chr10	97914687	97915205	518	259.0	
54643	chr10	98028170	98028604	434	217.0	
54644	chr10	98045735	98046192	457	228.0	
54645	chr10	98132921	98135820	2899	1450.0	
54646	chr10	98138058	98138380	322	161.0	
54647	chr10	98142406	98142757	351	176.0	
54648	chr10	98170462	98170912	450	225.0	
54649	chr10	98259733	98260414	681	340.0	
54650	chr10	98262488	98263026	538	269.0	
54651	chr10	98267886	98269065	1179	590.0	
54652	chr10	98276337	98276663	326	163.0	
54653	chr10	98295358	98295915	557	278.0	
54654	chr10	98309506	98309966	460	230.0	
54655	chr10	98314507	98315029	522	261.0	
54656	chr10	98316205	98317111	906	453.0	
54657	chr10	98322968	98323818	850	425.0	
54658	chr10	98331894	98332266	372	186.0	
54659	chr10	98339584	98340655	1071	536.0	
54660	chr10	98349403	98350074	671	336.0	
54661	chr10	98353270	98353507	237	118.0	
54662	chr10	98361325	98361654	329	164.0	
54663	chr10	98391027	98391898	871	436.0	
54664	chr10	98409078	98409215	137	68.0	
54665	chr10	98414676	98415827	1151	576.0	
54666	chr10	98425614	98426135	521	260.0	
54667	chr10	98444240	98444676	436	218.0	
54668	chr10	98445323	98447651	2328	1164.0	
54669	chr10	98467202	98468494	1292	646.0	
54670	chr10	98664411	98664851	440	220.0	
54671	chr10	98886593	98887118	525	262.0	
54672	chr10	99233946	99234468	522	261.0	
54673	chr10	99392425	99392920	495	248.0	
54674	chr10	99403658	99404106	448	224.0	
54675	chr10	99429928	99431843	1915	958.0	
54676	chr10	99435952	99436432	480	240.0	
54677	chr10	99530649	99531121	472	236.0	
54678	chr10	99532596	99533367	771	386.0	
54679	chr10	99535128	99535754	626	313.0	
54680	chr10	99536899	99537722	823	412.0	
54681	chr10	99540715	99540994	279	140.0	
54682	chr10	99560501	99560918	417	208.0	
54683	chr10	99570017	99570249	232	116.0	
54684	chr10	99600473	99600674	201	100.0	
54685	chr10	99612011	99612892	881	440.0	
54686	chr10	99618742	99622207	3465	1732.0	
54687	chr10	99630479	99630795	316	158.0	
54688	chr10	99656243	99656279	36	18.0	
54689	chr10	99658466	99660226	1760	880.0	
54690	chr10	99674681	99675117	436	218.0	
54691	chr10	99685127	99686115	988	494.0	
54692	chr10	99711111	99711562	451	226.0	
54693	chr10	99731286	99733151	1865	932.0	
54694	chr10	99779328	99779633	305	152.0	
54695	chr10	99815733	99815957	224	112.0	
54696	chr10	99828471	99828801	330	165.0	
54697	chr10	99845580	99846520	940	470.0	
54698	chr10	99869970	99870811	841	420.0	
54699	chr10	99927695	99928096	401	200.0	
54700	chr10	99975482	99975782	300	150.0	
54701	chr10	99981778	99982315	537	268.0	
54702	chr10	99983250	99983833	583	292.0	
54703	chr10	99993642	99994988	1346	673.0	
54704	chr10	100006195	100006918	723	362.0	
54705	chr10	100009056	100010809	1753	876.0	
54706	chr10	100014145	100014744	599	300.0	
54707	chr10	100020380	100020828	448	224.0	
54708	chr10	100045983	100046458	475	238.0	
54709	chr10	100167503	100168319	816	408.0	
54710	chr10	100182250	100183952	1702	851.0	
54711	chr10	100184814	100187377	2563	1282.0	
54712	chr10	100192319	100192777	458	229.0	
54713	chr10	100228632	100230187	1555	778.0	
54714	chr10	100240737	100241243	506	253.0	
54715	chr10	100256857	100257607	750	375.0	
54716	chr10	100265598	100265604	6	3.0	
54717	chr10	100266787	100268265	1478	739.0	
54718	chr10	100282953	100283296	343	172.0	
54719	chr10	100285549	100287507	1958	979.0	
54720	chr10	100291204	100292675	1471	736.0	
54721	chr10	100326622	100327609	987	494.0	
54722	chr10	100338350	100339739	1389	694.0	
54723	chr10	100342265	100342808	543	272.0	
54724	chr10	100346095	100348580	2485	1242.0	
54725	chr10	100365005	100365033	28	14.0	
54726	chr10	100370256	100371873	1617	808.0	
54727	chr10	100372819	100374546	1727	864.0	
54728	chr10	100377855	100378240	385	192.0	
54729	chr10	100419985	100420291	306	153.0	
54730	chr10	100433484	100434358	874	437.0	
54731	chr10	100481215	100483822	2607	1304.0	
54732	chr10	100508436	100509783	1347	674.0	
54733	chr10	100510506	100511635	1129	564.0	
54734	chr10	100518629	100519352	723	362.0	
54735	chr10	100528379	100530488	2109	1054.0	
54736	chr10	100535196	100536565	1369	684.0	
54737	chr10	100551249	100551650	401	200.0	
54738	chr10	100561809	100563383	1574	787.0	
54739	chr10	100653844	100655388	1544	772.0	
54740	chr10	100656482	100656976	494	247.0	
54741	chr10	100670944	100671412	468	234.0	
54742	chr10	100680835	100681099	264	132.0	
54743	chr10	100715455	100715810	355	178.0	
54744	chr10	100729059	100729843	784	392.0	
54745	chr10	100730823	100731590	767	384.0	
54746	chr10	100735399	100735548	149	74.0	
54747	chr10	100743519	100744139	620	310.0	
54748	chr10	100825923	100829533	3610	1805.0	
54749	chr10	100878461	100878812	351	176.0	
54750	chr10	100894925	100894944	19	10.0	
54751	chr10	100912099	100913900	1801	900.0	
54752	chr10	100968914	100970668	1754	877.0	
54753	chr10	100986734	100988087	1353	676.0	
54754	chr10	100996260	101000640	4380	2190.0	
54755	chr10	101012562	101015536	2974	1487.0	
54756	chr10	101018028	101019769	1741	870.0	
54757	chr10	101028555	101029213	658	329.0	
54758	chr10	101029777	101029789	12	6.0	
54759	chr10	101030303	101033380	3077	1538.0	
54760	chr10	101040788	101043733	2945	1472.0	
54761	chr10	101049805	101050861	1056	528.0	
54762	chr10	101059717	101063971	4254	2127.0	
54763	chr10	101065991	101068274	2283	1142.0	
54764	chr10	101070910	101072134	1224	612.0	
54765	chr10	101095370	101096026	656	328.0	
54766	chr10	101114578	101115062	484	242.0	
54767	chr10	101120865	101122000	1135	568.0	
54768	chr10	101123356	101123967	611	306.0	
54769	chr10	101131039	101132441	1402	701.0	
54770	chr10	101134683	101135513	830	415.0	
54771	chr10	101139316	101140992	1676	838.0	
54772	chr10	101141956	101142863	907	454.0	
54773	chr10	101161644	101162186	542	271.0	
54774	chr10	101213518	101215515	1997	998.0	
54775	chr10	101216169	101216671	502	251.0	
54776	chr10	101217455	101218014	559	280.0	
54777	chr10	101222590	101223777	1187	594.0	
54778	chr10	101225312	101229232	3920	1960.0	
54779	chr10	101230187	101230536	349	174.0	
54780	chr10	101236488	101237779	1291	646.0	
54781	chr10	101238710	101239119	409	204.0	
54782	chr10	101272177	101272650	473	236.0	
54783	chr10	101291575	101292795	1220	610.0	
54784	chr10	101297818	101298324	506	253.0	
54785	chr10	101353280	101355104	1824	912.0	
54786	chr10	101364626	101365162	536	268.0	
54787	chr10	101397087	101397557	470	235.0	
54788	chr10	101442175	101442581	406	203.0	
54789	chr10	101454002	101454083	81	40.0	
54790	chr10	101467254	101467727	473	236.0	
54791	chr10	101536830	101537152	322	161.0	
54792	chr10	101558182	101558567	385	192.0	
54793	chr10	101566362	101567195	833	416.0	
54794	chr10	101569374	101571113	1739	870.0	
54795	chr10	101587528	101588872	1344	672.0	
54796	chr10	101593177	101593836	659	330.0	
54797	chr10	101602682	101603225	543	272.0	
54798	chr10	101617801	101618679	878	439.0	
54799	chr10	101693533	101695785	2252	1126.0	
54800	chr10	101774531	101776235	1704	852.0	promoter
54801	chr10	101778784	101784505	5721	2860.0	"promoter	enhancer	protein_binding_site"
54802	chr10	101814671	101819597	4926	2463.0	
54803	chr10	101829095	101831951	2856	1428.0	
54804	chr10	101834194	101834998	804	402.0	
54805	chr10	101835746	101836542	796	398.0	
54806	chr10	101839291	101844633	5342	2671.0	
54807	chr10	101848211	101849334	1123	562.0	
54808	chr10	101858812	101859184	372	186.0	
54809	chr10	101889586	101890058	472	236.0	
54810	chr10	101901335	101901739	404	202.0	
54811	chr10	101903823	101904303	480	240.0	
54812	chr10	101909423	101909444	21	10.0	
54813	chr10	101920460	101920902	442	221.0	
54814	chr10	101968942	101969475	533	266.0	
54815	chr10	101973331	101974524	1193	596.0	
54816	chr10	101985929	101986950	1021	510.0	
54817	chr10	102001294	102002884	1590	795.0	
54818	chr10	102007167	102007347	180	90.0	
54819	chr10	102009745	102010266	521	260.0	
54820	chr10	102024745	102025281	536	268.0	
54821	chr10	102043862	102044141	279	140.0	
54822	chr10	102055183	102056907	1724	862.0	
54823	chr10	102064513	102066483	1970	985.0	
54824	chr10	102068809	102069556	747	374.0	
54825	chr10	102072772	102073474	702	351.0	
54826	chr10	102112287	102112610	323	162.0	
54827	chr10	102113175	102122252	9077	4538.0	
54828	chr10	102132153	102134330	2177	1088.0	
54829	chr10	102151374	102153650	2276	1138.0	
54830	chr10	102169136	102170103	967	484.0	
54831	chr10	102188774	102189880	1106	553.0	
54832	chr10	102213640	102214010	370	185.0	
54833	chr10	102225715	102227612	1897	948.0	
54834	chr10	102229486	102232280	2794	1397.0	
54835	chr10	102240745	102242413	1668	834.0	
54836	chr10	102244621	102246552	1931	966.0	
54837	chr10	102322853	102323361	508	254.0	
54838	chr10	102351885	102352540	655	328.0	
54839	chr10	102384054	102385496	1442	721.0	
54840	chr10	102390814	102390821	7	4.0	
54841	chr10	102392634	102411597	18963	9482.0	
54842	chr10	102412998	102413481	483	242.0	
54843	chr10	102414609	102415046	437	218.0	
54844	chr10	102417270	102417558	288	144.0	
54845	chr10	102418990	102423306	4316	2158.0	
54846	chr10	102431874	102436338	4464	2232.0	
54847	chr10	102444959	102445144	185	92.0	
54848	chr10	102449190	102451887	2697	1348.0	
54849	chr10	102452496	102455054	2558	1279.0	
54850	chr10	102455835	102456333	498	249.0	
54851	chr10	102460697	102462175	1478	739.0	
54852	chr10	102467884	102468646	762	381.0	
54853	chr10	102469172	102469862	690	345.0	
54854	chr10	102473438	102473829	391	196.0	
54855	chr10	102478655	102479763	1108	554.0	
54856	chr10	102501292	102505532	4240	2120.0	
54857	chr10	102509348	102509887	539	270.0	
54858	chr10	102511839	102512296	457	228.0	
54859	chr10	102534195	102534790	595	298.0	
54860	chr10	102583574	102584442	868	434.0	
54861	chr10	102596429	102596849	420	210.0	
54862	chr10	102612029	102613522	1493	746.0	
54863	chr10	102615240	102615683	443	222.0	
54864	chr10	102632601	102633910	1309	654.0	
54865	chr10	102635234	102636053	819	410.0	
54866	chr10	102641674	102653051	11377	5688.0	
54867	chr10	102658116	102658397	281	140.0	
54868	chr10	102660351	102662105	1754	877.0	
54869	chr10	102669565	102670225	660	330.0	
54870	chr10	102673683	102675365	1682	841.0	
54871	chr10	102676004	102676705	701	350.0	
54872	chr10	102678680	102679441	761	380.0	
54873	chr10	102710679	102712056	1377	688.0	
54874	chr10	102713243	102715532	2289	1144.0	
54875	chr10	102728970	102729805	835	418.0	
54876	chr10	102738701	102739336	635	318.0	
54877	chr10	102743224	102745009	1785	892.0	
54878	chr10	102753071	102753540	469	234.0	
54879	chr10	102773373	102774500	1127	564.0	
54880	chr10	102775678	102777263	1585	792.0	
54881	chr10	102783409	102784047	638	319.0	
54882	chr10	102785555	102786369	814	407.0	
54883	chr10	102795727	102797056	1329	664.0	
54884	chr10	102801989	102802365	376	188.0	
54885	chr10	102803076	102803610	534	267.0	
54886	chr10	102812345	102812869	524	262.0	
54887	chr10	102815436	102816830	1394	697.0	
54888	chr10	102818674	102819585	911	456.0	
54889	chr10	102834827	102835402	575	288.0	
54890	chr10	102853831	102854880	1049	524.0	
54891	chr10	102916816	102919511	2695	1348.0	
54892	chr10	102927531	102928016	485	242.0	
54893	chr10	102994730	102994756	26	13.0	
54894	chr10	103053770	103054922	1152	576.0	
54895	chr10	103069356	103070869	1513	756.0	
54896	chr10	103181183	103181710	527	264.0	
54897	chr10	103192015	103194556	2541	1270.0	
54898	chr10	103197061	103198109	1048	524.0	
54899	chr10	103199445	103199930	485	242.0	
54900	chr10	103202190	103202810	620	310.0	
54901	chr10	103224717	103225140	423	212.0	
54902	chr10	103225798	103226334	536	268.0	
54903	chr10	103241265	103242288	1023	512.0	
54904	chr10	103244604	103245129	525	262.0	
54905	chr10	103284073	103284681	608	304.0	
54906	chr10	103350326	103351644	1318	659.0	
54907	chr10	103367367	103369229	1862	931.0	
54908	chr10	103395728	103397363	1635	818.0	
54909	chr10	103416630	103417271	641	320.0	
54910	chr10	103433750	103434249	499	250.0	
54911	chr10	103450776	103452915	2139	1070.0	
54912	chr10	103458747	103459404	657	328.0	
54913	chr10	103465367	103465777	410	205.0	
54914	chr10	103470615	103472447	1832	916.0	
54915	chr10	103476346	103476726	380	190.0	
54916	chr10	103481857	103482360	503	252.0	
54917	chr10	103485571	103486179	608	304.0	
54918	chr10	103490586	103491135	549	274.0	
54919	chr10	103493325	103494682	1357	678.0	
54920	chr10	103504207	103504763	556	278.0	
54921	chr10	103515459	103515879	420	210.0	
54922	chr10	103542684	103543562	878	439.0	
54923	chr10	103551291	103552506	1215	608.0	
54924	chr10	103554676	103555616	940	470.0	
54925	chr10	103558639	103559246	607	304.0	
54926	chr10	103564790	103565212	422	211.0	
54927	chr10	103583870	103585483	1613	806.0	
54928	chr10	103592688	103593170	482	241.0	
54929	chr10	103598896	103598905	9	4.0	
54930	chr10	103605665	103606113	448	224.0	
54931	chr10	103632285	103632396	111	56.0	
54932	chr10	103644959	103645804	845	422.0	
54933	chr10	103659568	103662349	2781	1390.0	
54934	chr10	103668369	103669217	848	424.0	
54935	chr10	103677703	103678878	1175	588.0	
54936	chr10	103679419	103679751	332	166.0	
54937	chr10	103683793	103683946	153	76.0	
54938	chr10	103685924	103686799	875	438.0	
54939	chr10	103691469	103694099	2630	1315.0	
54940	chr10	103696194	103697123	929	464.0	
54941	chr10	103712663	103713497	834	417.0	
54942	chr10	103736779	103737040	261	130.0	
54943	chr10	103757669	103758300	631	316.0	
54944	chr10	103759081	103759182	101	50.0	
54945	chr10	103763667	103764317	650	325.0	
54946	chr10	103765709	103766455	746	373.0	
54947	chr10	103771779	103773016	1237	618.0	
54948	chr10	103800557	103801252	695	348.0	
54949	chr10	103845939	103846468	529	264.0	
54950	chr10	103850160	103850194	34	17.0	
54951	chr10	103854392	103855974	1582	791.0	
54952	chr10	103859121	103859640	519	260.0	
54953	chr10	103884629	103885098	469	234.0	
54954	chr10	103888051	103888956	905	452.0	
54955	chr10	103890348	103890494	146	73.0	
54956	chr10	103901213	103901624	411	206.0	
54957	chr10	103907859	103909054	1195	598.0	
54958	chr10	103910614	103911937	1323	662.0	
54959	chr10	103915545	103916365	820	410.0	
54960	chr10	103917242	103919106	1864	932.0	
54961	chr10	103921685	103922149	464	232.0	
54962	chr10	103965959	103968889	2930	1465.0	
54963	chr10	103969450	103970475	1025	512.0	
54964	chr10	103983219	103984032	813	406.0	
54965	chr10	104002996	104003154	158	79.0	
54966	chr10	104113617	104113885	268	134.0	
54967	chr10	104120467	104122779	2312	1156.0	
54968	chr10	104144925	104145296	371	186.0	
54969	chr10	104170812	104171310	498	249.0	
54970	chr10	104209591	104209974	383	192.0	
54971	chr10	104230591	104230772	181	90.0	
54972	chr10	104231707	104233074	1367	684.0	
54973	chr10	104246552	104247970	1418	709.0	
54974	chr10	104248905	104248966	61	30.0	
54975	chr10	104253992	104256938	2946	1473.0	
54976	chr10	104260574	104261072	498	249.0	
54977	chr10	104267047	104269827	2780	1390.0	
54978	chr10	104274572	104275264	692	346.0	
54979	chr10	104290961	104292092	1131	566.0	
54980	chr10	104297717	104298156	439	220.0	
54981	chr10	104300321	104301439	1118	559.0	
54982	chr10	104303109	104304387	1278	639.0	
54983	chr10	104305365	104309271	3906	1953.0	
54984	chr10	104309863	104311751	1888	944.0	
54985	chr10	104312551	104316703	4152	2076.0	
54986	chr10	104318897	104319942	1045	522.0	
54987	chr10	104320975	104331881	10906	5453.0	
54988	chr10	104332771	104340082	7311	3656.0	
54989	chr10	104345900	104346358	458	229.0	
54990	chr10	104347935	104348007	72	36.0	
54991	chr10	104349273	104354387	5114	2557.0	
54992	chr10	104387277	104387615	338	169.0	
54993	chr10	104417609	104418092	483	242.0	
54994	chr10	104580752	104581216	464	232.0	
54995	chr10	104587248	104587588	340	170.0	
54996	chr10	104601071	104601472	401	200.0	
54997	chr10	104614276	104614595	319	160.0	
54998	chr10	104935705	104935952	247	124.0	
54999	chr10	105807928	105808428	500	250.0	
55000	chr10	105837881	105838466	585	292.0	
55001	chr10	106625035	106625167	132	66.0	
55002	chr10	106836984	106837334	350	175.0	
55003	chr10	106935893	106936555	662	331.0	
55004	chr10	106942222	106942663	441	220.0	
55005	chr10	106957797	106958292	495	248.0	
55006	chr10	106959008	106959085	77	38.0	
55007	chr10	106960084	106960576	492	246.0	
55008	chr10	106992014	106992714	700	350.0	
55009	chr10	106997653	106998191	538	269.0	
55010	chr10	107616624	107617432	808	404.0	
55011	chr10	107653886	107654399	513	256.0	
55012	chr10	107686048	107686571	523	262.0	
55013	chr10	107687696	107688095	399	200.0	
55014	chr10	107689235	107689798	563	282.0	
55015	chr10	107728816	107729205	389	194.0	
55016	chr10	109852367	109852863	496	248.0	
55017	chr10	109884088	109884784	696	348.0	
55018	chr10	109892210	109892571	361	180.0	
55019	chr10	109910097	109911135	1038	519.0	
55020	chr10	109912347	109912793	446	223.0	
55021	chr10	109914749	109915496	747	374.0	
55022	chr10	109919937	109924269	4332	2166.0	
55023	chr10	109929506	109929925	419	210.0	
55024	chr10	109933614	109935680	2066	1033.0	
55025	chr10	109945708	109946209	501	250.0	
55026	chr10	109956635	109957124	489	244.0	
55027	chr10	109978335	109978800	465	232.0	
55028	chr10	109996371	109996749	378	189.0	
55029	chr10	110004493	110004628	135	68.0	
55030	chr10	110006776	110011083	4307	2154.0	
55031	chr10	110013596	110014043	447	224.0	
55032	chr10	110016050	110016225	175	88.0	
55033	chr10	110017273	110017363	90	45.0	
55034	chr10	110023043	110023463	420	210.0	
55035	chr10	110058281	110058724	443	222.0	
55036	chr10	110060137	110060152	15	8.0	
55037	chr10	110067862	110068923	1061	530.0	
55038	chr10	110069435	110070143	708	354.0	
55039	chr10	110070645	110070920	275	138.0	
55040	chr10	110072350	110073012	662	331.0	
55041	chr10	110074239	110074738	499	250.0	
55042	chr10	110076383	110078335	1952	976.0	
55043	chr10	110081676	110082485	809	404.0	
55044	chr10	110085482	110087113	1631	816.0	
55045	chr10	110119165	110119189	24	12.0	
55046	chr10	110136954	110138829	1875	938.0	
55047	chr10	110141079	110142446	1367	684.0	
55048	chr10	110151464	110151837	373	186.0	
55049	chr10	110153519	110153890	371	186.0	
55050	chr10	110156276	110157807	1531	766.0	
55051	chr10	110162544	110163238	694	347.0	
55052	chr10	110168571	110169028	457	228.0	
55053	chr10	110170148	110171138	990	495.0	
55054	chr10	110176244	110176386	142	71.0	
55055	chr10	110192615	110192818	203	102.0	
55056	chr10	110200490	110200991	501	250.0	
55057	chr10	110206146	110212815	6669	3334.0	
55058	chr10	110214299	110214824	525	262.0	
55059	chr10	110215822	110216288	466	233.0	
55060	chr10	110218661	110219151	490	245.0	
55061	chr10	110221472	110222551	1079	540.0	
55062	chr10	110225230	110227948	2718	1359.0	
55063	chr10	110241457	110241816	359	180.0	
55064	chr10	110254448	110254927	479	240.0	
55065	chr10	110269281	110270062	781	390.0	
55066	chr10	110273182	110273947	765	382.0	
55067	chr10	110275142	110275524	382	191.0	
55068	chr10	110279205	110279818	613	306.0	
55069	chr10	110304091	110306631	2540	1270.0	
55070	chr10	110311281	110311815	534	267.0	
55071	chr10	110340879	110340993	114	57.0	
55072	chr10	110348385	110348671	286	143.0	
55073	chr10	110353286	110357897	4611	2306.0	
55074	chr10	110364183	110364188	5	2.0	
55075	chr10	110387963	110388681	718	359.0	
55076	chr10	110392906	110392982	76	38.0	
55077	chr10	110395785	110396172	387	194.0	
55078	chr10	110410005	110410756	751	376.0	
55079	chr10	110412932	110416268	3336	1668.0	
55080	chr10	110420352	110421853	1501	750.0	
55081	chr10	110423629	110424301	672	336.0	
55082	chr10	110425817	110427351	1534	767.0	
55083	chr10	110441504	110442284	780	390.0	
55084	chr10	110447120	110447515	395	198.0	
55085	chr10	110457964	110458911	947	474.0	
55086	chr10	110459800	110461277	1477	738.0	
55087	chr10	110492232	110492932	700	350.0	
55088	chr10	110495909	110505091	9182	4591.0	
55089	chr10	110508122	110511088	2966	1483.0	
55090	chr10	110511784	110515882	4098	2049.0	
55091	chr10	110516760	110518228	1468	734.0	
55092	chr10	110521877	110522850	973	486.0	
55093	chr10	110524494	110524810	316	158.0	
55094	chr10	110525426	110526211	785	392.0	
55095	chr10	110528984	110530695	1711	856.0	
55096	chr10	110535785	110536747	962	481.0	
55097	chr10	110546926	110547615	689	344.0	
55098	chr10	110556902	110557549	647	324.0	
55099	chr10	110566753	110568757	2004	1002.0	
55100	chr10	110600444	110600903	459	230.0	
55101	chr10	110610216	110610749	533	266.0	
55102	chr10	110617856	110617994	138	69.0	
55103	chr10	110641157	110641597	440	220.0	
55104	chr10	110643480	110644514	1034	517.0	
55105	chr10	110671777	110672942	1165	582.0	
55106	chr10	110681244	110681360	116	58.0	
55107	chr10	110717811	110718351	540	270.0	
55108	chr10	110724455	110724664	209	104.0	
55109	chr10	110739955	110739975	20	10.0	
55110	chr10	110744873	110745176	303	152.0	
55111	chr10	110746184	110746928	744	372.0	
55112	chr10	110750844	110751396	552	276.0	
55113	chr10	110774108	110774566	458	229.0	
55114	chr10	110783226	110784142	916	458.0	
55115	chr10	110802526	110804461	1935	968.0	
55116	chr10	110834738	110835327	589	294.0	
55117	chr10	110841793	110843797	2004	1002.0	
55118	chr10	110849720	110851428	1708	854.0	
55119	chr10	110852472	110853188	716	358.0	
55120	chr10	110857316	110861454	4138	2069.0	
55121	chr10	110862180	110862886	706	353.0	
55122	chr10	110864113	110866490	2377	1188.0	
55123	chr10	110867234	110869767	2533	1266.0	
55124	chr10	110870632	110874346	3714	1857.0	
55125	chr10	110876003	110876405	402	201.0	
55126	chr10	110877176	110877330	154	77.0	
55127	chr10	110878795	110880553	1758	879.0	
55128	chr10	110883796	110884435	639	320.0	
55129	chr10	110886391	110886642	251	126.0	
55130	chr10	110892889	110894167	1278	639.0	
55131	chr10	110897142	110897271	129	64.0	
55132	chr10	110902471	110904032	1561	780.0	
55133	chr10	110917881	110921292	3411	1706.0	
55134	chr10	110925596	110925679	83	42.0	
55135	chr10	110931974	110932277	303	152.0	
55136	chr10	110993036	110993510	474	237.0	
55137	chr10	111017201	111017463	262	131.0	
55138	chr10	111030305	111030744	439	220.0	
55139	chr10	111076034	111077124	1090	545.0	
55140	chr10	111128694	111129209	515	258.0	
55141	chr10	111598483	111598772	289	144.0	
55142	chr10	112115828	112116120	292	146.0	
55143	chr10	112137337	112137817	480	240.0	
55144	chr10	112139998	112140599	601	300.0	
55145	chr10	112182964	112184731	1767	884.0	
55146	chr10	112185693	112185799	106	53.0	
55147	chr10	112307902	112308224	322	161.0	
55148	chr10	112314811	112315274	463	232.0	
55149	chr10	112335472	112335537	65	32.0	
55150	chr10	112369218	112370071	853	426.0	
55151	chr10	112374551	112376954	2403	1202.0	
55152	chr10	112377654	112378021	367	184.0	
55153	chr10	112388989	112390121	1132	566.0	
55154	chr10	112445967	112448037	2070	1035.0	
55155	chr10	112448899	112449239	340	170.0	
55156	chr10	112471837	112472335	498	249.0	
55157	chr10	112530944	112531309	365	182.0	
55158	chr10	112532235	112532642	407	204.0	
55159	chr10	112605104	112605399	295	148.0	
55160	chr10	112663311	112663664	353	176.0	
55161	chr10	112721082	112721440	358	179.0	
55162	chr10	112815499	112816069	570	285.0	
55163	chr10	112835934	112836722	788	394.0	
55164	chr10	112843849	112843897	48	24.0	
55165	chr10	112851359	112852927	1568	784.0	
55166	chr10	112875749	112876297	548	274.0	
55167	chr10	112881024	112881150	126	63.0	
55168	chr10	112945715	112946116	401	200.0	
55169	chr10	112949056	112952844	3788	1894.0	
55170	chr10	112955965	112956216	251	126.0	
55171	chr10	112981453	112981946	493	246.0	
55172	chr10	112985868	112986650	782	391.0	
55173	chr10	113005346	113005761	415	208.0	
55174	chr10	113006593	113008253	1660	830.0	
55175	chr10	113033998	113034453	455	228.0	
55176	chr10	113050828	113051293	465	232.0	
55177	chr10	113087212	113087846	634	317.0	
55178	chr10	113093577	113094867	1290	645.0	
55179	chr10	113097020	113097431	411	206.0	
55180	chr10	113099496	113100094	598	299.0	
55181	chr10	113108435	113108863	428	214.0	
55182	chr10	113126507	113127067	560	280.0	
55183	chr10	113138231	113138713	482	241.0	
55184	chr10	113151013	113152062	1049	524.0	
55185	chr10	113153455	113154205	750	375.0	
55186	chr10	113163709	113163898	189	94.0	
55187	chr10	113169790	113170627	837	418.0	
55188	chr10	113179006	113179801	795	398.0	
55189	chr10	113180440	113181107	667	334.0	
55190	chr10	113221708	113222055	347	174.0	
55191	chr10	113233058	113233530	472	236.0	
55192	chr10	113235410	113235969	559	280.0	
55193	chr10	113267693	113268507	814	407.0	
55194	chr10	113273047	113274041	994	497.0	
55195	chr10	113300380	113301241	861	430.0	
55196	chr10	113303734	113304148	414	207.0	
55197	chr10	113310323	113310758	435	218.0	
55198	chr10	113313174	113313554	380	190.0	
55199	chr10	113320183	113321637	1454	727.0	
55200	chr10	113322709	113323324	615	308.0	
55201	chr10	113326091	113326802	711	356.0	
55202	chr10	113359690	113360021	331	166.0	
55203	chr10	113381492	113382557	1065	532.0	
55204	chr10	113385054	113385757	703	352.0	
55205	chr10	113427242	113427582	340	170.0	
55206	chr10	113442352	113442675	323	162.0	
55207	chr10	113499102	113499283	181	90.0	
55208	chr10	113503869	113504307	438	219.0	
55209	chr10	113521210	113521560	350	175.0	
55210	chr10	113563370	113563887	517	258.0	
55211	chr10	113678631	113682734	4103	2052.0	
55212	chr10	113683391	113683472	81	40.0	
55213	chr10	113689055	113689190	135	68.0	
55214	chr10	113799535	113800015	480	240.0	
55215	chr10	113803287	113803331	44	22.0	
55216	chr10	113844107	113844633	526	263.0	
55217	chr10	113851501	113851974	473	236.0	
55218	chr10	113853598	113856094	2496	1248.0	
55219	chr10	113865908	113866255	347	174.0	
55220	chr10	113953567	113954097	530	265.0	
55221	chr10	113960251	113962280	2029	1014.0	
55222	chr10	113965093	113966197	1104	552.0	
55223	chr10	113987658	113988290	632	316.0	
55224	chr10	113993695	113994106	411	206.0	
55225	chr10	113997579	113997669	90	45.0	
55226	chr10	113999583	113999917	334	167.0	
55227	chr10	114021093	114021559	466	233.0	
55228	chr10	114024656	114025829	1173	586.0	
55229	chr10	114026382	114026807	425	212.0	
55230	chr10	114031056	114031490	434	217.0	
55231	chr10	114042823	114045753	2930	1465.0	
55232	chr10	114057838	114058244	406	203.0	
55233	chr10	114060382	114060872	490	245.0	
55234	chr10	114061736	114062211	475	238.0	
55235	chr10	114068230	114068289	59	30.0	
55236	chr10	114071235	114071308	73	36.0	
55237	chr10	114074012	114074140	128	64.0	
55238	chr10	114082916	114083488	572	286.0	
55239	chr10	114084287	114084559	272	136.0	
55240	chr10	114095889	114096545	656	328.0	
55241	chr10	114099194	114099587	393	196.0	
55242	chr10	114100725	114101691	966	483.0	
55243	chr10	114103286	114103717	431	216.0	
55244	chr10	114108443	114109066	623	312.0	
55245	chr10	114131071	114131530	459	230.0	
55246	chr10	114172260	114175298	3038	1519.0	
55247	chr10	114239408	114239435	27	14.0	
55248	chr10	114303701	114305473	1772	886.0	
55249	chr10	114458934	114459358	424	212.0	
55250	chr10	114471096	114471813	717	358.0	
55251	chr10	114492599	114493096	497	248.0	
55252	chr10	114495319	114495727	408	204.0	
55253	chr10	114496686	114497353	667	334.0	
55254	chr10	114498598	114500274	1676	838.0	
55255	chr10	114513272	114514372	1100	550.0	
55256	chr10	114520339	114520766	427	214.0	
55257	chr10	114524001	114524104	103	52.0	
55258	chr10	114525079	114527799	2720	1360.0	
55259	chr10	114538301	114538981	680	340.0	
55260	chr10	114540445	114542155	1710	855.0	
55261	chr10	114543536	114545182	1646	823.0	
55262	chr10	114547458	114547758	300	150.0	
55263	chr10	114550649	114551115	466	233.0	
55264	chr10	114631892	114632325	433	216.0	
55265	chr10	114694779	114695060	281	140.0	
55266	chr10	114708952	114709259	307	154.0	
55267	chr10	114767588	114768555	967	484.0	
55268	chr10	114786413	114786869	456	228.0	
55269	chr10	114801247	114801968	721	360.0	
55270	chr10	114811001	114811254	253	126.0	
55271	chr10	114812021	114812032	11	6.0	
55272	chr10	114815899	114816011	112	56.0	
55273	chr10	114821186	114823223	2037	1018.0	
55274	chr10	114856878	114857383	505	252.0	
55275	chr10	114874705	114875608	903	452.0	
55276	chr10	114877094	114877269	175	88.0	
55277	chr10	114879589	114879995	406	203.0	
55278	chr10	114937563	114938924	1361	680.0	
55279	chr10	115092807	115093586	779	390.0	
55280	chr10	115167708	115168243	535	268.0	
55281	chr10	116444536	116444918	382	191.0	
55282	chr10	116450809	116451277	468	234.0	
55283	chr10	116465299	116465992	693	346.0	
55284	chr10	116490666	116491098	432	216.0	
55285	chr10	116682292	116682729	437	218.0	
55286	chr10	116723666	116724417	751	376.0	
55287	chr10	116741833	116743402	1569	784.0	
55288	chr10	116787778	116788480	702	351.0	
55289	chr10	116796853	116797380	527	264.0	
55290	chr10	116847968	116848586	618	309.0	
55291	chr10	116849273	116850024	751	376.0	
55292	chr10	116947037	116948825	1788	894.0	
55293	chr10	117004224	117005517	1293	646.0	
55294	chr10	117071324	117071645	321	160.0	
55295	chr10	117134972	117135005	33	16.0	
55296	chr10	117163082	117163146	64	32.0	
55297	chr10	117165750	117166161	411	206.0	
55298	chr10	117167304	117168946	1642	821.0	
55299	chr10	117174542	117176380	1838	919.0	
55300	chr10	117216378	117217763	1385	692.0	
55301	chr10	117226693	117227257	564	282.0	
55302	chr10	117237234	117237870	636	318.0	
55303	chr10	117241763	117241893	130	65.0	
55304	chr10	117259251	117259621	370	185.0	
55305	chr10	117320152	117320181	29	14.0	
55306	chr10	117342118	117342749	631	316.0	
55307	chr10	117350849	117351379	530	265.0	
55308	chr10	117353741	117354060	319	160.0	
55309	chr10	117364192	117364975	783	392.0	
55310	chr10	117373303	117376777	3474	1737.0	
55311	chr10	117397995	117398478	483	242.0	
55312	chr10	117431221	117431523	302	151.0	
55313	chr10	117439356	117439717	361	180.0	
55314	chr10	117441752	117443464	1712	856.0	
55315	chr10	117454353	117454920	567	284.0	
55316	chr10	117456335	117456863	528	264.0	
55317	chr10	117496482	117496948	466	233.0	
55318	chr10	117830691	117831292	601	300.0	enhancer
55319	chr10	118035042	118036168	1126	563.0	
55320	chr10	118045826	118047616	1790	895.0	
55321	chr10	118241303	118241380	77	38.0	
55322	chr10	118340398	118340942	544	272.0	
55323	chr10	118341622	118343000	1378	689.0	
55324	chr10	118394541	118394663	122	61.0	
55325	chr10	118423780	118424236	456	228.0	
55326	chr10	118459564	118459974	410	205.0	
55327	chr10	118501889	118501893	4	2.0	
55328	chr10	118504505	118504937	432	216.0	
55329	chr10	118531114	118531894	780	390.0	
55330	chr10	118544099	118544454	355	178.0	
55331	chr10	118551676	118552028	352	176.0	
55332	chr10	118562895	118563251	356	178.0	
55333	chr10	118568193	118568929	736	368.0	
55334	chr10	118594363	118594848	485	242.0	
55335	chr10	118621555	118622016	461	230.0	
55336	chr10	118658037	118658554	517	258.0	
55337	chr10	118669119	118669191	72	36.0	
55338	chr10	118698299	118699136	837	418.0	
55339	chr10	118720988	118721465	477	238.0	
55340	chr10	118729373	118730293	920	460.0	
55341	chr10	118730861	118731253	392	196.0	
55342	chr10	118732146	118733276	1130	565.0	
55343	chr10	118737586	118737987	401	200.0	
55344	chr10	118753638	118756184	2546	1273.0	
55345	chr10	118792239	118794012	1773	886.0	
55346	chr10	118800923	118801305	382	191.0	
55347	chr10	118809392	118809594	202	101.0	
55348	chr10	118832064	118832626	562	281.0	
55349	chr10	118850443	118851501	1058	529.0	
55350	chr10	118870496	118871348	852	426.0	
55351	chr10	119028773	119031180	2407	1204.0	
55352	chr10	119075619	119077841	2222	1111.0	
55353	chr10	119079433	119081703	2270	1135.0	
55354	chr10	119090541	119091694	1153	576.0	
55355	chr10	119095750	119096125	375	188.0	
55356	chr10	119100825	119101269	444	222.0	
55357	chr10	119102861	119105118	2257	1128.0	
55358	chr10	119107703	119108215	512	256.0	
55359	chr10	119111947	119112325	378	189.0	
55360	chr10	119113903	119114302	399	200.0	
55361	chr10	119120188	119120843	655	328.0	
55362	chr10	119130542	119132440	1898	949.0	
55363	chr10	119133695	119134390	695	348.0	
55364	chr10	119135105	119135966	861	430.0	
55365	chr10	119139381	119139935	554	277.0	
55366	chr10	119164515	119167076	2561	1280.0	
55367	chr10	119177754	119179690	1936	968.0	
55368	chr10	119189879	119190238	359	180.0	
55369	chr10	119191359	119191657	298	149.0	
55370	chr10	119198193	119199836	1643	822.0	
55371	chr10	119205914	119210106	4192	2096.0	
55372	chr10	119211636	119212640	1004	502.0	
55373	chr10	119213605	119214196	591	296.0	
55374	chr10	119233509	119233876	367	184.0	
55375	chr10	119268324	119270020	1696	848.0	
55376	chr10	119270524	119272425	1901	950.0	
55377	chr10	119280718	119281240	522	261.0	
55378	chr10	119283677	119284330	653	326.0	
55379	chr10	119285118	119286337	1219	610.0	
55380	chr10	119289240	119289558	318	159.0	
55381	chr10	119292975	119293325	350	175.0	
55382	chr10	119299599	119299883	284	142.0	
55383	chr10	119300958	119302156	1198	599.0	
55384	chr10	119305499	119307262	1763	882.0	
55385	chr10	119309387	119309742	355	178.0	
55386	chr10	119312857	119314349	1492	746.0	
55387	chr10	119315097	119316005	908	454.0	
55388	chr10	119320991	119321422	431	216.0	
55389	chr10	119360216	119360772	556	278.0	
55390	chr10	119369370	119370570	1200	600.0	
55391	chr10	119373579	119373980	401	200.0	
55392	chr10	119383465	119383630	165	82.0	
55393	chr10	119394923	119395934	1011	506.0	
55394	chr10	119401586	119402239	653	326.0	
55395	chr10	119405141	119405662	521	260.0	
55396	chr10	119406593	119407722	1129	564.0	
55397	chr10	119416516	119417486	970	485.0	
55398	chr10	119445092	119446108	1016	508.0	
55399	chr10	119466599	119467069	470	235.0	
55400	chr10	119477615	119479350	1735	868.0	
55401	chr10	119489201	119490214	1013	506.0	
55402	chr10	119493136	119493519	383	192.0	
55403	chr10	119499205	119499511	306	153.0	
55404	chr10	119501660	119503309	1649	824.0	
55405	chr10	119504685	119506354	1669	834.0	
55406	chr10	119516119	119518579	2460	1230.0	
55407	chr10	119532777	119533480	703	352.0	
55408	chr10	119535860	119536534	674	337.0	
55409	chr10	119537615	119539625	2010	1005.0	
55410	chr10	119540955	119543895	2940	1470.0	
55411	chr10	119575434	119576438	1004	502.0	
55412	chr10	119595284	119597972	2688	1344.0	
55413	chr10	119602453	119602920	467	234.0	
55414	chr10	119608323	119608673	350	175.0	
55415	chr10	119618279	119618818	539	270.0	
55416	chr10	119642436	119643037	601	300.0	
55417	chr10	119650508	119653716	3208	1604.0	
55418	chr10	119655402	119656079	677	338.0	
55419	chr10	119663403	119664502	1099	550.0	
55420	chr10	119679786	119680563	777	388.0	
55421	chr10	119681910	119682767	857	428.0	
55422	chr10	119686213	119687289	1076	538.0	
55423	chr10	119687975	119688258	283	142.0	
55424	chr10	119693270	119693612	342	171.0	
55425	chr10	119700340	119700824	484	242.0	
55426	chr10	119703890	119705729	1839	920.0	
55427	chr10	119708960	119709278	318	159.0	
55428	chr10	119723708	119727004	3296	1648.0	
55429	chr10	119750345	119751050	705	352.0	
55430	chr10	119783615	119784016	401	200.0	
55431	chr10	119784607	119785104	497	248.0	
55432	chr10	119786098	119786436	338	169.0	
55433	chr10	119818602	119818790	188	94.0	
55434	chr10	119845665	119846044	379	190.0	
55435	chr10	119850466	119851111	645	322.0	
55436	chr10	119859354	119859826	472	236.0	
55437	chr10	119871466	119874120	2654	1327.0	
55438	chr10	119888650	119889434	784	392.0	
55439	chr10	119892082	119893575	1493	746.0	
55440	chr10	119896318	119896323	5	2.0	
55441	chr10	119919834	119920341	507	254.0	
55442	chr10	120456860	120457111	251	126.0	
55443	chr10	120601109	120601641	532	266.0	
55444	chr10	120643294	120643717	423	212.0	
55445	chr10	120684179	120684791	612	306.0	
55446	chr10	120714943	120715687	744	372.0	
55447	chr10	120719252	120719764	512	256.0	
55448	chr10	120745941	120746508	567	284.0	
55449	chr10	120749841	120750679	838	419.0	
55450	chr10	120789564	120790329	765	382.0	
55451	chr10	120850786	120852180	1394	697.0	
55452	chr10	120883075	120883460	385	192.0	
55453	chr10	120942751	120943296	545	272.0	
55454	chr10	120948824	120949535	711	356.0	
55455	chr10	120969272	120969499	227	114.0	
55456	chr10	120979369	120979804	435	218.0	
55457	chr10	120987270	120987776	506	253.0	
55458	chr10	121024672	121025111	439	220.0	
55459	chr10	121068971	121070620	1649	824.0	
55460	chr10	121077356	121077639	283	142.0	
55461	chr10	121157839	121158561	722	361.0	
55462	chr10	121260411	121260711	300	150.0	
55463	chr10	121598507	121598599	92	46.0	
55464	chr10	121608761	121608956	195	98.0	
55465	chr10	121709628	121710541	913	456.0	
55466	chr10	121737778	121738370	592	296.0	
55467	chr10	121823949	121824322	373	186.0	
55468	chr10	121886994	121887423	429	214.0	
55469	chr10	121900504	121900976	472	236.0	
55470	chr10	121926605	121929076	2471	1236.0	
55471	chr10	121942754	121943170	416	208.0	
55472	chr10	121974210	121975748	1538	769.0	
55473	chr10	122141071	122141495	424	212.0	
55474	chr10	122147194	122147676	482	241.0	
55475	chr10	122268080	122268395	315	158.0	
55476	chr10	122298701	122299386	685	342.0	
55477	chr10	122301104	122301646	542	271.0	
55478	chr10	122342571	122343102	531	266.0	
55479	chr10	122373558	122376114	2556	1278.0	
55480	chr10	122407892	122407987	95	48.0	
55481	chr10	122417039	122417637	598	299.0	
55482	chr10	122422149	122422761	612	306.0	
55483	chr10	122435187	122435637	450	225.0	
55484	chr10	122461383	122463060	1677	838.0	
55485	chr10	122468858	122469665	807	404.0	
55486	chr10	122485633	122485954	321	160.0	
55487	chr10	122491258	122491578	320	160.0	
55488	chr10	122515680	122516411	731	366.0	
55489	chr10	122541567	122541985	418	209.0	
55490	chr10	122544424	122544999	575	288.0	
55491	chr10	122551356	122551883	527	264.0	
55492	chr10	122558423	122558904	481	240.0	
55493	chr10	122565648	122566082	434	217.0	
55494	chr10	122703871	122703969	98	49.0	
55495	chr10	122878760	122880642	1882	941.0	
55496	chr10	122911882	122912310	428	214.0	
55497	chr10	122953606	122955035	1429	714.0	
55498	chr10	122979748	122981601	1853	926.0	
55499	chr10	123007504	123009970	2466	1233.0	
55500	chr10	123039331	123039413	82	41.0	
55501	chr10	123043341	123043737	396	198.0	
55502	chr10	123129747	123129974	227	114.0	
55503	chr10	123132687	123133743	1056	528.0	
55504	chr10	123135178	123137882	2704	1352.0	
55505	chr10	123139506	123140706	1200	600.0	
55506	chr10	123142546	123143280	734	367.0	
55507	chr10	123144887	123146990	2103	1052.0	
55508	chr10	123147724	123151819	4095	2048.0	
55509	chr10	123153494	123155386	1892	946.0	
55510	chr10	123160339	123161068	729	364.0	
55511	chr10	123241078	123242358	1280	640.0	
55512	chr10	123254518	123254793	275	138.0	
55513	chr10	123392201	123392619	418	209.0	
55514	chr10	123402508	123403110	602	301.0	
55515	chr10	123427440	123427782	342	171.0	
55516	chr10	123462800	123463624	824	412.0	
55517	chr10	123464368	123464928	560	280.0	
55518	chr10	123485578	123485995	417	208.0	
55519	chr10	123526626	123527576	950	475.0	
55520	chr10	123559252	123559768	516	258.0	
55521	chr10	123573224	123573580	356	178.0	
55522	chr10	123582123	123582555	432	216.0	
55523	chr10	123583846	123583982	136	68.0	
55524	chr10	123772038	123772627	589	294.0	
55525	chr10	123967661	123968035	374	187.0	
55526	chr10	123991841	123991932	91	46.0	
55527	chr10	123994208	123996317	2109	1054.0	
55528	chr10	123997160	123998516	1356	678.0	
55529	chr10	124000781	124001794	1013	506.0	
55530	chr10	124025688	124026146	458	229.0	
55531	chr10	124033303	124033774	471	236.0	
55532	chr10	124035462	124036672	1210	605.0	
55533	chr10	124037510	124038343	833	416.0	
55534	chr10	124039465	124039603	138	69.0	
55535	chr10	124040312	124040864	552	276.0	
55536	chr10	124043000	124043839	839	420.0	
55537	chr10	124063653	124065118	1465	732.0	
55538	chr10	124067262	124067901	639	320.0	
55539	chr10	124072200	124072447	247	124.0	
55540	chr10	124074396	124075263	867	434.0	
55541	chr10	124083813	124084958	1145	572.0	
55542	chr10	124091570	124094868	3298	1649.0	
55543	chr10	124100704	124101142	438	219.0	
55544	chr10	124106514	124106756	242	121.0	
55545	chr10	124230903	124233542	2639	1320.0	
55546	chr10	124251934	124252639	705	352.0	
55547	chr10	124259151	124259569	418	209.0	
55548	chr10	124266412	124266808	396	198.0	
55549	chr10	124285336	124286197	861	430.0	
55550	chr10	124289762	124291949	2187	1094.0	
55551	chr10	124306710	124307461	751	376.0	
55552	chr10	124315786	124315854	68	34.0	
55553	chr10	124325627	124325681	54	27.0	
55554	chr10	124332530	124332948	418	209.0	
55555	chr10	124340813	124342381	1568	784.0	
55556	chr10	124344933	124345246	313	156.0	
55557	chr10	124354794	124355445	651	326.0	
55558	chr10	124388549	124390023	1474	737.0	
55559	chr10	124394117	124395125	1008	504.0	
55560	chr10	124396725	124397175	450	225.0	
55561	chr10	124403077	124404303	1226	613.0	
55562	chr10	124412551	124412604	53	26.0	
55563	chr10	124416212	124416515	303	152.0	
55564	chr10	124417863	124419719	1856	928.0	
55565	chr10	124450006	124450424	418	209.0	
55566	chr10	124461201	124462697	1496	748.0	
55567	chr10	124465216	124465805	589	294.0	
55568	chr10	124493448	124494463	1015	508.0	
55569	chr10	124520625	124521034	409	204.0	
55570	chr10	124523149	124524035	886	443.0	
55571	chr10	124529721	124530929	1208	604.0	
55572	chr10	124534198	124535281	1083	542.0	
55573	chr10	124536165	124536485	320	160.0	
55574	chr10	124539592	124540805	1213	606.0	
55575	chr10	124544872	124545007	135	68.0	
55576	chr10	124569842	124570184	342	171.0	
55577	chr10	124588800	124589176	376	188.0	
55578	chr10	124600771	124602495	1724	862.0	
55579	chr10	124603129	124603140	11	6.0	
55580	chr10	124603801	124604406	605	302.0	
55581	chr10	124605724	124607201	1477	738.0	
55582	chr10	124611270	124614203	2933	1466.0	
55583	chr10	124615612	124616796	1184	592.0	
55584	chr10	124617682	124620690	3008	1504.0	
55585	chr10	124624491	124625106	615	308.0	
55586	chr10	124626022	124626023	1	0.0	
55587	chr10	124626634	124631203	4569	2284.0	
55588	chr10	124631772	124632601	829	414.0	
55589	chr10	124636303	124639356	3053	1526.0	
55590	chr10	124640180	124642701	2521	1260.0	
55591	chr10	124644750	124645394	644	322.0	
55592	chr10	124646218	124653653	7435	3718.0	
55593	chr10	124654391	124655763	1372	686.0	
55594	chr10	124656608	124656815	207	104.0	
55595	chr10	124657497	124659982	2485	1242.0	
55596	chr10	124670101	124673256	3155	1578.0	
55597	chr10	124677327	124679636	2309	1154.0	
55598	chr10	124680336	124681314	978	489.0	
55599	chr10	124683521	124684313	792	396.0	
55600	chr10	124685112	124685960	848	424.0	
55601	chr10	124686746	124687491	745	372.0	
55602	chr10	124688366	124689650	1284	642.0	
55603	chr10	124691794	124692105	311	156.0	
55604	chr10	124693701	124695371	1670	835.0	
55605	chr10	124696217	124703121	6904	3452.0	
55606	chr10	124703937	124704123	186	93.0	
55607	chr10	124705078	124706018	940	470.0	
55608	chr10	124707562	124708018	456	228.0	
55609	chr10	124709087	124710251	1164	582.0	
55610	chr10	124714775	124715830	1055	528.0	
55611	chr10	124717783	124720225	2442	1221.0	
55612	chr10	124721170	124725441	4271	2136.0	
55613	chr10	124728194	124729698	1504	752.0	
55614	chr10	124732430	124735302	2872	1436.0	
55615	chr10	124737087	124737609	522	261.0	
55616	chr10	124739006	124739152	146	73.0	
55617	chr10	124739690	124746238	6548	3274.0	
55618	chr10	124791121	124793002	1881	940.0	
55619	chr10	124801160	124803016	1856	928.0	
55620	chr10	124911693	124912513	820	410.0	
55621	chr10	124916044	124918665	2621	1310.0	
55622	chr10	124924331	124925075	744	372.0	
55623	chr10	124936141	124936308	167	84.0	
55624	chr10	124942532	124943286	754	377.0	
55625	chr10	124947105	124947351	246	123.0	
55626	chr10	124957378	124958025	647	324.0	
55627	chr10	124976152	124976705	553	276.0	
55628	chr10	124992454	124992899	445	222.0	
55629	chr10	125015116	125015893	777	388.0	
55630	chr10	125047986	125048503	517	258.0	
55631	chr10	125056994	125057925	931	466.0	
55632	chr10	125061068	125062555	1487	744.0	
55633	chr10	125064576	125065651	1075	538.0	
55634	chr10	125102165	125102622	457	228.0	
55635	chr10	125145014	125145462	448	224.0	
55636	chr10	125146651	125148504	1853	926.0	
55637	chr10	125149007	125149716	709	354.0	
55638	chr10	125151632	125152357	725	362.0	
55639	chr10	125154775	125154972	197	98.0	
55640	chr10	125158446	125162369	3923	1962.0	
55641	chr10	125171983	125172262	279	140.0	
55642	chr10	125718498	125720430	1932	966.0	
55643	chr10	125792317	125792851	534	267.0	
55644	chr10	125820686	125821103	417	208.0	
55645	chr10	125822466	125824293	1827	914.0	
55646	chr10	125868395	125868704	309	154.0	
55647	chr10	125895452	125897184	1732	866.0	
55648	chr10	125982244	125982766	522	261.0	
55649	chr10	126011985	126012398	413	206.0	
55650	chr10	126036499	126036950	451	226.0	
55651	chr10	126041311	126043431	2120	1060.0	
55652	chr10	126049810	126050238	428	214.0	
55653	chr10	126062373	126062840	467	234.0	
55654	chr10	126087516	126087523	7	4.0	
55655	chr10	126092440	126092879	439	220.0	
55656	chr10	126101668	126102189	521	260.0	
55657	chr10	126104708	126105104	396	198.0	
55658	chr10	126110425	126110817	392	196.0	
55659	chr10	126135840	126136620	780	390.0	
55660	chr10	126387045	126387361	316	158.0	
55661	chr10	126388069	126388548	479	240.0	
55662	chr10	126469137	126469820	683	342.0	
55663	chr10	126663470	126663698	228	114.0	
55664	chr10	127070715	127070791	76	38.0	
55665	chr10	127243530	127243830	300	150.0	
55666	chr10	127250689	127250979	290	145.0	
55667	chr10	127254227	127254799	572	286.0	
55668	chr10	127293303	127294199	896	448.0	
55669	chr10	127533891	127534906	1015	508.0	
55670	chr10	127853715	127854436	721	360.0	
55671	chr10	127855012	127855549	537	268.0	
55672	chr10	127878424	127879179	755	378.0	
55673	chr10	127880432	127881299	867	434.0	
55674	chr10	127882828	127883154	326	163.0	
55675	chr10	127889564	127890023	459	230.0	
55676	chr10	127899910	127900457	547	274.0	
55677	chr10	127905933	127908022	2089	1044.0	
55678	chr10	127918611	127920680	2069	1034.0	
55679	chr10	127921533	127922397	864	432.0	
55680	chr10	127926402	127927052	650	325.0	
55681	chr10	127945323	127945862	539	270.0	
55682	chr10	127973659	127974090	431	216.0	
55683	chr10	127977536	127978059	523	262.0	
55684	chr10	127979066	127979504	438	219.0	
55685	chr10	127990262	127991647	1385	692.0	
55686	chr10	128011113	128012019	906	453.0	
55687	chr10	128035426	128036113	687	344.0	
55688	chr10	128042100	128042730	630	315.0	
55689	chr10	128045487	128045881	394	197.0	
55690	chr10	128046745	128052005	5260	2630.0	
55691	chr10	128052608	128052935	327	164.0	
55692	chr10	128053710	128055019	1309	654.0	
55693	chr10	128056427	128056435	8	4.0	
55694	chr10	128057355	128060556	3201	1600.0	
55695	chr10	128061984	128065638	3654	1827.0	
55696	chr10	128066446	128067518	1072	536.0	
55697	chr10	128068772	128070127	1355	678.0	
55698	chr10	128077443	128078901	1458	729.0	
55699	chr10	128080429	128080565	136	68.0	
55700	chr10	128086113	128086946	833	416.0	
55701	chr10	128087474	128087702	228	114.0	
55702	chr10	128095288	128096349	1061	530.0	
55703	chr10	128102855	128103994	1139	570.0	
55704	chr10	128124845	128127485	2640	1320.0	
55705	chr10	128147050	128147534	484	242.0	
55706	chr10	128149552	128150710	1158	579.0	
55707	chr10	128160976	128161484	508	254.0	
55708	chr10	128178341	128178736	395	198.0	
55709	chr10	128180714	128181416	702	351.0	
55710	chr10	128187227	128188275	1048	524.0	
55711	chr10	128209829	128212721	2892	1446.0	
55712	chr10	128221139	128221602	463	232.0	
55713	chr10	129031501	129031967	466	233.0	
55714	chr10	129035297	129037058	1761	880.0	
55715	chr10	129042739	129043114	375	188.0	
55716	chr10	129057779	129058358	579	290.0	
55717	chr10	129090644	129090998	354	177.0	
55718	chr10	129140840	129141289	449	224.0	
55719	chr10	129466266	129468205	1939	970.0	
55720	chr10	129472982	129473552	570	285.0	
55721	chr10	129517583	129518624	1041	520.0	
55722	chr10	129716105	129716624	519	260.0	
55723	chr10	129871233	129871354	121	60.0	
55724	chr10	129877978	129878141	163	82.0	
55725	chr10	129889128	129889515	387	194.0	
55726	chr10	129958600	129958835	235	118.0	
55727	chr10	129963054	129964802	1748	874.0	
55728	chr10	129971607	129972050	443	222.0	
55729	chr10	130108965	130112231	3266	1633.0	
55730	chr10	130127493	130128242	749	374.0	
55731	chr10	130135417	130137419	2002	1001.0	
55732	chr10	130171198	130171565	367	184.0	
55733	chr10	130179630	130180014	384	192.0	
55734	chr10	130189835	130190916	1081	540.0	
55735	chr10	130300544	130302117	1573	786.0	
55736	chr10	130630109	130630497	388	194.0	
55737	chr10	130631181	130631891	710	355.0	
55738	chr10	130636528	130636667	139	70.0	
55739	chr10	130638948	130639386	438	219.0	
55740	chr10	131043606	131043926	320	160.0	
55741	chr10	131311743	131312180	437	218.0	
55742	chr10	131743334	131743417	83	42.0	
55743	chr10	131928144	131928821	677	338.0	
55744	chr10	131943425	131943770	345	172.0	
55745	chr10	131965077	131965542	465	232.0	
55746	chr10	131972250	131973745	1495	748.0	
55747	chr10	131978870	131979465	595	298.0	
55748	chr10	131980882	131982982	2100	1050.0	
55749	chr10	131992712	131993287	575	288.0	
55750	chr10	132001441	132002058	617	308.0	
55751	chr10	132022982	132023681	699	350.0	
55752	chr10	132142364	132143017	653	326.0	
55753	chr10	132158034	132162591	4557	2278.0	
55754	chr10	132163141	132163900	759	380.0	
55755	chr10	132185350	132187655	2305	1152.0	
55756	chr10	132222970	132223690	720	360.0	
55757	chr10	132226186	132226482	296	148.0	
55758	chr10	132229687	132230692	1005	502.0	
55759	chr10	132231940	132233290	1350	675.0	
55760	chr10	132248841	132249423	582	291.0	
55761	chr10	132257409	132257510	101	50.0	
55762	chr10	132306802	132309335	2533	1266.0	
55763	chr10	132320059	132320740	681	340.0	
55764	chr10	132322774	132323101	327	164.0	
55765	chr10	132329584	132333001	3417	1708.0	
55766	chr10	132335008	132337524	2516	1258.0	
55767	chr10	132352553	132353044	491	246.0	
55768	chr10	132360746	132361176	430	215.0	
55769	chr10	132375601	132376300	699	350.0	
55770	chr10	132385289	132385648	359	180.0	
55771	chr10	132387040	132388378	1338	669.0	
55772	chr10	132389028	132390001	973	486.0	
55773	chr10	132390584	132390753	169	84.0	
55774	chr10	132392020	132398808	6788	3394.0	
55775	chr10	132399543	132402063	2520	1260.0	
55776	chr10	132407558	132409076	1518	759.0	
55777	chr10	132411866	132412217	351	176.0	
55778	chr10	132412869	132413186	317	158.0	
55779	chr10	132417304	132419304	2000	1000.0	
55780	chr10	132419903	132423794	3891	1946.0	
55781	chr10	132427874	132428406	532	266.0	
55782	chr10	132434325	132434847	522	261.0	
55783	chr10	132443537	132445688	2151	1076.0	
55784	chr10	132446217	132449912	3695	1848.0	
55785	chr10	132450589	132453874	3285	1642.0	
55786	chr10	132457567	132459136	1569	784.0	
55787	chr10	132511077	132511725	648	324.0	
55788	chr10	132517278	132517703	425	212.0	
55789	chr10	132536368	132540997	4629	2314.0	
55790	chr10	132541737	132541816	79	40.0	
55791	chr10	132544121	132545282	1161	580.0	
55792	chr10	132546639	132548892	2253	1126.0	
55793	chr10	132550958	132552103	1145	572.0	
55794	chr10	132554395	132556186	1791	896.0	
55795	chr10	132560067	132560774	707	354.0	
55796	chr10	132570887	132572808	1921	960.0	
55797	chr10	132574918	132576329	1411	706.0	
55798	chr10	132580204	132580554	350	175.0	
55799	chr10	132585948	132587209	1261	630.0	
55800	chr10	132588130	132589804	1674	837.0	
55801	chr10	132592965	132594713	1748	874.0	
55802	chr10	132612060	132612368	308	154.0	
55803	chr10	132616037	132616946	909	454.0	
55804	chr10	132625529	132625857	328	164.0	
55805	chr10	132627992	132628647	655	328.0	enhancer
55806	chr10	132634363	132634729	366	183.0	
55807	chr10	132637730	132638264	534	267.0	
55808	chr10	132654654	132655127	473	236.0	
55809	chr10	132684394	132684770	376	188.0	
55810	chr10	132837064	132837253	189	94.0	
55811	chr10	132904250	132904613	363	182.0	
55812	chr10	132915495	132915671	176	88.0	
55813	chr10	132930057	132930677	620	310.0	
55814	chr10	132931356	132932004	648	324.0	
55815	chr10	132940251	132940755	504	252.0	
55816	chr10	132942634	132942753	119	60.0	
55817	chr10	132961858	132962938	1080	540.0	
55818	chr10	132967642	132967957	315	158.0	
55819	chr10	132987714	132988095	381	190.0	
55820	chr10	133008891	133010850	1959	980.0	
55821	chr10	133012416	133014179	1763	882.0	
55822	chr10	133058570	133058684	114	57.0	
55823	chr10	133124992	133125022	30	15.0	
55824	chr10	133127781	133128088	307	154.0	
55825	chr10	133143800	133144560	760	380.0	
55826	chr10	133159765	133160836	1071	536.0	
55827	chr10	133174035	133174675	640	320.0	
55828	chr10	133226410	133226822	412	206.0	
55829	chr10	133230251	133230948	697	348.0	
55830	chr10	133234759	133237507	2748	1374.0	
55831	chr10	133240705	133241997	1292	646.0	
55832	chr10	133246917	133247417	500	250.0	
55833	chr10	133253249	133253895	646	323.0	
55834	chr10	133257308	133264930	7622	3811.0	
55835	chr10	133266163	133266210	47	24.0	
55836	chr10	133267426	133268340	914	457.0	
55837	chr10	133269279	133269601	322	161.0	
55838	chr10	133270475	133271612	1137	568.0	
55839	chr10	133273750	133280785	7035	3518.0	
55840	chr10	133292989	133294795	1806	903.0	
55841	chr10	133304801	133306346	1545	772.0	
55842	chr10	133307438	133309911	2473	1236.0	
55843	chr10	133313755	133314435	680	340.0	
55844	chr10	133315786	133316197	411	206.0	
55845	chr10	133318360	133319459	1099	550.0	
55846	chr10	133321078	133321344	266	133.0	
55847	chr10	133324170	133326277	2107	1054.0	
55848	chr10	133329285	133330432	1147	574.0	
55849	chr10	133334452	133337759	3307	1654.0	
55850	chr10	133338839	133338866	27	14.0	
55851	chr10	133339695	133339732	37	18.0	
55852	chr10	133356897	133360314	3417	1708.0	
55853	chr10	133361952	133362218	266	133.0	
55854	chr10	133372819	133374588	1769	884.0	
55855	chr10	133377859	133380183	2324	1162.0	
55856	chr10	133381039	133381658	619	310.0	
55857	chr10	133388805	133390903	2098	1049.0	
55858	chr10	133391980	133392173	193	96.0	
55859	chr10	133393525	133395253	1728	864.0	
55860	chr10	133400858	133401597	739	370.0	
55861	chr10	133423342	133423710	368	184.0	
55862	chr10	133437715	133438194	479	240.0	
55863	chr10	133438815	133439284	469	234.0	
55864	chr10	133442304	133442961	657	328.0	
55865	chr10	133453472	133454113	641	320.0	
55866	chr10	133475172	133476156	984	492.0	
55867	chr10	133519956	133520868	912	456.0	
55868	chr10	133528973	133529570	597	298.0	
55869	chr10	133565661	133566024	363	182.0	
55870	chr11	189277	190543	1266	633.0	
55871	chr11	191383	192811	1428	714.0	
55872	chr11	195169	195750	581	290.0	
55873	chr11	201485	202775	1290	645.0	
55874	chr11	205554	210436	4882	2441.0	
55875	chr11	211086	211120	34	17.0	
55876	chr11	235409	237842	2433	1216.0	
55877	chr11	250493	251337	844	422.0	
55878	chr11	266624	270110	3486	1743.0	
55879	chr11	277332	282004	4672	2336.0	
55880	chr11	286704	295510	8806	4403.0	
55881	chr11	296051	300641	4590	2295.0	
55882	chr11	303271	303747	476	238.0	
55883	chr11	304719	305532	813	406.0	
55884	chr11	307122	310338	3216	1608.0	
55885	chr11	311658	318172	6514	3257.0	
55886	chr11	319062	321147	2085	1042.0	
55887	chr11	326363	327773	1410	705.0	
55888	chr11	329194	331743	2549	1274.0	
55889	chr11	350235	351408	1173	586.0	
55890	chr11	353983	356673	2690	1345.0	
55891	chr11	359220	359796	576	288.0	
55892	chr11	361786	362175	389	194.0	
55893	chr11	364025	364866	841	420.0	
55894	chr11	368291	370047	1756	878.0	
55895	chr11	396358	397673	1315	658.0	
55896	chr11	406123	410460	4337	2168.0	
55897	chr11	413036	418328	5292	2646.0	
55898	chr11	441417	442469	1052	526.0	
55899	chr11	447676	448981	1305	652.0	
55900	chr11	449629	451705	2076	1038.0	
55901	chr11	456467	457471	1004	502.0	
55902	chr11	466245	466353	108	54.0	
55903	chr11	500746	500941	195	98.0	
55904	chr11	502158	505165	3007	1504.0	
55905	chr11	505724	509452	3728	1864.0	
55906	chr11	511473	513424	1951	976.0	
55907	chr11	514646	515358	712	356.0	
55908	chr11	516068	516069	1	0.0	
55909	chr11	518119	519392	1273	636.0	
55910	chr11	520532	521457	925	462.0	
55911	chr11	531843	532030	187	94.0	
55912	chr11	534328	538985	4657	2328.0	
55913	chr11	554223	557889	3666	1833.0	
55914	chr11	559172	562104	2932	1466.0	
55915	chr11	565998	569568	3570	1785.0	
55916	chr11	574087	577190	3103	1552.0	
55917	chr11	587551	588729	1178	589.0	
55918	chr11	605708	605709	1	0.0	
55919	chr11	606282	606624	342	171.0	
55920	chr11	607647	617331	9684	4842.0	
55921	chr11	617952	618135	183	92.0	
55922	chr11	620326	621617	1291	646.0	
55923	chr11	623945	624363	418	209.0	
55924	chr11	625314	627175	1861	930.0	
55925	chr11	628430	629636	1206	603.0	
55926	chr11	636919	637525	606	303.0	
55927	chr11	639280	641367	2087	1044.0	
55928	chr11	642758	642806	48	24.0	
55929	chr11	653135	653415	280	140.0	
55930	chr11	662618	663135	517	258.0	
55931	chr11	691264	691275	11	6.0	
55932	chr11	692753	698409	5656	2828.0	
55933	chr11	702792	703251	459	230.0	
55934	chr11	705691	707186	1495	748.0	
55935	chr11	720448	723893	3445	1722.0	
55936	chr11	725568	727036	1468	734.0	
55937	chr11	727609	728749	1140	570.0	
55938	chr11	729630	730076	446	223.0	
55939	chr11	737448	738238	790	395.0	
55940	chr11	746514	749032	2518	1259.0	
55941	chr11	749668	750234	566	283.0	
55942	chr11	762373	762897	524	262.0	
55943	chr11	764928	765775	847	424.0	
55944	chr11	776469	779387	2918	1459.0	
55945	chr11	783594	783925	331	166.0	
55946	chr11	789532	790989	1457	728.0	
55947	chr11	795353	799201	3848	1924.0	
55948	chr11	804301	806225	1924	962.0	
55949	chr11	808191	812044	3853	1926.0	
55950	chr11	812555	812566	11	6.0	
55951	chr11	813074	814248	1174	587.0	
55952	chr11	815838	816568	730	365.0	
55953	chr11	818469	822921	4452	2226.0	
55954	chr11	823556	835483	11927	5964.0	
55955	chr11	836551	838668	2117	1058.0	
55956	chr11	839865	840340	475	238.0	
55957	chr11	841851	845366	3515	1758.0	
55958	chr11	848040	850388	2348	1174.0	
55959	chr11	856815	857390	575	288.0	
55960	chr11	859962	859965	3	2.0	
55961	chr11	910065	911804	1739	870.0	
55962	chr11	916800	917132	332	166.0	
55963	chr11	919298	919423	125	62.0	
55964	chr11	924640	928431	3791	1896.0	
55965	chr11	962124	962206	82	41.0	
55966	chr11	965421	965928	507	254.0	
55967	chr11	966549	966574	25	12.0	
55968	chr11	970503	970619	116	58.0	
55969	chr11	1016570	1018142	1572	786.0	
55970	chr11	1027643	1027663	20	10.0	
55971	chr11	1049572	1049925	353	176.0	
55972	chr11	1050839	1051695	856	428.0	
55973	chr11	1114760	1115044	284	142.0	
55974	chr11	1202892	1203543	651	326.0	
55975	chr11	1259790	1260544	754	377.0	
55976	chr11	1261976	1263509	1533	766.0	
55977	chr11	1264330	1264916	586	293.0	
55978	chr11	1293609	1293960	351	176.0	
55979	chr11	1299055	1299573	518	259.0	
55980	chr11	1303390	1303791	401	200.0	
55981	chr11	1307114	1307826	712	356.0	
55982	chr11	1308556	1311718	3162	1581.0	
55983	chr11	1317993	1318401	408	204.0	
55984	chr11	1323681	1324167	486	243.0	
55985	chr11	1330659	1330892	233	116.0	
55986	chr11	1335438	1339469	4031	2016.0	
55987	chr11	1380891	1384457	3566	1783.0	
55988	chr11	1387968	1392382	4414	2207.0	
55989	chr11	1401554	1402055	501	250.0	
55990	chr11	1435990	1436448	458	229.0	
55991	chr11	1446040	1446619	579	290.0	
55992	chr11	1452574	1452848	274	137.0	
55993	chr11	1453502	1454251	749	374.0	
55994	chr11	1455647	1455896	249	124.0	
55995	chr11	1458834	1459579	745	372.0	
55996	chr11	1469550	1469556	6	3.0	
55997	chr11	1478618	1478924	306	153.0	
55998	chr11	1515269	1516522	1253	626.0	
55999	chr11	1521741	1522219	478	239.0	
56000	chr11	1523845	1524241	396	198.0	
56001	chr11	1546347	1550263	3916	1958.0	
56002	chr11	1553038	1553086	48	24.0	
56003	chr11	1555104	1555967	863	432.0	
56004	chr11	1557118	1557530	412	206.0	
56005	chr11	1558779	1575283	16504	8252.0	
56006	chr11	1584422	1585001	579	290.0	
56007	chr11	1588986	1589710	724	362.0	
56008	chr11	1595355	1595841	486	243.0	
56009	chr11	1598797	1599231	434	217.0	
56010	chr11	1605866	1606392	526	263.0	
56011	chr11	1619319	1619937	618	309.0	
56012	chr11	1628637	1629423	786	393.0	
56013	chr11	1640095	1640503	408	204.0	
56014	chr11	1652619	1653307	688	344.0	
56015	chr11	1690450	1691042	592	296.0	
56016	chr11	1693126	1694509	1383	692.0	
56017	chr11	1706889	1706944	55	28.0	
56018	chr11	1729005	1729610	605	302.0	
56019	chr11	1746335	1747115	780	390.0	
56020	chr11	1748278	1749581	1303	652.0	
56021	chr11	1750135	1752322	2187	1094.0	
56022	chr11	1755142	1756192	1050	525.0	
56023	chr11	1757156	1761344	4188	2094.0	
56024	chr11	1761872	1764676	2804	1402.0	
56025	chr11	1770341	1771021	680	340.0	
56026	chr11	1771526	1773191	1665	832.0	
56027	chr11	1777620	1778562	942	471.0	
56028	chr11	1780898	1783623	2725	1362.0	
56029	chr11	1785725	1786458	733	366.0	
56030	chr11	1792679	1792738	59	30.0	
56031	chr11	1810656	1811291	635	318.0	
56032	chr11	1824913	1825403	490	245.0	
56033	chr11	1832229	1833245	1016	508.0	
56034	chr11	1837477	1838533	1056	528.0	
56035	chr11	1839442	1840827	1385	692.0	
56036	chr11	1843827	1846004	2177	1088.0	
56037	chr11	1849713	1855717	6004	3002.0	
56038	chr11	1858162	1858666	504	252.0	
56039	chr11	1863095	1864670	1575	788.0	
56040	chr11	1870560	1871671	1111	556.0	
56041	chr11	1876377	1876774	397	198.0	
56042	chr11	1880038	1883213	3175	1588.0	
56043	chr11	1887652	1892610	4958	2479.0	
56044	chr11	1896642	1897610	968	484.0	
56045	chr11	1912328	1912674	346	173.0	
56046	chr11	1916044	1919025	2981	1490.0	
56047	chr11	1919594	1920086	492	246.0	
56048	chr11	1921104	1921959	855	428.0	
56049	chr11	1922687	1923318	631	316.0	
56050	chr11	1926394	1927089	695	348.0	
56051	chr11	1928123	1928883	760	380.0	
56052	chr11	1939077	1939671	594	297.0	
56053	chr11	1946576	1949416	2840	1420.0	
56054	chr11	1953416	1953962	546	273.0	
56055	chr11	1968612	1968935	323	162.0	
56056	chr11	1978873	1979144	271	136.0	
56057	chr11	1986379	1987677	1298	649.0	"enhancer	enhancer"
56058	chr11	1997931	2001044	3113	1556.0	"insulator	regulatory_region	protein_binding_site	repeat_region	repeat_region	insulator	protein_binding_site	insulator	repeat_region	protein_binding_site	repeat_region	protein_binding_site"
56059	chr11	2001833	2003306	1473	736.0	"regulatory_region	insulator	repeat_region	insulator	repeat_region	insulator	protein_binding_site	repeat_region	protein_binding_site	repeat_region	protein_binding_site"
56060	chr11	2036815	2038112	1297	648.0	
56061	chr11	2089469	2089919	450	225.0	
56062	chr11	2093056	2093561	505	252.0	
56063	chr11	2100408	2100808	400	200.0	
56064	chr11	2137261	2137359	98	49.0	
56065	chr11	2138428	2139589	1161	580.0	
56066	chr11	2151046	2152583	1537	768.0	
56067	chr11	2153528	2154015	487	244.0	
56068	chr11	2156386	2157063	677	338.0	
56069	chr11	2166040	2166597	557	278.0	
56070	chr11	2186615	2187481	866	433.0	
56071	chr11	2190760	2191636	876	438.0	
56072	chr11	2194698	2195379	681	340.0	
56073	chr11	2196971	2198079	1108	554.0	
56074	chr11	2198889	2199332	443	222.0	
56075	chr11	2213388	2213973	585	292.0	
56076	chr11	2217020	2217759	739	370.0	
56077	chr11	2265302	2266475	1173	586.0	
56078	chr11	2268581	2271686	3105	1552.0	
56079	chr11	2293854	2294394	540	270.0	
56080	chr11	2298884	2307069	8185	4092.0	
56081	chr11	2316328	2316573	245	122.0	
56082	chr11	2317570	2317939	369	184.0	
56083	chr11	2376654	2397154	20500	10250.0	enhancer
56084	chr11	2398298	2404294	5996	2998.0	
56085	chr11	2404865	2405488	623	312.0	
56086	chr11	2406201	2406443	242	121.0	
56087	chr11	2409584	2409910	326	163.0	
56088	chr11	2415885	2416192	307	154.0	
56089	chr11	2419598	2421473	1875	938.0	
56090	chr11	2427843	2429329	1486	743.0	
56091	chr11	2430516	2431037	521	260.0	
56092	chr11	2440632	2441192	560	280.0	
56093	chr11	2442458	2443068	610	305.0	
56094	chr11	2443675	2448141	4466	2233.0	
56095	chr11	2463395	2463711	316	158.0	
56096	chr11	2467150	2467846	696	348.0	
56097	chr11	2480372	2481677	1305	652.0	
56098	chr11	2511415	2512166	751	376.0	
56099	chr11	2526595	2527696	1101	550.0	
56100	chr11	2531154	2534353	3199	1600.0	
56101	chr11	2560880	2561669	789	394.0	
56102	chr11	2564797	2565098	301	150.0	
56103	chr11	2676750	2677575	825	412.0	
56104	chr11	2681356	2681922	566	283.0	
56105	chr11	2687586	2689273	1687	844.0	
56106	chr11	2690466	2690635	169	84.0	
56107	chr11	2693869	2694209	340	170.0	
56108	chr11	2698414	2701236	2822	1411.0	enhancer
56109	chr11	2778682	2779098	416	208.0	
56110	chr11	2791578	2792063	485	242.0	
56111	chr11	2812108	2813208	1100	550.0	
56112	chr11	2825159	2827273	2114	1057.0	
56113	chr11	2837046	2837557	511	256.0	
56114	chr11	2860458	2861085	627	314.0	
56115	chr11	2868188	2868955	767	384.0	
56116	chr11	2870864	2871327	463	232.0	
56117	chr11	2880455	2880763	308	154.0	
56118	chr11	2882657	2883020	363	182.0	
56119	chr11	2883833	2889021	5188	2594.0	
56120	chr11	2891374	2893529	2155	1078.0	
56121	chr11	2898263	2900114	1851	926.0	
56122	chr11	2901166	2903241	2075	1038.0	
56123	chr11	2912575	2913239	664	332.0	
56124	chr11	2913843	2914030	187	94.0	
56125	chr11	2926798	2926856	58	29.0	
56126	chr11	2927630	2934261	6631	3316.0	
56127	chr11	2937317	2937876	559	280.0	
56128	chr11	2939096	2939377	281	140.0	
56129	chr11	2939955	2944104	4149	2074.0	
56130	chr11	2945035	2946292	1257	628.0	
56131	chr11	2952524	2952618	94	47.0	
56132	chr11	2958275	2958593	318	159.0	
56133	chr11	2963457	2963890	433	216.0	
56134	chr11	2975521	2976048	527	264.0	
56135	chr11	2987548	2989995	2447	1224.0	
56136	chr11	2990517	2993321	2804	1402.0	
56137	chr11	3002352	3002785	433	216.0	
56138	chr11	3006620	3007364	744	372.0	
56139	chr11	3013835	3015301	1466	733.0	
56140	chr11	3016002	3016390	388	194.0	
56141	chr11	3021161	3021594	433	216.0	
56142	chr11	3022105	3023094	989	494.0	
56143	chr11	3030606	3031075	469	234.0	
56144	chr11	3036297	3038193	1896	948.0	
56145	chr11	3049423	3050627	1204	602.0	
56146	chr11	3056282	3058129	1847	924.0	
56147	chr11	3091519	3092557	1038	519.0	
56148	chr11	3099235	3099621	386	193.0	
56149	chr11	3100254	3101379	1125	562.0	
56150	chr11	3109921	3110540	619	310.0	
56151	chr11	3112103	3112928	825	412.0	
56152	chr11	3124385	3124948	563	282.0	
56153	chr11	3126468	3126937	469	234.0	
56154	chr11	3133556	3134013	457	228.0	
56155	chr11	3134861	3137324	2463	1232.0	
56156	chr11	3137844	3138275	431	216.0	
56157	chr11	3153598	3154575	977	488.0	
56158	chr11	3156145	3157949	1804	902.0	
56159	chr11	3159211	3159216	5	2.0	
56160	chr11	3160119	3161051	932	466.0	
56161	chr11	3163258	3165772	2514	1257.0	
56162	chr11	3169137	3170028	891	446.0	
56163	chr11	3185049	3185175	126	63.0	
56164	chr11	3195281	3195619	338	169.0	
56165	chr11	3203003	3203014	11	6.0	
56166	chr11	3205394	3205823	429	214.0	
56167	chr11	3206570	3206871	301	150.0	
56168	chr11	3217007	3217704	697	348.0	
56169	chr11	3226152	3226439	287	144.0	
56170	chr11	3227874	3228275	401	200.0	
56171	chr11	3341297	3341693	396	198.0	
56172	chr11	3378353	3379588	1235	618.0	
56173	chr11	3408442	3409189	747	374.0	
56174	chr11	3416897	3417407	510	255.0	
56175	chr11	3421691	3423842	2151	1076.0	
56176	chr11	3437462	3437759	297	148.0	
56177	chr11	3454830	3455298	468	234.0	
56178	chr11	3511451	3512751	1300	650.0	
56179	chr11	3544922	3545234	312	156.0	
56180	chr11	3580552	3581590	1038	519.0	
56181	chr11	3609675	3610107	432	216.0	
56182	chr11	3614105	3615113	1008	504.0	
56183	chr11	3626158	3626727	569	284.0	
56184	chr11	3641802	3642625	823	412.0	
56185	chr11	3722947	3723527	580	290.0	
56186	chr11	3767568	3767822	254	127.0	
56187	chr11	3781223	3781897	674	337.0	
56188	chr11	3784795	3786217	1422	711.0	
56189	chr11	3787111	3788395	1284	642.0	
56190	chr11	3790780	3791126	346	173.0	
56191	chr11	3792889	3793268	379	190.0	
56192	chr11	3794485	3794849	364	182.0	
56193	chr11	3795654	3798587	2933	1466.0	
56194	chr11	3807578	3809696	2118	1059.0	
56195	chr11	3824430	3826092	1662	831.0	
56196	chr11	3830696	3833044	2348	1174.0	
56197	chr11	3834213	3842402	8189	4094.0	
56198	chr11	3848957	3849687	730	365.0	
56199	chr11	3852742	3853243	501	250.0	
56200	chr11	3853825	3858481	4656	2328.0	
56201	chr11	3859160	3862052	2892	1446.0	
56202	chr11	3865497	3867978	2481	1240.0	
56203	chr11	3871108	3871709	601	300.0	
56204	chr11	3879195	3881111	1916	958.0	
56205	chr11	3882674	3883085	411	206.0	
56206	chr11	3893615	3895430	1815	908.0	
56207	chr11	3896606	3897070	464	232.0	
56208	chr11	3900241	3900673	432	216.0	
56209	chr11	3902614	3902632	18	9.0	
56210	chr11	3903298	3903935	637	318.0	
56211	chr11	3904852	3905941	1089	544.0	
56212	chr11	3914577	3915265	688	344.0	
56213	chr11	3916314	3916339	25	12.0	
56214	chr11	3919290	3920582	1292	646.0	
56215	chr11	3928007	3928408	401	200.0	
56216	chr11	3933081	3933419	338	169.0	
56217	chr11	3939268	3939331	63	32.0	
56218	chr11	3942291	3943843	1552	776.0	
56219	chr11	3946595	3947936	1341	670.0	
56220	chr11	3949037	3949581	544	272.0	
56221	chr11	3951217	3951679	462	231.0	
56222	chr11	3959333	3959337	4	2.0	
56223	chr11	3969593	3969916	323	162.0	
56224	chr11	3984884	3985287	403	202.0	
56225	chr11	3989763	3990345	582	291.0	
56226	chr11	4007302	4007403	101	50.0	
56227	chr11	4044425	4045209	784	392.0	
56228	chr11	4048912	4049609	697	348.0	
56229	chr11	4057719	4058683	964	482.0	
56230	chr11	4066802	4067457	655	328.0	
56231	chr11	4068961	4069382	421	210.0	
56232	chr11	4072292	4073169	877	438.0	
56233	chr11	4086604	4086970	366	183.0	
56234	chr11	4089744	4091040	1296	648.0	
56235	chr11	4091619	4093162	1543	772.0	
56236	chr11	4093910	4096430	2520	1260.0	
56237	chr11	4096965	4097466	501	250.0	
56238	chr11	4182125	4182453	328	164.0	
56239	chr11	4186886	4188063	1177	588.0	
56240	chr11	4392865	4394322	1457	728.0	
56241	chr11	4423662	4423719	57	28.0	
56242	chr11	4433567	4434297	730	365.0	
56243	chr11	4436467	4436789	322	161.0	
56244	chr11	4441512	4441934	422	211.0	
56245	chr11	4454032	4454402	370	185.0	
56246	chr11	4455276	4456149	873	436.0	
56247	chr11	4459347	4459963	616	308.0	
56248	chr11	4468228	4468545	317	158.0	
56249	chr11	4480562	4480922	360	180.0	
56250	chr11	4482303	4482893	590	295.0	
56251	chr11	4492803	4493670	867	434.0	
56252	chr11	4539626	4539992	366	183.0	
56253	chr11	4607485	4608979	1494	747.0	
56254	chr11	4609890	4610902	1012	506.0	
56255	chr11	4636835	4637479	644	322.0	
56256	chr11	5124049	5124431	382	191.0	
56257	chr11	5476226	5476592	366	183.0	
56258	chr11	5596436	5596872	436	218.0	
56259	chr11	5600196	5600741	545	272.0	
56260	chr11	5624252	5625806	1554	777.0	
56261	chr11	5631870	5632614	744	372.0	
56262	chr11	5683492	5685609	2117	1058.0	
56263	chr11	5689221	5692607	3386	1693.0	
56264	chr11	5700340	5701058	718	359.0	
56265	chr11	5712492	5712789	297	148.0	
56266	chr11	5808355	5809575	1220	610.0	
56267	chr11	5815467	5815968	501	250.0	
56268	chr11	5818443	5818946	503	252.0	
56269	chr11	6011957	6012505	548	274.0	
56270	chr11	6022932	6023421	489	244.0	
56271	chr11	6094167	6094537	370	185.0	
56272	chr11	6110015	6110402	387	194.0	
56273	chr11	6124203	6124695	492	246.0	
56274	chr11	6129331	6130468	1137	568.0	
56275	chr11	6191642	6192252	610	305.0	
56276	chr11	6196325	6196764	439	220.0	
56277	chr11	6200585	6202022	1437	718.0	
56278	chr11	6203376	6203870	494	247.0	
56279	chr11	6204639	6205178	539	270.0	
56280	chr11	6219443	6219657	214	107.0	
56281	chr11	6225816	6226291	475	238.0	
56282	chr11	6228456	6228955	499	250.0	
56283	chr11	6229764	6230839	1075	538.0	
56284	chr11	6233787	6235765	1978	989.0	
56285	chr11	6237339	6237595	256	128.0	
56286	chr11	6240638	6241360	722	361.0	
56287	chr11	6251068	6251568	500	250.0	
56288	chr11	6258631	6260282	1651	826.0	
56289	chr11	6269927	6270377	450	225.0	
56290	chr11	6298647	6298948	301	150.0	
56291	chr11	6315758	6316268	510	255.0	
56292	chr11	6319297	6321283	1986	993.0	
56293	chr11	6353379	6353902	523	262.0	
56294	chr11	6363012	6363516	504	252.0	
56295	chr11	6378117	6379835	1718	859.0	
56296	chr11	6389538	6392282	2744	1372.0	
56297	chr11	6401614	6405070	3456	1728.0	
56298	chr11	6413391	6416057	2666	1333.0	
56299	chr11	6417975	6420080	2105	1052.0	
56300	chr11	6437954	6439443	1489	744.0	
56301	chr11	6443141	6443871	730	365.0	
56302	chr11	6468850	6469640	790	395.0	
56303	chr11	6472632	6475785	3153	1576.0	
56304	chr11	6480553	6482741	2188	1094.0	
56305	chr11	6505599	6506088	489	244.0	
56306	chr11	6526457	6526771	314	157.0	
56307	chr11	6531232	6531741	509	254.0	
56308	chr11	6602727	6607697	4970	2485.0	
56309	chr11	6611205	6613333	2128	1064.0	
56310	chr11	6617146	6620064	2918	1459.0	
56311	chr11	6620622	6621047	425	212.0	
56312	chr11	6627355	6628157	802	401.0	
56313	chr11	6635201	6636016	815	408.0	
56314	chr11	6646019	6647933	1914	957.0	
56315	chr11	6648460	6648966	506	253.0	
56316	chr11	6654050	6656444	2394	1197.0	
56317	chr11	6667578	6668416	838	419.0	
56318	chr11	6670654	6670823	169	84.0	
56319	chr11	6682500	6684053	1553	776.0	
56320	chr11	6693861	6694361	500	250.0	
56321	chr11	6703365	6703987	622	311.0	
56322	chr11	6705778	6706394	616	308.0	
56323	chr11	6711532	6711942	410	205.0	
56324	chr11	6733365	6734273	908	454.0	
56325	chr11	6735214	6735721	507	254.0	
56326	chr11	6736525	6736960	435	218.0	
56327	chr11	6737625	6738541	916	458.0	
56328	chr11	6742391	6742501	110	55.0	
56329	chr11	6744384	6744466	82	41.0	
56330	chr11	6745578	6747389	1811	906.0	
56331	chr11	6755141	6755793	652	326.0	
56332	chr11	6757305	6757840	535	268.0	
56333	chr11	6772288	6772966	678	339.0	
56334	chr11	6812369	6812844	475	238.0	
56335	chr11	6926164	6926823	659	330.0	
56336	chr11	7098256	7098622	366	183.0	
56337	chr11	7353145	7353385	240	120.0	
56338	chr11	7436580	7437153	573	286.0	
56339	chr11	7442535	7443019	484	242.0	
56340	chr11	7449459	7449742	283	142.0	
56341	chr11	7495853	7496833	980	490.0	
56342	chr11	7498182	7498641	459	230.0	
56343	chr11	7511525	7514864	3339	1670.0	
56344	chr11	7515656	7515892	236	118.0	
56345	chr11	7516504	7516875	371	186.0	
56346	chr11	7520066	7521603	1537	768.0	
56347	chr11	7522129	7522552	423	212.0	
56348	chr11	7523435	7523836	401	200.0	
56349	chr11	7524549	7525258	709	354.0	
56350	chr11	7526942	7527514	572	286.0	
56351	chr11	7530903	7531465	562	281.0	
56352	chr11	7536135	7536473	338	169.0	
56353	chr11	7538017	7538405	388	194.0	
56354	chr11	7548864	7549237	373	186.0	
56355	chr11	7571635	7572163	528	264.0	
56356	chr11	7577661	7578647	986	493.0	
56357	chr11	7579266	7579903	637	318.0	
56358	chr11	7580755	7581080	325	162.0	
56359	chr11	7590371	7590414	43	22.0	
56360	chr11	7591704	7593457	1753	876.0	
56361	chr11	7600166	7600678	512	256.0	
56362	chr11	7651372	7651459	87	44.0	
56363	chr11	7657314	7657746	432	216.0	
56364	chr11	7665530	7666190	660	330.0	
56365	chr11	7673298	7674486	1188	594.0	
56366	chr11	7676972	7677564	592	296.0	
56367	chr11	7688229	7688630	401	200.0	
56368	chr11	7694558	7695128	570	285.0	
56369	chr11	7892704	7893366	662	331.0	
56370	chr11	7986277	7988022	1745	872.0	
56371	chr11	8006323	8006787	464	232.0	
56372	chr11	8018439	8020277	1838	919.0	
56373	chr11	8033077	8033761	684	342.0	
56374	chr11	8081122	8081286	164	82.0	
56375	chr11	8092673	8092892	219	110.0	
56376	chr11	8099278	8099692	414	207.0	
56377	chr11	8168465	8169359	894	447.0	
56378	chr11	8192503	8193016	513	256.0	
56379	chr11	8197963	8198364	401	200.0	
56380	chr11	8201543	8202585	1042	521.0	
56381	chr11	8206101	8207347	1246	623.0	enhancer
56382	chr11	8209143	8209619	476	238.0	
56383	chr11	8219310	8219594	284	142.0	
56384	chr11	8225513	8226011	498	249.0	
56385	chr11	8258967	8259214	247	124.0	
56386	chr11	8262761	8264240	1479	740.0	
56387	chr11	8267818	8268517	699	350.0	
56388	chr11	8327655	8329402	1747	874.0	
56389	chr11	8331904	8332691	787	394.0	
56390	chr11	8333973	8334468	495	248.0	
56391	chr11	8338008	8338452	444	222.0	
56392	chr11	8340238	8340787	549	274.0	
56393	chr11	8343604	8343652	48	24.0	
56394	chr11	8348214	8348366	152	76.0	
56395	chr11	8363802	8364572	770	385.0	
56396	chr11	8384178	8384579	401	200.0	
56397	chr11	8533371	8533674	303	152.0	
56398	chr11	8566615	8566970	355	178.0	
56399	chr11	8593823	8594515	692	346.0	
56400	chr11	8603970	8604706	736	368.0	
56401	chr11	8681806	8684517	2711	1356.0	
56402	chr11	8686277	8686288	11	6.0	
56403	chr11	8687393	8689690	2297	1148.0	
56404	chr11	8704995	8705648	653	326.0	
56405	chr11	8715527	8715958	431	216.0	
56406	chr11	8718284	8718751	467	234.0	
56407	chr11	8732222	8732771	549	274.0	
56408	chr11	8810523	8810883	360	180.0	
56409	chr11	8812462	8812883	421	210.0	
56410	chr11	8813594	8813997	403	202.0	
56411	chr11	8827310	8827510	200	100.0	
56412	chr11	8828640	8828941	301	150.0	
56413	chr11	8910080	8912276	2196	1098.0	
56414	chr11	8913912	8914829	917	458.0	
56415	chr11	8959495	8960018	523	262.0	
56416	chr11	8962634	8965548	2914	1457.0	
56417	chr11	8967379	8967469	90	45.0	
56418	chr11	8989499	8989585	86	43.0	
56419	chr11	9001628	9002312	684	342.0	
56420	chr11	9002945	9006346	3401	1700.0	
56421	chr11	9015525	9016203	678	339.0	
56422	chr11	9017533	9018450	917	458.0	
56423	chr11	9038511	9039558	1047	524.0	
56424	chr11	9060561	9061357	796	398.0	
56425	chr11	9130325	9130722	397	198.0	
56426	chr11	9137508	9138364	856	428.0	
56427	chr11	9158901	9159574	673	336.0	
56428	chr11	9160098	9160905	807	404.0	
56429	chr11	9162073	9162579	506	253.0	
56430	chr11	9163372	9163781	409	204.0	
56431	chr11	9165806	9166322	516	258.0	
56432	chr11	9203917	9204267	350	175.0	
56433	chr11	9209042	9209294	252	126.0	
56434	chr11	9211038	9211327	289	144.0	
56435	chr11	9231333	9232267	934	467.0	
56436	chr11	9246299	9246876	577	288.0	
56437	chr11	9249964	9251664	1700	850.0	
56438	chr11	9260410	9261178	768	384.0	
56439	chr11	9263117	9265969	2852	1426.0	
56440	chr11	9273145	9274378	1233	616.0	
56441	chr11	9280535	9281125	590	295.0	
56442	chr11	9313655	9315499	1844	922.0	
56443	chr11	9317216	9317818	602	301.0	
56444	chr11	9347256	9347427	171	86.0	
56445	chr11	9362540	9362690	150	75.0	
56446	chr11	9363729	9365047	1318	659.0	
56447	chr11	9376273	9376499	226	113.0	
56448	chr11	9384144	9385761	1617	808.0	
56449	chr11	9393014	9393544	530	265.0	
56450	chr11	9417560	9418035	475	238.0	
56451	chr11	9459645	9462824	3179	1590.0	
56452	chr11	9502729	9502779	50	25.0	
56453	chr11	9506486	9507216	730	365.0	
56454	chr11	9510767	9511527	760	380.0	
56455	chr11	9513314	9513722	408	204.0	
56456	chr11	9534856	9535770	914	457.0	
56457	chr11	9551867	9552415	548	274.0	
56458	chr11	9565867	9566439	572	286.0	
56459	chr11	9568822	9569307	485	242.0	
56460	chr11	9572568	9576250	3682	1841.0	
56461	chr11	9577247	9578771	1524	762.0	
56462	chr11	9600697	9602132	1435	718.0	
56463	chr11	9613065	9615621	2556	1278.0	
56464	chr11	9631086	9631733	647	324.0	
56465	chr11	9633690	9634079	389	194.0	
56466	chr11	9639030	9640530	1500	750.0	
56467	chr11	9642973	9643225	252	126.0	
56468	chr11	9660882	9661348	466	233.0	
56469	chr11	9662094	9662857	763	382.0	
56470	chr11	9663385	9665152	1767	884.0	
56471	chr11	9667311	9667324	13	6.0	
56472	chr11	9681697	9682229	532	266.0	
56473	chr11	9688950	9689600	650	325.0	
56474	chr11	9691768	9692223	455	228.0	
56475	chr11	9692740	9693044	304	152.0	
56476	chr11	9702378	9702435	57	28.0	
56477	chr11	9716550	9717278	728	364.0	
56478	chr11	9719881	9720472	591	296.0	
56479	chr11	9739135	9739566	431	216.0	
56480	chr11	9745371	9746043	672	336.0	
56481	chr11	9748276	9748959	683	342.0	
56482	chr11	9755739	9755988	249	124.0	
56483	chr11	9757563	9760199	2636	1318.0	
56484	chr11	9862069	9862537	468	234.0	
56485	chr11	9947606	9947711	105	52.0	
56486	chr11	9972923	9973225	302	151.0	
56487	chr11	10017934	10018316	382	191.0	
56488	chr11	10041763	10042492	729	364.0	
56489	chr11	10207967	10208502	535	268.0	
56490	chr11	10255768	10255786	18	9.0	
56491	chr11	10285049	10285928	879	440.0	
56492	chr11	10288198	10288536	338	169.0	
56493	chr11	10290000	10290417	417	208.0	
56494	chr11	10292066	10292388	322	161.0	
56495	chr11	10293088	10295905	2817	1408.0	
56496	chr11	10297853	10298942	1089	544.0	
56497	chr11	10302217	10308674	6457	3228.0	
56498	chr11	10314552	10315158	606	303.0	
56499	chr11	10317860	10318279	419	210.0	
56500	chr11	10322742	10323460	718	359.0	
56501	chr11	10327246	10328812	1566	783.0	
56502	chr11	10366393	10367096	703	352.0	
56503	chr11	10377219	10377607	388	194.0	
56504	chr11	10382527	10383006	479	240.0	
56505	chr11	10398403	10398952	549	274.0	
56506	chr11	10400874	10401275	401	200.0	
56507	chr11	10406072	10406591	519	260.0	
56508	chr11	10407113	10407398	285	142.0	
56509	chr11	10413222	10413736	514	257.0	
56510	chr11	10414587	10415123	536	268.0	
56511	chr11	10436020	10437109	1089	544.0	
56512	chr11	10441874	10442643	769	384.0	
56513	chr11	10444950	10445359	409	204.0	
56514	chr11	10449912	10452399	2487	1244.0	
56515	chr11	10454831	10457019	2188	1094.0	
56516	chr11	10458736	10459934	1198	599.0	
56517	chr11	10460649	10460751	102	51.0	
56518	chr11	10488643	10489515	872	436.0	
56519	chr11	10502407	10504484	2077	1038.0	
56520	chr11	10540376	10541951	1575	788.0	
56521	chr11	10544958	10545517	559	280.0	
56522	chr11	10564987	10565022	35	18.0	
56523	chr11	10581301	10582203	902	451.0	
56524	chr11	10592314	10592766	452	226.0	
56525	chr11	10597775	10598412	637	318.0	
56526	chr11	10600913	10601171	258	129.0	
56527	chr11	10601847	10602354	507	254.0	
56528	chr11	10605961	10607084	1123	562.0	
56529	chr11	10608523	10608966	443	222.0	
56530	chr11	10612169	10612866	697	348.0	
56531	chr11	10623017	10623986	969	484.0	
56532	chr11	10639282	10640720	1438	719.0	
56533	chr11	10641477	10642164	687	344.0	
56534	chr11	10654073	10655357	1284	642.0	
56535	chr11	10657388	10657818	430	215.0	
56536	chr11	10659038	10660080	1042	521.0	
56537	chr11	10673564	10673935	371	186.0	
56538	chr11	10674877	10675504	627	314.0	
56539	chr11	10725154	10726030	876	438.0	
56540	chr11	10730300	10730514	214	107.0	
56541	chr11	10735351	10736490	1139	570.0	
56542	chr11	10742639	10744206	1567	784.0	
56543	chr11	10748608	10748882	274	137.0	
56544	chr11	10750537	10752132	1595	798.0	
56545	chr11	10758969	10759331	362	181.0	
56546	chr11	10770661	10770991	330	165.0	
56547	chr11	10777892	10778208	316	158.0	
56548	chr11	10786031	10786679	648	324.0	
56549	chr11	10791637	10800880	9243	4622.0	
56550	chr11	10802653	10802824	171	86.0	
56551	chr11	10803356	10810257	6901	3450.0	
56552	chr11	10815017	10815459	442	221.0	
56553	chr11	10823380	10823415	35	18.0	
56554	chr11	10824829	10825338	509	254.0	
56555	chr11	10856624	10859337	2713	1356.0	
56556	chr11	10878560	10879265	705	352.0	
56557	chr11	10892184	10892709	525	262.0	
56558	chr11	10897867	10900805	2938	1469.0	
56559	chr11	10902396	10903093	697	348.0	
56560	chr11	10913976	10914443	467	234.0	
56561	chr11	10918688	10919123	435	218.0	
56562	chr11	10920262	10920576	314	157.0	
56563	chr11	10930441	10932073	1632	816.0	
56564	chr11	10933488	10934827	1339	670.0	
56565	chr11	10978200	10978562	362	181.0	
56566	chr11	10979435	10979944	509	254.0	
56567	chr11	10990138	10990591	453	226.0	
56568	chr11	11010569	11010921	352	176.0	
56569	chr11	11022582	11022763	181	90.0	
56570	chr11	11028026	11028515	489	244.0	
56571	chr11	11036788	11037265	477	238.0	
56572	chr11	11149440	11150771	1331	666.0	
56573	chr11	11155904	11157591	1687	844.0	
56574	chr11	11171717	11172356	639	320.0	
56575	chr11	11243697	11244604	907	454.0	
56576	chr11	11266001	11266405	404	202.0	
56577	chr11	11311071	11311704	633	316.0	
56578	chr11	11313365	11313812	447	224.0	
56579	chr11	11318887	11319397	510	255.0	
56580	chr11	11370223	11370699	476	238.0	
56581	chr11	11416541	11417212	671	336.0	
56582	chr11	11620922	11622477	1555	778.0	
56583	chr11	11787696	11788214	518	259.0	
56584	chr11	11798709	11799260	551	276.0	
56585	chr11	11841033	11843782	2749	1374.0	
56586	chr11	11844713	11845148	435	218.0	
56587	chr11	11848921	11849878	957	478.0	
56588	chr11	11856578	11858318	1740	870.0	
56589	chr11	11865138	11865167	29	14.0	
56590	chr11	11871553	11872415	862	431.0	
56591	chr11	11884841	11885203	362	181.0	
56592	chr11	11931418	11931819	401	200.0	
56593	chr11	11960288	11961112	824	412.0	
56594	chr11	11966768	11967267	499	250.0	
56595	chr11	11987549	11988063	514	257.0	
56596	chr11	11995531	11996021	490	245.0	
56597	chr11	11998417	11998807	390	195.0	
56598	chr11	12008290	12009686	1396	698.0	
56599	chr11	12024241	12024697	456	228.0	
56600	chr11	12042103	12042735	632	316.0	
56601	chr11	12044179	12045001	822	411.0	
56602	chr11	12046222	12047990	1768	884.0	
56603	chr11	12066978	12067361	383	192.0	
56604	chr11	12086173	12088502	2329	1164.0	
56605	chr11	12089940	12090733	793	396.0	
56606	chr11	12091664	12092059	395	198.0	
56607	chr11	12098957	12099582	625	312.0	
56608	chr11	12109522	12111611	2089	1044.0	
56609	chr11	12112170	12112383	213	106.0	
56610	chr11	12118868	12119223	355	178.0	
56611	chr11	12124371	12125330	959	480.0	
56612	chr11	12126461	12127028	567	284.0	
56613	chr11	12128463	12128569	106	53.0	
56614	chr11	12130401	12130571	170	85.0	
56615	chr11	12133827	12134667	840	420.0	
56616	chr11	12157342	12157559	217	108.0	
56617	chr11	12159212	12160257	1045	522.0	
56618	chr11	12166987	12167511	524	262.0	
56619	chr11	12170868	12171313	445	222.0	
56620	chr11	12174348	12174978	630	315.0	
56621	chr11	12175863	12176328	465	232.0	
56622	chr11	12189477	12190023	546	273.0	
56623	chr11	12192735	12193291	556	278.0	
56624	chr11	12195633	12196978	1345	672.0	
56625	chr11	12198133	12199793	1660	830.0	
56626	chr11	12200342	12200367	25	12.0	
56627	chr11	12214900	12216844	1944	972.0	
56628	chr11	12221851	12222931	1080	540.0	
56629	chr11	12223538	12225436	1898	949.0	
56630	chr11	12235582	12236998	1416	708.0	
56631	chr11	12242259	12242665	406	203.0	
56632	chr11	12281577	12282313	736	368.0	
56633	chr11	12288615	12288938	323	162.0	
56634	chr11	12331278	12331697	419	210.0	
56635	chr11	12356944	12357296	352	176.0	
56636	chr11	12362704	12363314	610	305.0	
56637	chr11	12365945	12366784	839	420.0	
56638	chr11	12377338	12378339	1001	500.0	
56639	chr11	12673728	12675381	1653	826.0	
56640	chr11	12680339	12680734	395	198.0	"enhancer	sequence_feature"
56641	chr11	12717787	12718398	611	306.0	
56642	chr11	12888740	12889822	1082	541.0	
56643	chr11	12894095	12894465	370	185.0	
56644	chr11	12964002	12964467	465	232.0	
56645	chr11	13055210	13055577	367	184.0	
56646	chr11	13183128	13183741	613	306.0	
56647	chr11	13205511	13205772	261	130.0	
56648	chr11	13207625	13208615	990	495.0	
56649	chr11	13210341	13210716	375	188.0	
56650	chr11	13238863	13239328	465	232.0	
56651	chr11	13250077	13250269	192	96.0	
56652	chr11	13275834	13275840	6	3.0	
56653	chr11	13276402	13279291	2889	1444.0	
56654	chr11	13279847	13281169	1322	661.0	
56655	chr11	13286355	13287627	1272	636.0	
56656	chr11	13297745	13298397	652	326.0	
56657	chr11	13303562	13304676	1114	557.0	
56658	chr11	13316418	13316676	258	129.0	
56659	chr11	13318871	13319249	378	189.0	
56660	chr11	13332788	13335716	2928	1464.0	
56661	chr11	13337914	13339670	1756	878.0	
56662	chr11	13343858	13344586	728	364.0	
56663	chr11	13348410	13348690	280	140.0	
56664	chr11	13384841	13385228	387	194.0	
56665	chr11	13462212	13464219	2007	1004.0	
56666	chr11	13465731	13466358	627	314.0	
56667	chr11	13486993	13488114	1121	560.0	
56668	chr11	13550690	13551200	510	255.0	
56669	chr11	13667297	13670157	2860	1430.0	
56670	chr11	13672763	13673263	500	250.0	
56671	chr11	13674186	13675584	1398	699.0	
56672	chr11	13680379	13680964	585	292.0	
56673	chr11	13691235	13691728	493	246.0	
56674	chr11	13745254	13745513	259	130.0	
56675	chr11	13772395	13772879	484	242.0	
56676	chr11	13776133	13776549	416	208.0	
56677	chr11	13860017	13860404	387	194.0	
56678	chr11	13868739	13869815	1076	538.0	
56679	chr11	13923747	13925013	1266	633.0	
56680	chr11	13938879	13938883	4	2.0	
56681	chr11	13940517	13941000	483	242.0	
56682	chr11	13955818	13956375	557	278.0	
56683	chr11	13962433	13964568	2135	1068.0	
56684	chr11	14035558	14035861	303	152.0	
56685	chr11	14074983	14075585	602	301.0	
56686	chr11	14078929	14079475	546	273.0	
56687	chr11	14148688	14149026	338	169.0	
56688	chr11	14189858	14190285	427	214.0	
56689	chr11	14237311	14238138	827	414.0	
56690	chr11	14249091	14249762	671	336.0	
56691	chr11	14269941	14271695	1754	877.0	
56692	chr11	14288242	14288677	435	218.0	
56693	chr11	14300611	14301180	569	284.0	
56694	chr11	14308588	14309513	925	462.0	
56695	chr11	14313079	14313566	487	244.0	
56696	chr11	14314167	14314502	335	168.0	
56697	chr11	14318484	14318502	18	9.0	
56698	chr11	14319894	14320556	662	331.0	
56699	chr11	14325080	14325422	342	171.0	
56700	chr11	14331455	14331914	459	230.0	
56701	chr11	14336916	14337489	573	286.0	
56702	chr11	14350225	14350647	422	211.0	
56703	chr11	14357549	14359828	2279	1140.0	
56704	chr11	14380860	14381697	837	418.0	
56705	chr11	14393838	14394367	529	264.0	
56706	chr11	14414665	14415686	1021	510.0	
56707	chr11	14435671	14436129	458	229.0	
56708	chr11	14451807	14452140	333	166.0	
56709	chr11	14454929	14455649	720	360.0	
56710	chr11	14499006	14501153	2147	1074.0	
56711	chr11	14518720	14521249	2529	1264.0	
56712	chr11	14536822	14537796	974	487.0	
56713	chr11	14541053	14541681	628	314.0	
56714	chr11	14544447	14545055	608	304.0	
56715	chr11	14554666	14555755	1089	544.0	
56716	chr11	14567279	14567352	73	36.0	
56717	chr11	14569425	14569996	571	286.0	
56718	chr11	14577781	14579312	1531	766.0	
56719	chr11	14587221	14587732	511	256.0	
56720	chr11	14611857	14612967	1110	555.0	
56721	chr11	14623265	14623363	98	49.0	
56722	chr11	14625369	14626320	951	476.0	
56723	chr11	14633628	14633881	253	126.0	
56724	chr11	14635765	14636785	1020	510.0	
56725	chr11	14638559	14638900	341	170.0	
56726	chr11	14642787	14646593	3806	1903.0	
56727	chr11	14673948	14674349	401	200.0	
56728	chr11	14713476	14714514	1038	519.0	
56729	chr11	14751831	14752604	773	386.0	
56730	chr11	14764226	14765715	1489	744.0	
56731	chr11	14768773	14769201	428	214.0	
56732	chr11	14774055	14774086	31	16.0	
56733	chr11	14783777	14784508	731	366.0	
56734	chr11	14890722	14892822	2100	1050.0	
56735	chr11	14894784	14895514	730	365.0	
56736	chr11	14898486	14898510	24	12.0	
56737	chr11	14904493	14908981	4488	2244.0	
56738	chr11	14969866	14970185	319	160.0	
56739	chr11	14973423	14975169	1746	873.0	
56740	chr11	15006104	15006548	444	222.0	
56741	chr11	15073313	15075408	2095	1048.0	
56742	chr11	15101098	15101506	408	204.0	
56743	chr11	15113281	15113880	599	300.0	
56744	chr11	15145580	15145814	234	117.0	
56745	chr11	15208532	15209044	512	256.0	
56746	chr11	15577314	15578171	857	428.0	
56747	chr11	15579971	15580589	618	309.0	
56748	chr11	15636615	15637168	553	276.0	
56749	chr11	15638344	15638785	441	220.0	
56750	chr11	15649902	15650938	1036	518.0	
56751	chr11	15770827	15771183	356	178.0	
56752	chr11	15799856	15800926	1070	535.0	
56753	chr11	15815500	15816968	1468	734.0	
56754	chr11	15818696	15820109	1413	706.0	
56755	chr11	15897215	15897604	389	194.0	
56756	chr11	15911734	15911972	238	119.0	
56757	chr11	15968078	15968092	14	7.0	
56758	chr11	16001752	16002333	581	290.0	
56759	chr11	16604401	16607172	2771	1386.0	
56760	chr11	16613352	16614359	1007	504.0	
56761	chr11	16737792	16739822	2030	1015.0	
56762	chr11	16741303	16741792	489	244.0	
56763	chr11	16759959	16760310	351	176.0	
56764	chr11	16779295	16779887	592	296.0	
56765	chr11	16785429	16786084	655	328.0	
56766	chr11	16788321	16788842	521	260.0	
56767	chr11	16790772	16792097	1325	662.0	
56768	chr11	16795078	16795582	504	252.0	
56769	chr11	16796313	16796596	283	142.0	
56770	chr11	16807211	16807846	635	318.0	
56771	chr11	16809894	16810596	702	351.0	
56772	chr11	16814386	16815696	1310	655.0	
56773	chr11	16817257	16817928	671	336.0	
56774	chr11	16820256	16820759	503	252.0	
56775	chr11	16935871	16936208	337	168.0	
56776	chr11	16945903	16946317	414	207.0	
56777	chr11	16986111	16987140	1029	514.0	
56778	chr11	17013585	17015431	1846	923.0	
56779	chr11	17063367	17063836	469	234.0	
56780	chr11	17073501	17073566	65	32.0	
56781	chr11	17076260	17078899	2639	1320.0	
56782	chr11	17082530	17082694	164	82.0	
56783	chr11	17097678	17099151	1473	736.0	
56784	chr11	17161569	17161911	342	171.0	
56785	chr11	17163885	17165178	1293	646.0	
56786	chr11	17203602	17203933	331	166.0	
56787	chr11	17207044	17210004	2960	1480.0	
56788	chr11	17211259	17211675	416	208.0	
56789	chr11	17221958	17222323	365	182.0	
56790	chr11	17230006	17231360	1354	677.0	
56791	chr11	17268689	17269132	443	222.0	
56792	chr11	17273842	17274380	538	269.0	
56793	chr11	17275321	17277881	2560	1280.0	
56794	chr11	17278929	17279330	401	200.0	
56795	chr11	17285340	17287439	2099	1050.0	
56796	chr11	17333846	17334210	364	182.0	
56797	chr11	17350748	17355157	4409	2204.0	
56798	chr11	17383372	17384531	1159	580.0	
56799	chr11	17386539	17387069	530	265.0	
56800	chr11	17387667	17390267	2600	1300.0	
56801	chr11	17400085	17400486	401	200.0	
56802	chr11	17504306	17505024	718	359.0	
56803	chr11	17528135	17528521	386	193.0	
56804	chr11	17544227	17544600	373	186.0	
56805	chr11	17598913	17599321	408	204.0	
56806	chr11	17730987	17731403	416	208.0	
56807	chr11	17735005	17735281	276	138.0	
56808	chr11	17921991	17922359	368	184.0	
56809	chr11	17979711	17980178	467	234.0	
56810	chr11	17991770	17992227	457	228.0	
56811	chr11	18010074	18014267	4193	2096.0	
56812	chr11	18088970	18089403	433	216.0	
56813	chr11	18101251	18101644	393	196.0	
56814	chr11	18105483	18106572	1089	544.0	
56815	chr11	18115260	18116081	821	410.0	
56816	chr11	18229506	18229818	312	156.0	
56817	chr11	18243685	18244377	692	346.0	
56818	chr11	18246174	18247088	914	457.0	
56819	chr11	18267621	18268691	1070	535.0	
56820	chr11	18277510	18278372	862	431.0	
56821	chr11	18280272	18281117	845	422.0	
56822	chr11	18282621	18282979	358	179.0	
56823	chr11	18310658	18311339	681	340.0	
56824	chr11	18312858	18313206	348	174.0	
56825	chr11	18314789	18315190	401	200.0	
56826	chr11	18320577	18323296	2719	1360.0	
56827	chr11	18324114	18324940	826	413.0	
56828	chr11	18330907	18333280	2373	1186.0	
56829	chr11	18382923	18384775	1852	926.0	
56830	chr11	18393822	18400357	6535	3268.0	
56831	chr11	18402524	18402563	39	20.0	
56832	chr11	18404084	18404260	176	88.0	
56833	chr11	18406453	18409489	3036	1518.0	
56834	chr11	18410305	18411436	1131	566.0	
56835	chr11	18412007	18412752	745	372.0	
56836	chr11	18522406	18522752	346	173.0	
56837	chr11	18526046	18528172	2126	1063.0	
56838	chr11	18540228	18540659	431	216.0	
56839	chr11	18579095	18579547	452	226.0	
56840	chr11	18587494	18591388	3894	1947.0	
56841	chr11	18615820	18616430	610	305.0	
56842	chr11	18617477	18619017	1540	770.0	
56843	chr11	18619528	18619895	367	184.0	
56844	chr11	18621873	18622338	465	232.0	
56845	chr11	18631900	18632122	222	111.0	
56846	chr11	18633153	18635293	2140	1070.0	
56847	chr11	18651087	18651612	525	262.0	
56848	chr11	18665407	18665482	75	38.0	
56849	chr11	18667041	18667414	373	186.0	
56850	chr11	18669226	18669686	460	230.0	
56851	chr11	18672115	18672871	756	378.0	
56852	chr11	18697144	18700918	3774	1887.0	
56853	chr11	18705469	18708524	3055	1528.0	
56854	chr11	18720594	18722618	2024	1012.0	
56855	chr11	18727529	18728107	578	289.0	
56856	chr11	18731602	18732554	952	476.0	
56857	chr11	18749088	18749525	437	218.0	
56858	chr11	18764022	18764713	691	346.0	
56859	chr11	18768570	18768804	234	117.0	
56860	chr11	18775698	18776031	333	166.0	
56861	chr11	18802616	18803020	404	202.0	
56862	chr11	19060584	19061013	429	214.0	
56863	chr11	19071077	19071681	604	302.0	
56864	chr11	19076708	19077413	705	352.0	
56865	chr11	19116285	19118032	1747	874.0	
56866	chr11	19240277	19242678	2401	1200.0	
56867	chr11	19243575	19244981	1406	703.0	
56868	chr11	19259688	19260172	484	242.0	
56869	chr11	19279509	19279742	233	116.0	
56870	chr11	19280828	19281513	685	342.0	
56871	chr11	19284021	19284317	296	148.0	
56872	chr11	19311320	19311757	437	218.0	
56873	chr11	19553678	19554154	476	238.0	
56874	chr11	19557642	19558088	446	223.0	
56875	chr11	19563967	19564461	494	247.0	
56876	chr11	19625402	19625909	507	254.0	
56877	chr11	19711889	19714820	2931	1466.0	
56878	chr11	19723404	19724424	1020	510.0	
56879	chr11	19742605	19743120	515	258.0	
56880	chr11	19938210	19938611	401	200.0	
56881	chr11	19951466	19952129	663	332.0	
56882	chr11	19963723	19964068	345	172.0	
56883	chr11	19970865	19971468	603	302.0	
56884	chr11	20046422	20046743	321	160.0	
56885	chr11	20110831	20111298	467	234.0	
56886	chr11	20112422	20112618	196	98.0	
56887	chr11	20128165	20128677	512	256.0	
56888	chr11	20131989	20132851	862	431.0	
56889	chr11	20156173	20157451	1278	639.0	
56890	chr11	20353815	20354272	457	228.0	
56891	chr11	20355187	20355675	488	244.0	
56892	chr11	20360443	20361205	762	381.0	
56893	chr11	20363116	20364784	1668	834.0	
56894	chr11	20367575	20367918	343	172.0	
56895	chr11	20386628	20388823	2195	1098.0	
56896	chr11	20397204	20397664	460	230.0	
56897	chr11	20474912	20475271	359	180.0	
56898	chr11	20610058	20610560	502	251.0	
56899	chr11	20648003	20648336	333	166.0	
56900	chr11	21511864	21512196	332	166.0	
56901	chr11	21625772	21626517	745	372.0	
56902	chr11	21635378	21636085	707	354.0	
56903	chr11	21640506	21640907	401	200.0	
56904	chr11	21896994	21897648	654	327.0	
56905	chr11	21912312	21912745	433	216.0	
56906	chr11	22162812	22163950	1138	569.0	
56907	chr11	22182184	22182575	391	196.0	
56908	chr11	22192727	22193850	1123	562.0	
56909	chr11	22244990	22245399	409	204.0	
56910	chr11	22624719	22626500	1781	890.0	
56911	chr11	22635334	22636134	800	400.0	
56912	chr11	22637983	22638576	593	296.0	
56913	chr11	22657196	22657702	506	253.0	
56914	chr11	22666780	22666971	191	96.0	
56915	chr11	22690857	22691289	432	216.0	
56916	chr11	22787568	22787963	395	198.0	
56917	chr11	22828833	22830505	1672	836.0	
56918	chr11	22875830	22876326	496	248.0	
56919	chr11	23181014	23181405	391	196.0	
56920	chr11	23539986	23540496	510	255.0	
56921	chr11	23564449	23564611	162	81.0	
56922	chr11	23569386	23569925	539	270.0	
56923	chr11	23688847	23689217	370	185.0	
56924	chr11	24312469	24312853	384	192.0	
56925	chr11	26087197	26087891	694	347.0	
56926	chr11	26276808	26277168	360	180.0	
56927	chr11	26284588	26285257	669	334.0	
56928	chr11	27184178	27184299	121	60.0	
56929	chr11	27234106	27234437	331	166.0	
56930	chr11	27362572	27363930	1358	679.0	
56931	chr11	27468190	27468609	419	210.0	
56932	chr11	27471135	27473395	2260	1130.0	
56933	chr11	27485904	27486346	442	221.0	
56934	chr11	27497230	27497625	395	198.0	
56935	chr11	27499028	27499596	568	284.0	
56936	chr11	27505903	27507774	1871	936.0	
56937	chr11	27698949	27699301	352	176.0	
56938	chr11	28107141	28108917	1776	888.0	
56939	chr11	28109713	28111250	1537	768.0	
56940	chr11	29518464	29519206	742	371.0	
56941	chr11	29527319	29528049	730	365.0	
56942	chr11	30196615	30196977	362	181.0	
56943	chr11	30281992	30282601	609	304.0	
56944	chr11	30322550	30324087	1537	768.0	
56945	chr11	30326145	30327010	865	432.0	
56946	chr11	30333445	30333734	289	144.0	
56947	chr11	30342325	30343231	906	453.0	
56948	chr11	30346059	30346520	461	230.0	
56949	chr11	30483106	30483269	163	82.0	
56950	chr11	30487052	30487796	744	372.0	
56951	chr11	30584271	30584669	398	199.0	
56952	chr11	30585205	30586861	1656	828.0	
56953	chr11	30917795	30918264	469	234.0	
56954	chr11	30919263	30920118	855	428.0	
56955	chr11	31366679	31367239	560	280.0	
56956	chr11	31368807	31370424	1617	808.0	
56957	chr11	31397254	31397640	386	193.0	
56958	chr11	31487928	31488161	233	116.0	
56959	chr11	31508837	31510583	1746	873.0	
56960	chr11	31809996	31813453	3457	1728.0	"promoter	enhancer	protein_binding_site	protein_binding_site"
56961	chr11	31817177	31818263	1086	543.0	promoter
56962	chr11	31958116	31958521	405	202.0	
56963	chr11	31995098	31996112	1014	507.0	
56964	chr11	32006805	32007196	391	196.0	
56965	chr11	32032407	32033381	974	487.0	
56966	chr11	32052129	32052584	455	228.0	
56967	chr11	32081036	32081440	404	202.0	
56968	chr11	32088323	32088902	579	290.0	
56969	chr11	32090632	32092240	1608	804.0	
56970	chr11	32121063	32121431	368	184.0	
56971	chr11	32122204	32122594	390	195.0	
56972	chr11	32154312	32154689	377	188.0	
56973	chr11	32173486	32173785	299	150.0	
56974	chr11	32176144	32176649	505	252.0	"enhancer	enhancer	sequence_feature"
56975	chr11	32259609	32259877	268	134.0	
56976	chr11	32312814	32313350	536	268.0	
56977	chr11	32323523	32323839	316	158.0	
56978	chr11	32333231	32333871	640	320.0	
56979	chr11	32374464	32374476	12	6.0	
56980	chr11	32420758	32421245	487	244.0	
56981	chr11	32426978	32427259	281	140.0	"region	enhancer	protein_binding_site"
56982	chr11	32435133	32435488	355	178.0	"region	promoter	promoter	protein_binding_site	protein_binding_site"
56983	chr11	32583090	32585462	2372	1186.0	
56984	chr11	32586676	32586872	196	98.0	
56985	chr11	32589013	32589278	265	132.0	
56986	chr11	32594259	32594629	370	185.0	
56987	chr11	32779350	32779432	82	41.0	
56988	chr11	32792820	32793317	497	248.0	
56989	chr11	32809178	32809641	463	232.0	
56990	chr11	32823654	32823972	318	159.0	
56991	chr11	32829129	32830771	1642	821.0	
56992	chr11	32847372	32848112	740	370.0	
56993	chr11	32849764	32850252	488	244.0	
56994	chr11	32852131	32852866	735	368.0	
56995	chr11	32870754	32871047	293	146.0	
56996	chr11	32884823	32885155	332	166.0	
56997	chr11	32891971	32894700	2729	1364.0	
56998	chr11	32902013	32902480	467	234.0	
56999	chr11	32960511	32960981	470	235.0	
57000	chr11	33005079	33005660	581	290.0	
57001	chr11	33011252	33012349	1097	548.0	
57002	chr11	33015413	33016717	1304	652.0	
57003	chr11	33038652	33041057	2405	1202.0	
57004	chr11	33048569	33049210	641	320.0	
57005	chr11	33052258	33052645	387	194.0	
57006	chr11	33063158	33066018	2860	1430.0	
57007	chr11	33160151	33162214	2063	1032.0	
57008	chr11	33165985	33166604	619	310.0	
57009	chr11	33172928	33173413	485	242.0	
57010	chr11	33178453	33179781	1328	664.0	
57011	chr11	33188100	33188574	474	237.0	
57012	chr11	33195351	33196036	685	342.0	
57013	chr11	33197714	33199325	1611	806.0	
57014	chr11	33211046	33212083	1037	518.0	
57015	chr11	33214118	33214778	660	330.0	
57016	chr11	33227878	33228224	346	173.0	
57017	chr11	33248700	33249043	343	172.0	
57018	chr11	33256453	33259266	2813	1406.0	
57019	chr11	33261726	33262411	685	342.0	
57020	chr11	33263495	33263942	447	224.0	
57021	chr11	33266392	33266876	484	242.0	
57022	chr11	33324319	33324922	603	302.0	
57023	chr11	33329690	33330162	472	236.0	
57024	chr11	33347543	33347841	298	149.0	
57025	chr11	33362303	33362793	490	245.0	
57026	chr11	33379969	33380357	388	194.0	
57027	chr11	33387926	33388453	527	264.0	
57028	chr11	33636054	33636669	615	308.0	
57029	chr11	33696408	33696809	401	200.0	
57030	chr11	33699873	33701977	2104	1052.0	
57031	chr11	33722676	33722963	287	144.0	
57032	chr11	33723601	33724000	399	200.0	
57033	chr11	33724602	33724903	301	150.0	
57034	chr11	33731969	33732683	714	357.0	
57035	chr11	33734697	33737895	3198	1599.0	
57036	chr11	33742426	33743093	667	334.0	
57037	chr11	33773298	33775557	2259	1130.0	
57038	chr11	33802560	33802700	140	70.0	
57039	chr11	33808179	33808836	657	328.0	
57040	chr11	33829083	33829931	848	424.0	
57041	chr11	33857792	33858347	555	278.0	
57042	chr11	33867066	33871253	4187	2094.0	
57043	chr11	33874365	33875265	900	450.0	
57044	chr11	33885361	33885805	444	222.0	
57045	chr11	33891110	33892312	1202	601.0	
57046	chr11	33893045	33895337	2292	1146.0	
57047	chr11	33900190	33900500	310	155.0	
57048	chr11	33907415	33907866	451	226.0	
57049	chr11	33912286	33913281	995	498.0	
57050	chr11	33919609	33919997	388	194.0	
57051	chr11	33921063	33921802	739	370.0	
57052	chr11	33930111	33931345	1234	617.0	
57053	chr11	33936939	33937340	401	200.0	
57054	chr11	33941508	33942020	512	256.0	
57055	chr11	33959868	33960291	423	212.0	
57056	chr11	33970977	33971432	455	228.0	
57057	chr11	33987920	33988404	484	242.0	
57058	chr11	33996751	33997640	889	444.0	
57059	chr11	34000973	34001340	367	184.0	
57060	chr11	34037182	34037412	230	115.0	
57061	chr11	34044870	34045344	474	237.0	
57062	chr11	34046247	34046425	178	89.0	
57063	chr11	34050873	34054202	3329	1664.0	
57064	chr11	34065900	34066260	360	180.0	
57065	chr11	34067614	34068008	394	197.0	
57066	chr11	34086783	34086998	215	108.0	
57067	chr11	34103036	34103215	179	90.0	
57068	chr11	34104388	34106479	2091	1046.0	
57069	chr11	34148449	34148917	468	234.0	
57070	chr11	34154097	34154915	818	409.0	
57071	chr11	34158623	34158894	271	136.0	
57072	chr11	34161797	34162120	323	162.0	
57073	chr11	34163668	34164009	341	170.0	
57074	chr11	34174017	34174981	964	482.0	
57075	chr11	34208350	34209006	656	328.0	
57076	chr11	34226160	34226619	459	230.0	
57077	chr11	34233874	34234689	815	408.0	
57078	chr11	34244244	34244301	57	28.0	
57079	chr11	34248351	34249134	783	392.0	
57080	chr11	34250185	34250272	87	44.0	
57081	chr11	34250828	34251917	1089	544.0	
57082	chr11	34300577	34301171	594	297.0	
57083	chr11	34308623	34310627	2004	1002.0	
57084	chr11	34313200	34313537	337	168.0	
57085	chr11	34319016	34319028	12	6.0	
57086	chr11	34321735	34321916	181	90.0	
57087	chr11	34328038	34328347	309	154.0	
57088	chr11	34329322	34329699	377	188.0	
57089	chr11	34333875	34334187	312	156.0	
57090	chr11	34337124	34337304	180	90.0	
57091	chr11	34338951	34340003	1052	526.0	
57092	chr11	34342160	34342627	467	234.0	
57093	chr11	34345024	34345425	401	200.0	
57094	chr11	34351701	34351889	188	94.0	
57095	chr11	34356204	34359924	3720	1860.0	
57096	chr11	34371379	34372138	759	380.0	
57097	chr11	34404929	34405739	810	405.0	
57098	chr11	34416757	34417210	453	226.0	
57099	chr11	34420606	34420907	301	150.0	
57100	chr11	34422272	34422379	107	54.0	
57101	chr11	34425955	34426337	382	191.0	
57102	chr11	34427004	34427756	752	376.0	
57103	chr11	34431836	34433244	1408	704.0	
57104	chr11	34438320	34440213	1893	946.0	
57105	chr11	34450898	34451520	622	311.0	
57106	chr11	34464493	34464958	465	232.0	
57107	chr11	34468219	34468636	417	208.0	
57108	chr11	34492845	34493191	346	173.0	
57109	chr11	34501521	34501940	419	210.0	
57110	chr11	34509472	34509862	390	195.0	
57111	chr11	34512827	34513252	425	212.0	
57112	chr11	34552237	34552691	454	227.0	
57113	chr11	34585523	34586628	1105	552.0	
57114	chr11	34605803	34606199	396	198.0	
57115	chr11	34613450	34613835	385	192.0	
57116	chr11	34614728	34615020	292	146.0	
57117	chr11	34620890	34621108	218	109.0	
57118	chr11	34624009	34624541	532	266.0	
57119	chr11	34633959	34634711	752	376.0	
57120	chr11	34650166	34651100	934	467.0	
57121	chr11	34653916	34655293	1377	688.0	
57122	chr11	34707423	34707822	399	200.0	
57123	chr11	34727481	34727686	205	102.0	
57124	chr11	34840695	34841170	475	238.0	
57125	chr11	34864432	34864806	374	187.0	
57126	chr11	34866427	34866637	210	105.0	
57127	chr11	34909940	34910267	327	164.0	
57128	chr11	34915183	34917346	2163	1082.0	
57129	chr11	34926019	34926538	519	260.0	
57130	chr11	34957248	34957558	310	155.0	
57131	chr11	34997821	34998652	831	416.0	
57132	chr11	35006401	35007218	817	408.0	
57133	chr11	35012353	35014332	1979	990.0	
57134	chr11	35029847	35031233	1386	693.0	
57135	chr11	35035792	35036598	806	403.0	
57136	chr11	35040006	35041159	1153	576.0	
57137	chr11	35042078	35042423	345	172.0	
57138	chr11	35043949	35046107	2158	1079.0	
57139	chr11	35046615	35048764	2149	1074.0	
57140	chr11	35050106	35051011	905	452.0	
57141	chr11	35057930	35059619	1689	844.0	
57142	chr11	35063866	35063870	4	2.0	
57143	chr11	35065972	35067622	1650	825.0	
57144	chr11	35073739	35074161	422	211.0	
57145	chr11	35077430	35079106	1676	838.0	
57146	chr11	35079692	35079873	181	90.0	
57147	chr11	35082030	35085145	3115	1558.0	
57148	chr11	35087562	35088408	846	423.0	
57149	chr11	35089728	35090199	471	236.0	
57150	chr11	35106521	35107077	556	278.0	
57151	chr11	35107792	35108643	851	426.0	
57152	chr11	35110815	35111688	873	436.0	
57153	chr11	35114798	35115453	655	328.0	
57154	chr11	35118950	35119281	331	166.0	
57155	chr11	35122099	35122903	804	402.0	
57156	chr11	35126220	35126918	698	349.0	
57157	chr11	35137433	35149563	12130	6065.0	
57158	chr11	35150495	35176024	25529	12764.0	
57159	chr11	35176778	35181361	4583	2292.0	
57160	chr11	35182255	35183097	842	421.0	
57161	chr11	35187109	35187540	431	216.0	
57162	chr11	35190900	35191539	639	320.0	
57163	chr11	35211036	35211171	135	68.0	
57164	chr11	35211830	35213091	1261	630.0	
57165	chr11	35214507	35215390	883	442.0	
57166	chr11	35216683	35217695	1012	506.0	
57167	chr11	35226808	35227000	192	96.0	
57168	chr11	35227577	35228632	1055	528.0	
57169	chr11	35235632	35237104	1472	736.0	
57170	chr11	35237861	35238565	704	352.0	
57171	chr11	35239720	35239844	124	62.0	
57172	chr11	35247169	35248439	1270	635.0	
57173	chr11	35250635	35251004	369	184.0	
57174	chr11	35257101	35257752	651	326.0	
57175	chr11	35272245	35273097	852	426.0	
57176	chr11	35303600	35304906	1306	653.0	
57177	chr11	35305546	35306179	633	316.0	
57178	chr11	35307964	35308607	643	322.0	
57179	chr11	35311274	35311743	469	234.0	
57180	chr11	35313134	35314046	912	456.0	
57181	chr11	35319092	35319347	255	128.0	
57182	chr11	35330680	35331532	852	426.0	
57183	chr11	35334276	35335520	1244	622.0	
57184	chr11	35337136	35337670	534	267.0	
57185	chr11	35342932	35343708	776	388.0	
57186	chr11	35345128	35345732	604	302.0	
57187	chr11	35349274	35349494	220	110.0	
57188	chr11	35387535	35388000	465	232.0	
57189	chr11	35391036	35391435	399	200.0	
57190	chr11	35391991	35392814	823	412.0	
57191	chr11	35404506	35404825	319	160.0	
57192	chr11	35485651	35486116	465	232.0	
57193	chr11	35579613	35580035	422	211.0	
57194	chr11	35616148	35616597	449	224.0	
57195	chr11	35617699	35619961	2262	1131.0	
57196	chr11	35661912	35663665	1753	876.0	
57197	chr11	35683766	35684232	466	233.0	
57198	chr11	35715034	35715260	226	113.0	
57199	chr11	35721907	35722387	480	240.0	
57200	chr11	35800973	35801441	468	234.0	
57201	chr11	35821665	35822551	886	443.0	
57202	chr11	35905733	35905812	79	40.0	
57203	chr11	35927587	35928387	800	400.0	
57204	chr11	35932219	35933465	1246	623.0	
57205	chr11	35943545	35944650	1105	552.0	
57206	chr11	36060868	36061382	514	257.0	
57207	chr11	36149537	36150386	849	424.0	
57208	chr11	36258774	36258952	178	89.0	
57209	chr11	36265955	36266436	481	240.0	
57210	chr11	36288537	36290108	1571	786.0	
57211	chr11	36292166	36292906	740	370.0	
57212	chr11	36304397	36304719	322	161.0	
57213	chr11	36306776	36307476	700	350.0	
57214	chr11	36326984	36327318	334	167.0	
57215	chr11	36333964	36334284	320	160.0	
57216	chr11	36350086	36350427	341	170.0	
57217	chr11	36352515	36353452	937	468.0	
57218	chr11	36354254	36354796	542	271.0	
57219	chr11	36356089	36356658	569	284.0	
57220	chr11	36360581	36361175	594	297.0	
57221	chr11	36361982	36362309	327	164.0	
57222	chr11	36363430	36363638	208	104.0	
57223	chr11	36365812	36366317	505	252.0	
57224	chr11	36373701	36373764	63	32.0	
57225	chr11	36375080	36378574	3494	1747.0	
57226	chr11	36380703	36381561	858	429.0	
57227	chr11	36382625	36382679	54	27.0	
57228	chr11	36385129	36385538	409	204.0	
57229	chr11	36388171	36388358	187	94.0	
57230	chr11	36390832	36391552	720	360.0	
57231	chr11	36392130	36392783	653	326.0	
57232	chr11	36399453	36399594	141	70.0	
57233	chr11	36400650	36401378	728	364.0	
57234	chr11	36407310	36407756	446	223.0	
57235	chr11	36408445	36409988	1543	772.0	
57236	chr11	36410690	36412122	1432	716.0	
57237	chr11	36412870	36413205	335	168.0	
57238	chr11	36417161	36417613	452	226.0	
57239	chr11	36420498	36421723	1225	612.0	
57240	chr11	36426286	36427454	1168	584.0	
57241	chr11	36449896	36450515	619	310.0	
57242	chr11	36452194	36454201	2007	1004.0	
57243	chr11	36460261	36460616	355	178.0	
57244	chr11	36465801	36465873	72	36.0	
57245	chr11	36466978	36467509	531	266.0	
57246	chr11	36469284	36469429	145	72.0	
57247	chr11	36478684	36479144	460	230.0	
57248	chr11	36487605	36488440	835	418.0	
57249	chr11	36492690	36493328	638	319.0	
57250	chr11	36500405	36500816	411	206.0	
57251	chr11	36508114	36510947	2833	1416.0	
57252	chr11	36533002	36533280	278	139.0	
57253	chr11	36541006	36541488	482	241.0	
57254	chr11	36558343	36559380	1037	518.0	
57255	chr11	36564331	36564989	658	329.0	
57256	chr11	36586495	36586964	469	234.0	
57257	chr11	36594145	36595121	976	488.0	
57258	chr11	36601096	36601547	451	226.0	
57259	chr11	36673068	36673149	81	40.0	
57260	chr11	36684757	36685299	542	271.0	
57261	chr11	36702635	36702996	361	180.0	
57262	chr11	36722727	36722753	26	13.0	
57263	chr11	36724938	36725347	409	204.0	
57264	chr11	36744508	36745011	503	252.0	
57265	chr11	36746948	36747724	776	388.0	
57266	chr11	37450551	37450952	401	200.0	
57267	chr11	39367571	39367897	326	163.0	
57268	chr11	39370903	39371644	741	370.0	
57269	chr11	39375135	39375536	401	200.0	
57270	chr11	40086552	40087284	732	366.0	
57271	chr11	40099745	40100069	324	162.0	
57272	chr11	40293978	40294466	488	244.0	
57273	chr11	43282947	43283310	363	182.0	
57274	chr11	43310125	43310624	499	250.0	
57275	chr11	43311403	43312985	1582	791.0	
57276	chr11	43316486	43316911	425	212.0	
57277	chr11	43358216	43360786	2570	1285.0	
57278	chr11	43367665	43367853	188	94.0	
57279	chr11	43508463	43508786	323	162.0	
57280	chr11	43576985	43577325	340	170.0	
57281	chr11	43579353	43579785	432	216.0	
57282	chr11	43643687	43644837	1150	575.0	
57283	chr11	43679983	43682503	2520	1260.0	
57284	chr11	43687354	43687620	266	133.0	
57285	chr11	43690897	43691867	970	485.0	
57286	chr11	43751753	43752085	332	166.0	
57287	chr11	43758861	43759319	458	229.0	
57288	chr11	43788202	43788992	790	395.0	
57289	chr11	43802565	43802843	278	139.0	
57290	chr11	43830940	43831304	364	182.0	
57291	chr11	43833756	43833894	138	69.0	
57292	chr11	43851987	43852475	488	244.0	
57293	chr11	43868638	43869772	1134	567.0	
57294	chr11	43880152	43881443	1291	646.0	
57295	chr11	43885304	43885731	427	214.0	
57296	chr11	43890165	43890624	459	230.0	
57297	chr11	43920634	43921161	527	264.0	
57298	chr11	43942030	43943606	1576	788.0	
57299	chr11	43944133	43945297	1164	582.0	
57300	chr11	44037362	44037670	308	154.0	
57301	chr11	44065628	44067735	2107	1054.0	
57302	chr11	44094178	44096801	2623	1312.0	
57303	chr11	44110161	44110663	502	251.0	
57304	chr11	44116345	44116751	406	203.0	
57305	chr11	44286270	44286703	433	216.0	
57306	chr11	44305553	44306448	895	448.0	
57307	chr11	44309747	44309768	21	10.0	
57308	chr11	44350961	44351438	477	238.0	
57309	chr11	44409850	44410208	358	179.0	
57310	chr11	44523462	44523908	446	223.0	
57311	chr11	44530490	44530696	206	103.0	
57312	chr11	44538228	44538907	679	340.0	
57313	chr11	44542534	44542577	43	22.0	
57314	chr11	44556552	44557788	1236	618.0	
57315	chr11	44559307	44560233	926	463.0	
57316	chr11	44564183	44571037	6854	3427.0	
57317	chr11	44574441	44575348	907	454.0	
57318	chr11	44578291	44578829	538	269.0	
57319	chr11	44591323	44592931	1608	804.0	
57320	chr11	44595963	44597956	1993	996.0	
57321	chr11	44600934	44601718	784	392.0	
57322	chr11	44608980	44609956	976	488.0	
57323	chr11	44611277	44612483	1206	603.0	
57324	chr11	44616454	44617328	874	437.0	
57325	chr11	44621039	44621576	537	268.0	
57326	chr11	44623428	44623791	363	182.0	
57327	chr11	44625771	44626200	429	214.0	
57328	chr11	44632752	44633109	357	178.0	
57329	chr11	44637425	44637917	492	246.0	
57330	chr11	44658680	44658757	77	38.0	
57331	chr11	44680866	44681733	867	434.0	
57332	chr11	44694521	44694796	275	138.0	
57333	chr11	44725861	44728360	2499	1250.0	
57334	chr11	44747668	44747683	15	8.0	
57335	chr11	44775354	44775796	442	221.0	
57336	chr11	44861778	44862884	1106	553.0	
57337	chr11	44871654	44872176	522	261.0	
57338	chr11	44894059	44894579	520	260.0	
57339	chr11	44899954	44900392	438	219.0	
57340	chr11	44910922	44911906	984	492.0	
57341	chr11	44915485	44917326	1841	920.0	
57342	chr11	44926879	44927686	807	404.0	
57343	chr11	44936175	44937329	1154	577.0	
57344	chr11	44939342	44940068	726	363.0	
57345	chr11	44942214	44944005	1791	896.0	
57346	chr11	44948951	44951770	2819	1410.0	
57347	chr11	44954773	44955611	838	419.0	
57348	chr11	44970206	44970745	539	270.0	
57349	chr11	44974168	44974526	358	179.0	
57350	chr11	44977663	44978116	453	226.0	
57351	chr11	44978981	44979180	199	100.0	
57352	chr11	45025873	45026693	820	410.0	
57353	chr11	45029276	45029677	401	200.0	
57354	chr11	45032031	45032585	554	277.0	
57355	chr11	45042525	45042926	401	200.0	
57356	chr11	45045580	45046621	1041	520.0	
57357	chr11	45048348	45048694	346	173.0	
57358	chr11	45073533	45074013	480	240.0	
57359	chr11	45078932	45080852	1920	960.0	
57360	chr11	45082808	45083885	1077	538.0	
57361	chr11	45089888	45090169	281	140.0	
57362	chr11	45093133	45094129	996	498.0	
57363	chr11	45097879	45098325	446	223.0	
57364	chr11	45100300	45101140	840	420.0	
57365	chr11	45102282	45103618	1336	668.0	
57366	chr11	45105279	45106108	829	414.0	
57367	chr11	45110515	45111046	531	266.0	
57368	chr11	45113843	45114149	306	153.0	
57369	chr11	45145785	45148227	2442	1221.0	
57370	chr11	45180073	45181288	1215	608.0	
57371	chr11	45233403	45233872	469	234.0	
57372	chr11	45293551	45293995	444	222.0	
57373	chr11	45332343	45332837	494	247.0	
57374	chr11	45339737	45340674	937	468.0	
57375	chr11	45354851	45356105	1254	627.0	
57376	chr11	45371127	45371755	628	314.0	
57377	chr11	45374575	45375105	530	265.0	
57378	chr11	45519058	45519481	423	212.0	
57379	chr11	45646511	45646988	477	238.0	
57380	chr11	45655216	45655649	433	216.0	
57381	chr11	45658588	45658817	229	114.0	
57382	chr11	45665384	45665965	581	290.0	
57383	chr11	45770958	45772530	1572	786.0	
57384	chr11	45795467	45795824	357	178.0	
57385	chr11	45801609	45802103	494	247.0	
57386	chr11	45803733	45805947	2214	1107.0	
57387	chr11	45817188	45817584	396	198.0	
57388	chr11	45819177	45819524	347	174.0	
57389	chr11	45842913	45843984	1071	536.0	
57390	chr11	45845139	45845669	530	265.0	
57391	chr11	45846483	45848861	2378	1189.0	
57392	chr11	45852814	45853088	274	137.0	
57393	chr11	45858023	45858414	391	196.0	
57394	chr11	45872681	45873148	467	234.0	
57395	chr11	45884976	45886654	1678	839.0	
57396	chr11	45899111	45901213	2102	1051.0	
57397	chr11	45901794	45902135	341	170.0	
57398	chr11	45903461	45903470	9	4.0	
57399	chr11	45904549	45904789	240	120.0	
57400	chr11	45905843	45908368	2525	1262.0	
57401	chr11	45909097	45909179	82	41.0	
57402	chr11	45917100	45920295	3195	1598.0	
57403	chr11	45921953	45923795	1842	921.0	
57404	chr11	45927165	45928113	948	474.0	
57405	chr11	45929637	45931656	2019	1010.0	
57406	chr11	45933130	45933882	752	376.0	
57407	chr11	45938623	45939076	453	226.0	
57408	chr11	45964780	45965506	726	363.0	
57409	chr11	46006369	46006842	473	236.0	
57410	chr11	46040831	46041059	228	114.0	
57411	chr11	46099914	46101061	1147	574.0	
57412	chr11	46112885	46113448	563	282.0	
57413	chr11	46117889	46122738	4849	2424.0	
57414	chr11	46126906	46127825	919	460.0	
57415	chr11	46210004	46210692	688	344.0	
57416	chr11	46229317	46229427	110	55.0	
57417	chr11	46236052	46239848	3796	1898.0	
57418	chr11	46242916	46244016	1100	550.0	
57419	chr11	46247704	46247706	2	1.0	
57420	chr11	46278379	46278801	422	211.0	
57421	chr11	46295036	46296339	1303	652.0	
57422	chr11	46302803	46303333	530	265.0	
57423	chr11	46305230	46305742	512	256.0	
57424	chr11	46308478	46309000	522	261.0	
57425	chr11	46309796	46310236	440	220.0	
57426	chr11	46314985	46315592	607	304.0	
57427	chr11	46318192	46319375	1183	592.0	
57428	chr11	46321465	46322187	722	361.0	
57429	chr11	46330473	46334054	3581	1790.0	
57430	chr11	46336642	46337222	580	290.0	
57431	chr11	46338659	46340245	1586	793.0	
57432	chr11	46342119	46342722	603	302.0	
57433	chr11	46344797	46349957	5160	2580.0	
57434	chr11	46351627	46354434	2807	1404.0	
57435	chr11	46356861	46357805	944	472.0	
57436	chr11	46360740	46363923	3183	1592.0	
57437	chr11	46367040	46368348	1308	654.0	
57438	chr11	46369374	46370022	648	324.0	
57439	chr11	46378094	46383283	5189	2594.0	
57440	chr11	46387785	46393363	5578	2789.0	
57441	chr11	46489949	46490331	382	191.0	
57442	chr11	46518933	46519348	415	208.0	
57443	chr11	46529067	46529757	690	345.0	
57444	chr11	46537774	46538256	482	241.0	
57445	chr11	46554129	46554741	612	306.0	
57446	chr11	46560091	46561307	1216	608.0	
57447	chr11	46593248	46594705	1457	728.0	
57448	chr11	46616501	46618476	1975	988.0	
57449	chr11	46659982	46660215	233	116.0	
57450	chr11	46669785	46671965	2180	1090.0	
57451	chr11	46672525	46672959	434	217.0	
57452	chr11	46674708	46675748	1040	520.0	
57453	chr11	46676447	46677530	1083	542.0	
57454	chr11	46699925	46701628	1703	852.0	
57455	chr11	46808817	46809140	323	162.0	
57456	chr11	46826244	46827362	1118	559.0	
57457	chr11	46845390	46846760	1370	685.0	
57458	chr11	46856848	46858061	1213	606.0	
57459	chr11	46859281	46859339	58	29.0	
57460	chr11	46889184	46890273	1089	544.0	
57461	chr11	46916385	46918890	2505	1252.0	
57462	chr11	46919766	46920293	527	264.0	
57463	chr11	46936233	46937344	1111	556.0	
57464	chr11	46981665	46981801	136	68.0	
57465	chr11	47118898	47119360	462	231.0	
57466	chr11	47152306	47153869	1563	782.0	
57467	chr11	47154986	47155694	708	354.0	
57468	chr11	47160790	47161987	1197	598.0	
57469	chr11	47175955	47178306	2351	1176.0	
57470	chr11	47179452	47179929	477	238.0	
57471	chr11	47185528	47187818	2290	1145.0	
57472	chr11	47213784	47216743	2959	1480.0	
57473	chr11	47225476	47226437	961	480.0	
57474	chr11	47233961	47235540	1579	790.0	
57475	chr11	47244782	47245421	639	320.0	
57476	chr11	47248077	47249539	1462	731.0	
57477	chr11	47254285	47255234	949	474.0	
57478	chr11	47257649	47258290	641	320.0	
57479	chr11	47259454	47259947	493	246.0	
57480	chr11	47265217	47265530	313	156.0	
57481	chr11	47268202	47272400	4198	2099.0	
57482	chr11	47328316	47328941	625	312.0	
57483	chr11	47355235	47355642	407	204.0	
57484	chr11	47359333	47360227	894	447.0	
57485	chr11	47360834	47361647	813	406.0	
57486	chr11	47373646	47375118	1472	736.0	
57487	chr11	47376201	47379200	2999	1500.0	
57488	chr11	47387780	47396313	8533	4266.0	
57489	chr11	47399694	47401245	1551	776.0	
57490	chr11	47406844	47410039	3195	1598.0	
57491	chr11	47410564	47411025	461	230.0	
57492	chr11	47411566	47412774	1208	604.0	
57493	chr11	47425572	47427375	1803	902.0	
57494	chr11	47453490	47454713	1223	612.0	
57495	chr11	47483758	47483830	72	36.0	
57496	chr11	47485044	47485374	330	165.0	
57497	chr11	47495238	47495783	545	272.0	
57498	chr11	47499134	47500019	885	442.0	
57499	chr11	47506660	47507643	983	492.0	
57500	chr11	47508693	47509487	794	397.0	
57501	chr11	47513132	47513929	797	398.0	
57502	chr11	47514605	47515695	1090	545.0	
57503	chr11	47518868	47519034	166	83.0	
57504	chr11	47523409	47524874	1465	732.0	
57505	chr11	47533871	47534162	291	146.0	
57506	chr11	47540345	47540750	405	202.0	
57507	chr11	47547442	47548245	803	402.0	
57508	chr11	47550200	47553880	3680	1840.0	
57509	chr11	47564888	47566737	1849	924.0	
57510	chr11	47578266	47579699	1433	716.0	
57511	chr11	47587582	47588385	803	402.0	
57512	chr11	47591907	47592498	591	296.0	
57513	chr11	47594272	47594344	72	36.0	
57514	chr11	47611458	47611919	461	230.0	
57515	chr11	47617072	47617345	273	136.0	
57516	chr11	47641691	47643402	1711	856.0	
57517	chr11	47714547	47715955	1408	704.0	
57518	chr11	47716747	47717039	292	146.0	
57519	chr11	47765369	47768916	3547	1774.0	
57520	chr11	47847609	47849227	1618	809.0	
57521	chr11	47850086	47850814	728	364.0	
57522	chr11	47853305	47854161	856	428.0	
57523	chr11	47854668	47855071	403	202.0	
57524	chr11	47857501	47858226	725	362.0	
57525	chr11	47859658	47859777	119	60.0	
57526	chr11	47861892	47862006	114	57.0	
57527	chr11	47863067	47863820	753	376.0	
57528	chr11	47879542	47880206	664	332.0	
57529	chr11	47899675	47900386	711	356.0	
57530	chr11	47908221	47908532	311	156.0	
57531	chr11	47912725	47913317	592	296.0	
57532	chr11	47915373	47915879	506	253.0	
57533	chr11	47917731	47918752	1021	510.0	
57534	chr11	47920138	47921038	900	450.0	
57535	chr11	47928353	47928890	537	268.0	
57536	chr11	47934365	47935201	836	418.0	
57537	chr11	47937557	47938295	738	369.0	
57538	chr11	47941865	47942409	544	272.0	
57539	chr11	47946834	47947586	752	376.0	
57540	chr11	47949861	47951916	2055	1028.0	
57541	chr11	47955414	47955635	221	110.0	
57542	chr11	47963863	47964267	404	202.0	
57543	chr11	47968133	47968473	340	170.0	
57544	chr11	47974101	47974629	528	264.0	
57545	chr11	47979379	47983899	4520	2260.0	
57546	chr11	47987330	47988304	974	487.0	
57547	chr11	47990515	47991802	1287	644.0	
57548	chr11	47996111	47996789	678	339.0	
57549	chr11	47999626	48002943	3317	1658.0	
57550	chr11	48004237	48009355	5118	2559.0	
57551	chr11	48011160	48014258	3098	1549.0	
57552	chr11	48014962	48020896	5934	2967.0	
57553	chr11	48022647	48023115	468	234.0	
57554	chr11	48025716	48026379	663	332.0	
57555	chr11	48028944	48029589	645	322.0	
57556	chr11	48031576	48032769	1193	596.0	
57557	chr11	48033704	48034257	553	276.0	
57558	chr11	48035024	48035138	114	57.0	
57559	chr11	48043296	48044998	1702	851.0	
57560	chr11	48050257	48051644	1387	694.0	
57561	chr11	48052697	48052886	189	94.0	
57562	chr11	48054364	48056466	2102	1051.0	
57563	chr11	48057998	48058468	470	235.0	
57564	chr11	48061245	48061705	460	230.0	
57565	chr11	48063360	48063997	637	318.0	
57566	chr11	48066795	48067645	850	425.0	
57567	chr11	48079577	48079989	412	206.0	
57568	chr11	48081077	48081672	595	298.0	
57569	chr11	48084540	48084709	169	84.0	
57570	chr11	48105861	48110563	4702	2351.0	
57571	chr11	48171071	48171095	24	12.0	
57572	chr11	48172798	48173269	471	236.0	
57573	chr11	48190813	48191700	887	444.0	
57574	chr11	48307785	48308120	335	168.0	
57575	chr11	48325080	48325276	196	98.0	
57576	chr11	48341429	48341940	511	256.0	
57577	chr11	50765516	50765834	318	159.0	
57578	chr11	50772607	50772976	369	184.0	
57579	chr11	54548908	54549758	850	425.0	
57580	chr11	54545677	54547344	1667	834.0	
57581	chr11	54543737	54543763	26	13.0	
57582	chr11	54542446	54542653	207	104.0	
57583	chr11	54538206	54540135	1929	964.0	
57584	chr11	54527724	54528441	717	358.0	
57585	chr11	57219085	57219419	334	167.0	
57586	chr11	57278074	57278499	425	212.0	
57587	chr11	57306924	57307623	699	350.0	
57588	chr11	57310970	57311833	863	432.0	
57589	chr11	57315612	57315620	8	4.0	
57590	chr11	57321633	57326289	4656	2328.0	
57591	chr11	57334613	57336695	2082	1041.0	
57592	chr11	57345437	57346260	823	412.0	
57593	chr11	57349593	57350279	686	343.0	
57594	chr11	57368623	57368811	188	94.0	
57595	chr11	57406365	57406990	625	312.0	
57596	chr11	57421800	57422040	240	120.0	
57597	chr11	57424447	57427909	3462	1731.0	
57598	chr11	57431953	57433137	1184	592.0	
57599	chr11	57434530	57435170	640	320.0	
57600	chr11	57457055	57461407	4352	2176.0	
57601	chr11	57464807	57465144	337	168.0	
57602	chr11	57473540	57474825	1285	642.0	
57603	chr11	57475950	57477354	1404	702.0	
57604	chr11	57479937	57480782	845	422.0	
57605	chr11	57482628	57483499	871	436.0	
57606	chr11	57484247	57484908	661	330.0	
57607	chr11	57485541	57486131	590	295.0	
57608	chr11	57491617	57492102	485	242.0	
57609	chr11	57493319	57494171	852	426.0	
57610	chr11	57499393	57500088	695	348.0	
57611	chr11	57513426	57516306	2880	1440.0	
57612	chr11	57526924	57527954	1030	515.0	
57613	chr11	57529509	57531783	2274	1137.0	
57614	chr11	57547812	57548279	467	234.0	
57615	chr11	57565507	57568851	3344	1672.0	
57616	chr11	57571591	57572150	559	280.0	
57617	chr11	57597924	57598371	447	224.0	
57618	chr11	57637751	57639835	2084	1042.0	
57619	chr11	57641250	57641939	689	344.0	
57620	chr11	57644681	57645449	768	384.0	
57621	chr11	57646048	57650630	4582	2291.0	
57622	chr11	57652164	57653048	884	442.0	
57623	chr11	57656953	57658403	1450	725.0	
57624	chr11	57663102	57663155	53	26.0	
57625	chr11	57666375	57669436	3061	1530.0	
57626	chr11	57711373	57713298	1925	962.0	
57627	chr11	57740676	57742557	1881	940.0	
57628	chr11	57751671	57752039	368	184.0	
57629	chr11	57761447	57762141	694	347.0	
57630	chr11	57763507	57763727	220	110.0	
57631	chr11	57775588	57775915	327	164.0	
57632	chr11	57785121	57785514	393	196.0	
57633	chr11	57788282	57788854	572	286.0	
57634	chr11	57791647	57793496	1849	924.0	
57635	chr11	57798907	57799576	669	334.0	
57636	chr11	57800339	57801457	1118	559.0	
57637	chr11	58029218	58029413	195	98.0	
57638	chr11	58513746	58514111	365	182.0	
57639	chr11	58524067	58525842	1775	888.0	
57640	chr11	58530217	58530696	479	240.0	
57641	chr11	58562487	58562759	272	136.0	
57642	chr11	58567796	58568727	931	466.0	
57643	chr11	58572984	58576353	3369	1684.0	
57644	chr11	58576877	58580285	3408	1704.0	
57645	chr11	58606133	58606142	9	4.0	
57646	chr11	58629842	58630250	408	204.0	
57647	chr11	58640399	58640992	593	296.0	
57648	chr11	58647184	58647585	401	200.0	
57649	chr11	58653944	58654513	569	284.0	
57650	chr11	58675501	58675978	477	238.0	
57651	chr11	58726857	58727545	688	344.0	
57652	chr11	58776944	58777362	418	209.0	
57653	chr11	58788209	58788847	638	319.0	
57654	chr11	58850668	58851059	391	196.0	
57655	chr11	58900793	58901169	376	188.0	
57656	chr11	58907426	58908273	847	424.0	
57657	chr11	58923207	58923613	406	203.0	
57658	chr11	58927314	58927851	537	268.0	
57659	chr11	58958522	58958916	394	197.0	
57660	chr11	58999205	59000377	1172	586.0	
57661	chr11	59009631	59010060	429	214.0	
57662	chr11	59012948	59013351	403	202.0	
57663	chr11	59053251	59053745	494	247.0	
57664	chr11	59058078	59059049	971	486.0	
57665	chr11	59077154	59077637	483	242.0	
57666	chr11	59078473	59078863	390	195.0	
57667	chr11	59095222	59095621	399	200.0	
57668	chr11	59097067	59097594	527	264.0	
57669	chr11	59101707	59102876	1169	584.0	
57670	chr11	59106257	59108442	2185	1092.0	
57671	chr11	59135627	59136722	1095	548.0	
57672	chr11	59142031	59146003	3972	1986.0	
57673	chr11	59152505	59152913	408	204.0	
57674	chr11	59158014	59158937	923	462.0	
57675	chr11	59171200	59174470	3270	1635.0	
57676	chr11	59182376	59182794	418	209.0	
57677	chr11	59186225	59186690	465	232.0	
57678	chr11	59199865	59200615	750	375.0	
57679	chr11	59206648	59207036	388	194.0	
57680	chr11	59207686	59208546	860	430.0	
57681	chr11	59210628	59210868	240	120.0	
57682	chr11	59212069	59213749	1680	840.0	
57683	chr11	59216429	59217559	1130	565.0	
57684	chr11	59218844	59219368	524	262.0	
57685	chr11	59222206	59225145	2939	1470.0	
57686	chr11	59247464	59248324	860	430.0	
57687	chr11	59254261	59254698	437	218.0	
57688	chr11	59263228	59263657	429	214.0	
57689	chr11	59270643	59270941	298	149.0	
57690	chr11	59272806	59274288	1482	741.0	
57691	chr11	59275863	59276191	328	164.0	
57692	chr11	59283978	59285055	1077	538.0	
57693	chr11	59289345	59289884	539	270.0	
57694	chr11	59368762	59368764	2	1.0	
57695	chr11	59380557	59380899	342	171.0	
57696	chr11	59413640	59413872	232	116.0	
57697	chr11	59429878	59430371	493	246.0	
57698	chr11	59510878	59511313	435	218.0	
57699	chr11	59537132	59538152	1020	510.0	
57700	chr11	59549772	59551975	2203	1102.0	
57701	chr11	59554281	59554355	74	37.0	
57702	chr11	59555771	59557989	2218	1109.0	
57703	chr11	59559769	59561571	1802	901.0	
57704	chr11	59565639	59566730	1091	546.0	
57705	chr11	59614581	59617051	2470	1235.0	
57706	chr11	59660191	59661059	868	434.0	
57707	chr11	59666917	59670173	3256	1628.0	
57708	chr11	59680465	59680975	510	255.0	
57709	chr11	59728702	59729373	671	336.0	
57710	chr11	59753706	59757361	3655	1828.0	
57711	chr11	59765001	59765456	455	228.0	
57712	chr11	59766582	59767697	1115	558.0	
57713	chr11	59771767	59773037	1270	635.0	
57714	chr11	59787050	59787134	84	42.0	
57715	chr11	59802310	59803014	704	352.0	
57716	chr11	59809933	59811374	1441	720.0	
57717	chr11	59813799	59814542	743	372.0	
57718	chr11	59822916	59823395	479	240.0	
57719	chr11	59866353	59866910	557	278.0	
57720	chr11	60119684	60120157	473	236.0	
57721	chr11	60169577	60169968	391	196.0	
57722	chr11	60170591	60170868	277	138.0	
57723	chr11	60182512	60184550	2038	1019.0	
57724	chr11	60185092	60185802	710	355.0	
57725	chr11	60188466	60188916	450	225.0	
57726	chr11	60193535	60194452	917	458.0	
57727	chr11	60235044	60235755	711	356.0	
57728	chr11	60242606	60243400	794	397.0	
57729	chr11	60251563	60252613	1050	525.0	
57730	chr11	60263354	60263774	420	210.0	
57731	chr11	60265587	60266006	419	210.0	
57732	chr11	60280268	60280992	724	362.0	
57733	chr11	60281546	60282641	1095	548.0	
57734	chr11	60310528	60311074	546	273.0	
57735	chr11	60333962	60334435	473	236.0	
57736	chr11	60336619	60337055	436	218.0	
57737	chr11	60343096	60343449	353	176.0	
57738	chr11	60345546	60345831	285	142.0	
57739	chr11	60363219	60364609	1390	695.0	
57740	chr11	60366934	60367526	592	296.0	
57741	chr11	60377460	60379128	1668	834.0	
57742	chr11	60389040	60390698	1658	829.0	
57743	chr11	60392637	60392654	17	8.0	
57744	chr11	60396392	60397308	916	458.0	
57745	chr11	60446174	60447228	1054	527.0	
57746	chr11	60455298	60456049	751	376.0	
57747	chr11	60457610	60457938	328	164.0	
57748	chr11	60476920	60477570	650	325.0	
57749	chr11	60482331	60482838	507	254.0	
57750	chr11	60485895	60486310	415	208.0	
57751	chr11	60498280	60499326	1046	523.0	
57752	chr11	60504333	60504614	281	140.0	
57753	chr11	60528918	60529392	474	237.0	
57754	chr11	60566829	60567199	370	185.0	
57755	chr11	60570939	60571354	415	208.0	
57756	chr11	60618482	60619138	656	328.0	
57757	chr11	60633752	60634357	605	302.0	
57758	chr11	60684585	60684632	47	24.0	
57759	chr11	60718054	60718298	244	122.0	
57760	chr11	60759438	60759742	304	152.0	
57761	chr11	60775272	60775967	695	348.0	
57762	chr11	60830937	60831635	698	349.0	
57763	chr11	60834610	60835972	1362	681.0	
57764	chr11	60841400	60843655	2255	1128.0	
57765	chr11	60858664	60858995	331	166.0	
57766	chr11	60872865	60873380	515	258.0	
57767	chr11	60887503	60887973	470	235.0	
57768	chr11	60899189	60899909	720	360.0	
57769	chr11	60905245	60907500	2255	1128.0	
57770	chr11	60909938	60911431	1493	746.0	
57771	chr11	60911934	60916224	4290	2145.0	
57772	chr11	60918945	60919916	971	486.0	
57773	chr11	60923849	60926311	2462	1231.0	
57774	chr11	60931871	60933150	1279	640.0	
57775	chr11	60935950	60935952	2	1.0	
57776	chr11	60937746	60937975	229	114.0	
57777	chr11	60944773	60945467	694	347.0	
57778	chr11	60950761	60954949	4188	2094.0	
57779	chr11	60955561	60956097	536	268.0	
57780	chr11	60970115	60975120	5005	2502.0	
57781	chr11	60978043	60980099	2056	1028.0	
57782	chr11	60981621	60983399	1778	889.0	
57783	chr11	60984078	60989607	5529	2764.0	
57784	chr11	60991348	60991902	554	277.0	
57785	chr11	60994205	60995212	1007	504.0	
57786	chr11	61004065	61005303	1238	619.0	
57787	chr11	61007335	61008606	1271	636.0	
57788	chr11	61011585	61012825	1240	620.0	
57789	chr11	61019218	61019489	271	136.0	
57790	chr11	61020000	61024324	4324	2162.0	
57791	chr11	61025365	61029379	4014	2007.0	
57792	chr11	61035795	61035797	2	1.0	
57793	chr11	61041687	61043577	1890	945.0	
57794	chr11	61060775	61062183	1408	704.0	
57795	chr11	61065936	61066540	604	302.0	
57796	chr11	61070227	61071942	1715	858.0	
57797	chr11	61075935	61076879	944	472.0	
57798	chr11	61079325	61084251	4926	2463.0	
57799	chr11	61091596	61095518	3922	1961.0	
57800	chr11	61098477	61098512	35	18.0	
57801	chr11	61101631	61104658	3027	1514.0	
57802	chr11	61106227	61107345	1118	559.0	
57803	chr11	61110189	61112414	2225	1112.0	
57804	chr11	61113101	61113548	447	224.0	
57805	chr11	61114923	61115365	442	221.0	
57806	chr11	61116543	61116803	260	130.0	
57807	chr11	61120033	61121269	1236	618.0	
57808	chr11	61123898	61124311	413	206.0	
57809	chr11	61126925	61126983	58	29.0	
57810	chr11	61129233	61130610	1377	688.0	
57811	chr11	61146514	61146940	426	213.0	
57812	chr11	61150007	61150224	217	108.0	
57813	chr11	61158843	61159296	453	226.0	
57814	chr11	61159945	61163096	3151	1576.0	
57815	chr11	61163761	61165356	1595	798.0	
57816	chr11	61167081	61167941	860	430.0	
57817	chr11	61168739	61169223	484	242.0	
57818	chr11	61171938	61173231	1293	646.0	
57819	chr11	61187435	61187996	561	280.0	
57820	chr11	61254348	61254880	532	266.0	
57821	chr11	61256619	61257138	519	260.0	
57822	chr11	61293662	61295709	2047	1024.0	
57823	chr11	61331655	61334244	2589	1294.0	
57824	chr11	61335893	61337003	1110	555.0	
57825	chr11	61347554	61348874	1320	660.0	
57826	chr11	61356032	61357913	1881	940.0	
57827	chr11	61359475	61363556	4081	2040.0	
57828	chr11	61378585	61379136	551	276.0	
57829	chr11	61381668	61382269	601	300.0	
57830	chr11	61385370	61386038	668	334.0	
57831	chr11	61391795	61393778	1983	992.0	
57832	chr11	61417248	61418539	1291	646.0	
57833	chr11	61428873	61430921	2048	1024.0	
57834	chr11	61431977	61432328	351	176.0	
57835	chr11	61435266	61435981	715	358.0	
57836	chr11	61446076	61446672	596	298.0	
57837	chr11	61477611	61478094	483	242.0	
57838	chr11	61508001	61509890	1889	944.0	
57839	chr11	61516850	61517347	497	248.0	
57840	chr11	61532104	61532558	454	227.0	
57841	chr11	61561993	61562395	402	201.0	
57842	chr11	61567116	61567918	802	401.0	
57843	chr11	61579267	61582183	2916	1458.0	
57844	chr11	61587409	61588979	1570	785.0	
57845	chr11	61628161	61628499	338	169.0	
57846	chr11	61638359	61638855	496	248.0	
57847	chr11	61654221	61654847	626	313.0	
57848	chr11	61671386	61671980	594	297.0	
57849	chr11	61679379	61681099	1720	860.0	
57850	chr11	61683606	61685048	1442	721.0	
57851	chr11	61685689	61686041	352	176.0	
57852	chr11	61688364	61689455	1091	546.0	
57853	chr11	61695356	61697052	1696	848.0	
57854	chr11	61697945	61698735	790	395.0	
57855	chr11	61700083	61703352	3269	1634.0	
57856	chr11	61715810	61717153	1343	672.0	
57857	chr11	61733110	61734209	1099	550.0	
57858	chr11	61742342	61742877	535	268.0	
57859	chr11	61747601	61748264	663	332.0	
57860	chr11	61752055	61753198	1143	572.0	
57861	chr11	61772603	61773012	409	204.0	
57862	chr11	61775519	61777992	2473	1236.0	
57863	chr11	61791792	61793561	1769	884.0	
57864	chr11	61797081	61797805	724	362.0	
57865	chr11	61814477	61817530	3053	1526.0	
57866	chr11	61827036	61829443	2407	1204.0	
57867	chr11	61830999	61831027	28	14.0	
57868	chr11	61833612	61836335	2723	1362.0	
57869	chr11	61870888	61871772	884	442.0	
57870	chr11	61878548	61878730	182	91.0	
57871	chr11	61880123	61880699	576	288.0	
57872	chr11	61890478	61894325	3847	1924.0	
57873	chr11	61895062	61895414	352	176.0	
57874	chr11	61897395	61899773	2378	1189.0	
57875	chr11	61911703	61913199	1496	748.0	
57876	chr11	61916956	61917955	999	500.0	
57877	chr11	61922375	61922925	550	275.0	
57878	chr11	61947381	61948232	851	426.0	
57879	chr11	61949337	61950090	753	376.0	
57880	chr11	61954516	61956444	1928	964.0	
57881	chr11	61956978	61957483	505	252.0	
57882	chr11	61959045	61968906	9861	4930.0	
57883	chr11	61969860	61970578	718	359.0	
57884	chr11	61971094	61973975	2881	1440.0	
57885	chr11	61976146	61976523	377	188.0	
57886	chr11	61979172	61979455	283	142.0	
57887	chr11	61982324	61982515	191	96.0	
57888	chr11	62004340	62005861	1521	760.0	
57889	chr11	62015600	62015920	320	160.0	
57890	chr11	62018367	62019623	1256	628.0	
57891	chr11	62020568	62021077	509	254.0	
57892	chr11	62024806	62026545	1739	870.0	
57893	chr11	62033307	62034510	1203	602.0	
57894	chr11	62041941	62042575	634	317.0	
57895	chr11	62054483	62054948	465	232.0	
57896	chr11	62081567	62082621	1054	527.0	
57897	chr11	62104410	62105768	1358	679.0	
57898	chr11	62107925	62108446	521	260.0	
57899	chr11	62112213	62112931	718	359.0	
57900	chr11	62123320	62125164	1844	922.0	
57901	chr11	62136726	62136821	95	48.0	
57902	chr11	62171135	62171639	504	252.0	
57903	chr11	62310032	62312010	1978	989.0	
57904	chr11	62315349	62315917	568	284.0	
57905	chr11	62324729	62325372	643	322.0	
57906	chr11	62330469	62330992	523	262.0	
57907	chr11	62336984	62338321	1337	668.0	
57908	chr11	62339872	62340631	759	380.0	
57909	chr11	62343837	62344656	819	410.0	
57910	chr11	62352641	62352827	186	93.0	
57911	chr11	62370940	62371512	572	286.0	
57912	chr11	62378420	62378925	505	252.0	
57913	chr11	62380517	62381342	825	412.0	
57914	chr11	62386079	62386465	386	193.0	
57915	chr11	62393284	62393731	447	224.0	
57916	chr11	62394570	62395491	921	460.0	
57917	chr11	62401920	62402891	971	486.0	
57918	chr11	62424447	62425361	914	457.0	
57919	chr11	62426722	62428337	1615	808.0	
57920	chr11	62429527	62429928	401	200.0	
57921	chr11	62435781	62436159	378	189.0	
57922	chr11	62440173	62440440	267	134.0	
57923	chr11	62443519	62444986	1467	734.0	
57924	chr11	62457562	62457975	413	206.0	
57925	chr11	62459275	62459290	15	8.0	
57926	chr11	62463441	62463508	67	34.0	
57927	chr11	62497034	62498033	999	500.0	
57928	chr11	62499423	62500350	927	464.0	
57929	chr11	62501858	62503545	1687	844.0	
57930	chr11	62505080	62505437	357	178.0	
57931	chr11	62508273	62509089	816	408.0	
57932	chr11	62509941	62510325	384	192.0	
57933	chr11	62511105	62547604	36499	18250.0	
57934	chr11	62549799	62549974	175	88.0	
57935	chr11	62550520	62559336	8816	4408.0	
57936	chr11	62560254	62561212	958	479.0	
57937	chr11	62572728	62575519	2791	1396.0	
57938	chr11	62589362	62589636	274	137.0	
57939	chr11	62590581	62594432	3851	1926.0	
57940	chr11	62598618	62603187	4569	2284.0	
57941	chr11	62607601	62608353	752	376.0	
57942	chr11	62611522	62614675	3153	1576.0	
57943	chr11	62621184	62624129	2945	1472.0	
57944	chr11	62627689	62628078	389	194.0	
57945	chr11	62637821	62638129	308	154.0	
57946	chr11	62640516	62641514	998	499.0	
57947	chr11	62645644	62647469	1825	912.0	
57948	chr11	62652162	62654004	1842	921.0	
57949	chr11	62664330	62666986	2656	1328.0	
57950	chr11	62668354	62668402	48	24.0	
57951	chr11	62669701	62670015	314	157.0	
57952	chr11	62670776	62672979	2203	1102.0	
57953	chr11	62678361	62679736	1375	688.0	
57954	chr11	62680696	62681235	539	270.0	
57955	chr11	62694436	62695296	860	430.0	
57956	chr11	62702188	62702679	491	246.0	
57957	chr11	62703904	62704302	398	199.0	
57958	chr11	62705331	62707913	2582	1291.0	
57959	chr11	62708426	62710393	1967	984.0	
57960	chr11	62725415	62725694	279	140.0	
57961	chr11	62726197	62729738	3541	1770.0	
57962	chr11	62753249	62754857	1608	804.0	
57963	chr11	62760942	62762348	1406	703.0	
57964	chr11	62769535	62772263	2728	1364.0	
57965	chr11	62774952	62775403	451	226.0	
57966	chr11	62786070	62807471	21401	10700.0	
57967	chr11	62810927	62811824	897	448.0	
57968	chr11	62813496	62815648	2152	1076.0	
57969	chr11	62816199	62817507	1308	654.0	
57970	chr11	62818122	62818423	301	150.0	
57971	chr11	62819364	62819817	453	226.0	
57972	chr11	62820402	62820612	210	105.0	
57973	chr11	62822206	62823407	1201	600.0	
57974	chr11	62823948	62826096	2148	1074.0	
57975	chr11	62827111	62827337	226	113.0	
57976	chr11	62829600	62835982	6382	3191.0	
57977	chr11	62836484	62836487	3	2.0	
57978	chr11	62837453	62843111	5658	2829.0	
57979	chr11	62848797	62848980	183	92.0	
57980	chr11	62849992	62856994	7002	3501.0	
57981	chr11	62857681	62857963	282	141.0	
57982	chr11	62862220	62863282	1062	531.0	
57983	chr11	62879859	62883422	3563	1782.0	
57984	chr11	62889170	62890516	1346	673.0	
57985	chr11	62891138	62891512	374	187.0	
57986	chr11	62905505	62906526	1021	510.0	
57987	chr11	62923113	62923414	301	150.0	
57988	chr11	62923962	62924499	537	268.0	
57989	chr11	62926238	62926599	361	180.0	
57990	chr11	63023757	63024548	791	396.0	
57991	chr11	63035634	63036099	465	232.0	
57992	chr11	63212729	63213032	303	152.0	
57993	chr11	63235485	63235879	394	197.0	
57994	chr11	63462185	63462485	300	150.0	
57995	chr11	63478726	63479304	578	289.0	
57996	chr11	63490826	63491389	563	282.0	
57997	chr11	63502330	63502614	284	142.0	
57998	chr11	63503416	63504017	601	300.0	
57999	chr11	63505150	63506593	1443	722.0	
58000	chr11	63507586	63508428	842	421.0	
58001	chr11	63518545	63519010	465	232.0	
58002	chr11	63531168	63532187	1019	510.0	
58003	chr11	63534807	63538422	3615	1808.0	
58004	chr11	63550886	63552421	1535	768.0	
58005	chr11	63553247	63554915	1668	834.0	
58006	chr11	63560782	63561255	473	236.0	
58007	chr11	63563971	63564467	496	248.0	
58008	chr11	63566375	63567993	1618	809.0	
58009	chr11	63572336	63572702	366	183.0	
58010	chr11	63574081	63575128	1047	524.0	
58011	chr11	63582369	63583222	853	426.0	
58012	chr11	63593089	63593510	421	210.0	
58013	chr11	63610500	63611009	509	254.0	
58014	chr11	63613136	63614846	1710	855.0	
58015	chr11	63617689	63618169	480	240.0	
58016	chr11	63620873	63621719	846	423.0	
58017	chr11	63631494	63631890	396	198.0	
58018	chr11	63633937	63634465	528	264.0	
58019	chr11	63635671	63636294	623	312.0	
58020	chr11	63639263	63639557	294	147.0	
58021	chr11	63670309	63672247	1938	969.0	
58022	chr11	63680742	63682951	2209	1104.0	
58023	chr11	63685270	63685675	405	202.0	
58024	chr11	63689298	63689627	329	164.0	
58025	chr11	63707976	63708256	280	140.0	
58026	chr11	63738663	63739155	492	246.0	
58027	chr11	63767123	63769948	2825	1412.0	
58028	chr11	63812777	63814473	1696	848.0	
58029	chr11	63816147	63816500	353	176.0	
58030	chr11	63829917	63830218	301	150.0	
58031	chr11	63832403	63832710	307	154.0	
58032	chr11	63836979	63841102	4123	2062.0	
58033	chr11	63845012	63845804	792	396.0	
58034	chr11	63850866	63851944	1078	539.0	
58035	chr11	63853547	63853626	79	40.0	
58036	chr11	63855950	63856292	342	171.0	
58037	chr11	63858442	63859176	734	367.0	
58038	chr11	63862929	63863408	479	240.0	
58039	chr11	63866019	63867033	1014	507.0	
58040	chr11	63868388	63870848	2460	1230.0	
58041	chr11	63871774	63873607	1833	916.0	
58042	chr11	63882601	63883451	850	425.0	
58043	chr11	63887407	63889343	1936	968.0	
58044	chr11	63892226	63892508	282	141.0	
58045	chr11	63906533	63907018	485	242.0	
58046	chr11	63915176	63920183	5007	2504.0	
58047	chr11	63921057	63921497	440	220.0	
58048	chr11	63937784	63940022	2238	1119.0	
58049	chr11	63940744	63941442	698	349.0	
58050	chr11	63945587	63946269	682	341.0	
58051	chr11	63950931	63952536	1605	802.0	
58052	chr11	63961446	63962052	606	303.0	
58053	chr11	63971043	63971167	124	62.0	
58054	chr11	63973928	63977010	3082	1541.0	
58055	chr11	63982088	63982525	437	218.0	
58056	chr11	63985345	63987196	1851	926.0	
58057	chr11	63993985	63994402	417	208.0	
58058	chr11	63998740	64002682	3942	1971.0	
58059	chr11	64004083	64004230	147	74.0	
58060	chr11	64007059	64008249	1190	595.0	
58061	chr11	64027535	64028603	1068	534.0	
58062	chr11	64060632	64061375	743	372.0	
58063	chr11	64074221	64074617	396	198.0	
58064	chr11	64091073	64091106	33	16.0	
58065	chr11	64092385	64092733	348	174.0	
58066	chr11	64094344	64094905	561	280.0	
58067	chr11	64145987	64146536	549	274.0	
58068	chr11	64148538	64149104	566	283.0	
58069	chr11	64152801	64153688	887	444.0	
58070	chr11	64164806	64166817	2011	1006.0	
58071	chr11	64181419	64182020	601	300.0	
58072	chr11	64184474	64187586	3112	1556.0	
58073	chr11	64198622	64198694	72	36.0	
58074	chr11	64204274	64208722	4448	2224.0	
58075	chr11	64224960	64227801	2841	1420.0	
58076	chr11	64229744	64231681	1937	968.0	
58077	chr11	64233787	64235599	1812	906.0	
58078	chr11	64237448	64243899	6451	3226.0	
58079	chr11	64244800	64248002	3202	1601.0	
58080	chr11	64250497	64253128	2631	1316.0	
58081	chr11	64267930	64272262	4332	2166.0	
58082	chr11	64283972	64286784	2812	1406.0	
58083	chr11	64291175	64292967	1792	896.0	
58084	chr11	64297520	64298493	973	486.0	
58085	chr11	64299002	64301914	2912	1456.0	
58086	chr11	64303870	64307153	3283	1642.0	
58087	chr11	64316442	64319912	3470	1735.0	
58088	chr11	64321222	64321572	350	175.0	
58089	chr11	64331280	64332446	1166	583.0	
58090	chr11	64334870	64335632	762	381.0	
58091	chr11	64339172	64344188	5016	2508.0	
58092	chr11	64354837	64355605	768	384.0	
58093	chr11	64356537	64356873	336	168.0	
58094	chr11	64357949	64361093	3144	1572.0	
58095	chr11	64373085	64373939	854	427.0	
58096	chr11	64385334	64386711	1377	688.0	
58097	chr11	64395603	64396359	756	378.0	
58098	chr11	64400059	64400557	498	249.0	
58099	chr11	64409742	64410709	967	484.0	
58100	chr11	64447832	64450156	2324	1162.0	
58101	chr11	64489740	64490242	502	251.0	
58102	chr11	64492514	64492951	437	218.0	
58103	chr11	64498049	64498689	640	320.0	
58104	chr11	64499532	64499632	100	50.0	
58105	chr11	64538475	64538819	344	172.0	
58106	chr11	64553410	64553880	470	235.0	
58107	chr11	64611793	64612312	519	260.0	
58108	chr11	64624586	64625493	907	454.0	
58109	chr11	64638082	64638407	325	162.0	
58110	chr11	64643470	64643943	473	236.0	
58111	chr11	64644886	64645020	134	67.0	
58112	chr11	64652860	64653541	681	340.0	
58113	chr11	64654861	64655782	921	460.0	
58114	chr11	64659700	64660137	437	218.0	
58115	chr11	64664257	64665890	1633	816.0	
58116	chr11	64675726	64676340	614	307.0	
58117	chr11	64688072	64689208	1136	568.0	
58118	chr11	64704420	64704837	417	208.0	
58119	chr11	64711247	64711512	265	132.0	
58120	chr11	64712263	64713924	1661	830.0	
58121	chr11	64722632	64725642	3010	1505.0	
58122	chr11	64739688	64739730	42	21.0	
58123	chr11	64741652	64748314	6662	3331.0	
58124	chr11	64750453	64751044	591	296.0	
58125	chr11	64752406	64753685	1279	640.0	
58126	chr11	64755253	64769470	14217	7108.0	
58127	chr11	64770337	64770342	5	2.0	
58128	chr11	64771691	64773082	1391	696.0	
58129	chr11	64774724	64780289	5565	2782.0	
58130	chr11	64787478	64788361	883	442.0	
58131	chr11	64793974	64794050	76	38.0	
58132	chr11	64799515	64804302	4787	2394.0	
58133	chr11	64809656	64811426	1770	885.0	
58134	chr11	64837172	64837538	366	183.0	
58135	chr11	64839155	64840112	957	478.0	
58136	chr11	64841613	64881302	39689	19844.0	
58137	chr11	64885341	64886549	1208	604.0	
58138	chr11	64887447	64888670	1223	612.0	
58139	chr11	64892536	64901037	8501	4250.0	
58140	chr11	64901961	64901994	33	16.0	
58141	chr11	64902965	64903915	950	475.0	
58142	chr11	64905560	64906875	1315	658.0	
58143	chr11	64908853	64909197	344	172.0	
58144	chr11	64911360	64911710	350	175.0	
58145	chr11	64915249	64918110	2861	1430.0	
58146	chr11	64923535	64925441	1906	953.0	
58147	chr11	64971454	64972509	1055	528.0	
58148	chr11	64990100	64990981	881	440.0	
58149	chr11	64996555	64997432	877	438.0	
58150	chr11	65013067	65015077	2010	1005.0	
58151	chr11	65026796	65028405	1609	804.0	
58152	chr11	65040423	65042047	1624	812.0	
58153	chr11	65043659	65044385	726	363.0	
58154	chr11	65047353	65048328	975	488.0	
58155	chr11	65053790	65054497	707	354.0	
58156	chr11	65061567	65062047	480	240.0	
58157	chr11	65069230	65069759	529	264.0	
58158	chr11	65078091	65078635	544	272.0	
58159	chr11	65081206	65081661	455	228.0	
58160	chr11	65083354	65085002	1648	824.0	
58161	chr11	65095552	65097204	1652	826.0	
58162	chr11	65107962	65108247	285	142.0	
58163	chr11	65109086	65113674	4588	2294.0	
58164	chr11	65114567	65120018	5451	2726.0	
58165	chr11	65120882	65122999	2117	1058.0	
58166	chr11	65128096	65128659	563	282.0	
58167	chr11	65129882	65130346	464	232.0	
58168	chr11	65132099	65135823	3724	1862.0	
58169	chr11	65149158	65149714	556	278.0	
58170	chr11	65150369	65152586	2217	1108.0	
58171	chr11	65169254	65169515	261	130.0	
58172	chr11	65180568	65182932	2364	1182.0	
58173	chr11	65204631	65205313	682	341.0	
58174	chr11	65213475	65214229	754	377.0	
58175	chr11	65222093	65222560	467	234.0	
58176	chr11	65225313	65226305	992	496.0	
58177	chr11	65250311	65250739	428	214.0	
58178	chr11	65253990	65254072	82	41.0	
58179	chr11	65261180	65263048	1868	934.0	
58180	chr11	65274945	65275440	495	248.0	
58181	chr11	65279688	65280600	912	456.0	
58182	chr11	65290253	65293258	3005	1502.0	
58183	chr11	65301873	65302218	345	172.0	
58184	chr11	65308158	65309186	1028	514.0	
58185	chr11	65311202	65311645	443	222.0	
58186	chr11	65314116	65317071	2955	1478.0	
58187	chr11	65329488	65330541	1053	526.0	
58188	chr11	65333227	65335109	1882	941.0	
58189	chr11	65352746	65353086	340	170.0	
58190	chr11	65353861	65356089	2228	1114.0	
58191	chr11	65362179	65363277	1098	549.0	
58192	chr11	65366133	65366847	714	357.0	
58193	chr11	65370967	65371488	521	260.0	
58194	chr11	65377898	65378959	1061	530.0	
58195	chr11	65381405	65383528	2123	1062.0	
58196	chr11	65384070	65387318	3248	1624.0	
58197	chr11	65389417	65389436	19	10.0	
58198	chr11	65403304	65404273	969	484.0	
58199	chr11	65407631	65408154	523	262.0	
58200	chr11	65415745	65451506	35761	17880.0	
58201	chr11	65452403	65456194	3791	1896.0	
58202	chr11	65457057	65458117	1060	530.0	
58203	chr11	65459753	65459935	182	91.0	
58204	chr11	65468778	65469431	653	326.0	
58205	chr11	65471270	65472783	1513	756.0	"enhancer	sequence_feature"
58206	chr11	65476393	65478408	2015	1008.0	"sequence_feature	enhancer"
58207	chr11	65481648	65481703	55	28.0	"enhancer	sequence_feature"
58208	chr11	65487252	65488590	1338	669.0	enhancer
58209	chr11	65491639	65493474	1835	918.0	
58210	chr11	65494446	65494911	465	232.0	
58211	chr11	65496586	65511447	14861	7430.0	
58212	chr11	65512071	65512264	193	96.0	
58213	chr11	65516071	65516971	900	450.0	
58214	chr11	65521848	65526530	4682	2341.0	
58215	chr11	65530057	65530485	428	214.0	
58216	chr11	65536322	65536894	572	286.0	
58217	chr11	65539533	65541858	2325	1162.0	
58218	chr11	65544354	65544614	260	130.0	
58219	chr11	65545499	65548129	2630	1315.0	
58220	chr11	65551852	65559112	7260	3630.0	
58221	chr11	65560299	65560809	510	255.0	
58222	chr11	65564849	65566608	1759	880.0	
58223	chr11	65569062	65578302	9240	4620.0	
58224	chr11	65579362	65579410	48	24.0	
58225	chr11	65586479	65590193	3714	1857.0	
58226	chr11	65593260	65594403	1143	572.0	
58227	chr11	65595089	65596594	1505	752.0	
58228	chr11	65597773	65597807	34	17.0	
58229	chr11	65598662	65598678	16	8.0	
58230	chr11	65607028	65607369	341	170.0	
58231	chr11	65609323	65617060	7737	3868.0	
58232	chr11	65625724	65626593	869	434.0	
58233	chr11	65633494	65634641	1147	574.0	
58234	chr11	65637046	65642555	5509	2754.0	
58235	chr11	65643733	65645859	2126	1063.0	
58236	chr11	65646375	65647394	1019	510.0	
58237	chr11	65649249	65656401	7152	3576.0	
58238	chr11	65657087	65657736	649	324.0	
58239	chr11	65658328	65660327	1999	1000.0	
58240	chr11	65661620	65664343	2723	1362.0	
58241	chr11	65706156	65706867	711	356.0	
58242	chr11	65711191	65713153	1962	981.0	
58243	chr11	65719087	65721114	2027	1014.0	
58244	chr11	65744356	65744894	538	269.0	
58245	chr11	65767846	65768175	329	164.0	
58246	chr11	65769703	65770385	682	341.0	
58247	chr11	65775332	65776968	1636	818.0	
58248	chr11	65779419	65782305	2886	1443.0	
58249	chr11	65785554	65788653	3099	1550.0	
58250	chr11	65791535	65792211	676	338.0	
58251	chr11	65810027	65810428	401	200.0	
58252	chr11	65814294	65814587	293	146.0	
58253	chr11	65817615	65818819	1204	602.0	
58254	chr11	65821314	65821437	123	62.0	
58255	chr11	65832947	65834936	1989	994.0	
58256	chr11	65846001	65861440	15439	7720.0	
58257	chr11	65867567	65868507	940	470.0	
58258	chr11	65870387	65874345	3958	1979.0	
58259	chr11	65879345	65881600	2255	1128.0	
58260	chr11	65884252	65885408	1156	578.0	
58261	chr11	65887395	65894674	7279	3640.0	
58262	chr11	65895353	65897402	2049	1024.0	
58263	chr11	65897989	65901266	3277	1638.0	
58264	chr11	65901870	65903604	1734	867.0	
58265	chr11	65909129	65909626	497	248.0	
58266	chr11	65911751	65912163	412	206.0	
58267	chr11	65914667	65916543	1876	938.0	
58268	chr11	65917337	65920512	3175	1588.0	
58269	chr11	65927577	65929040	1463	732.0	
58270	chr11	65932209	65932687	478	239.0	
58271	chr11	65940934	65942039	1105	552.0	
58272	chr11	65956519	65957399	880	440.0	
58273	chr11	65960860	65962506	1646	823.0	
58274	chr11	65969209	65969211	2	1.0	
58275	chr11	65986368	65986813	445	222.0	
58276	chr11	65988533	65989747	1214	607.0	
58277	chr11	66001438	66003365	1927	964.0	
58278	chr11	66011873	66011984	111	56.0	
58279	chr11	66012699	66013578	879	440.0	
58280	chr11	66014686	66015252	566	283.0	
58281	chr11	66020607	66021500	893	446.0	
58282	chr11	66022176	66023090	914	457.0	
58283	chr11	66044693	66045764	1071	536.0	
58284	chr11	66048989	66049362	373	186.0	
58285	chr11	66051404	66053080	1676	838.0	
58286	chr11	66066723	66072117	5394	2697.0	
58287	chr11	66080260	66081991	1731	866.0	
58288	chr11	66099979	66101641	1662	831.0	
58289	chr11	66112244	66113920	1676	838.0	
58290	chr11	66115295	66117209	1914	957.0	
58291	chr11	66117718	66118230	512	256.0	
58292	chr11	66126028	66127617	1589	794.0	
58293	chr11	66134449	66134992	543	272.0	
58294	chr11	66183544	66184147	603	302.0	
58295	chr11	66209062	66209633	571	286.0	
58296	chr11	66221862	66223197	1335	668.0	
58297	chr11	66256509	66259035	2526	1263.0	
58298	chr11	66264059	66269957	5898	2949.0	
58299	chr11	66272501	66273118	617	308.0	
58300	chr11	66276255	66276370	115	58.0	
58301	chr11	66277010	66279400	2390	1195.0	
58302	chr11	66281779	66283283	1504	752.0	
58303	chr11	66283827	66283896	69	34.0	
58304	chr11	66287237	66290307	3070	1535.0	
58305	chr11	66291421	66292948	1527	764.0	
58306	chr11	66311532	66314274	2742	1371.0	
58307	chr11	66315907	66318948	3041	1520.0	
58308	chr11	66322362	66322590	228	114.0	
58309	chr11	66326212	66329123	2911	1456.0	
58310	chr11	66335032	66337382	2350	1175.0	
58311	chr11	66344461	66345666	1205	602.0	
58312	chr11	66346872	66349302	2430	1215.0	
58313	chr11	66363831	66364421	590	295.0	
58314	chr11	66370825	66372958	2133	1066.0	
58315	chr11	66386006	66386775	769	384.0	
58316	chr11	66388933	66389444	511	256.0	
58317	chr11	66408278	66409494	1216	608.0	
58318	chr11	66418077	66419111	1034	517.0	
58319	chr11	66421162	66422329	1167	584.0	
58320	chr11	66429895	66430435	540	270.0	
58321	chr11	66438261	66439654	1393	696.0	
58322	chr11	66443443	66444320	877	438.0	
58323	chr11	66450651	66450755	104	52.0	
58324	chr11	66457777	66458242	465	232.0	
58325	chr11	66459135	66459511	376	188.0	
58326	chr11	66465055	66468254	3199	1600.0	
58327	chr11	66478576	66481207	2631	1316.0	
58328	chr11	66509286	66511115	1829	914.0	
58329	chr11	66543357	66544649	1292	646.0	
58330	chr11	66545429	66547253	1824	912.0	
58331	chr11	66547886	66548331	445	222.0	
58332	chr11	66559143	66559714	571	286.0	
58333	chr11	66568006	66569065	1059	530.0	
58334	chr11	66578926	66579618	692	346.0	
58335	chr11	66592307	66593923	1616	808.0	
58336	chr11	66595162	66595815	653	326.0	
58337	chr11	66600659	66601149	490	245.0	
58338	chr11	66607562	66608664	1102	551.0	
58339	chr11	66609859	66610263	404	202.0	
58340	chr11	66611529	66611987	458	229.0	
58341	chr11	66615923	66620142	4219	2110.0	
58342	chr11	66621200	66621305	105	52.0	
58343	chr11	66622136	66626814	4678	2339.0	
58344	chr11	66627315	66627386	71	36.0	
58345	chr11	66628353	66629102	749	374.0	
58346	chr11	66630001	66630708	707	354.0	
58347	chr11	66633378	66633382	4	2.0	
58348	chr11	66635649	66635689	40	20.0	
58349	chr11	66637618	66640101	2483	1242.0	
58350	chr11	66641207	66641666	459	230.0	
58351	chr11	66643725	66644218	493	246.0	
58352	chr11	66646799	66647037	238	119.0	
58353	chr11	66648694	66648758	64	32.0	
58354	chr11	66650973	66651626	653	326.0	
58355	chr11	66652670	66653089	419	210.0	
58356	chr11	66659715	66660145	430	215.0	
58357	chr11	66676269	66679241	2972	1486.0	
58358	chr11	66694544	66695290	746	373.0	
58359	chr11	66727123	66728625	1502	751.0	
58360	chr11	66744137	66745818	1681	840.0	"repeat_region	sequence_feature"
58361	chr11	66834157	66834732	575	288.0	
58362	chr11	66842313	66844289	1976	988.0	
58363	chr11	66851671	66852438	767	384.0	
58364	chr11	66855611	66857836	2225	1112.0	
58365	chr11	66868559	66869287	728	364.0	
58366	chr11	66883101	66883563	462	231.0	
58367	chr11	66921003	66921681	678	339.0	
58368	chr11	66956639	66959377	2738	1369.0	
58369	chr11	66961952	66961959	7	4.0	
58370	chr11	66970459	66971531	1072	536.0	
58371	chr11	66982230	66982417	187	94.0	
58372	chr11	67023646	67025115	1469	734.0	
58373	chr11	67027903	67028301	398	199.0	
58374	chr11	67053849	67054265	416	208.0	
58375	chr11	67056559	67057087	528	264.0	
58376	chr11	67071422	67072145	723	362.0	
58377	chr11	67073046	67073644	598	299.0	
58378	chr11	67078103	67078844	741	370.0	
58379	chr11	67081361	67082506	1145	572.0	
58380	chr11	67094920	67095321	401	200.0	
58381	chr11	67103751	67104184	433	216.0	
58382	chr11	67113099	67113753	654	327.0	
58383	chr11	67114912	67116169	1257	628.0	
58384	chr11	67117485	67121578	4093	2046.0	
58385	chr11	67168183	67168690	507	254.0	
58386	chr11	67190077	67190898	821	410.0	
58387	chr11	67195991	67196437	446	223.0	
58388	chr11	67211782	67213724	1942	971.0	
58389	chr11	67235081	67235418	337	168.0	
58390	chr11	67238745	67241907	3162	1581.0	
58391	chr11	67245254	67245265	11	6.0	
58392	chr11	67252067	67253448	1381	690.0	
58393	chr11	67255388	67256187	799	400.0	
58394	chr11	67256766	67256902	136	68.0	
58395	chr11	67258497	67259439	942	471.0	
58396	chr11	67261158	67263743	2585	1292.0	
58397	chr11	67265749	67278817	13068	6534.0	
58398	chr11	67282958	67291590	8632	4316.0	
58399	chr11	67292982	67293610	628	314.0	
58400	chr11	67301821	67304987	3166	1583.0	
58401	chr11	67311666	67313535	1869	934.0	
58402	chr11	67316668	67318676	2008	1004.0	
58403	chr11	67345406	67346242	836	418.0	
58404	chr11	67350965	67351966	1001	500.0	
58405	chr11	67352496	67355019	2523	1262.0	
58406	chr11	67356436	67357899	1463	732.0	
58407	chr11	67364247	67365137	890	445.0	
58408	chr11	67366838	67375147	8309	4154.0	
58409	chr11	67375783	67376031	248	124.0	
58410	chr11	67380962	67383163	2201	1100.0	
58411	chr11	67389220	67389901	681	340.0	
58412	chr11	67391046	67392806	1760	880.0	
58413	chr11	67396302	67397481	1179	590.0	
58414	chr11	67400328	67405830	5502	2751.0	
58415	chr11	67406463	67410555	4092	2046.0	
58416	chr11	67411226	67411253	27	14.0	
58417	chr11	67411940	67412177	237	118.0	
58418	chr11	67412886	67413802	916	458.0	
58419	chr11	67414845	67421981	7136	3568.0	
58420	chr11	67427474	67429291	1817	908.0	
58421	chr11	67432991	67444748	11757	5878.0	
58422	chr11	67445906	67446907	1001	500.0	
58423	chr11	67449115	67449952	837	418.0	
58424	chr11	67459668	67460567	899	450.0	
58425	chr11	67463763	67465790	2027	1014.0	
58426	chr11	67466582	67466584	2	1.0	
58427	chr11	67467771	67469987	2216	1108.0	
58428	chr11	67482255	67487255	5000	2500.0	
58429	chr11	67491021	67491549	528	264.0	
58430	chr11	67492859	67493460	601	300.0	
58431	chr11	67497212	67497267	55	28.0	
58432	chr11	67497928	67498108	180	90.0	
58433	chr11	67500988	67501731	743	372.0	
58434	chr11	67503959	67509394	5435	2718.0	
58435	chr11	67572643	67573103	460	230.0	
58436	chr11	67579345	67579987	642	321.0	
58437	chr11	67582541	67585402	2861	1430.0	
58438	chr11	67586610	67586770	160	80.0	
58439	chr11	67587378	67588551	1173	586.0	
58440	chr11	67592161	67592446	285	142.0	
58441	chr11	67606176	67607571	1395	698.0	
58442	chr11	67613350	67616788	3438	1719.0	
58443	chr11	67628945	67631364	2419	1210.0	
58444	chr11	67639887	67640475	588	294.0	
58445	chr11	67646482	67647303	821	410.0	
58446	chr11	67648044	67651278	3234	1617.0	
58447	chr11	67659155	67659863	708	354.0	
58448	chr11	67713832	67714284	452	226.0	
58449	chr11	67731905	67732605	700	350.0	
58450	chr11	67792316	67792634	318	159.0	
58451	chr11	67804471	67806794	2323	1162.0	
58452	chr11	67884377	67885398	1021	510.0	
58453	chr11	67954905	67956303	1398	699.0	
58454	chr11	67990787	67991188	401	200.0	
58455	chr11	67993717	67994229	512	256.0	
58456	chr11	67996623	67998484	1861	930.0	
58457	chr11	68001905	68004760	2855	1428.0	
58458	chr11	68008636	68011423	2787	1394.0	
58459	chr11	68012196	68012381	185	92.0	
58460	chr11	68014421	68015055	634	317.0	
58461	chr11	68025118	68025418	300	150.0	
58462	chr11	68029548	68031536	1988	994.0	
58463	chr11	68036286	68041216	4930	2465.0	
58464	chr11	68054115	68054167	52	26.0	
58465	chr11	68090634	68091137	503	252.0	
58466	chr11	68099380	68099903	523	262.0	
58467	chr11	68115211	68115701	490	245.0	
58468	chr11	68118039	68118239	200	100.0	
58469	chr11	68118753	68122549	3796	1898.0	
58470	chr11	68128251	68128739	488	244.0	
58471	chr11	68141658	68142615	957	478.0	
58472	chr11	68144740	68144989	249	124.0	
58473	chr11	68146004	68146634	630	315.0	
58474	chr11	68206056	68206769	713	356.0	
58475	chr11	68209041	68210055	1014	507.0	
58476	chr11	68212292	68215549	3257	1628.0	
58477	chr11	68216310	68216466	156	78.0	
58478	chr11	68257169	68258023	854	427.0	
58479	chr11	68266453	68266906	453	226.0	
58480	chr11	68271036	68272883	1847	924.0	
58481	chr11	68273525	68274187	662	331.0	
58482	chr11	68281989	68282921	932	466.0	
58483	chr11	68297473	68298350	877	438.0	
58484	chr11	68303130	68303511	381	190.0	
58485	chr11	68312172	68313917	1745	872.0	
58486	chr11	68328337	68328721	384	192.0	
58487	chr11	68331365	68331480	115	58.0	
58488	chr11	68337376	68337815	439	220.0	
58489	chr11	68340336	68340695	359	180.0	
58490	chr11	68370513	68371785	1272	636.0	
58491	chr11	68380512	68380871	359	180.0	
58492	chr11	68383923	68384374	451	226.0	
58493	chr11	68437361	68437810	449	224.0	
58494	chr11	68446973	68447834	861	430.0	
58495	chr11	68459527	68463047	3520	1760.0	
58496	chr11	68468398	68468827	429	214.0	
58497	chr11	68471648	68472564	916	458.0	
58498	chr11	68528584	68529086	502	251.0	
58499	chr11	68546597	68546833	236	118.0	
58500	chr11	68550377	68550768	391	196.0	
58501	chr11	68552471	68553027	556	278.0	
58502	chr11	68583971	68584455	484	242.0	
58503	chr11	68690745	68691038	293	146.0	
58504	chr11	68724281	68724687	406	203.0	
58505	chr11	68735101	68736066	965	482.0	
58506	chr11	68749940	68752102	2162	1081.0	
58507	chr11	68798231	68798576	345	172.0	
58508	chr11	68816758	68817456	698	349.0	
58509	chr11	68825484	68826112	628	314.0	
58510	chr11	68827621	68829290	1669	834.0	
58511	chr11	68835603	68835621	18	9.0	
58512	chr11	68837739	68844539	6800	3400.0	
58513	chr11	68854900	68856133	1233	616.0	
58514	chr11	68869664	68870319	655	328.0	
58515	chr11	68903183	68904893	1710	855.0	
58516	chr11	68927206	68928629	1423	712.0	
58517	chr11	68955164	68956599	1435	718.0	
58518	chr11	68962828	68963233	405	202.0	
58519	chr11	68974626	68975100	474	237.0	
58520	chr11	69010378	69011450	1072	536.0	
58521	chr11	69013283	69013684	401	200.0	
58522	chr11	69027922	69028408	486	243.0	
58523	chr11	69030235	69030795	560	280.0	
58524	chr11	69038939	69039664	725	362.0	
58525	chr11	69044141	69044648	507	254.0	
58526	chr11	69047538	69051765	4227	2114.0	
58527	chr11	69052672	69053101	429	214.0	
58528	chr11	69055735	69056716	981	490.0	
58529	chr11	69078954	69080954	2000	1000.0	
58530	chr11	69088566	69089141	575	288.0	
58531	chr11	69101122	69102061	939	470.0	
58532	chr11	69122845	69123601	756	378.0	
58533	chr11	69141774	69142064	290	145.0	
58534	chr11	69166675	69166793	118	59.0	
58535	chr11	69292288	69292787	499	250.0	
58536	chr11	69293782	69294286	504	252.0	
58537	chr11	69295971	69299321	3350	1675.0	
58538	chr11	69301575	69302146	571	286.0	
58539	chr11	69311334	69312353	1019	510.0	
58540	chr11	69337237	69337729	492	246.0	
58541	chr11	69382256	69382585	329	164.0	
58542	chr11	69436498	69436888	390	195.0	
58543	chr11	69443103	69445540	2437	1218.0	
58544	chr11	69449648	69449758	110	55.0	
58545	chr11	69515776	69516037	261	130.0	
58546	chr11	69530339	69530862	523	262.0	
58547	chr11	69539456	69540253	797	398.0	
58548	chr11	69558526	69559169	643	322.0	
58549	chr11	69576226	69576353	127	64.0	
58550	chr11	69637218	69638080	862	431.0	
58551	chr11	69638883	69639640	757	378.0	
58552	chr11	69640370	69643917	3547	1774.0	
58553	chr11	69670127	69670681	554	277.0	
58554	chr11	69674421	69675999	1578	789.0	
58555	chr11	69685657	69686323	666	333.0	
58556	chr11	69712066	69712606	540	270.0	
58557	chr11	69888536	69888959	423	212.0	
58558	chr11	69972483	69972597	114	57.0	
58559	chr11	70177257	70177731	474	237.0	
58560	chr11	70191508	70191968	460	230.0	
58561	chr11	70195857	70196565	708	354.0	
58562	chr11	70201843	70204824	2981	1490.0	
58563	chr11	70269656	70271830	2174	1087.0	
58564	chr11	70314687	70316329	1642	821.0	
58565	chr11	70317615	70317964	349	174.0	
58566	chr11	70323722	70324746	1024	512.0	
58567	chr11	70325724	70327234	1510	755.0	
58568	chr11	70352619	70352886	267	134.0	
58569	chr11	70354167	70354436	269	134.0	
58570	chr11	70364934	70365678	744	372.0	
58571	chr11	70397586	70400200	2614	1307.0	
58572	chr11	70415923	70416497	574	287.0	
58573	chr11	70423987	70424665	678	339.0	
58574	chr11	70438666	70438958	292	146.0	
58575	chr11	70482935	70483442	507	254.0	
58576	chr11	70755502	70755917	415	208.0	
58577	chr11	70814848	70815230	382	191.0	
58578	chr11	70902074	70902476	402	201.0	
58579	chr11	71373747	71374133	386	193.0	
58580	chr11	71381754	71382110	356	178.0	
58581	chr11	71383460	71383818	358	179.0	
58582	chr11	71418782	71419032	250	125.0	
58583	chr11	71420553	71420557	4	2.0	
58584	chr11	71433203	71433838	635	318.0	
58585	chr11	71447123	71449957	2834	1417.0	
58586	chr11	71451706	71454078	2372	1186.0	
58587	chr11	71454701	71455122	421	210.0	
58588	chr11	71532091	71532346	255	128.0	
58589	chr11	71639144	71639658	514	257.0	
58590	chr11	71710264	71710823	559	280.0	
58591	chr11	71786165	71788465	2300	1150.0	
58592	chr11	71792559	71793250	691	346.0	
58593	chr11	71800150	71800824	674	337.0	
58594	chr11	71813253	71814191	938	469.0	
58595	chr11	71864263	71864358	95	48.0	
58596	chr11	71927785	71929615	1830	915.0	
58597	chr11	71934213	71934615	402	201.0	
58598	chr11	71962489	71962926	437	218.0	
58599	chr11	71977684	71978536	852	426.0	
58600	chr11	71986134	71986550	416	208.0	
58601	chr11	71991373	71991984	611	306.0	
58602	chr11	71993669	71994014	345	172.0	
58603	chr11	71996708	71997704	996	498.0	
58604	chr11	71998294	71999710	1416	708.0	
58605	chr11	72001272	72001812	540	270.0	
58606	chr11	72003118	72003179	61	30.0	
58607	chr11	72024997	72025936	939	470.0	
58608	chr11	72038477	72038559	82	41.0	
58609	chr11	72039289	72042541	3252	1626.0	
58610	chr11	72061957	72062363	406	203.0	
58611	chr11	72069194	72070449	1255	628.0	
58612	chr11	72075054	72075711	657	328.0	
58613	chr11	72079407	72082446	3039	1520.0	
58614	chr11	72090886	72092014	1128	564.0	
58615	chr11	72100246	72101024	778	389.0	
58616	chr11	72102138	72104052	1914	957.0	
58617	chr11	72111653	72113467	1814	907.0	
58618	chr11	72119407	72119433	26	13.0	
58619	chr11	72132638	72133763	1125	562.0	
58620	chr11	72135350	72135974	624	312.0	
58621	chr11	72143778	72144458	680	340.0	
58622	chr11	72172063	72172230	167	84.0	
58623	chr11	72183337	72183877	540	270.0	
58624	chr11	72209101	72209514	413	206.0	
58625	chr11	72217734	72218361	627	314.0	
58626	chr11	72221352	72226280	4928	2464.0	
58627	chr11	72237920	72238596	676	338.0	
58628	chr11	72239377	72241314	1937	968.0	
58629	chr11	72244108	72244421	313	156.0	
58630	chr11	72247562	72247604	42	21.0	
58631	chr11	72263244	72263751	507	254.0	
58632	chr11	72269136	72269758	622	311.0	
58633	chr11	72272892	72273651	759	380.0	
58634	chr11	72290708	72291224	516	258.0	
58635	chr11	72333712	72334057	345	172.0	
58636	chr11	72347754	72348078	324	162.0	
58637	chr11	72349982	72350353	371	186.0	
58638	chr11	72387792	72388574	782	391.0	
58639	chr11	72405171	72405200	29	14.0	
58640	chr11	72411462	72412441	979	490.0	
58641	chr11	72413951	72414608	657	328.0	
58642	chr11	72423840	72424140	300	150.0	
58643	chr11	72425283	72425779	496	248.0	
58644	chr11	72430693	72431585	892	446.0	
58645	chr11	72432440	72435285	2845	1422.0	
58646	chr11	72436574	72437039	465	232.0	
58647	chr11	72440344	72441144	800	400.0	
58648	chr11	72446874	72447787	913	456.0	
58649	chr11	72471202	72471737	535	268.0	
58650	chr11	72478714	72478983	269	134.0	
58651	chr11	72482185	72482723	538	269.0	
58652	chr11	72483463	72484316	853	426.0	
58653	chr11	72519217	72520583	1366	683.0	
58654	chr11	72553676	72554149	473	236.0	
58655	chr11	72569889	72570395	506	253.0	
58656	chr11	72573308	72573792	484	242.0	
58657	chr11	72584120	72586322	2202	1101.0	
58658	chr11	72588396	72588760	364	182.0	
58659	chr11	72589692	72590767	1075	538.0	
58660	chr11	72591865	72592566	701	350.0	
58661	chr11	72607290	72607463	173	86.0	
58662	chr11	72609125	72609353	228	114.0	
58663	chr11	72612259	72612690	431	216.0	
58664	chr11	72613766	72614623	857	428.0	
58665	chr11	72624726	72625232	506	253.0	
58666	chr11	72635550	72635842	292	146.0	
58667	chr11	72642115	72643685	1570	785.0	
58668	chr11	72653702	72654113	411	206.0	
58669	chr11	72662434	72662569	135	68.0	
58670	chr11	72667553	72667680	127	64.0	
58671	chr11	72668642	72668992	350	175.0	
58672	chr11	72669790	72669888	98	49.0	
58673	chr11	72670685	72671255	570	285.0	
58674	chr11	72673534	72677496	3962	1981.0	
58675	chr11	72678678	72679000	322	161.0	
58676	chr11	72679615	72682533	2918	1459.0	
58677	chr11	72683394	72685168	1774	887.0	
58678	chr11	72685708	72686227	519	260.0	
58679	chr11	72712215	72712945	730	365.0	
58680	chr11	72717791	72723201	5410	2705.0	
58681	chr11	72724802	72726101	1299	650.0	
58682	chr11	72727553	72727895	342	171.0	
58683	chr11	72730986	72731057	71	36.0	
58684	chr11	72735490	72742816	7326	3663.0	
58685	chr11	72743386	72744782	1396	698.0	
58686	chr11	72749361	72749581	220	110.0	
58687	chr11	72750531	72753776	3245	1622.0	
58688	chr11	72758952	72759673	721	360.0	
58689	chr11	72762855	72763311	456	228.0	
58690	chr11	72776792	72777136	344	172.0	
58691	chr11	72780761	72782704	1943	972.0	
58692	chr11	72787117	72788582	1465	732.0	
58693	chr11	72792748	72795360	2612	1306.0	
58694	chr11	72805028	72805737	709	354.0	
58695	chr11	72807041	72808754	1713	856.0	
58696	chr11	72810550	72811235	685	342.0	
58697	chr11	72812481	72816916	4435	2218.0	
58698	chr11	72821715	72823253	1538	769.0	
58699	chr11	72826380	72826645	265	132.0	
58700	chr11	72827594	72828817	1223	612.0	
58701	chr11	72831368	72832179	811	406.0	
58702	chr11	72834708	72835686	978	489.0	
58703	chr11	72848846	72849289	443	222.0	
58704	chr11	72924549	72925007	458	229.0	
58705	chr11	72935736	72936087	351	176.0	
58706	chr11	72951130	72952402	1272	636.0	
58707	chr11	72969791	72970336	545	272.0	
58708	chr11	72975718	72976465	747	374.0	
58709	chr11	72982016	72982088	72	36.0	
58710	chr11	73003129	73003443	314	157.0	
58711	chr11	73028547	73029068	521	260.0	
58712	chr11	73034347	73034748	401	200.0	
58713	chr11	73047893	73048511	618	309.0	
58714	chr11	73072901	73073386	485	242.0	
58715	chr11	73085188	73085747	559	280.0	
58716	chr11	73087726	73088197	471	236.0	
58717	chr11	73137598	73138046	448	224.0	
58718	chr11	73140395	73144005	3610	1805.0	
58719	chr11	73147719	73148056	337	168.0	
58720	chr11	73152302	73154819	2517	1258.0	
58721	chr11	73157090	73158166	1076	538.0	
58722	chr11	73162303	73162757	454	227.0	
58723	chr11	73177795	73178654	859	430.0	
58724	chr11	73184903	73186704	1801	900.0	
58725	chr11	73189130	73189933	803	402.0	
58726	chr11	73191756	73192508	752	376.0	
58727	chr11	73200256	73200620	364	182.0	
58728	chr11	73201493	73201515	22	11.0	
58729	chr11	73204524	73206011	1487	744.0	
58730	chr11	73214378	73214993	615	308.0	
58731	chr11	73215718	73216868	1150	575.0	
58732	chr11	73217421	73219005	1584	792.0	
58733	chr11	73224071	73224462	391	196.0	
58734	chr11	73236655	73237346	691	346.0	
58735	chr11	73242349	73243035	686	343.0	
58736	chr11	73249225	73250167	942	471.0	
58737	chr11	73252808	73253235	427	214.0	
58738	chr11	73269920	73270432	512	256.0	
58739	chr11	73271585	73272583	998	499.0	
58740	chr11	73274535	73275133	598	299.0	
58741	chr11	73280446	73281773	1327	664.0	
58742	chr11	73283557	73284081	524	262.0	
58743	chr11	73287777	73290034	2257	1128.0	
58744	chr11	73292189	73292451	262	131.0	
58745	chr11	73295200	73295983	783	392.0	
58746	chr11	73306935	73309854	2919	1460.0	
58747	chr11	73313650	73314076	426	213.0	
58748	chr11	73321749	73322822	1073	536.0	
58749	chr11	73335069	73335987	918	459.0	
58750	chr11	73350351	73351839	1488	744.0	
58751	chr11	73360428	73360885	457	228.0	
58752	chr11	73363718	73364277	559	280.0	
58753	chr11	73365388	73366910	1522	761.0	
58754	chr11	73372260	73372853	593	296.0	
58755	chr11	73375437	73415876	40439	20220.0	
58756	chr11	73416654	73417041	387	194.0	
58757	chr11	73418448	73418489	41	20.0	
58758	chr11	73424744	73425831	1087	544.0	
58759	chr11	73459231	73460024	793	396.0	
58760	chr11	73461592	73462670	1078	539.0	
58761	chr11	73466691	73466924	233	116.0	
58762	chr11	73480717	73481057	340	170.0	
58763	chr11	73528429	73528832	403	202.0	
58764	chr11	73538478	73538998	520	260.0	
58765	chr11	73547915	73548220	305	152.0	
58766	chr11	73554629	73555098	469	234.0	
58767	chr11	73579075	73579089	14	7.0	
58768	chr11	73597194	73599265	2071	1036.0	
58769	chr11	73622984	73624303	1319	660.0	
58770	chr11	73625622	73626161	539	270.0	
58771	chr11	73645328	73645769	441	220.0	
58772	chr11	73646999	73648256	1257	628.0	
58773	chr11	73660589	73661746	1157	578.0	
58774	chr11	73716158	73716486	328	164.0	
58775	chr11	73750394	73750518	124	62.0	
58776	chr11	73757667	73757914	247	124.0	
58777	chr11	73759725	73762036	2311	1156.0	
58778	chr11	73778888	73780177	1289	644.0	
58779	chr11	73787459	73788767	1308	654.0	
58780	chr11	73876080	73877625	1545	772.0	
58781	chr11	73907270	73907589	319	160.0	
58782	chr11	73950773	73951232	459	230.0	
58783	chr11	73963907	73965441	1534	767.0	
58784	chr11	73967729	73977001	9272	4636.0	
58785	chr11	73978712	73984598	5886	2943.0	
58786	chr11	73991755	73991852	97	48.0	
58787	chr11	73994840	73996650	1810	905.0	
58788	chr11	73997354	73997683	329	164.0	
58789	chr11	73999545	73999904	359	180.0	
58790	chr11	74001777	74002116	339	170.0	
58791	chr11	74004828	74006011	1183	592.0	
58792	chr11	74010416	74010683	267	134.0	
58793	chr11	74011299	74012346	1047	524.0	
58794	chr11	74014899	74015300	401	200.0	
58795	chr11	74018090	74019109	1019	510.0	
58796	chr11	74019897	74021138	1241	620.0	
58797	chr11	74022444	74023726	1282	641.0	
58798	chr11	74025616	74026223	607	304.0	
58799	chr11	74030472	74031367	895	448.0	
58800	chr11	74033059	74033460	401	200.0	
58801	chr11	74169931	74172057	2126	1063.0	
58802	chr11	74232288	74232812	524	262.0	
58803	chr11	74255565	74256212	647	324.0	
58804	chr11	74311326	74311965	639	320.0	
58805	chr11	74312618	74312620	2	1.0	
58806	chr11	74321516	74321898	382	191.0	
58807	chr11	74388605	74389328	723	362.0	
58808	chr11	74397244	74399358	2114	1057.0	
58809	chr11	74417451	74417885	434	217.0	
58810	chr11	74449227	74450094	867	434.0	
58811	chr11	74453346	74453828	482	241.0	
58812	chr11	74460524	74463034	2510	1255.0	
58813	chr11	74467009	74467883	874	437.0	
58814	chr11	74471672	74472123	451	226.0	
58815	chr11	74473660	74474295	635	318.0	
58816	chr11	74492568	74494413	1845	922.0	
58817	chr11	74570487	74570928	441	220.0	
58818	chr11	74580978	74581812	834	417.0	
58819	chr11	74592248	74593647	1399	700.0	
58820	chr11	74683289	74683549	260	130.0	
58821	chr11	74685821	74686374	553	276.0	
58822	chr11	74702317	74702820	503	252.0	
58823	chr11	74726339	74727023	684	342.0	
58824	chr11	74735512	74735952	440	220.0	
58825	chr11	74739686	74740232	546	273.0	
58826	chr11	74747888	74750286	2398	1199.0	
58827	chr11	74768224	74768691	467	234.0	
58828	chr11	74770674	74770711	37	18.0	
58829	chr11	74776659	74776965	306	153.0	
58830	chr11	74783176	74784743	1567	784.0	
58831	chr11	74929676	74930217	541	270.0	
58832	chr11	74948467	74950210	1743	872.0	
58833	chr11	74980608	74981120	512	256.0	
58834	chr11	74988364	74990636	2272	1136.0	
58835	chr11	75022679	75023317	638	319.0	
58836	chr11	75031971	75032335	364	182.0	
58837	chr11	75100270	75100775	505	252.0	
58838	chr11	75140440	75141128	688	344.0	
58839	chr11	75142956	75144887	1931	966.0	
58840	chr11	75147823	75148408	585	292.0	
58841	chr11	75174537	75175284	747	374.0	
58842	chr11	75181489	75182076	587	294.0	
58843	chr11	75195209	75195685	476	238.0	
58844	chr11	75204751	75205401	650	325.0	
58845	chr11	75214274	75214817	543	272.0	
58846	chr11	75240323	75242476	2153	1076.0	
58847	chr11	75248356	75249278	922	461.0	
58848	chr11	75260467	75266593	6126	3063.0	
58849	chr11	75271035	75271400	365	182.0	
58850	chr11	75275309	75276162	853	426.0	
58851	chr11	75280050	75280925	875	438.0	
58852	chr11	75328482	75329611	1129	564.0	
58853	chr11	75337164	75337806	642	321.0	
58854	chr11	75339981	75342372	2391	1196.0	
58855	chr11	75343598	75346206	2608	1304.0	
58856	chr11	75347082	75347504	422	211.0	
58857	chr11	75349324	75353141	3817	1908.0	
58858	chr11	75365465	75366352	887	444.0	
58859	chr11	75369749	75370395	646	323.0	
58860	chr11	75380579	75381098	519	260.0	
58861	chr11	75383177	75384950	1773	886.0	
58862	chr11	75388302	75389278	976	488.0	
58863	chr11	75398873	75403063	4190	2095.0	
58864	chr11	75405876	75406623	747	374.0	
58865	chr11	75407146	75408514	1368	684.0	
58866	chr11	75427991	75428895	904	452.0	
58867	chr11	75429592	75431797	2205	1102.0	
58868	chr11	75434306	75434502	196	98.0	
58869	chr11	75445099	75446096	997	498.0	
58870	chr11	75451480	75451842	362	181.0	
58871	chr11	75475214	75476364	1150	575.0	
58872	chr11	75482285	75482341	56	28.0	
58873	chr11	75491998	75492718	720	360.0	
58874	chr11	75504389	75504969	580	290.0	
58875	chr11	75507645	75509091	1446	723.0	
58876	chr11	75517191	75517826	635	318.0	
58877	chr11	75523095	75526689	3594	1797.0	
58878	chr11	75531918	75532789	871	436.0	
58879	chr11	75534761	75534982	221	110.0	
58880	chr11	75536786	75538053	1267	634.0	
58881	chr11	75547562	75547941	379	190.0	
58882	chr11	75561367	75563882	2515	1258.0	
58883	chr11	75575167	75575565	398	199.0	
58884	chr11	75576314	75577605	1291	646.0	
58885	chr11	75582788	75584197	1409	704.0	
58886	chr11	75639732	75640260	528	264.0	
58887	chr11	75667704	75669075	1371	686.0	
58888	chr11	75673967	75674344	377	188.0	
58889	chr11	75689684	75690558	874	437.0	
58890	chr11	75706188	75706720	532	266.0	
58891	chr11	75723112	75723633	521	260.0	
58892	chr11	75762798	75763314	516	258.0	
58893	chr11	75767978	75769444	1466	733.0	
58894	chr11	75771360	75774177	2817	1408.0	
58895	chr11	75777315	75778143	828	414.0	
58896	chr11	75780061	75780478	417	208.0	
58897	chr11	75801603	75802214	611	306.0	
58898	chr11	75803023	75803713	690	345.0	
58899	chr11	75810013	75811425	1412	706.0	
58900	chr11	75814004	75817487	3483	1742.0	
58901	chr11	75822544	75822978	434	217.0	
58902	chr11	75824252	75824938	686	343.0	
58903	chr11	75826357	75827113	756	378.0	
58904	chr11	75836304	75836876	572	286.0	
58905	chr11	75867721	75868187	466	233.0	
58906	chr11	75873362	75874327	965	482.0	
58907	chr11	75886886	75887128	242	121.0	
58908	chr11	75891813	75892779	966	483.0	
58909	chr11	75896807	75897210	403	202.0	
58910	chr11	75907945	75908181	236	118.0	
58911	chr11	75966925	75967090	165	82.0	
58912	chr11	76071303	76071406	103	52.0	
58913	chr11	76119116	76119427	311	156.0	
58914	chr11	76123290	76123366	76	38.0	
58915	chr11	76139309	76139642	333	166.0	
58916	chr11	76151909	76153935	2026	1013.0	
58917	chr11	76161234	76161801	567	284.0	
58918	chr11	76199894	76200765	871	436.0	
58919	chr11	76205819	76211323	5504	2752.0	
58920	chr11	76215070	76215220	150	75.0	
58921	chr11	76222573	76222579	6	3.0	
58922	chr11	76226701	76226998	297	148.0	
58923	chr11	76227889	76228305	416	208.0	
58924	chr11	76231825	76232645	820	410.0	
58925	chr11	76233647	76236897	3250	1625.0	
58926	chr11	76237933	76238344	411	206.0	
58927	chr11	76250829	76252136	1307	654.0	
58928	chr11	76266702	76266742	40	20.0	
58929	chr11	76287947	76288749	802	401.0	
58930	chr11	76313344	76313360	16	8.0	
58931	chr11	76318541	76319391	850	425.0	
58932	chr11	76335674	76336881	1207	604.0	
58933	chr11	76339060	76339782	722	361.0	
58934	chr11	76377010	76377150	140	70.0	
58935	chr11	76379975	76381958	1983	992.0	
58936	chr11	76392892	76393311	419	210.0	
58937	chr11	76443867	76446320	2453	1226.0	
58938	chr11	76495049	76495440	391	196.0	
58939	chr11	76588274	76589019	745	372.0	
58940	chr11	76598481	76598858	377	188.0	
58941	chr11	76610946	76611445	499	250.0	
58942	chr11	76626679	76627993	1314	657.0	
58943	chr11	76629102	76630895	1793	896.0	
58944	chr11	76637339	76638031	692	346.0	
58945	chr11	76642354	76642671	317	158.0	
58946	chr11	76657106	76657719	613	306.0	
58947	chr11	76664539	76665533	994	497.0	
58948	chr11	76666322	76666850	528	264.0	
58949	chr11	76670159	76673504	3345	1672.0	
58950	chr11	76674552	76674967	415	208.0	
58951	chr11	76678285	76678790	505	252.0	
58952	chr11	76680553	76681295	742	371.0	
58953	chr11	76685829	76687078	1249	624.0	
58954	chr11	76690654	76691249	595	298.0	
58955	chr11	76721663	76722240	577	288.0	
58956	chr11	76733855	76734316	461	230.0	
58957	chr11	76768340	76769059	719	360.0	
58958	chr11	76782823	76783436	613	306.0	
58959	chr11	76798702	76799685	983	492.0	
58960	chr11	76807239	76807836	597	298.0	
58961	chr11	76810185	76810654	469	234.0	
58962	chr11	76823567	76824568	1001	500.0	
58963	chr11	76839237	76839638	401	200.0	
58964	chr11	76856104	76856724	620	310.0	
58965	chr11	76857695	76858495	800	400.0	
58966	chr11	76860165	76862080	1915	958.0	
58967	chr11	76863087	76863702	615	308.0	
58968	chr11	76868476	76868605	129	64.0	
58969	chr11	76885382	76885770	388	194.0	
58970	chr11	76919077	76920519	1442	721.0	
58971	chr11	77038786	77039145	359	180.0	
58972	chr11	77039700	77040106	406	203.0	
58973	chr11	77045899	77048317	2418	1209.0	
58974	chr11	77065862	77068354	2492	1246.0	
58975	chr11	77071879	77073627	1748	874.0	
58976	chr11	77082444	77083305	861	430.0	
58977	chr11	77090875	77091748	873	436.0	
58978	chr11	77101166	77101518	352	176.0	
58979	chr11	77113530	77113847	317	158.0	
58980	chr11	77126866	77127730	864	432.0	
58981	chr11	77142106	77142586	480	240.0	
58982	chr11	77147613	77148488	875	438.0	
58983	chr11	77152055	77152580	525	262.0	
58984	chr11	77175755	77176369	614	307.0	
58985	chr11	77188300	77188758	458	229.0	
58986	chr11	77191986	77192400	414	207.0	
58987	chr11	77381797	77382127	330	165.0	
58988	chr11	77409139	77412497	3358	1679.0	
58989	chr11	77418310	77419287	977	488.0	
58990	chr11	77435942	77436265	323	162.0	
58991	chr11	77444247	77444647	400	200.0	
58992	chr11	77445901	77446209	308	154.0	
58993	chr11	77448347	77449567	1220	610.0	
58994	chr11	77456342	77457028	686	343.0	
58995	chr11	77470383	77470829	446	223.0	
58996	chr11	77471522	77472047	525	262.0	
58997	chr11	77472975	77475065	2090	1045.0	
58998	chr11	77476039	77476263	224	112.0	
58999	chr11	77497281	77497633	352	176.0	
59000	chr11	77501501	77502886	1385	692.0	
59001	chr11	77511992	77512662	670	335.0	
59002	chr11	77548236	77548661	425	212.0	
59003	chr11	77589135	77590583	1448	724.0	
59004	chr11	77619647	77619982	335	168.0	
59005	chr11	77630899	77631465	566	283.0	
59006	chr11	77633798	77634507	709	354.0	
59007	chr11	77636626	77638402	1776	888.0	
59008	chr11	77661122	77661153	31	16.0	
59009	chr11	77776529	77776796	267	134.0	
59010	chr11	77819064	77821922	2858	1429.0	
59011	chr11	77842454	77842855	401	200.0	
59012	chr11	77992164	77992296	132	66.0	
59013	chr11	77993813	77995647	1834	917.0	
59014	chr11	77999364	78000596	1232	616.0	
59015	chr11	78039996	78040317	321	160.0	
59016	chr11	78045784	78046787	1003	502.0	
59017	chr11	78078502	78080449	1947	974.0	
59018	chr11	78138644	78140382	1738	869.0	
59019	chr11	78143306	78143813	507	254.0	
59020	chr11	78180764	78181620	856	428.0	
59021	chr11	78187439	78190094	2655	1328.0	
59022	chr11	78192969	78193441	472	236.0	
59023	chr11	78202466	78203827	1361	680.0	
59024	chr11	78223321	78223753	432	216.0	
59025	chr11	78228335	78228833	498	249.0	
59026	chr11	78289576	78290796	1220	610.0	
59027	chr11	78291849	78292813	964	482.0	
59028	chr11	78312724	78313105	381	190.0	
59029	chr11	78313876	78314352	476	238.0	
59030	chr11	78323309	78323751	442	221.0	
59031	chr11	78325521	78325801	280	140.0	
59032	chr11	78332142	78332458	316	158.0	
59033	chr11	78338210	78338624	414	207.0	
59034	chr11	78350115	78351576	1461	730.0	
59035	chr11	78359906	78360275	369	184.0	
59036	chr11	78363016	78363497	481	240.0	
59037	chr11	78379023	78379362	339	170.0	
59038	chr11	78390724	78391218	494	247.0	
59039	chr11	78397327	78397907	580	290.0	
59040	chr11	78413856	78414638	782	391.0	
59041	chr11	78416134	78421382	5248	2624.0	
59042	chr11	78424198	78425456	1258	629.0	
59043	chr11	78427433	78428381	948	474.0	
59044	chr11	78429785	78429903	118	59.0	
59045	chr11	78432152	78432611	459	230.0	
59046	chr11	78438499	78439025	526	263.0	
59047	chr11	78448652	78448905	253	126.0	
59048	chr11	78465015	78465887	872	436.0	
59049	chr11	78533266	78533687	421	210.0	
59050	chr11	78560786	78561123	337	168.0	
59051	chr11	78564281	78565050	769	384.0	
59052	chr11	78573854	78575881	2027	1014.0	
59053	chr11	78577450	78577834	384	192.0	
59054	chr11	78586447	78586894	447	224.0	
59055	chr11	78645174	78645639	465	232.0	
59056	chr11	78646653	78646932	279	140.0	
59057	chr11	78798542	78799123	581	290.0	
59058	chr11	78812546	78812818	272	136.0	
59059	chr11	78815909	78815952	43	22.0	
59060	chr11	78828573	78829056	483	242.0	
59061	chr11	78852295	78852571	276	138.0	
59062	chr11	78935322	78936104	782	391.0	
59063	chr11	79189124	79189435	311	156.0	
59064	chr11	79387306	79387931	625	312.0	
59065	chr11	79400759	79400890	131	66.0	
59066	chr11	79404325	79404692	367	184.0	
59067	chr11	79406359	79406821	462	231.0	
59068	chr11	79437053	79437427	374	187.0	
59069	chr11	79438909	79439097	188	94.0	
59070	chr11	79440283	79442419	2136	1068.0	
59071	chr11	79458763	79459058	295	148.0	
59072	chr11	79482816	79483165	349	174.0	
59073	chr11	79493581	79493930	349	174.0	
59074	chr11	81644240	81644650	410	205.0	
59075	chr11	81787722	81787870	148	74.0	
59076	chr11	81869185	81870966	1781	890.0	
59077	chr11	81874588	81875087	499	250.0	
59078	chr11	81963056	81963335	279	140.0	
59079	chr11	82494938	82495339	401	200.0	
59080	chr11	82521214	82521967	753	376.0	
59081	chr11	82547034	82547683	649	324.0	
59082	chr11	82557207	82557763	556	278.0	
59083	chr11	82673629	82673973	344	172.0	
59084	chr11	82682197	82682636	439	220.0	
59085	chr11	82695638	82696136	498	249.0	
59086	chr11	82718163	82718618	455	228.0	
59087	chr11	82732995	82734142	1147	574.0	
59088	chr11	82750739	82751238	499	250.0	
59089	chr11	82775748	82776148	400	200.0	
59090	chr11	82864155	82864738	583	292.0	
59091	chr11	82867426	82868022	596	298.0	
59092	chr11	82883710	82884356	646	323.0	
59093	chr11	82889118	82891625	2507	1254.0	
59094	chr11	82895365	82896348	983	492.0	
59095	chr11	82898251	82902387	4136	2068.0	
59096	chr11	82906106	82906625	519	260.0	
59097	chr11	82907248	82907864	616	308.0	
59098	chr11	82919974	82920730	756	378.0	
59099	chr11	82927193	82927923	730	365.0	
59100	chr11	82955611	82956778	1167	584.0	
59101	chr11	82959888	82961156	1268	634.0	
59102	chr11	82970601	82972135	1534	767.0	
59103	chr11	82989860	82990326	466	233.0	
59104	chr11	83035369	83035925	556	278.0	
59105	chr11	83044906	83045375	469	234.0	
59106	chr11	83053920	83054440	520	260.0	
59107	chr11	83056348	83056355	7	4.0	
59108	chr11	83061855	83064088	2233	1116.0	
59109	chr11	83066489	83066801	312	156.0	
59110	chr11	83069187	83073687	4500	2250.0	
59111	chr11	83115877	83116523	646	323.0	
59112	chr11	83117201	83117972	771	386.0	
59113	chr11	83122154	83122387	233	116.0	
59114	chr11	83141346	83141352	6	3.0	
59115	chr11	83155646	83163196	7550	3775.0	
59116	chr11	83164639	83164899	260	130.0	
59117	chr11	83169003	83169712	709	354.0	
59118	chr11	83171130	83171587	457	228.0	
59119	chr11	83172489	83172892	403	202.0	
59120	chr11	83173779	83174474	695	348.0	
59121	chr11	83175781	83176220	439	220.0	
59122	chr11	83187475	83187976	501	250.0	
59123	chr11	83192743	83195662	2919	1460.0	
59124	chr11	83207066	83207133	67	34.0	
59125	chr11	83241367	83241688	321	160.0	
59126	chr11	83249954	83250446	492	246.0	
59127	chr11	83285321	83287006	1685	842.0	
59128	chr11	83289466	83289963	497	248.0	
59129	chr11	83292711	83293384	673	336.0	
59130	chr11	83438513	83438785	272	136.0	
59131	chr11	83828005	83828315	310	155.0	
59132	chr11	84549346	84549658	312	156.0	
59133	chr11	84714270	84714744	474	237.0	
59134	chr11	84720747	84721866	1119	560.0	
59135	chr11	85123849	85124258	409	204.0	
59136	chr11	85316909	85317436	527	264.0	
59137	chr11	85595283	85595713	430	215.0	
59138	chr11	85611711	85611910	199	100.0	
59139	chr11	85627190	85629258	2068	1034.0	
59140	chr11	85647250	85648604	1354	677.0	
59141	chr11	85651857	85651969	112	56.0	
59142	chr11	85663022	85665890	2868	1434.0	
59143	chr11	85680908	85681291	383	192.0	
59144	chr11	85682321	85683301	980	490.0	
59145	chr11	85694383	85694787	404	202.0	
59146	chr11	85699735	85700721	986	493.0	
59147	chr11	85737742	85738155	413	206.0	
59148	chr11	85740785	85741153	368	184.0	
59149	chr11	85745474	85746072	598	299.0	
59150	chr11	85749451	85751221	1770	885.0	
59151	chr11	85752175	85753854	1679	840.0	
59152	chr11	85755272	85756965	1693	846.0	
59153	chr11	85758522	85758700	178	89.0	
59154	chr11	85774730	85774850	120	60.0	
59155	chr11	85780822	85782062	1240	620.0	
59156	chr11	85808914	85811777	2863	1432.0	
59157	chr11	85823595	85824666	1071	536.0	
59158	chr11	85826156	85828135	1979	990.0	
59159	chr11	85854343	85855825	1482	741.0	
59160	chr11	85913404	85913973	569	284.0	
59161	chr11	85937872	85938132	260	130.0	
59162	chr11	85941348	85941803	455	228.0	
59163	chr11	85945717	85946188	471	236.0	
59164	chr11	85947802	85948442	640	320.0	
59165	chr11	85950873	85951109	236	118.0	
59166	chr11	85953418	85954795	1377	688.0	
59167	chr11	85989732	85990140	408	204.0	
59168	chr11	86021281	86021884	603	302.0	
59169	chr11	86041633	86043271	1638	819.0	
59170	chr11	86046926	86048094	1168	584.0	
59171	chr11	86048624	86048987	363	182.0	
59172	chr11	86052347	86053503	1156	578.0	
59173	chr11	86056203	86057004	801	400.0	
59174	chr11	86058467	86058810	343	172.0	
59175	chr11	86061966	86063155	1189	594.0	
59176	chr11	86064180	86065740	1560	780.0	
59177	chr11	86066368	86070542	4174	2087.0	
59178	chr11	86077933	86078135	202	101.0	
59179	chr11	86116281	86116723	442	221.0	
59180	chr11	86134714	86135181	467	234.0	
59181	chr11	86138603	86139483	880	440.0	
59182	chr11	86141399	86142205	806	403.0	
59183	chr11	86143336	86144128	792	396.0	
59184	chr11	86151417	86152219	802	401.0	
59185	chr11	86156427	86156982	555	278.0	
59186	chr11	86161727	86163614	1887	944.0	
59187	chr11	86171756	86172116	360	180.0	
59188	chr11	86176381	86176963	582	291.0	
59189	chr11	86178355	86178710	355	178.0	
59190	chr11	86180661	86180776	115	58.0	
59191	chr11	86182940	86183470	530	265.0	
59192	chr11	86192904	86194156	1252	626.0	
59193	chr11	86201421	86203358	1937	968.0	
59194	chr11	86205618	86206355	737	368.0	
59195	chr11	86214637	86215214	577	288.0	
59196	chr11	86218159	86220222	2063	1032.0	
59197	chr11	86243721	86246355	2634	1317.0	
59198	chr11	86247928	86249089	1161	580.0	
59199	chr11	86287046	86287547	501	250.0	
59200	chr11	86289004	86289137	133	66.0	
59201	chr11	86291587	86292318	731	366.0	
59202	chr11	86293086	86293762	676	338.0	
59203	chr11	86301682	86302887	1205	602.0	
59204	chr11	86416568	86416851	283	142.0	
59205	chr11	86456039	86456534	495	248.0	
59206	chr11	86486471	86487233	762	381.0	
59207	chr11	86504002	86504604	602	301.0	
59208	chr11	86514528	86514607	79	40.0	
59209	chr11	86551364	86551601	237	118.0	
59210	chr11	86592752	86593395	643	322.0	
59211	chr11	86597282	86597574	292	146.0	
59212	chr11	86608142	86608798	656	328.0	
59213	chr11	86632819	86632920	101	50.0	
59214	chr11	86671585	86672732	1147	574.0	
59215	chr11	86743467	86743518	51	26.0	
59216	chr11	86799980	86801017	1037	518.0	
59217	chr11	86802585	86802998	413	206.0	
59218	chr11	86805772	86806616	844	422.0	
59219	chr11	86818438	86818908	470	235.0	
59220	chr11	86870022	86870331	309	154.0	
59221	chr11	86939061	86939488	427	214.0	
59222	chr11	86954889	86956681	1792	896.0	
59223	chr11	86978815	86979167	352	176.0	
59224	chr11	87030549	87031126	577	288.0	
59225	chr11	87036113	87038631	2518	1259.0	
59226	chr11	87076453	87076801	348	174.0	
59227	chr11	87081263	87081934	671	336.0	
59228	chr11	87097425	87097938	513	256.0	
59229	chr11	87213746	87213751	5	2.0	
59230	chr11	87219366	87219636	270	135.0	
59231	chr11	87290322	87290649	327	164.0	
59232	chr11	87298978	87299386	408	204.0	
59233	chr11	87351976	87351981	5	2.0	
59234	chr11	87352610	87353514	904	452.0	
59235	chr11	87397324	87397679	355	178.0	
59236	chr11	87421326	87421707	381	190.0	
59237	chr11	88016383	88016809	426	213.0	
59238	chr11	88102659	88102918	259	130.0	
59239	chr11	88103642	88104054	412	206.0	
59240	chr11	88174560	88175779	1219	610.0	
59241	chr11	88179150	88179535	385	192.0	
59242	chr11	88208733	88209141	408	204.0	
59243	chr11	88231901	88232247	346	173.0	
59244	chr11	88301075	88302231	1156	578.0	
59245	chr11	88302978	88303454	476	238.0	
59246	chr11	88324751	88325287	536	268.0	
59247	chr11	88327180	88327555	375	188.0	
59248	chr11	88328981	88329262	281	140.0	
59249	chr11	88335029	88339038	4009	2004.0	
59250	chr11	88341561	88342262	701	350.0	
59251	chr11	88343239	88343248	9	4.0	
59252	chr11	88345296	88345859	563	282.0	
59253	chr11	88354152	88355209	1057	528.0	
59254	chr11	88357263	88357832	569	284.0	
59255	chr11	88359499	88360008	509	254.0	
59256	chr11	88363480	88364199	719	360.0	
59257	chr11	88367341	88367756	415	208.0	
59258	chr11	88402398	88402695	297	148.0	
59259	chr11	88414224	88415550	1326	663.0	
59260	chr11	88421487	88421988	501	250.0	
59261	chr11	88435419	88435818	399	200.0	
59262	chr11	88474630	88475039	409	204.0	
59263	chr11	88484717	88485398	681	340.0	
59264	chr11	88508846	88509482	636	318.0	
59265	chr11	88544108	88544831	723	362.0	
59266	chr11	88552391	88552850	459	230.0	
59267	chr11	88843545	88844345	800	400.0	
59268	chr11	88844880	88845309	429	214.0	
59269	chr11	89612100	89612511	411	206.0	
59270	chr11	90202354	90202551	197	98.0	
59271	chr11	90204776	90205490	714	357.0	
59272	chr11	90206060	90206062	2	1.0	
59273	chr11	90220330	90220812	482	241.0	
59274	chr11	90221886	90223969	2083	1042.0	
59275	chr11	90251020	90251324	304	152.0	
59276	chr11	90343712	90344048	336	168.0	
59277	chr11	92941942	92942375	433	216.0	
59278	chr11	93085085	93085532	447	224.0	
59279	chr11	93089450	93089818	368	184.0	
59280	chr11	93166928	93166940	12	6.0	
59281	chr11	93193687	93194132	445	222.0	
59282	chr11	93196795	93198675	1880	940.0	
59283	chr11	93199513	93200216	703	352.0	
59284	chr11	93209461	93209891	430	215.0	
59285	chr11	93225713	93226010	297	148.0	
59286	chr11	93234525	93235076	551	276.0	
59287	chr11	93497428	93498057	629	314.0	
59288	chr11	93513033	93513166	133	66.0	
59289	chr11	93515390	93515894	504	252.0	
59290	chr11	93521137	93521376	239	120.0	
59291	chr11	93522789	93525184	2395	1198.0	
59292	chr11	93526355	93527163	808	404.0	
59293	chr11	93528901	93530234	1333	666.0	
59294	chr11	93537516	93538429	913	456.0	
59295	chr11	93541195	93543889	2694	1347.0	
59296	chr11	93591417	93591721	304	152.0	
59297	chr11	93604242	93604690	448	224.0	
59298	chr11	93608130	93608881	751	376.0	
59299	chr11	93612292	93612622	330	165.0	
59300	chr11	93614468	93615602	1134	567.0	
59301	chr11	93622245	93622436	191	96.0	
59302	chr11	93645348	93645792	444	222.0	
59303	chr11	93652028	93652477	449	224.0	
59304	chr11	93654237	93655651	1414	707.0	
59305	chr11	93660951	93663328	2377	1188.0	
59306	chr11	93689304	93689677	373	186.0	
59307	chr11	93718103	93718724	621	310.0	
59308	chr11	93728278	93728368	90	45.0	
59309	chr11	93733551	93733699	148	74.0	
59310	chr11	93734671	93735456	785	392.0	
59311	chr11	93737900	93738946	1046	523.0	
59312	chr11	93739853	93742461	2608	1304.0	
59313	chr11	93774589	93774923	334	167.0	
59314	chr11	93783547	93785403	1856	928.0	
59315	chr11	94127508	94131713	4205	2102.0	
59316	chr11	94134026	94134196	170	85.0	
59317	chr11	94135042	94135615	573	286.0	
59318	chr11	94147384	94147794	410	205.0	
59319	chr11	94152211	94152689	478	239.0	
59320	chr11	94171686	94171988	302	151.0	
59321	chr11	94183728	94184192	464	232.0	
59322	chr11	94325664	94326098	434	217.0	
59323	chr11	94473126	94473857	731	366.0	
59324	chr11	94493073	94494695	1622	811.0	
59325	chr11	94504689	94505168	479	240.0	
59326	chr11	94507503	94507820	317	158.0	
59327	chr11	94512188	94513507	1319	660.0	
59328	chr11	94519449	94520116	667	334.0	
59329	chr11	94525957	94526942	985	492.0	
59330	chr11	94534121	94534707	586	293.0	
59331	chr11	94543098	94546255	3157	1578.0	
59332	chr11	94546785	94547170	385	192.0	
59333	chr11	94550548	94550985	437	218.0	
59334	chr11	94558375	94558968	593	296.0	
59335	chr11	94574207	94575022	815	408.0	
59336	chr11	94576321	94576764	443	222.0	
59337	chr11	94581859	94582315	456	228.0	
59338	chr11	94583552	94584668	1116	558.0	
59339	chr11	94598148	94598222	74	37.0	
59340	chr11	94602614	94603503	889	444.0	
59341	chr11	94623054	94623596	542	271.0	
59342	chr11	94638329	94639499	1170	585.0	
59343	chr11	94650741	94651226	485	242.0	
59344	chr11	94726467	94726700	233	116.0	
59345	chr11	94740664	94741555	891	446.0	
59346	chr11	94767880	94769537	1657	828.0	
59347	chr11	94786557	94786871	314	157.0	
59348	chr11	94876611	94877177	566	283.0	
59349	chr11	94897264	94897704	440	220.0	
59350	chr11	94922616	94923281	665	332.0	
59351	chr11	94924604	94925789	1185	592.0	
59352	chr11	94926723	94926858	135	68.0	
59353	chr11	94934828	94935206	378	189.0	
59354	chr11	94972889	94974272	1383	692.0	
59355	chr11	95037637	95037813	176	88.0	
59356	chr11	95066614	95070435	3821	1910.0	
59357	chr11	95088681	95090808	2127	1064.0	
59358	chr11	95092883	95093620	737	368.0	
59359	chr11	95096129	95096663	534	267.0	
59360	chr11	95108213	95108633	420	210.0	
59361	chr11	95138423	95138745	322	161.0	
59362	chr11	95147515	95147759	244	122.0	
59363	chr11	95149939	95154943	5004	2502.0	
59364	chr11	95158073	95158156	83	42.0	
59365	chr11	95211695	95211725	30	15.0	
59366	chr11	95222958	95223203	245	122.0	
59367	chr11	95229383	95233085	3702	1851.0	
59368	chr11	95241679	95242482	803	402.0	
59369	chr11	95244975	95245511	536	268.0	
59370	chr11	95249004	95249450	446	223.0	
59371	chr11	95253846	95255027	1181	590.0	
59372	chr11	95256131	95257014	883	442.0	
59373	chr11	95268417	95268681	264	132.0	
59374	chr11	95280139	95280713	574	287.0	
59375	chr11	95283656	95283951	295	148.0	
59376	chr11	95296431	95297387	956	478.0	
59377	chr11	95306780	95307231	451	226.0	
59378	chr11	95318521	95318853	332	166.0	
59379	chr11	95336003	95336385	382	191.0	
59380	chr11	95337147	95338160	1013	506.0	
59381	chr11	95360640	95360795	155	78.0	
59382	chr11	95363003	95363631	628	314.0	
59383	chr11	95365331	95365796	465	232.0	
59384	chr11	95371088	95371558	470	235.0	
59385	chr11	95443385	95443762	377	188.0	
59386	chr11	95451863	95452091	228	114.0	
59387	chr11	95505713	95506424	711	356.0	
59388	chr11	95605450	95605932	482	241.0	
59389	chr11	95641486	95642033	547	274.0	
59390	chr11	95650246	95650654	408	204.0	
59391	chr11	95688510	95689377	867	434.0	
59392	chr11	95697959	95698491	532	266.0	
59393	chr11	95699548	95701183	1635	818.0	
59394	chr11	95702997	95703459	462	231.0	
59395	chr11	95705030	95706132	1102	551.0	
59396	chr11	95715570	95716404	834	417.0	
59397	chr11	95764198	95764693	495	248.0	
59398	chr11	95767519	95768022	503	252.0	
59399	chr11	95788700	95791812	3112	1556.0	
59400	chr11	95835900	95836487	587	294.0	
59401	chr11	95849121	95849426	305	152.0	
59402	chr11	95923355	95924658	1303	652.0	
59403	chr11	96011969	96012750	781	390.0	
59404	chr11	96013478	96014681	1203	602.0	
59405	chr11	96016076	96016694	618	309.0	
59406	chr11	96053391	96053690	299	150.0	
59407	chr11	96054844	96055266	422	211.0	
59408	chr11	96062240	96062537	297	148.0	
59409	chr11	96074669	96076600	1931	966.0	
59410	chr11	96091493	96091961	468	234.0	
59411	chr11	96105322	96106027	705	352.0	
59412	chr11	96134516	96135205	689	344.0	
59413	chr11	96139921	96140322	401	200.0	
59414	chr11	96155721	96157651	1930	965.0	
59415	chr11	96168559	96169143	584	292.0	
59416	chr11	96173371	96173859	488	244.0	
59417	chr11	96185545	96185745	200	100.0	
59418	chr11	96188334	96188982	648	324.0	
59419	chr11	96194250	96194469	219	110.0	
59420	chr11	96197711	96198371	660	330.0	
59421	chr11	96199400	96200147	747	374.0	
59422	chr11	96204550	96205534	984	492.0	
59423	chr11	96207094	96208300	1206	603.0	
59424	chr11	96211417	96213061	1644	822.0	
59425	chr11	96214883	96216527	1644	822.0	
59426	chr11	96220203	96220728	525	262.0	
59427	chr11	96221458	96221844	386	193.0	
59428	chr11	96229392	96230026	634	317.0	
59429	chr11	96230541	96231234	693	346.0	
59430	chr11	96241326	96241836	510	255.0	
59431	chr11	96242452	96244103	1651	826.0	
59432	chr11	96246577	96247455	878	439.0	
59433	chr11	96253683	96255311	1628	814.0	
59434	chr11	96256123	96256979	856	428.0	
59435	chr11	96257929	96259338	1409	704.0	
59436	chr11	96260375	96260380	5	2.0	
59437	chr11	96263185	96263826	641	320.0	
59438	chr11	96265203	96266255	1052	526.0	
59439	chr11	96267101	96268134	1033	516.0	
59440	chr11	96272829	96273345	516	258.0	
59441	chr11	96293508	96293981	473	236.0	
59442	chr11	96299575	96300011	436	218.0	
59443	chr11	96303046	96303468	422	211.0	
59444	chr11	96306916	96307875	959	480.0	
59445	chr11	96314663	96314725	62	31.0	
59446	chr11	96317561	96317851	290	145.0	
59447	chr11	96331587	96332248	661	330.0	
59448	chr11	96335370	96335688	318	159.0	
59449	chr11	96338045	96343949	5904	2952.0	
59450	chr11	96388981	96390870	1889	944.0	
59451	chr11	96393728	96394263	535	268.0	
59452	chr11	96426739	96427188	449	224.0	
59453	chr11	96463815	96465119	1304	652.0	
59454	chr11	99015880	99015998	118	59.0	
59455	chr11	100612880	100612985	105	52.0	
59456	chr11	100680991	100681546	555	278.0	
59457	chr11	100686914	100688168	1254	627.0	
59458	chr11	101009257	101009803	546	273.0	
59459	chr11	101508508	101508520	12	6.0	
59460	chr11	101552892	101553287	395	198.0	
59461	chr11	101553973	101554485	512	256.0	
59462	chr11	101860741	101861110	369	184.0	
59463	chr11	101914336	101916399	2063	1032.0	
59464	chr11	102007825	102008196	371	186.0	
59465	chr11	102047276	102047679	403	202.0	
59466	chr11	102109764	102112225	2461	1230.0	
59467	chr11	102267629	102269501	1872	936.0	
59468	chr11	102282802	102283581	779	390.0	
59469	chr11	102287074	102288601	1527	764.0	
59470	chr11	102293298	102294460	1162	581.0	
59471	chr11	102300801	102301288	487	244.0	
59472	chr11	102303377	102303896	519	260.0	
59473	chr11	102304931	102304976	45	22.0	
59474	chr11	102305714	102307630	1916	958.0	
59475	chr11	102312683	102313990	1307	654.0	
59476	chr11	102314655	102314667	12	6.0	
59477	chr11	102316353	102321773	5420	2710.0	
59478	chr11	102322441	102323039	598	299.0	
59479	chr11	102325145	102325194	49	24.0	
59480	chr11	102341485	102342416	931	466.0	
59481	chr11	102345804	102350685	4881	2440.0	
59482	chr11	102353746	102354101	355	178.0	
59483	chr11	102360566	102362178	1612	806.0	
59484	chr11	102367286	102367843	557	278.0	
59485	chr11	102390464	102391471	1007	504.0	
59486	chr11	102393251	102393734	483	242.0	
59487	chr11	102402570	102402939	369	184.0	
59488	chr11	102406985	102407441	456	228.0	
59489	chr11	102413430	102413966	536	268.0	
59490	chr11	102415116	102415770	654	327.0	
59491	chr11	102417017	102417390	373	186.0	
59492	chr11	102421287	102421413	126	63.0	
59493	chr11	102422844	102423597	753	376.0	
59494	chr11	102426926	102427617	691	346.0	
59495	chr11	102429793	102430916	1123	562.0	
59496	chr11	102438859	102439165	306	153.0	
59497	chr11	102447077	102447768	691	346.0	
59498	chr11	102448721	102449402	681	340.0	
59499	chr11	102451108	102453913	2805	1402.0	
59500	chr11	102455552	102456868	1316	658.0	
59501	chr11	102466620	102466734	114	57.0	
59502	chr11	102470149	102470714	565	282.0	
59503	chr11	102474285	102474983	698	349.0	
59504	chr11	102476819	102477252	433	216.0	
59505	chr11	102495102	102496017	915	458.0	
59506	chr11	102546372	102547579	1207	604.0	
59507	chr11	102559813	102561142	1329	664.0	
59508	chr11	102577086	102577643	557	278.0	
59509	chr11	102599844	102599981	137	68.0	
59510	chr11	102612872	102613426	554	277.0	
59511	chr11	102664400	102664491	91	46.0	
59512	chr11	102666319	102666758	439	220.0	
59513	chr11	102680890	102681407	517	258.0	
59514	chr11	102685710	102686425	715	358.0	
59515	chr11	102709237	102709638	401	200.0	
59516	chr11	102712084	102712585	501	250.0	
59517	chr11	102722673	102723258	585	292.0	
59518	chr11	102727710	102728398	688	344.0	
59519	chr11	102733228	102733668	440	220.0	
59520	chr11	102757729	102758646	917	458.0	
59521	chr11	102760275	102760718	443	222.0	
59522	chr11	102919807	102920679	872	436.0	
59523	chr11	102924893	102925449	556	278.0	
59524	chr11	102940934	102941392	458	229.0	
59525	chr11	103035845	103036597	752	376.0	
59526	chr11	103055160	103055561	401	200.0	
59527	chr11	103067349	103067467	118	59.0	
59528	chr11	103070093	103070620	527	264.0	
59529	chr11	103090989	103092876	1887	944.0	
59530	chr11	103108852	103110409	1557	778.0	
59531	chr11	103325887	103326435	548	274.0	
59532	chr11	103601249	103601572	323	162.0	
59533	chr11	103662831	103663300	469	234.0	
59534	chr11	103682273	103682718	445	222.0	
59535	chr11	103878774	103878839	65	32.0	
59536	chr11	103904156	103904462	306	153.0	
59537	chr11	104073819	104074425	606	303.0	
59538	chr11	104075710	104076298	588	294.0	
59539	chr11	104152983	104153367	384	192.0	
59540	chr11	104163601	104164655	1054	527.0	
59541	chr11	104609150	104609698	548	274.0	
59542	chr11	104653296	104653868	572	286.0	
59543	chr11	104668982	104669380	398	199.0	
59544	chr11	104688651	104689189	538	269.0	
59545	chr11	104700595	104700931	336	168.0	
59546	chr11	104705090	104706809	1719	860.0	
59547	chr11	104709001	104709362	361	180.0	
59548	chr11	104736548	104736896	348	174.0	
59549	chr11	104798612	104799761	1149	574.0	
59550	chr11	104823802	104823957	155	78.0	
59551	chr11	104836651	104837241	590	295.0	
59552	chr11	104858847	104859750	903	452.0	
59553	chr11	104876323	104877772	1449	724.0	
59554	chr11	104897747	104898621	874	437.0	
59555	chr11	104907812	104908350	538	269.0	
59556	chr11	104916570	104918979	2409	1204.0	
59557	chr11	104934576	104935040	464	232.0	
59558	chr11	104946830	104947405	575	288.0	
59559	chr11	104967504	104969667	2163	1082.0	
59560	chr11	105000743	105001264	521	260.0	
59561	chr11	105022819	105023497	678	339.0	
59562	chr11	105027804	105027979	175	88.0	
59563	chr11	105032437	105035989	3552	1776.0	
59564	chr11	105043636	105046096	2460	1230.0	
59565	chr11	105055162	105055501	339	170.0	
59566	chr11	105070228	105071786	1558	779.0	
59567	chr11	105080355	105080894	539	270.0	
59568	chr11	105092549	105092577	28	14.0	
59569	chr11	105099713	105101697	1984	992.0	
59570	chr11	105110667	105110721	54	27.0	
59571	chr11	105181443	105181996	553	276.0	
59572	chr11	105189489	105190024	535	268.0	
59573	chr11	105207970	105208443	473	236.0	
59574	chr11	105213934	105214212	278	139.0	
59575	chr11	105220050	105220604	554	277.0	
59576	chr11	105244500	105244800	300	150.0	
59577	chr11	105829049	105829493	444	222.0	
59578	chr11	105862798	105863109	311	156.0	
59579	chr11	106021159	106023132	1973	986.0	
59580	chr11	106076316	106078528	2212	1106.0	
59581	chr11	106087793	106088243	450	225.0	
59582	chr11	107457166	107458462	1296	648.0	
59583	chr11	107549223	107549665	442	221.0	
59584	chr11	107563605	107564252	647	324.0	
59585	chr11	107564764	107566353	1589	794.0	
59586	chr11	107568115	107568202	87	44.0	
59587	chr11	107576476	107576900	424	212.0	
59588	chr11	107590043	107592492	2449	1224.0	
59589	chr11	107682664	107683435	771	386.0	
59590	chr11	107689554	107690025	471	236.0	
59591	chr11	107741027	107741344	317	158.0	
59592	chr11	107799236	107799695	459	230.0	
59593	chr11	107824922	107825238	316	158.0	
59594	chr11	107840463	107841474	1011	506.0	
59595	chr11	107849623	107850065	442	221.0	
59596	chr11	107857918	107860030	2112	1056.0	
59597	chr11	107898514	107898635	121	60.0	
59598	chr11	107916597	107916931	334	167.0	
59599	chr11	107923756	107923818	62	31.0	
59600	chr11	107927808	107930230	2422	1211.0	
59601	chr11	107956925	107957687	762	381.0	
59602	chr11	107988067	107989148	1081	540.0	
59603	chr11	107999717	108000207	490	245.0	
59604	chr11	108008381	108010489	2108	1054.0	
59605	chr11	108069907	108070493	586	293.0	
59606	chr11	108117766	108118176	410	205.0	
59607	chr11	108120884	108122336	1452	726.0	
59608	chr11	108123862	108124507	645	322.0	
59609	chr11	108136240	108136595	355	178.0	
59610	chr11	108160903	108161360	457	228.0	
59611	chr11	108199593	108200597	1004	502.0	
59612	chr11	108219059	108219530	471	236.0	
59613	chr11	108220830	108227156	6326	3163.0	
59614	chr11	108235630	108237938	2308	1154.0	
59615	chr11	108239030	108239718	688	344.0	
59616	chr11	108241420	108242105	685	342.0	
59617	chr11	108245513	108246094	581	290.0	
59618	chr11	108246936	108247237	301	150.0	
59619	chr11	108286547	108286628	81	40.0	
59620	chr11	108465395	108465729	334	167.0	
59621	chr11	108466594	108468159	1565	782.0	
59622	chr11	108496669	108498935	2266	1133.0	
59623	chr11	108538001	108538498	497	248.0	
59624	chr11	108592595	108594354	1759	880.0	
59625	chr11	108648032	108648718	686	343.0	
59626	chr11	108654149	108654471	322	161.0	
59627	chr11	108655009	108655349	340	170.0	
59628	chr11	108664245	108665712	1467	734.0	
59629	chr11	108666438	108666743	305	152.0	
59630	chr11	108697847	108698309	462	231.0	
59631	chr11	108733397	108734018	621	310.0	
59632	chr11	108734969	108735356	387	194.0	
59633	chr11	108853961	108854857	896	448.0	
59634	chr11	108887370	108888020	650	325.0	
59635	chr11	108895779	108896312	533	266.0	
59636	chr11	108965591	108966100	509	254.0	
59637	chr11	108994697	108995412	715	358.0	
59638	chr11	109022998	109023477	479	240.0	
59639	chr11	109747615	109748324	709	354.0	
59640	chr11	109945926	109946935	1009	504.0	
59641	chr11	109971272	109971453	181	90.0	
59642	chr11	109973039	109973249	210	105.0	
59643	chr11	109984675	109985390	715	358.0	
59644	chr11	109999958	110000498	540	270.0	
59645	chr11	110026871	110027788	917	458.0	
59646	chr11	110068766	110069884	1118	559.0	
59647	chr11	110086723	110087508	785	392.0	
59648	chr11	110088158	110088563	405	202.0	
59649	chr11	110092068	110094176	2108	1054.0	
59650	chr11	110098544	110099002	458	229.0	
59651	chr11	110174080	110174600	520	260.0	
59652	chr11	110192624	110193020	396	198.0	
59653	chr11	110201260	110201781	521	260.0	
59654	chr11	110208935	110209352	417	208.0	
59655	chr11	110293395	110293717	322	161.0	
59656	chr11	110295505	110298710	3205	1602.0	
59657	chr11	110312176	110312587	411	206.0	
59658	chr11	110327941	110329018	1077	538.0	
59659	chr11	110329581	110329660	79	40.0	
59660	chr11	110338692	110339135	443	222.0	
59661	chr11	110345740	110345986	246	123.0	
59662	chr11	110348896	110349802	906	453.0	
59663	chr11	110373047	110374073	1026	513.0	
59664	chr11	110374875	110375449	574	287.0	
59665	chr11	110376602	110377512	910	455.0	
59666	chr11	110409195	110409568	373	186.0	
59667	chr11	110428936	110431805	2869	1434.0	
59668	chr11	110433261	110434241	980	490.0	
59669	chr11	110435224	110435630	406	203.0	
59670	chr11	110448050	110448057	7	4.0	
59671	chr11	110463153	110463559	406	203.0	
59672	chr11	110479004	110480158	1154	577.0	
59673	chr11	110490842	110491317	475	238.0	
59674	chr11	110492321	110492718	397	198.0	
59675	chr11	110497072	110497961	889	444.0	
59676	chr11	110522521	110522731	210	105.0	
59677	chr11	110524302	110524484	182	91.0	
59678	chr11	110526345	110526787	442	221.0	
59679	chr11	110565649	110566066	417	208.0	
59680	chr11	110711607	110713591	1984	992.0	
59681	chr11	110776087	110776488	401	200.0	
59682	chr11	110777773	110778748	975	488.0	
59683	chr11	110797271	110798884	1613	806.0	
59684	chr11	110907511	110908101	590	295.0	
59685	chr11	110919424	110919991	567	284.0	
59686	chr11	110968307	110968772	465	232.0	
59687	chr11	110972427	110973090	663	332.0	
59688	chr11	110977606	110978093	487	244.0	
59689	chr11	110989642	110990231	589	294.0	
59690	chr11	111018524	111020482	1958	979.0	
59691	chr11	111068906	111069494	588	294.0	
59692	chr11	111176872	111178012	1140	570.0	
59693	chr11	111185314	111185650	336	168.0	
59694	chr11	111186557	111187038	481	240.0	
59695	chr11	111222858	111223253	395	198.0	
59696	chr11	111229609	111231067	1458	729.0	
59697	chr11	111283194	111283681	487	244.0	
59698	chr11	111378653	111380226	1573	786.0	
59699	chr11	111394284	111394582	298	149.0	
59700	chr11	111398333	111398390	57	28.0	
59701	chr11	111409872	111410365	493	246.0	
59702	chr11	111414542	111414887	345	172.0	
59703	chr11	111417018	111418176	1158	579.0	
59704	chr11	111422916	111423403	487	244.0	
59705	chr11	111429018	111429477	459	230.0	
59706	chr11	111436601	111437151	550	275.0	
59707	chr11	111446138	111447212	1074	537.0	
59708	chr11	111450466	111450720	254	127.0	
59709	chr11	111512714	111513294	580	290.0	
59710	chr11	111514565	111514953	388	194.0	
59711	chr11	111528613	111529067	454	227.0	
59712	chr11	111531700	111532131	431	216.0	
59713	chr11	111539395	111539614	219	110.0	
59714	chr11	111540374	111541928	1554	777.0	
59715	chr11	111542643	111542923	280	140.0	
59716	chr11	111565094	111565553	459	230.0	
59717	chr11	111586234	111586899	665	332.0	
59718	chr11	111597627	111598110	483	242.0	
59719	chr11	111601570	111605037	3467	1734.0	
59720	chr11	111631533	111631926	393	196.0	
59721	chr11	111764841	111767265	2424	1212.0	
59722	chr11	111776537	111777737	1200	600.0	
59723	chr11	111796968	111797442	474	237.0	
59724	chr11	111841353	111841915	562	281.0	
59725	chr11	111843605	111844145	540	270.0	
59726	chr11	111845142	111846177	1035	518.0	
59727	chr11	111870522	111872202	1680	840.0	
59728	chr11	111877730	111880237	2507	1254.0	
59729	chr11	111926152	111927853	1701	850.0	
59730	chr11	111931681	111932446	765	382.0	
59731	chr11	111936531	111939333	2802	1401.0	
59732	chr11	111977129	111977811	682	341.0	
59733	chr11	111981985	111982412	427	214.0	
59734	chr11	112004413	112004804	391	196.0	
59735	chr11	112024052	112026163	2111	1056.0	
59736	chr11	112050797	112051053	256	128.0	
59737	chr11	112073543	112075017	1474	737.0	
59738	chr11	112085953	112087471	1518	759.0	
59739	chr11	112103403	112103875	472	236.0	
59740	chr11	112113376	112113873	497	248.0	
59741	chr11	112120161	112120860	699	350.0	
59742	chr11	112129548	112130140	592	296.0	
59743	chr11	112157228	112157847	619	310.0	
59744	chr11	112159080	112160447	1367	684.0	
59745	chr11	112161099	112161407	308	154.0	
59746	chr11	112163896	112164584	688	344.0	
59747	chr11	112174997	112175887	890	445.0	
59748	chr11	112179163	112180079	916	458.0	
59749	chr11	112211631	112211768	137	68.0	
59750	chr11	112219452	112220402	950	475.0	
59751	chr11	112225721	112227575	1854	927.0	
59752	chr11	112279704	112281127	1423	712.0	
59753	chr11	112281786	112282187	401	200.0	
59754	chr11	112289688	112290810	1122	561.0	
59755	chr11	112297238	112297865	627	314.0	
59756	chr11	112321894	112322198	304	152.0	
59757	chr11	112525269	112525604	335	168.0	
59758	chr11	112537967	112538088	121	60.0	
59759	chr11	112555608	112556116	508	254.0	
59760	chr11	112588139	112588583	444	222.0	
59761	chr11	112615825	112616529	704	352.0	
59762	chr11	112620577	112621250	673	336.0	
59763	chr11	112623046	112623390	344	172.0	
59764	chr11	112627831	112627840	9	4.0	
59765	chr11	112798032	112798096	64	32.0	
59766	chr11	112880412	112880877	465	232.0	
59767	chr11	112886801	112887191	390	195.0	
59768	chr11	112961007	112963603	2596	1298.0	
59769	chr11	112977790	112978291	501	250.0	
59770	chr11	113019684	113020116	432	216.0	
59771	chr11	113114483	113114818	335	168.0	
59772	chr11	113188168	113189235	1067	534.0	
59773	chr11	113190275	113190868	593	296.0	
59774	chr11	113204175	113204843	668	334.0	
59775	chr11	113289474	113290015	541	270.0	
59776	chr11	113305643	113306324	681	340.0	
59777	chr11	113313857	113315458	1601	800.0	
59778	chr11	113376123	113376559	436	218.0	
59779	chr11	113474362	113474636	274	137.0	
59780	chr11	113532679	113533101	422	211.0	
59781	chr11	113593716	113594055	339	170.0	
59782	chr11	113772964	113774388	1424	712.0	
59783	chr11	113796602	113797071	469	234.0	
59784	chr11	113831354	113831630	276	138.0	
59785	chr11	113839753	113840261	508	254.0	
59786	chr11	113841318	113841642	324	162.0	
59787	chr11	113859753	113860108	355	178.0	
59788	chr11	113868064	113868478	414	207.0	
59789	chr11	113874354	113877957	3603	1802.0	
59790	chr11	113896239	113896738	499	250.0	
59791	chr11	113928291	113928730	439	220.0	
59792	chr11	113948016	113948362	346	173.0	
59793	chr11	113952379	113953059	680	340.0	
59794	chr11	113977112	113978168	1056	528.0	
59795	chr11	113994308	113994754	446	223.0	
59796	chr11	114026378	114026790	412	206.0	
59797	chr11	114031720	114032308	588	294.0	
59798	chr11	114035927	114036690	763	382.0	
59799	chr11	114044043	114044916	873	436.0	
59800	chr11	114058801	114062097	3296	1648.0	
59801	chr11	114064204	114064537	333	166.0	
59802	chr11	114065269	114067008	1739	870.0	
59803	chr11	114072221	114076353	4132	2066.0	
59804	chr11	114077187	114078360	1173	586.0	
59805	chr11	114079895	114080969	1074	537.0	
59806	chr11	114082632	114084038	1406	703.0	
59807	chr11	114086896	114087599	703	352.0	
59808	chr11	114089599	114089954	355	178.0	
59809	chr11	114099470	114099874	404	202.0	
59810	chr11	114103161	114103933	772	386.0	
59811	chr11	114111195	114111902	707	354.0	
59812	chr11	114131462	114132038	576	288.0	
59813	chr11	114134829	114136267	1438	719.0	
59814	chr11	114137031	114137654	623	312.0	
59815	chr11	114139066	114140184	1118	559.0	
59816	chr11	114147919	114148376	457	228.0	
59817	chr11	114149661	114149906	245	122.0	
59818	chr11	114154324	114155227	903	452.0	
59819	chr11	114159166	114161219	2053	1026.0	
59820	chr11	114163942	114164563	621	310.0	
59821	chr11	114165849	114167550	1701	850.0	
59822	chr11	114168617	114169194	577	288.0	
59823	chr11	114172301	114173565	1264	632.0	
59824	chr11	114179264	114179528	264	132.0	
59825	chr11	114180407	114180917	510	255.0	
59826	chr11	114182861	114183831	970	485.0	
59827	chr11	114185320	114185907	587	294.0	
59828	chr11	114187098	114187712	614	307.0	
59829	chr11	114193127	114193356	229	114.0	
59830	chr11	114196273	114197417	1144	572.0	
59831	chr11	114208297	114208801	504	252.0	
59832	chr11	114216065	114217199	1134	567.0	
59833	chr11	114226430	114226581	151	76.0	
59834	chr11	114258463	114259567	1104	552.0	
59835	chr11	114260470	114261516	1046	523.0	
59836	chr11	114262650	114263102	452	226.0	
59837	chr11	114280800	114280930	130	65.0	
59838	chr11	114340178	114340881	703	352.0	
59839	chr11	114346615	114347232	617	308.0	
59840	chr11	114348165	114348670	505	252.0	
59841	chr11	114399520	114401466	1946	973.0	
59842	chr11	114438891	114440418	1527	764.0	
59843	chr11	115194241	115194881	640	320.0	
59844	chr11	115214621	115215243	622	311.0	
59845	chr11	115217853	115218314	461	230.0	
59846	chr11	115222187	115223153	966	483.0	
59847	chr11	115256266	115257232	966	483.0	
59848	chr11	115267831	115268332	501	250.0	
59849	chr11	115324546	115324989	443	222.0	
59850	chr11	115502005	115505340	3335	1668.0	
59851	chr11	115705290	115705676	386	193.0	
59852	chr11	115706727	115708164	1437	718.0	
59853	chr11	115709152	115710058	906	453.0	
59854	chr11	115716500	115716891	391	196.0	
59855	chr11	115759795	115760500	705	352.0	
59856	chr11	115761345	115761782	437	218.0	
59857	chr11	115869766	115870191	425	212.0	
59858	chr11	115872394	115872982	588	294.0	
59859	chr11	115912293	115913012	719	360.0	
59860	chr11	115925073	115925462	389	194.0	
59861	chr11	115926298	115926434	136	68.0	
59862	chr11	115930909	115931960	1051	526.0	
59863	chr11	115941410	115941902	492	246.0	
59864	chr11	115975757	115975962	205	102.0	
59865	chr11	116276504	116276992	488	244.0	
59866	chr11	116314033	116314376	343	172.0	
59867	chr11	116348184	116348669	485	242.0	
59868	chr11	116691676	116692075	399	200.0	
59869	chr11	116732622	116733164	542	271.0	
59870	chr11	116734037	116734320	283	142.0	
59871	chr11	116742786	116743190	404	202.0	
59872	chr11	116769923	116770337	414	207.0	
59873	chr11	116772194	116775522	3328	1664.0	
59874	chr11	116776492	116776643	151	76.0	
59875	chr11	116787219	116790260	3041	1520.0	
59876	chr11	116790991	116791961	970	485.0	insulator
59877	chr11	116793689	116794086	397	198.0	
59878	chr11	116834969	116836627	1658	829.0	
59879	chr11	116851208	116854587	3379	1690.0	
59880	chr11	116855439	116855577	138	69.0	
59881	chr11	116879773	116880288	515	258.0	
59882	chr11	116890145	116890533	388	194.0	
59883	chr11	116894978	116895492	514	257.0	
59884	chr11	116906314	116906788	474	237.0	
59885	chr11	116912933	116913468	535	268.0	
59886	chr11	116924776	116925498	722	361.0	
59887	chr11	116926805	116932863	6058	3029.0	
59888	chr11	116938677	116939153	476	238.0	
59889	chr11	116948326	116949010	684	342.0	
59890	chr11	116953520	116954281	761	380.0	
59891	chr11	116955524	116956084	560	280.0	
59892	chr11	116972651	116973317	666	333.0	
59893	chr11	116979999	116982480	2481	1240.0	
59894	chr11	116984196	116985006	810	405.0	
59895	chr11	116986331	116987280	949	474.0	
59896	chr11	116989691	116989729	38	19.0	
59897	chr11	116993456	116994609	1153	576.0	
59898	chr11	116999935	117001334	1399	700.0	
59899	chr11	117002810	117003315	505	252.0	
59900	chr11	117005693	117006471	778	389.0	
59901	chr11	117019988	117020697	709	354.0	
59902	chr11	117022493	117023353	860	430.0	
59903	chr11	117024905	117025757	852	426.0	
59904	chr11	117037576	117038291	715	358.0	
59905	chr11	117045927	117046285	358	179.0	
59906	chr11	117050126	117050380	254	127.0	
59907	chr11	117057323	117057735	412	206.0	
59908	chr11	117062505	117063921	1416	708.0	
59909	chr11	117068466	117068923	457	228.0	
59910	chr11	117070009	117070537	528	264.0	
59911	chr11	117072443	117074594	2151	1076.0	
59912	chr11	117075145	117075608	463	232.0	
59913	chr11	117077065	117077227	162	81.0	
59914	chr11	117078049	117078684	635	318.0	
59915	chr11	117081173	117082292	1119	560.0	
59916	chr11	117082936	117091005	8069	4034.0	
59917	chr11	117091848	117100971	9123	4562.0	
59918	chr11	117105532	117106600	1068	534.0	
59919	chr11	117138681	117139050	369	184.0	
59920	chr11	117143377	117145866	2489	1244.0	
59921	chr11	117178066	117181859	3793	1896.0	
59922	chr11	117185362	117187026	1664	832.0	
59923	chr11	117187562	117187566	4	2.0	
59924	chr11	117188642	117190327	1685	842.0	
59925	chr11	117193429	117193747	318	159.0	
59926	chr11	117195161	117198309	3148	1574.0	
59927	chr11	117201484	117201842	358	179.0	
59928	chr11	117203022	117203526	504	252.0	
59929	chr11	117226194	117227259	1065	532.0	
59930	chr11	117229934	117233587	3653	1826.0	
59931	chr11	117313112	117313458	346	173.0	
59932	chr11	117314700	117316691	1991	996.0	
59933	chr11	117327310	117328996	1686	843.0	
59934	chr11	117426172	117426607	435	218.0	
59935	chr11	117459977	117460428	451	226.0	
59936	chr11	117490049	117490153	104	52.0	
59937	chr11	117535395	117535899	504	252.0	
59938	chr11	117795920	117797490	1570	785.0	
59939	chr11	117804936	117805515	579	290.0	
59940	chr11	117806834	117808387	1553	776.0	
59941	chr11	117809179	117809920	741	370.0	
59942	chr11	117814436	117819513	5077	2538.0	
59943	chr11	117821928	117822501	573	286.0	
59944	chr11	117823107	117825616	2509	1254.0	
59945	chr11	117827876	117829280	1404	702.0	
59946	chr11	117830547	117831267	720	360.0	
59947	chr11	117835905	117836945	1040	520.0	
59948	chr11	117841450	117842704	1254	627.0	
59949	chr11	117843743	117844430	687	344.0	
59950	chr11	117849817	117850244	427	214.0	
59951	chr11	117857130	117857648	518	259.0	
59952	chr11	117874275	117874703	428	214.0	
59953	chr11	117875371	117876919	1548	774.0	
59954	chr11	117899935	117900866	931	466.0	
59955	chr11	117904602	117904947	345	172.0	
59956	chr11	117907085	117907864	779	390.0	
59957	chr11	117919341	117920051	710	355.0	
59958	chr11	117930598	117931300	702	351.0	
59959	chr11	117931985	117932341	356	178.0	
59960	chr11	117934777	117935084	307	154.0	
59961	chr11	117946505	117947671	1166	583.0	
59962	chr11	117949750	117952046	2296	1148.0	
59963	chr11	117952550	117953699	1149	574.0	
59964	chr11	117959356	117960121	765	382.0	
59965	chr11	117969270	117971316	2046	1023.0	
59966	chr11	117973396	117973971	575	288.0	
59967	chr11	117974523	117975064	541	270.0	
59968	chr11	117977026	117977500	474	237.0	
59969	chr11	117979441	117981166	1725	862.0	
59970	chr11	117982819	117983151	332	166.0	
59971	chr11	117983943	117984505	562	281.0	
59972	chr11	117985059	117990273	5214	2607.0	
59973	chr11	117993657	117994902	1245	622.0	
59974	chr11	117997414	118004215	6801	3400.0	
59975	chr11	118004733	118005150	417	208.0	
59976	chr11	118005707	118008985	3278	1639.0	
59977	chr11	118009936	118012952	3016	1508.0	
59978	chr11	118015233	118016633	1400	700.0	
59979	chr11	118045984	118047094	1110	555.0	
59980	chr11	118050894	118053899	3005	1502.0	
59981	chr11	118060904	118061220	316	158.0	
59982	chr11	118081191	118081536	345	172.0	
59983	chr11	118084223	118084690	467	234.0	
59984	chr11	118088000	118089158	1158	579.0	
59985	chr11	118128801	118129871	1070	535.0	
59986	chr11	118142022	118143381	1359	680.0	
59987	chr11	118145035	118146409	1374	687.0	
59988	chr11	118147573	118147945	372	186.0	
59989	chr11	118152572	118153427	855	428.0	
59990	chr11	118156461	118157046	585	292.0	
59991	chr11	118171373	118172085	712	356.0	
59992	chr11	118180403	118180731	328	164.0	
59993	chr11	118183629	118184098	469	234.0	
59994	chr11	118184760	118185534	774	387.0	
59995	chr11	118186665	118187169	504	252.0	
59996	chr11	118198200	118198802	602	301.0	
59997	chr11	118200867	118201318	451	226.0	
59998	chr11	118202286	118203101	815	408.0	
59999	chr11	118206215	118207183	968	484.0	
60000	chr11	118212786	118213172	386	193.0	
60001	chr11	118214049	118215679	1630	815.0	
60002	chr11	118216769	118217977	1208	604.0	
60003	chr11	118219663	118220191	528	264.0	
60004	chr11	118223578	118225485	1907	954.0	
60005	chr11	118226222	118230579	4357	2178.0	
60006	chr11	118238361	118242164	3803	1902.0	
60007	chr11	118245882	118246507	625	312.0	
60008	chr11	118247146	118247277	131	66.0	
60009	chr11	118251065	118253044	1979	990.0	
60010	chr11	118258609	118258720	111	56.0	
60011	chr11	118263731	118264671	940	470.0	
60012	chr11	118281394	118281584	190	95.0	
60013	chr11	118283966	118284315	349	174.0	
60014	chr11	118290852	118292092	1240	620.0	
60015	chr11	118295774	118296489	715	358.0	
60016	chr11	118304187	118306977	2790	1395.0	
60017	chr11	118315475	118317683	2208	1104.0	
60018	chr11	118318679	118319892	1213	606.0	
60019	chr11	118321673	118321922	249	124.0	
60020	chr11	118334697	118335178	481	240.0	
60021	chr11	118338117	118346044	7927	3964.0	
60022	chr11	118346659	118346938	279	140.0	
60023	chr11	118352989	118353805	816	408.0	
60024	chr11	118358883	118360369	1486	743.0	
60025	chr11	118396012	118396609	597	298.0	
60026	chr11	118398479	118399755	1276	638.0	
60027	chr11	118400374	118402487	2113	1056.0	
60028	chr11	118414882	118416096	1214	607.0	
60029	chr11	118434126	118439167	5041	2520.0	
60030	chr11	118441957	118442147	190	95.0	
60031	chr11	118488276	118488955	679	340.0	
60032	chr11	118524295	118524779	484	242.0	
60033	chr11	118530232	118532035	1803	902.0	
60034	chr11	118565356	118566558	1202	601.0	
60035	chr11	118571637	118573813	2176	1088.0	
60036	chr11	118594980	118595471	491	246.0	
60037	chr11	118607169	118611573	4404	2202.0	
60038	chr11	118619407	118619803	396	198.0	
60039	chr11	118621022	118621688	666	333.0	
60040	chr11	118634747	118635120	373	186.0	
60041	chr11	118659172	118660065	893	446.0	
60042	chr11	118689504	118691021	1517	758.0	
60043	chr11	118692111	118693973	1862	931.0	
60044	chr11	118695596	118696193	597	298.0	
60045	chr11	118699359	118700847	1488	744.0	
60046	chr11	118703508	118705836	2328	1164.0	
60047	chr11	118739369	118739639	270	135.0	
60048	chr11	118770958	118772084	1126	563.0	
60049	chr11	118773284	118773685	401	200.0	
60050	chr11	118785399	118785551	152	76.0	
60051	chr11	118788064	118793635	5571	2786.0	
60052	chr11	118820563	118821348	785	392.0	
60053	chr11	118834390	118834892	502	251.0	
60054	chr11	118838818	118839301	483	242.0	
60055	chr11	118841084	118842014	930	465.0	
60056	chr11	118852148	118852262	114	57.0	
60057	chr11	118868711	118868854	143	72.0	
60058	chr11	118869669	118871268	1599	800.0	
60059	chr11	118872174	118873099	925	462.0	
60060	chr11	118876060	118878645	2585	1292.0	
60061	chr11	118882467	118884960	2493	1246.0	
60062	chr11	118886127	118888082	1955	978.0	
60063	chr11	118889125	118889177	52	26.0	
60064	chr11	118891816	118893982	2166	1083.0	
60065	chr11	118894703	118898064	3361	1680.0	
60066	chr11	118899044	118899419	375	188.0	
60067	chr11	118900032	118901033	1001	500.0	
60068	chr11	118901576	118902151	575	288.0	
60069	chr11	118906721	118931044	24323	12162.0	
60070	chr11	118939972	118940826	854	427.0	
60071	chr11	118943490	118943884	394	197.0	
60072	chr11	118956274	118957194	920	460.0	
60073	chr11	118980291	118980709	418	209.0	
60074	chr11	118996725	118998912	2187	1094.0	
60075	chr11	119015182	119015571	389	194.0	
60076	chr11	119017322	119019873	2551	1276.0	
60077	chr11	119029210	119031523	2313	1156.0	
60078	chr11	119039826	119039930	104	52.0	
60079	chr11	119044701	119045283	582	291.0	
60080	chr11	119051206	119051218	12	6.0	
60081	chr11	119051758	119052217	459	230.0	
60082	chr11	119055836	119058107	2271	1136.0	
60083	chr11	119065350	119065853	503	252.0	
60084	chr11	119066474	119068545	2071	1036.0	
60085	chr11	119082983	119083328	345	172.0	
60086	chr11	119084162	119085939	1777	888.0	
60087	chr11	119090392	119090872	480	240.0	
60088	chr11	119092370	119096250	3880	1940.0	
60089	chr11	119100201	119103184	2983	1492.0	
60090	chr11	119106432	119109072	2640	1320.0	
60091	chr11	119115168	119116644	1476	738.0	
60092	chr11	119120711	119122440	1729	864.0	
60093	chr11	119134351	119134879	528	264.0	
60094	chr11	119143170	119143495	325	162.0	
60095	chr11	119144791	119145330	539	270.0	
60096	chr11	119148034	119149938	1904	952.0	
60097	chr11	119156121	119156403	282	141.0	
60098	chr11	119167962	119169767	1805	902.0	
60099	chr11	119172343	119172841	498	249.0	
60100	chr11	119192066	119192787	721	360.0	
60101	chr11	119196612	119197539	927	464.0	
60102	chr11	119204915	119208049	3134	1567.0	"sequence_feature	repeat_region"
60103	chr11	119241314	119241442	128	64.0	
60104	chr11	119258154	119258595	441	220.0	
60105	chr11	119259916	119260374	458	229.0	
60106	chr11	119262304	119263977	1673	836.0	
60107	chr11	119266479	119266950	471	236.0	
60108	chr11	119284505	119285041	536	268.0	
60109	chr11	119305472	119307274	1802	901.0	
60110	chr11	119310739	119311124	385	192.0	
60111	chr11	119311696	119311783	87	44.0	
60112	chr11	119314906	119317531	2625	1312.0	
60113	chr11	119318424	119319625	1201	600.0	
60114	chr11	119320639	119322467	1828	914.0	
60115	chr11	119323324	119324146	822	411.0	
60116	chr11	119333846	119335338	1492	746.0	
60117	chr11	119337849	119338943	1094	547.0	
60118	chr11	119339674	119342127	2453	1226.0	
60119	chr11	119356016	119357440	1424	712.0	
60120	chr11	119359673	119360071	398	199.0	
60121	chr11	119362765	119365590	2825	1412.0	
60122	chr11	119370374	119370829	455	228.0	
60123	chr11	119373877	119375159	1282	641.0	
60124	chr11	119380432	119382580	2148	1074.0	
60125	chr11	119389899	119390237	338	169.0	
60126	chr11	119440573	119441236	663	332.0	
60127	chr11	119474652	119475132	480	240.0	
60128	chr11	119481285	119481803	518	259.0	
60129	chr11	119509282	119510678	1396	698.0	
60130	chr11	119524910	119525937	1027	514.0	
60131	chr11	119533778	119534728	950	475.0	
60132	chr11	119537644	119537933	289	144.0	
60133	chr11	119538696	119539287	591	296.0	
60134	chr11	119540939	119541273	334	167.0	
60135	chr11	119550350	119550712	362	181.0	
60136	chr11	119573618	119574371	753	376.0	
60137	chr11	119584139	119585103	964	482.0	
60138	chr11	119615391	119616225	834	417.0	
60139	chr11	119618013	119618743	730	365.0	
60140	chr11	119624282	119624435	153	76.0	
60141	chr11	119626944	119627311	367	184.0	
60142	chr11	119642094	119642386	292	146.0	
60143	chr11	119666286	119666995	709	354.0	
60144	chr11	119673639	119674449	810	405.0	
60145	chr11	119684405	119684829	424	212.0	
60146	chr11	119690821	119691666	845	422.0	
60147	chr11	119694591	119694817	226	113.0	
60148	chr11	119709364	119710031	667	334.0	
60149	chr11	119712345	119712926	581	290.0	
60150	chr11	119722294	119722648	354	177.0	
60151	chr11	119727256	119730548	3292	1646.0	
60152	chr11	119741219	119742933	1714	857.0	
60153	chr11	119751455	119752103	648	324.0	
60154	chr11	120108203	120108581	378	189.0	
60155	chr11	120168721	120169827	1106	553.0	
60156	chr11	120172158	120173038	880	440.0	
60157	chr11	120207834	120212234	4400	2200.0	
60158	chr11	120219916	120219925	9	4.0	
60159	chr11	120222399	120222713	314	157.0	
60160	chr11	120223889	120225549	1660	830.0	
60161	chr11	120227291	120227407	116	58.0	
60162	chr11	120229816	120230217	401	200.0	
60163	chr11	120235000	120235434	434	217.0	
60164	chr11	120302960	120303460	500	250.0	
60165	chr11	120324969	120325837	868	434.0	
60166	chr11	120334741	120337465	2724	1362.0	
60167	chr11	120339595	120339767	172	86.0	
60168	chr11	120344044	120345152	1108	554.0	
60169	chr11	120511010	120511866	856	428.0	
60170	chr11	120546059	120546075	16	8.0	
60171	chr11	120564931	120565302	371	186.0	
60172	chr11	120684901	120685290	389	194.0	
60173	chr11	120794153	120794280	127	64.0	
60174	chr11	120839861	120840407	546	273.0	
60175	chr11	120908393	120909185	792	396.0	
60176	chr11	120929571	120930020	449	224.0	
60177	chr11	120952487	120953228	741	370.0	
60178	chr11	120985886	120986420	534	267.0	
60179	chr11	121023469	121024850	1381	690.0	
60180	chr11	121059568	121060002	434	217.0	
60181	chr11	121091328	121091988	660	330.0	
60182	chr11	121112497	121112949	452	226.0	
60183	chr11	121194687	121195149	462	231.0	
60184	chr11	121249131	121249581	450	225.0	
60185	chr11	121291784	121293750	1966	983.0	
60186	chr11	121309754	121310060	306	153.0	
60187	chr11	121319207	121319770	563	282.0	
60188	chr11	121321568	121322055	487	244.0	
60189	chr11	121328150	121329419	1269	634.0	
60190	chr11	121336247	121336639	392	196.0	
60191	chr11	121339968	121340942	974	487.0	
60192	chr11	121358727	121359113	386	193.0	
60193	chr11	121367178	121368112	934	467.0	
60194	chr11	121372859	121373532	673	336.0	
60195	chr11	121376113	121376563	450	225.0	
60196	chr11	121379397	121379595	198	99.0	
60197	chr11	121405619	121405984	365	182.0	
60198	chr11	121414505	121414877	372	186.0	
60199	chr11	121415845	121416274	429	214.0	
60200	chr11	121416921	121417815	894	447.0	
60201	chr11	121418382	121419313	931	466.0	
60202	chr11	121419866	121420191	325	162.0	
60203	chr11	121421481	121421958	477	238.0	
60204	chr11	121422566	121423140	574	287.0	
60205	chr11	121426939	121427643	704	352.0	
60206	chr11	121429555	121430712	1157	578.0	
60207	chr11	121435344	121435450	106	53.0	
60208	chr11	121436000	121436758	758	379.0	
60209	chr11	121437266	121438030	764	382.0	
60210	chr11	121445401	121445800	399	200.0	
60211	chr11	121446937	121447429	492	246.0	
60212	chr11	121448216	121456473	8257	4128.0	
60213	chr11	121459210	121460182	972	486.0	
60214	chr11	121462906	121465136	2230	1115.0	
60215	chr11	121465782	121468674	2892	1446.0	
60216	chr11	121472232	121472817	585	292.0	
60217	chr11	121481563	121484477	2914	1457.0	
60218	chr11	121485083	121485696	613	306.0	
60219	chr11	121494625	121495189	564	282.0	
60220	chr11	121503087	121503424	337	168.0	
60221	chr11	121508423	121508849	426	213.0	
60222	chr11	121514353	121515254	901	450.0	
60223	chr11	121524372	121524480	108	54.0	
60224	chr11	121543998	121544354	356	178.0	
60225	chr11	121544944	121545395	451	226.0	
60226	chr11	121569887	121570440	553	276.0	
60227	chr11	121574512	121576058	1546	773.0	
60228	chr11	121576752	121576805	53	26.0	
60229	chr11	121578242	121579017	775	388.0	
60230	chr11	121582229	121582756	527	264.0	
60231	chr11	121588674	121591895	3221	1610.0	
60232	chr11	121650542	121651331	789	394.0	
60233	chr11	121655250	121656409	1159	580.0	
60234	chr11	121767384	121767916	532	266.0	
60235	chr11	121829302	121829501	199	100.0	
60236	chr11	121877164	121877476	312	156.0	
60237	chr11	121887515	121888088	573	286.0	
60238	chr11	121890877	121891609	732	366.0	
60239	chr11	121901404	121901762	358	179.0	
60240	chr11	121903836	121904691	855	428.0	
60241	chr11	121929858	121930554	696	348.0	enhancer
60242	chr11	121944777	121945176	399	200.0	
60243	chr11	122202915	122203349	434	217.0	
60244	chr11	122215361	122215794	433	216.0	
60245	chr11	122242725	122243107	382	191.0	
60246	chr11	122253573	122254407	834	417.0	
60247	chr11	122258523	122259270	747	374.0	
60248	chr11	122319761	122320280	519	260.0	
60249	chr11	122342398	122342734	336	168.0	
60250	chr11	122505720	122506134	414	207.0	
60251	chr11	122523856	122524605	749	374.0	
60252	chr11	122556587	122557004	417	208.0	
60253	chr11	122580415	122581659	1244	622.0	
60254	chr11	122628867	122629444	577	288.0	
60255	chr11	122633199	122633613	414	207.0	
60256	chr11	122637562	122637997	435	218.0	
60257	chr11	122647579	122648240	661	330.0	
60258	chr11	122654767	122657322	2555	1278.0	
60259	chr11	122659945	122660635	690	345.0	
60260	chr11	122663763	122665139	1376	688.0	
60261	chr11	122665731	122666027	296	148.0	
60262	chr11	122666804	122667110	306	153.0	
60263	chr11	122668370	122669050	680	340.0	
60264	chr11	122672848	122673355	507	254.0	
60265	chr11	122675041	122675811	770	385.0	
60266	chr11	122688273	122688575	302	151.0	
60267	chr11	122690504	122691952	1448	724.0	
60268	chr11	122696454	122698568	2114	1057.0	
60269	chr11	122708626	122709067	441	220.0	
60270	chr11	122713927	122715000	1073	536.0	
60271	chr11	122716123	122716323	200	100.0	
60272	chr11	122716863	122718145	1282	641.0	
60273	chr11	122726434	122727827	1393	696.0	
60274	chr11	122733282	122733801	519	260.0	
60275	chr11	122741614	122744965	3351	1676.0	
60276	chr11	122745731	122746787	1056	528.0	
60277	chr11	122748852	122749536	684	342.0	
60278	chr11	122754451	122754991	540	270.0	
60279	chr11	122756148	122757105	957	478.0	
60280	chr11	122781307	122782046	739	370.0	
60281	chr11	122796057	122796583	526	263.0	
60282	chr11	122832633	122833053	420	210.0	
60283	chr11	122838056	122839065	1009	504.0	
60284	chr11	122842952	122844309	1357	678.0	
60285	chr11	122844946	122845063	117	58.0	
60286	chr11	122847416	122847910	494	247.0	
60287	chr11	122849860	122850793	933	466.0	
60288	chr11	122851534	122852890	1356	678.0	
60289	chr11	122853799	122854411	612	306.0	
60290	chr11	122856334	122857306	972	486.0	
60291	chr11	122863707	122865177	1470	735.0	
60292	chr11	122882459	122883848	1389	694.0	
60293	chr11	122981641	122982186	545	272.0	
60294	chr11	122984167	122984962	795	398.0	
60295	chr11	123020919	123021447	528	264.0	
60296	chr11	123023044	123023569	525	262.0	
60297	chr11	123033808	123035159	1351	676.0	
60298	chr11	123036199	123036493	294	147.0	
60299	chr11	123037047	123037211	164	82.0	
60300	chr11	123037800	123040516	2716	1358.0	
60301	chr11	123041106	123042266	1160	580.0	
60302	chr11	123043506	123043988	482	241.0	
60303	chr11	123044536	123065048	20512	10256.0	
60304	chr11	123068708	123071077	2369	1184.0	
60305	chr11	123072086	123072552	466	233.0	
60306	chr11	123082944	123084193	1249	624.0	
60307	chr11	123087499	123088299	800	400.0	
60308	chr11	123101024	123101025	1	0.0	
60309	chr11	123103162	123103682	520	260.0	
60310	chr11	123110503	123110767	264	132.0	
60311	chr11	123111354	123111804	450	225.0	
60312	chr11	123137560	123137914	354	177.0	
60313	chr11	123233246	123233796	550	275.0	
60314	chr11	123246952	123247643	691	346.0	
60315	chr11	123261427	123261934	507	254.0	
60316	chr11	123263674	123264451	777	388.0	
60317	chr11	123300970	123304104	3134	1567.0	
60318	chr11	123357877	123358789	912	456.0	
60319	chr11	123381866	123382002	136	68.0	
60320	chr11	123407323	123407975	652	326.0	
60321	chr11	123413591	123414025	434	217.0	
60322	chr11	123419632	123419874	242	121.0	
60323	chr11	123421523	123422022	499	250.0	
60324	chr11	123429442	123432102	2660	1330.0	
60325	chr11	123434274	123435256	982	491.0	
60326	chr11	123451350	123451352	2	1.0	
60327	chr11	123452658	123453069	411	206.0	
60328	chr11	123453978	123454854	876	438.0	
60329	chr11	123456317	123457879	1562	781.0	
60330	chr11	123465523	123466305	782	391.0	
60331	chr11	123474232	123474639	407	204.0	
60332	chr11	123478127	123479756	1629	814.0	
60333	chr11	123484575	123484752	177	88.0	
60334	chr11	123504580	123504649	69	34.0	
60335	chr11	123511049	123511656	607	304.0	
60336	chr11	123517741	123518072	331	166.0	
60337	chr11	123547174	123547631	457	228.0	
60338	chr11	123549936	123550351	415	208.0	
60339	chr11	123554833	123555317	484	242.0	
60340	chr11	123559941	123560478	537	268.0	
60341	chr11	123564282	123564589	307	154.0	
60342	chr11	123571340	123571494	154	77.0	
60343	chr11	123576915	123577422	507	254.0	
60344	chr11	123580455	123581068	613	306.0	
60345	chr11	123640897	123641352	455	228.0	
60346	chr11	123653955	123654827	872	436.0	
60347	chr11	123660062	123660335	273	136.0	
60348	chr11	123680884	123681601	717	358.0	
60349	chr11	123707623	123707768	145	72.0	
60350	chr11	123711280	123711681	401	200.0	
60351	chr11	123740584	123742595	2011	1006.0	
60352	chr11	124069188	124069836	648	324.0	
60353	chr11	124070834	124071802	968	484.0	
60354	chr11	124075858	124076973	1115	558.0	
60355	chr11	124101663	124102166	503	252.0	
60356	chr11	124115016	124116264	1248	624.0	
60357	chr11	124176973	124177808	835	418.0	
60358	chr11	124193140	124193648	508	254.0	
60359	chr11	124195069	124195547	478	239.0	
60360	chr11	124207299	124207697	398	199.0	
60361	chr11	124224594	124225333	739	370.0	
60362	chr11	124265059	124265468	409	204.0	
60363	chr11	124330032	124330546	514	257.0	
60364	chr11	124339670	124340026	356	178.0	
60365	chr11	124402351	124402674	323	162.0	
60366	chr11	124481678	124482010	332	166.0	
60367	chr11	124514724	124515018	294	147.0	
60368	chr11	124518920	124519278	358	179.0	
60369	chr11	124586428	124586590	162	81.0	
60370	chr11	124605633	124606199	566	283.0	
60371	chr11	124622156	124623749	1593	796.0	
60372	chr11	124633413	124633420	7	4.0	
60373	chr11	124644205	124645091	886	443.0	
60374	chr11	124668908	124669768	860	430.0	
60375	chr11	124670686	124671263	577	288.0	
60376	chr11	124672763	124674543	1780	890.0	
60377	chr11	124717896	124718704	808	404.0	
60378	chr11	124725600	124725840	240	120.0	
60379	chr11	124732135	124732786	651	326.0	
60380	chr11	124736201	124737339	1138	569.0	
60381	chr11	124739326	124741045	1719	860.0	
60382	chr11	124745746	124747668	1922	961.0	
60383	chr11	124748548	124749222	674	337.0	
60384	chr11	124749931	124750298	367	184.0	
60385	chr11	124752692	124753618	926	463.0	
60386	chr11	124757876	124760727	2851	1426.0	
60387	chr11	124761363	124763804	2441	1220.0	
60388	chr11	124777373	124777384	11	6.0	
60389	chr11	124791948	124792453	505	252.0	
60390	chr11	124793613	124794088	475	238.0	
60391	chr11	124798973	124801460	2487	1244.0	
60392	chr11	124836533	124837882	1349	674.0	
60393	chr11	124839002	124840414	1412	706.0	
60394	chr11	124863844	124864118	274	137.0	
60395	chr11	124865226	124866758	1532	766.0	
60396	chr11	124867665	124868120	455	228.0	
60397	chr11	124868832	124869691	859	430.0	
60398	chr11	124872763	124873091	328	164.0	
60399	chr11	124874829	124877584	2755	1378.0	
60400	chr11	124893054	124893348	294	147.0	
60401	chr11	124920469	124921553	1084	542.0	
60402	chr11	124923344	124923654	310	155.0	
60403	chr11	124930864	124931130	266	133.0	
60404	chr11	124950557	124951239	682	341.0	
60405	chr11	124953381	124954815	1434	717.0	
60406	chr11	124961903	124962453	550	275.0	
60407	chr11	125062482	125064015	1533	766.0	
60408	chr11	125069850	125071539	1689	844.0	
60409	chr11	125072219	125073063	844	422.0	
60410	chr11	125075876	125076171	295	148.0	
60411	chr11	125091163	125091564	401	200.0	
60412	chr11	125110859	125112549	1690	845.0	
60413	chr11	125124074	125125118	1044	522.0	
60414	chr11	125141614	125142340	726	363.0	
60415	chr11	125164266	125165982	1716	858.0	
60416	chr11	125166497	125166812	315	158.0	
60417	chr11	125345762	125346095	333	166.0	
60418	chr11	125348738	125349139	401	200.0	
60419	chr11	125355125	125355601	476	238.0	
60420	chr11	125404799	125405295	496	248.0	
60421	chr11	125429354	125429363	9	4.0	
60422	chr11	125451417	125451742	325	162.0	
60423	chr11	125452614	125453119	505	252.0	
60424	chr11	125494045	125496694	2649	1324.0	
60425	chr11	125509343	125509959	616	308.0	
60426	chr11	125511905	125512577	672	336.0	
60427	chr11	125513259	125515254	1995	998.0	
60428	chr11	125568783	125570537	1754	877.0	
60429	chr11	125577942	125578204	262	131.0	
60430	chr11	125591299	125593772	2473	1236.0	
60431	chr11	125625057	125626942	1885	942.0	
60432	chr11	125874474	125874950	476	238.0	
60433	chr11	125886649	125888622	1973	986.0	
60434	chr11	125902567	125904798	2231	1116.0	
60435	chr11	125922989	125923421	432	216.0	
60436	chr11	126061067	126061194	127	64.0	
60437	chr11	126062074	126063844	1770	885.0	
60438	chr11	126083891	126084521	630	315.0	
60439	chr11	126194074	126194516	442	221.0	
60440	chr11	126210858	126212538	1680	840.0	
60441	chr11	126214260	126215011	751	376.0	
60442	chr11	126262220	126262325	105	52.0	
60443	chr11	126267913	126269899	1986	993.0	
60444	chr11	126280485	126281380	895	448.0	
60445	chr11	126281888	126285342	3454	1727.0	
60446	chr11	126293736	126294202	466	233.0	
60447	chr11	126303431	126305186	1755	878.0	
60448	chr11	126305783	126306042	259	130.0	
60449	chr11	126307738	126308093	355	178.0	
60450	chr11	126310221	126312320	2099	1050.0	
60451	chr11	126313890	126314190	300	150.0	
60452	chr11	126317480	126319732	2252	1126.0	
60453	chr11	126329116	126330191	1075	538.0	
60454	chr11	126332131	126332810	679	340.0	
60455	chr11	126335989	126336743	754	377.0	
60456	chr11	126337410	126337853	443	222.0	
60457	chr11	126345719	126346690	971	486.0	
60458	chr11	126351286	126351605	319	160.0	
60459	chr11	126353320	126353711	391	196.0	
60460	chr11	126354723	126357169	2446	1223.0	
60461	chr11	126358435	126358782	347	174.0	
60462	chr11	126368753	126369187	434	217.0	
60463	chr11	126386597	126387063	466	233.0	
60464	chr11	126391335	126392464	1129	564.0	
60465	chr11	126416189	126417139	950	475.0	
60466	chr11	126440733	126441438	705	352.0	
60467	chr11	126457040	126457141	101	50.0	
60468	chr11	126464711	126466188	1477	738.0	
60469	chr11	126467990	126468642	652	326.0	
60470	chr11	126469343	126469643	300	150.0	
60471	chr11	126478036	126478319	283	142.0	
60472	chr11	126480416	126481354	938	469.0	
60473	chr11	126485247	126485373	126	63.0	
60474	chr11	126862881	126863171	290	145.0	
60475	chr11	126990368	126990718	350	175.0	
60476	chr11	128026731	128027018	287	144.0	
60477	chr11	128031283	128032155	872	436.0	
60478	chr11	128035617	128037009	1392	696.0	
60479	chr11	128038618	128040287	1669	834.0	
60480	chr11	128042224	128042616	392	196.0	
60481	chr11	128045145	128045437	292	146.0	
60482	chr11	128051105	128051700	595	298.0	
60483	chr11	128052677	128055127	2450	1225.0	
60484	chr11	128095526	128095928	402	201.0	
60485	chr11	128157563	128158348	785	392.0	
60486	chr11	128172052	128172768	716	358.0	
60487	chr11	128189845	128190940	1095	548.0	
60488	chr11	128194828	128195686	858	429.0	
60489	chr11	128229197	128229501	304	152.0	
60490	chr11	128238761	128239458	697	348.0	
60491	chr11	128262708	128262917	209	104.0	
60492	chr11	128271207	128271978	771	386.0	
60493	chr11	128285299	128285711	412	206.0	
60494	chr11	128289639	128292520	2881	1440.0	
60495	chr11	128297014	128297362	348	174.0	
60496	chr11	128299076	128299759	683	342.0	
60497	chr11	128300814	128301054	240	120.0	
60498	chr11	128301841	128303343	1502	751.0	
60499	chr11	128304213	128306027	1814	907.0	
60500	chr11	128308353	128308701	348	174.0	
60501	chr11	128315907	128317004	1097	548.0	
60502	chr11	128318671	128319685	1014	507.0	
60503	chr11	128323196	128325509	2313	1156.0	enhancer
60504	chr11	128328925	128329761	836	418.0	
60505	chr11	128341210	128343530	2320	1160.0	
60506	chr11	128345215	128345843	628	314.0	
60507	chr11	128350098	128350143	45	22.0	
60508	chr11	128367543	128368061	518	259.0	
60509	chr11	128379665	128379902	237	118.0	
60510	chr11	128399045	128399533	488	244.0	
60511	chr11	128422364	128423335	971	486.0	
60512	chr11	128448659	128449804	1145	572.0	
60513	chr11	128451280	128457690	6410	3205.0	
60514	chr11	128459389	128459722	333	166.0	
60515	chr11	128460661	128460700	39	20.0	
60516	chr11	128462764	128478766	16002	8001.0	
60517	chr11	128480005	128480756	751	376.0	
60518	chr11	128481878	128484251	2373	1186.0	
60519	chr11	128487976	128489559	1583	792.0	
60520	chr11	128490198	128490949	751	376.0	
60521	chr11	128491764	128493725	1961	980.0	
60522	chr11	128494291	128495195	904	452.0	
60523	chr11	128496144	128498043	1899	950.0	
60524	chr11	128498594	128499186	592	296.0	
60525	chr11	128499783	128510923	11140	5570.0	
60526	chr11	128512151	128513247	1096	548.0	
60527	chr11	128513988	128518296	4308	2154.0	
60528	chr11	128519331	128519621	290	145.0	
60529	chr11	128520247	128523816	3569	1784.0	
60530	chr11	128524881	128526381	1500	750.0	
60531	chr11	128527838	128528269	431	216.0	
60532	chr11	128544633	128545120	487	244.0	
60533	chr11	128548290	128549405	1115	558.0	
60534	chr11	128550321	128553689	3368	1684.0	
60535	chr11	128563812	128564427	615	308.0	
60536	chr11	128565764	128566413	649	324.0	
60537	chr11	128568242	128568628	386	193.0	
60538	chr11	128575534	128576357	823	412.0	
60539	chr11	128579766	128580750	984	492.0	
60540	chr11	128582680	128583281	601	300.0	
60541	chr11	128596346	128596392	46	23.0	
60542	chr11	128610698	128611946	1248	624.0	
60543	chr11	128619964	128620160	196	98.0	
60544	chr11	128623893	128625913	2020	1010.0	
60545	chr11	128627892	128631241	3349	1674.0	
60546	chr11	128632068	128632595	527	264.0	
60547	chr11	128653657	128654257	600	300.0	
60548	chr11	128658410	128658899	489	244.0	
60549	chr11	128660923	128661367	444	222.0	
60550	chr11	128663797	128664622	825	412.0	
60551	chr11	128684720	128687813	3093	1546.0	
60552	chr11	128690893	128691118	225	112.0	
60553	chr11	128691759	128698391	6632	3316.0	
60554	chr11	128703602	128704923	1321	660.0	
60555	chr11	128705491	128705910	419	210.0	
60556	chr11	128713331	128714967	1636	818.0	
60557	chr11	128715846	128719638	3792	1896.0	
60558	chr11	128720274	128721819	1545	772.0	
60559	chr11	128723374	128724123	749	374.0	
60560	chr11	128724802	128730132	5330	2665.0	
60561	chr11	128730901	128731557	656	328.0	
60562	chr11	128733725	128735235	1510	755.0	
60563	chr11	128735845	128736620	775	388.0	
60564	chr11	128737735	128738107	372	186.0	
60565	chr11	128738666	128739409	743	372.0	
60566	chr11	128741899	128742055	156	78.0	
60567	chr11	128745737	128746302	565	282.0	
60568	chr11	128747452	128748251	799	400.0	
60569	chr11	128754316	128754688	372	186.0	
60570	chr11	128755732	128755922	190	95.0	
60571	chr11	128757022	128758073	1051	526.0	
60572	chr11	128772454	128773383	929	464.0	
60573	chr11	128775995	128776924	929	464.0	
60574	chr11	128802407	128802821	414	207.0	
60575	chr11	128815325	128815406	81	40.0	
60576	chr11	128826074	128826358	284	142.0	
60577	chr11	128827356	128827634	278	139.0	
60578	chr11	128830100	128831943	1843	922.0	
60579	chr11	128834400	128834550	150	75.0	
60580	chr11	128837597	128838050	453	226.0	
60581	chr11	128840134	128840510	376	188.0	
60582	chr11	128841480	128842093	613	306.0	
60583	chr11	128845227	128845734	507	254.0	
60584	chr11	128848756	128849275	519	260.0	
60585	chr11	128859585	128860312	727	364.0	
60586	chr11	128866696	128867749	1053	526.0	
60587	chr11	128868763	128870438	1675	838.0	
60588	chr11	128884661	128885162	501	250.0	
60589	chr11	128886735	128887143	408	204.0	
60590	chr11	128890433	128892124	1691	846.0	
60591	chr11	128903629	128906572	2943	1472.0	
60592	chr11	128908503	128908977	474	237.0	
60593	chr11	128918192	128918232	40	20.0	
60594	chr11	128928349	128928868	519	260.0	
60595	chr11	128956428	128956884	456	228.0	
60596	chr11	128965456	128965897	441	220.0	
60597	chr11	129117605	129117984	379	190.0	
60598	chr11	129192213	129192297	84	42.0	
60599	chr11	129278410	129281006	2596	1298.0	
60600	chr11	129284376	129285150	774	387.0	
60601	chr11	129314282	129314888	606	303.0	
60602	chr11	129317643	129318298	655	328.0	
60603	chr11	129323965	129324719	754	377.0	
60604	chr11	129327622	129328160	538	269.0	
60605	chr11	129331748	129332258	510	255.0	
60606	chr11	129364035	129364633	598	299.0	
60607	chr11	129695465	129696500	1035	518.0	
60608	chr11	129750391	129751458	1067	534.0	
60609	chr11	129767185	129767263	78	39.0	
60610	chr11	129814046	129816533	2487	1244.0	
60611	chr11	129825133	129825957	824	412.0	
60612	chr11	129840278	129840569	291	146.0	
60613	chr11	129853554	129854459	905	452.0	
60614	chr11	129881595	129881988	393	196.0	
60615	chr11	129888528	129888762	234	117.0	
60616	chr11	129894560	129896486	1926	963.0	
60617	chr11	129921713	129922241	528	264.0	
60618	chr11	129923042	129923759	717	358.0	
60619	chr11	129929723	129931190	1467	734.0	
60620	chr11	129950008	129951201	1193	596.0	
60621	chr11	129968578	129969191	613	306.0	
60622	chr11	129969772	129970285	513	256.0	
60623	chr11	129992345	129992805	460	230.0	
60624	chr11	129994395	129994534	139	70.0	
60625	chr11	130001037	130004874	3837	1918.0	
60626	chr11	130037084	130037369	285	142.0	
60627	chr11	130041892	130042543	651	326.0	
60628	chr11	130043361	130044124	763	382.0	
60629	chr11	130049140	130051584	2444	1222.0	
60630	chr11	130064564	130064951	387	194.0	
60631	chr11	130068539	130073070	4531	2266.0	
60632	chr11	130076543	130077098	555	278.0	
60633	chr11	130078173	130078213	40	20.0	
60634	chr11	130085813	130086285	472	236.0	
60635	chr11	130087505	130087907	402	201.0	
60636	chr11	130089294	130089496	202	101.0	
60637	chr11	130092923	130093181	258	129.0	
60638	chr11	130094239	130096611	2372	1186.0	
60639	chr11	130101600	130101916	316	158.0	
60640	chr11	130103421	130103572	151	76.0	
60641	chr11	130106452	130106800	348	174.0	
60642	chr11	130109432	130109794	362	181.0	
60643	chr11	130118152	130119492	1340	670.0	
60644	chr11	130121562	130122655	1093	546.0	
60645	chr11	130123805	130124810	1005	502.0	
60646	chr11	130126554	130126857	303	152.0	
60647	chr11	130131967	130132708	741	370.0	
60648	chr11	130146229	130147554	1325	662.0	
60649	chr11	130154368	130154995	627	314.0	
60650	chr11	130156351	130157017	666	333.0	
60651	chr11	130159488	130160969	1481	740.0	
60652	chr11	130162685	130163159	474	237.0	
60653	chr11	130163698	130164507	809	404.0	
60654	chr11	130165748	130166782	1034	517.0	
60655	chr11	130180493	130182122	1629	814.0	
60656	chr11	130202006	130202349	343	172.0	
60657	chr11	130203288	130203637	349	174.0	
60658	chr11	130212796	130213856	1060	530.0	
60659	chr11	130223418	130223739	321	160.0	
60660	chr11	130243781	130244182	401	200.0	
60661	chr11	130269565	130269745	180	90.0	
60662	chr11	130313388	130316166	2778	1389.0	
60663	chr11	130340409	130341312	903	452.0	
60664	chr11	130388523	130389950	1427	714.0	
60665	chr11	130400822	130401257	435	218.0	
60666	chr11	130402647	130402749	102	51.0	
60667	chr11	130420911	130421254	343	172.0	
60668	chr11	130427776	130428646	870	435.0	
60669	chr11	130431118	130431681	563	282.0	
60670	chr11	130434205	130435388	1183	592.0	
60671	chr11	130439312	130439382	70	35.0	
60672	chr11	130448374	130448717	343	172.0	
60673	chr11	130561568	130561791	223	112.0	
60674	chr11	130601262	130601610	348	174.0	
60675	chr11	130614626	130614976	350	175.0	
60676	chr11	130616536	130617423	887	444.0	
60677	chr11	130827751	130828151	400	200.0	
60678	chr11	130858244	130858484	240	120.0	
60679	chr11	130861701	130862581	880	440.0	
60680	chr11	130894348	130894855	507	254.0	
60681	chr11	130915669	130917107	1438	719.0	
60682	chr11	130923233	130923704	471	236.0	
60683	chr11	130995323	130995486	163	82.0	
60684	chr11	131186615	131187046	431	216.0	
60685	chr11	131407987	131408566	579	290.0	
60686	chr11	131668441	131669225	784	392.0	
60687	chr11	131673921	131674363	442	221.0	
60688	chr11	131687969	131688351	382	191.0	
60689	chr11	131691529	131691877	348	174.0	
60690	chr11	131694764	131695216	452	226.0	
60691	chr11	131748173	131748494	321	160.0	
60692	chr11	131822554	131822950	396	198.0	
60693	chr11	131824715	131825253	538	269.0	
60694	chr11	131827370	131827840	470	235.0	
60695	chr11	131833520	131833745	225	112.0	
60696	chr11	131840580	131841537	957	478.0	
60697	chr11	131842271	131842389	118	59.0	
60698	chr11	132045132	132045538	406	203.0	
60699	chr11	132058054	132059116	1062	531.0	
60700	chr11	132099926	132099940	14	7.0	
60701	chr11	132126430	132126713	283	142.0	
60702	chr11	132540639	132541341	702	351.0	
60703	chr11	132718793	132719829	1036	518.0	
60704	chr11	132773219	132773223	4	2.0	
60705	chr11	133082664	133083426	762	381.0	
60706	chr11	133134592	133134884	292	146.0	
60707	chr11	133163486	133163626	140	70.0	
60708	chr11	133204394	133204489	95	48.0	
60709	chr11	133918897	133918940	43	22.0	
60710	chr11	133919548	133919621	73	36.0	
60711	chr11	133927379	133929090	1711	856.0	
60712	chr11	133944660	133948866	4206	2103.0	
60713	chr11	133955041	133957868	2827	1414.0	
60714	chr11	133967189	133967760	571	286.0	
60715	chr11	134027638	134028170	532	266.0	
60716	chr11	134032520	134035147	2627	1314.0	
60717	chr11	134036248	134038076	1828	914.0	
60718	chr11	134045770	134045916	146	73.0	
60719	chr11	134050240	134051112	872	436.0	
60720	chr11	134058237	134058762	525	262.0	
60721	chr11	134068614	134069952	1338	669.0	
60722	chr11	134070642	134070713	71	36.0	
60723	chr11	134072745	134073217	472	236.0	
60724	chr11	134139704	134140197	493	246.0	
60725	chr11	134207372	134207892	520	260.0	
60726	chr11	134223168	134226033	2865	1432.0	
60727	chr11	134228550	134229266	716	358.0	
60728	chr11	134232173	134232552	379	190.0	
60729	chr11	134244557	134245048	491	246.0	
60730	chr11	134250249	134250597	348	174.0	
60731	chr11	134252410	134254315	1905	952.0	
60732	chr11	134262017	134262408	391	196.0	
60733	chr11	134266686	134267310	624	312.0	
60734	chr11	134270149	134270789	640	320.0	
60735	chr11	134275328	134277061	1733	866.0	
60736	chr11	134331238	134332807	1569	784.0	
60737	chr11	134349000	134350116	1116	558.0	
60738	chr11	134359958	134360688	730	365.0	
60739	chr11	134386994	134387466	472	236.0	
60740	chr11	134402464	134402763	299	150.0	
60741	chr11	134411492	134413160	1668	834.0	
60742	chr11	134582375	134584380	2005	1002.0	
60743	chr11	135075674	135076187	513	256.0	
60744	chr12	27914	28291	377	188.0	
60745	chr12	23197	23398	201	100.0	
60746	chr12	21551	22435	884	442.0	
60747	chr12	10975	11526	551	276.0	
60748	chr12	46363	46483	120	60.0	
60749	chr12	67078	67455	377	188.0	
60750	chr12	102045	102260	215	108.0	
60751	chr12	111540	112250	710	355.0	
60752	chr12	128028	128518	490	245.0	
60753	chr12	153114	153658	544	272.0	
60754	chr12	172405	173066	661	330.0	
60755	chr12	180348	180935	587	294.0	
60756	chr12	188911	189526	615	308.0	
60757	chr12	211821	214396	2575	1288.0	
60758	chr12	215087	215463	376	188.0	
60759	chr12	219723	220384	661	330.0	
60760	chr12	233480	233728	248	124.0	
60761	chr12	388200	390188	1988	994.0	
60762	chr12	400984	402468	1484	742.0	
60763	chr12	406705	407265	560	280.0	
60764	chr12	442211	442650	439	220.0	
60765	chr12	452894	455330	2436	1218.0	
60766	chr12	459177	461116	1939	970.0	
60767	chr12	463337	463685	348	174.0	
60768	chr12	526117	526279	162	81.0	
60769	chr12	538637	539971	1334	667.0	
60770	chr12	546319	547417	1098	549.0	
60771	chr12	552002	554216	2214	1107.0	
60772	chr12	559812	560328	516	258.0	
60773	chr12	561646	564807	3161	1580.0	
60774	chr12	569283	570663	1380	690.0	
60775	chr12	575820	576848	1028	514.0	
60776	chr12	591075	591628	553	276.0	
60777	chr12	593613	594029	416	208.0	
60778	chr12	609708	611601	1893	946.0	
60779	chr12	614247	614730	483	242.0	
60780	chr12	617224	618027	803	402.0	
60781	chr12	619459	619645	186	93.0	
60782	chr12	622174	622836	662	331.0	
60783	chr12	630089	631415	1326	663.0	
60784	chr12	632332	633135	803	402.0	
60785	chr12	636580	637015	435	218.0	
60786	chr12	638873	639624	751	376.0	
60787	chr12	641810	644420	2610	1305.0	
60788	chr12	650978	651384	406	203.0	
60789	chr12	659135	659405	270	135.0	
60790	chr12	662797	663372	575	288.0	
60791	chr12	666851	668126	1275	638.0	
60792	chr12	668978	669564	586	293.0	
60793	chr12	672038	675274	3236	1618.0	
60794	chr12	682191	683025	834	417.0	
60795	chr12	684465	686307	1842	921.0	
60796	chr12	689471	689892	421	210.0	
60797	chr12	697402	697856	454	227.0	
60798	chr12	719116	720069	953	476.0	
60799	chr12	724289	724842	553	276.0	
60800	chr12	726094	726609	515	258.0	
60801	chr12	728763	729207	444	222.0	
60802	chr12	750768	756038	5270	2635.0	
60803	chr12	757951	758614	663	332.0	
60804	chr12	759542	759802	260	130.0	
60805	chr12	768489	768777	288	144.0	
60806	chr12	769735	770160	425	212.0	
60807	chr12	774227	774353	126	63.0	
60808	chr12	775967	776681	714	357.0	
60809	chr12	779241	780075	834	417.0	
60810	chr12	780687	781035	348	174.0	
60811	chr12	789384	790319	935	468.0	
60812	chr12	795193	795769	576	288.0	
60813	chr12	804925	805455	530	265.0	
60814	chr12	806945	807948	1003	502.0	
60815	chr12	813880	814642	762	381.0	
60816	chr12	816353	816854	501	250.0	
60817	chr12	822995	823967	972	486.0	
60818	chr12	870456	870727	271	136.0	
60819	chr12	874055	874294	239	120.0	
60820	chr12	898259	898606	347	174.0	
60821	chr12	905239	906618	1379	690.0	
60822	chr12	911480	911881	401	200.0	
60823	chr12	914115	914531	416	208.0	
60824	chr12	915070	915451	381	190.0	
60825	chr12	916262	916732	470	235.0	
60826	chr12	948539	950677	2138	1069.0	
60827	chr12	977241	977440	199	100.0	
60828	chr12	989789	992255	2466	1233.0	
60829	chr12	993806	994219	413	206.0	
60830	chr12	995636	996402	766	383.0	
60831	chr12	1048204	1048690	486	243.0	
60832	chr12	1093139	1093590	451	226.0	
60833	chr12	1108214	1108678	464	232.0	
60834	chr12	1117936	1118439	503	252.0	
60835	chr12	1122840	1123168	328	164.0	
60836	chr12	1126224	1126450	226	113.0	
60837	chr12	1188084	1188366	282	141.0	
60838	chr12	1204551	1205236	685	342.0	
60839	chr12	1227080	1227294	214	107.0	
60840	chr12	1277771	1278400	629	314.0	
60841	chr12	1289673	1290224	551	276.0	
60842	chr12	1305973	1306222	249	124.0	
60843	chr12	1328221	1328915	694	347.0	
60844	chr12	1421445	1421846	401	200.0	
60845	chr12	1473330	1473925	595	298.0	
60846	chr12	1488844	1489405	561	280.0	
60847	chr12	1504323	1504721	398	199.0	
60848	chr12	1529951	1534477	4526	2263.0	
60849	chr12	1544964	1545669	705	352.0	
60850	chr12	1583265	1584067	802	401.0	
60851	chr12	1587926	1588231	305	152.0	
60852	chr12	1590657	1591484	827	414.0	
60853	chr12	1592339	1595741	3402	1701.0	
60854	chr12	1601161	1602424	1263	632.0	
60855	chr12	1604826	1606523	1697	848.0	
60856	chr12	1608728	1609179	451	226.0	
60857	chr12	1616404	1616896	492	246.0	
60858	chr12	1618433	1618856	423	212.0	
60859	chr12	1619473	1619989	516	258.0	
60860	chr12	1629650	1630955	1305	652.0	
60861	chr12	1633468	1633882	414	207.0	
60862	chr12	1634524	1636192	1668	834.0	
60863	chr12	1646843	1647292	449	224.0	
60864	chr12	1652579	1653451	872	436.0	
60865	chr12	1658560	1663514	4954	2477.0	
60866	chr12	1666714	1667284	570	285.0	
60867	chr12	1668626	1669591	965	482.0	
60868	chr12	1690345	1693617	3272	1636.0	
60869	chr12	1711865	1712021	156	78.0	
60870	chr12	1715961	1716591	630	315.0	
60871	chr12	1740488	1740997	509	254.0	
60872	chr12	1790849	1792009	1160	580.0	
60873	chr12	1795602	1801245	5643	2822.0	
60874	chr12	1804057	1805284	1227	614.0	
60875	chr12	1808762	1809245	483	242.0	
60876	chr12	1809976	1810590	614	307.0	
60877	chr12	1811537	1813588	2051	1026.0	
60878	chr12	1831101	1831430	329	164.0	
60879	chr12	1842511	1842744	233	116.0	
60880	chr12	1915415	1916131	716	358.0	
60881	chr12	1917517	1918766	1249	624.0	
60882	chr12	1920921	1922402	1481	740.0	
60883	chr12	1924635	1925268	633	316.0	
60884	chr12	1929501	1930460	959	480.0	
60885	chr12	1939745	1940610	865	432.0	
60886	chr12	1993457	1994490	1033	516.0	
60887	chr12	2003648	2005194	1546	773.0	
60888	chr12	2034611	2035773	1162	581.0	
60889	chr12	2052662	2053330	668	334.0	
60890	chr12	2063994	2064589	595	298.0	
60891	chr12	2259626	2259696	70	35.0	
60892	chr12	2283895	2285212	1317	658.0	
60893	chr12	2287968	2288411	443	222.0	
60894	chr12	2291154	2291600	446	223.0	
60895	chr12	2294479	2296354	1875	938.0	
60896	chr12	2309790	2310015	225	112.0	
60897	chr12	2322910	2323975	1065	532.0	
60898	chr12	2333748	2334219	471	236.0	
60899	chr12	2336293	2336956	663	332.0	
60900	chr12	2338962	2339328	366	183.0	
60901	chr12	2341782	2342392	610	305.0	
60902	chr12	2344940	2345335	395	198.0	
60903	chr12	2357863	2358930	1067	534.0	
60904	chr12	2364472	2365175	703	352.0	
60905	chr12	2395423	2395568	145	72.0	
60906	chr12	2500324	2500730	406	203.0	
60907	chr12	2547208	2547778	570	285.0	
60908	chr12	2551355	2552088	733	366.0	
60909	chr12	2582966	2583441	475	238.0	
60910	chr12	2682240	2683381	1141	570.0	
60911	chr12	2690568	2692609	2041	1020.0	
60912	chr12	2693234	2693677	443	222.0	
60913	chr12	2752386	2753309	923	462.0	
60914	chr12	2783399	2784622	1223	612.0	
60915	chr12	2793977	2796939	2962	1481.0	
60916	chr12	2812087	2814191	2104	1052.0	
60917	chr12	2836597	2836646	49	24.0	
60918	chr12	2853564	2854001	437	218.0	
60919	chr12	2867883	2868406	523	262.0	
60920	chr12	2876321	2878912	2591	1296.0	
60921	chr12	2885110	2885843	733	366.0	
60922	chr12	2890076	2891721	1645	822.0	
60923	chr12	2944603	2945037	434	217.0	
60924	chr12	3034160	3034485	325	162.0	
60925	chr12	3041482	3042880	1398	699.0	
60926	chr12	3073305	3074211	906	453.0	
60927	chr12	3076538	3078270	1732	866.0	
60928	chr12	3129339	3129694	355	178.0	
60929	chr12	3135408	3135846	438	219.0	
60930	chr12	3202983	3203347	364	182.0	
60931	chr12	3250778	3251393	615	308.0	
60932	chr12	3275397	3275848	451	226.0	
60933	chr12	3281756	3282079	323	162.0	
60934	chr12	3299786	3300944	1158	579.0	
60935	chr12	3361198	3361546	348	174.0	
60936	chr12	3363507	3364137	630	315.0	
60937	chr12	3658362	3658709	347	174.0	
60938	chr12	3704658	3705129	471	236.0	
60939	chr12	3718019	3718534	515	258.0	
60940	chr12	3727817	3729340	1523	762.0	
60941	chr12	3730081	3730372	291	146.0	
60942	chr12	3744241	3744907	666	333.0	
60943	chr12	3747485	3747867	382	191.0	
60944	chr12	3751507	3754230	2723	1362.0	
60945	chr12	3777156	3777618	462	231.0	
60946	chr12	3803829	3804290	461	230.0	
60947	chr12	3838582	3839133	551	276.0	
60948	chr12	3869633	3870735	1102	551.0	
60949	chr12	3871309	3871784	475	238.0	
60950	chr12	3872401	3874145	1744	872.0	
60951	chr12	3879482	3879486	4	2.0	
60952	chr12	3883140	3883597	457	228.0	
60953	chr12	3885410	3886114	704	352.0	
60954	chr12	3888703	3889060	357	178.0	
60955	chr12	3892616	3893011	395	198.0	
60956	chr12	3896727	3898100	1373	686.0	
60957	chr12	3907217	3907820	603	302.0	
60958	chr12	3928815	3929141	326	163.0	
60959	chr12	3933470	3933747	277	138.0	
60960	chr12	3935135	3935269	134	67.0	
60961	chr12	3947642	3948243	601	300.0	
60962	chr12	3950755	3951306	551	276.0	
60963	chr12	3962316	3963296	980	490.0	
60964	chr12	3972559	3975255	2696	1348.0	
60965	chr12	3988361	3989049	688	344.0	
60966	chr12	3995743	3996269	526	263.0	
60967	chr12	4027171	4028009	838	419.0	
60968	chr12	4030796	4032238	1442	721.0	
60969	chr12	4035872	4036147	275	138.0	
60970	chr12	4036715	4037116	401	200.0	
60971	chr12	4037773	4037866	93	46.0	
60972	chr12	4038747	4039131	384	192.0	
60973	chr12	4091130	4091811	681	340.0	
60974	chr12	4106684	4108091	1407	704.0	
60975	chr12	4114930	4115392	462	231.0	
60976	chr12	4117369	4119604	2235	1118.0	
60977	chr12	4133506	4134089	583	292.0	
60978	chr12	4135734	4137414	1680	840.0	
60979	chr12	4141514	4141832	318	159.0	
60980	chr12	4142388	4144335	1947	974.0	
60981	chr12	4146008	4147691	1683	842.0	
60982	chr12	4148314	4148973	659	330.0	
60983	chr12	4152473	4152476	3	2.0	
60984	chr12	4152989	4154076	1087	544.0	
60985	chr12	4164422	4165575	1153	576.0	
60986	chr12	4170007	4170303	296	148.0	
60987	chr12	4202508	4202892	384	192.0	
60988	chr12	4203765	4204241	476	238.0	
60989	chr12	4214720	4216208	1488	744.0	
60990	chr12	4217044	4217495	451	226.0	
60991	chr12	4223190	4224834	1644	822.0	
60992	chr12	4240383	4240784	401	200.0	
60993	chr12	4243165	4243873	708	354.0	
60994	chr12	4246169	4246539	370	185.0	
60995	chr12	4251145	4251629	484	242.0	
60996	chr12	4268344	4277578	9234	4617.0	
60997	chr12	4278435	4279133	698	349.0	
60998	chr12	4280423	4284448	4025	2012.0	
60999	chr12	4285909	4290041	4132	2066.0	
61000	chr12	4292871	4294479	1608	804.0	
61001	chr12	4307736	4308277	541	270.0	
61002	chr12	4320258	4322026	1768	884.0	
61003	chr12	4322748	4323819	1071	536.0	
61004	chr12	4353628	4354141	513	256.0	
61005	chr12	4355918	4356301	383	192.0	
61006	chr12	4421517	4421884	367	184.0	
61007	chr12	4432005	4432154	149	74.0	
61008	chr12	4434609	4435160	551	276.0	
61009	chr12	4439182	4439692	510	255.0	
61010	chr12	4471214	4472607	1393	696.0	
61011	chr12	4477075	4477555	480	240.0	
61012	chr12	4506813	4507286	473	236.0	
61013	chr12	4538042	4539343	1301	650.0	
61014	chr12	4555753	4556206	453	226.0	
61015	chr12	4557005	4557207	202	101.0	
61016	chr12	4561920	4562617	697	348.0	
61017	chr12	4564793	4565269	476	238.0	
61018	chr12	4567000	4568026	1026	513.0	
61019	chr12	4604529	4605355	826	413.0	
61020	chr12	4648056	4649771	1715	858.0	
61021	chr12	4807361	4808252	891	446.0	
61022	chr12	4808885	4810206	1321	660.0	
61023	chr12	4816065	4816399	334	167.0	
61024	chr12	4819669	4820073	404	202.0	
61025	chr12	4825437	4825999	562	281.0	
61026	chr12	4829212	4830169	957	478.0	
61027	chr12	4849017	4849412	395	198.0	
61028	chr12	4855367	4855892	525	262.0	
61029	chr12	4857621	4858357	736	368.0	
61030	chr12	4910947	4910977	30	15.0	
61031	chr12	5003009	5003405	396	198.0	
61032	chr12	5022458	5022794	336	168.0	
61033	chr12	5043698	5044057	359	180.0	
61034	chr12	5049063	5049551	488	244.0	
61035	chr12	5051903	5052379	476	238.0	
61036	chr12	5440934	5441389	455	228.0	
61037	chr12	5745295	5745588	293	146.0	
61038	chr12	5965869	5966257	388	194.0	
61039	chr12	5988533	5989071	538	269.0	
61040	chr12	6038038	6038557	519	260.0	
61041	chr12	6039778	6040422	644	322.0	
61042	chr12	6056353	6057117	764	382.0	
61043	chr12	6062904	6063625	721	360.0	
61044	chr12	6069392	6069790	398	199.0	
61045	chr12	6074332	6075726	1394	697.0	
61046	chr12	6092746	6093790	1044	522.0	
61047	chr12	6106266	6106621	355	178.0	
61048	chr12	6138615	6139617	1002	501.0	
61049	chr12	6140720	6141584	864	432.0	
61050	chr12	6143314	6143701	387	194.0	
61051	chr12	6145482	6146041	559	280.0	
61052	chr12	6163546	6163616	70	35.0	
61053	chr12	6167063	6169876	2813	1406.0	
61054	chr12	6180171	6180574	403	202.0	
61055	chr12	6182801	6184075	1274	637.0	
61056	chr12	6189150	6189259	109	54.0	
61057	chr12	6192684	6193092	408	204.0	
61058	chr12	6193809	6194339	530	265.0	
61059	chr12	6195550	6196347	797	398.0	
61060	chr12	6199525	6201821	2296	1148.0	
61061	chr12	6229750	6231608	1858	929.0	
61062	chr12	6278041	6279361	1320	660.0	
61063	chr12	6284766	6285453	687	344.0	
61064	chr12	6295186	6295264	78	39.0	
61065	chr12	6307364	6307864	500	250.0	
61066	chr12	6310347	6311140	793	396.0	
61067	chr12	6312796	6313197	401	200.0	
61068	chr12	6318357	6318748	391	196.0	
61069	chr12	6322782	6325223	2441	1220.0	
61070	chr12	6326305	6326718	413	206.0	
61071	chr12	6330154	6330639	485	242.0	
61072	chr12	6332276	6334087	1811	906.0	
61073	chr12	6335034	6342501	7467	3734.0	
61074	chr12	6345245	6346329	1084	542.0	
61075	chr12	6347445	6348036	591	296.0	
61076	chr12	6352140	6353043	903	452.0	
61077	chr12	6355857	6356717	860	430.0	
61078	chr12	6358801	6359288	487	244.0	
61079	chr12	6361690	6362540	850	425.0	
61080	chr12	6363128	6364434	1306	653.0	
61081	chr12	6367439	6368620	1181	590.0	
61082	chr12	6372516	6373036	520	260.0	
61083	chr12	6376347	6377374	1027	514.0	
61084	chr12	6378528	6379175	647	324.0	
61085	chr12	6380743	6380751	8	4.0	
61086	chr12	6383430	6384588	1158	579.0	
61087	chr12	6392722	6392870	148	74.0	
61088	chr12	6394351	6394826	475	238.0	
61089	chr12	6416470	6417306	836	418.0	
61090	chr12	6423257	6424313	1056	528.0	
61091	chr12	6425709	6427814	2105	1052.0	
61092	chr12	6430188	6431025	837	418.0	
61093	chr12	6433058	6433131	73	36.0	
61094	chr12	6434114	6434621	507	254.0	
61095	chr12	6442856	6447229	4373	2186.0	
61096	chr12	6448130	6448461	331	166.0	
61097	chr12	6450476	6453798	3322	1661.0	
61098	chr12	6454581	6454835	254	127.0	
61099	chr12	6455682	6456322	640	320.0	
61100	chr12	6457023	6464755	7732	3866.0	
61101	chr12	6465292	6467082	1790	895.0	
61102	chr12	6467698	6471751	4053	2026.0	
61103	chr12	6492658	6494822	2164	1082.0	
61104	chr12	6532040	6541256	9216	4608.0	
61105	chr12	6542201	6542823	622	311.0	
61106	chr12	6548653	6552022	3369	1684.0	
61107	chr12	6553960	6557125	3165	1582.0	
61108	chr12	6557751	6558752	1001	500.0	
61109	chr12	6563169	6564051	882	441.0	
61110	chr12	6565385	6566038	653	326.0	
61111	chr12	6567172	6571168	3996	1998.0	
61112	chr12	6572033	6573992	1959	980.0	
61113	chr12	6574990	6583811	8821	4410.0	
61114	chr12	6584921	6610488	25567	12784.0	
61115	chr12	6611038	6614850	3812	1906.0	
61116	chr12	6615898	6616083	185	92.0	
61117	chr12	6617575	6618909	1334	667.0	
61118	chr12	6620130	6621026	896	448.0	
61119	chr12	6626711	6628289	1578	789.0	
61120	chr12	6631074	6632972	1898	949.0	
61121	chr12	6635067	6636728	1661	830.0	
61122	chr12	6638379	6638891	512	256.0	
61123	chr12	6643363	6644877	1514	757.0	
61124	chr12	6646946	6647738	792	396.0	
61125	chr12	6662486	6663983	1497	748.0	
61126	chr12	6684541	6685069	528	264.0	
61127	chr12	6688121	6690326	2205	1102.0	
61128	chr12	6696792	6698431	1639	820.0	
61129	chr12	6699752	6701434	1682	841.0	
61130	chr12	6703715	6703914	199	100.0	
61131	chr12	6708966	6709236	270	135.0	
61132	chr12	6723256	6724981	1725	862.0	
61133	chr12	6735611	6736092	481	240.0	
61134	chr12	6745314	6746513	1199	600.0	
61135	chr12	6752226	6754770	2544	1272.0	
61136	chr12	6758451	6758912	461	230.0	
61137	chr12	6763828	6768056	4228	2114.0	
61138	chr12	6771067	6775976	4909	2454.0	
61139	chr12	6778310	6779557	1247	624.0	
61140	chr12	6783212	6783322	110	55.0	
61141	chr12	6784513	6785172	659	330.0	
61142	chr12	6786390	6787293	903	452.0	
61143	chr12	6788879	6793563	4684	2342.0	
61144	chr12	6812544	6813022	478	239.0	
61145	chr12	6820847	6822168	1321	660.0	
61146	chr12	6825178	6826236	1058	529.0	
61147	chr12	6827141	6829951	2810	1405.0	
61148	chr12	6835566	6836322	756	378.0	
61149	chr12	6839767	6840106	339	170.0	
61150	chr12	6850760	6853625	2865	1432.0	
61151	chr12	6865887	6870150	4263	2132.0	
61152	chr12	6870976	6874712	3736	1868.0	
61153	chr12	6879513	6880136	623	312.0	
61154	chr12	6883952	6884030	78	39.0	
61155	chr12	6887464	6887817	353	176.0	
61156	chr12	6890534	6892039	1505	752.0	
61157	chr12	6894305	6894733	428	214.0	
61158	chr12	6899389	6900576	1187	594.0	
61159	chr12	6904111	6905605	1494	747.0	
61160	chr12	6909686	6910080	394	197.0	
61161	chr12	6913731	6915785	2054	1027.0	
61162	chr12	6922164	6923129	965	482.0	
61163	chr12	6923849	6925619	1770	885.0	
61164	chr12	6927211	6930254	3043	1522.0	
61165	chr12	6932672	6933170	498	249.0	
61166	chr12	6935156	6938931	3775	1888.0	"sequence_feature	repeat_region"
61167	chr12	6942584	6948065	5481	2740.0	
61168	chr12	6948688	6962949	14261	7130.0	enhancer
61169	chr12	6964635	6965875	1240	620.0	
61170	chr12	6969863	6971675	1812	906.0	
61171	chr12	7005250	7005679	429	214.0	
61172	chr12	7008128	7008277	149	74.0	
61173	chr12	7017678	7019276	1598	799.0	
61174	chr12	7022025	7022305	280	140.0	
61175	chr12	7042888	7043186	298	149.0	
61176	chr12	7058473	7058860	387	194.0	
61177	chr12	7091985	7093066	1081	540.0	
61178	chr12	7107762	7109763	2001	1000.0	
61179	chr12	7113200	7113916	716	358.0	
61180	chr12	7129268	7132120	2852	1426.0	
61181	chr12	7141958	7142504	546	273.0	
61182	chr12	7144381	7144829	448	224.0	
61183	chr12	7162658	7163023	365	182.0	
61184	chr12	7188369	7190855	2486	1243.0	
61185	chr12	7219613	7220084	471	236.0	
61186	chr12	7345287	7345619	332	166.0	
61187	chr12	7374616	7374691	75	38.0	
61188	chr12	7439774	7440595	821	410.0	
61189	chr12	7444145	7444453	308	154.0	
61190	chr12	7460563	7461033	470	235.0	
61191	chr12	7498663	7499230	567	284.0	
61192	chr12	7501195	7501569	374	187.0	
61193	chr12	7503616	7504143	527	264.0	
61194	chr12	7512561	7512993	432	216.0	
61195	chr12	7542689	7543308	619	310.0	
61196	chr12	7555810	7556127	317	158.0	
61197	chr12	7571335	7571829	494	247.0	
61198	chr12	7588655	7589243	588	294.0	
61199	chr12	7601378	7601815	437	218.0	
61200	chr12	7609559	7609838	279	140.0	
61201	chr12	7612851	7613260	409	204.0	
61202	chr12	7638226	7641216	2990	1495.0	
61203	chr12	7645380	7645990	610	305.0	
61204	chr12	7675423	7675876	453	226.0	
61205	chr12	7677361	7677784	423	212.0	
61206	chr12	7693717	7694210	493	246.0	
61207	chr12	7752541	7752907	366	183.0	
61208	chr12	7755662	7756106	444	222.0	
61209	chr12	7806852	7807269	417	208.0	
61210	chr12	7832056	7832576	520	260.0	
61211	chr12	7834786	7835233	447	224.0	
61212	chr12	7837299	7837810	511	256.0	
61213	chr12	7859773	7860531	758	379.0	
61214	chr12	7863018	7863457	439	220.0	
61215	chr12	7872898	7873006	108	54.0	
61216	chr12	7884680	7885031	351	176.0	
61217	chr12	7890939	7891538	599	300.0	
61218	chr12	7900182	7900491	309	154.0	
61219	chr12	7906281	7908054	1773	886.0	
61220	chr12	7908658	7924230	15572	7786.0	
61221	chr12	7925174	7936959	11785	5892.0	
61222	chr12	7938090	7938362	272	136.0	
61223	chr12	7948564	7949460	896	448.0	
61224	chr12	7958547	7961458	2911	1456.0	
61225	chr12	7966507	7967055	548	274.0	
61226	chr12	7970145	7973004	2859	1430.0	
61227	chr12	7977204	7978161	957	478.0	
61228	chr12	7986967	7987063	96	48.0	
61229	chr12	7989722	7990768	1046	523.0	
61230	chr12	7994921	7996085	1164	582.0	
61231	chr12	8018547	8019745	1198	599.0	
61232	chr12	8025935	8027913	1978	989.0	
61233	chr12	8031827	8035902	4075	2038.0	
61234	chr12	8036838	8037743	905	452.0	
61235	chr12	8038475	8039262	787	394.0	
61236	chr12	8045746	8046435	689	344.0	
61237	chr12	8050902	8051730	828	414.0	
61238	chr12	8052569	8053181	612	306.0	
61239	chr12	8057535	8058864	1329	664.0	
61240	chr12	8064448	8064784	336	168.0	
61241	chr12	8065977	8067058	1081	540.0	
61242	chr12	8070603	8071112	509	254.0	
61243	chr12	8077428	8077464	36	18.0	
61244	chr12	8078304	8078871	567	284.0	
61245	chr12	8080054	8080555	501	250.0	
61246	chr12	8081193	8083285	2092	1046.0	
61247	chr12	8084023	8084758	735	368.0	
61248	chr12	8087649	8089166	1517	758.0	
61249	chr12	8096197	8096677	480	240.0	
61250	chr12	8108751	8109257	506	253.0	
61251	chr12	8123329	8124244	915	458.0	
61252	chr12	8127012	8127628	616	308.0	
61253	chr12	8156604	8157511	907	454.0	
61254	chr12	8179950	8180791	841	420.0	
61255	chr12	8226992	8227859	867	434.0	
61256	chr12	8231635	8232295	660	330.0	
61257	chr12	8237207	8238069	862	431.0	
61258	chr12	8242114	8244441	2327	1164.0	
61259	chr12	8266616	8267177	561	280.0	
61260	chr12	8269072	8269888	816	408.0	
61261	chr12	8320084	8320872	788	394.0	
61262	chr12	8389986	8390914	928	464.0	
61263	chr12	8396220	8397125	905	452.0	
61264	chr12	8452833	8453704	871	436.0	
61265	chr12	8455285	8456320	1035	518.0	
61266	chr12	8465538	8466949	1411	706.0	
61267	chr12	8492175	8492253	78	39.0	
61268	chr12	8492812	8493647	835	418.0	
61269	chr12	8501724	8502058	334	167.0	
61270	chr12	8513314	8513724	410	205.0	
61271	chr12	8519039	8519596	557	278.0	
61272	chr12	8540052	8542653	2601	1300.0	
61273	chr12	8544058	8544674	616	308.0	
61274	chr12	8565918	8566919	1001	500.0	
61275	chr12	8572345	8573059	714	357.0	
61276	chr12	8583952	8584261	309	154.0	
61277	chr12	8591110	8591542	432	216.0	
61278	chr12	8608952	8609651	699	350.0	
61279	chr12	8618940	8619833	893	446.0	
61280	chr12	8644262	8645362	1100	550.0	
61281	chr12	8657328	8657820	492	246.0	
61282	chr12	8667266	8667664	398	199.0	
61283	chr12	8675660	8675854	194	97.0	
61284	chr12	8682001	8682521	520	260.0	
61285	chr12	8687887	8688136	249	124.0	
61286	chr12	8696682	8699017	2335	1168.0	
61287	chr12	8709273	8709914	641	320.0	
61288	chr12	8849780	8850292	512	256.0	
61289	chr12	8860477	8860830	353	176.0	
61290	chr12	8890501	8891244	743	372.0	
61291	chr12	8902564	8903259	695	348.0	
61292	chr12	8912872	8915448	2576	1288.0	
61293	chr12	8947612	8952364	4752	2376.0	
61294	chr12	8953619	8954921	1302	651.0	
61295	chr12	8960107	8960642	535	268.0	
61296	chr12	8985205	8985669	464	232.0	
61297	chr12	8987222	8988242	1020	510.0	
61298	chr12	8989325	8989984	659	330.0	
61299	chr12	8991900	8992712	812	406.0	
61300	chr12	8996667	8997195	528	264.0	
61301	chr12	9009949	9010653	704	352.0	
61302	chr12	9024511	9025963	1452	726.0	
61303	chr12	9027140	9028193	1053	526.0	
61304	chr12	9032482	9033036	554	277.0	
61305	chr12	9039311	9039857	546	273.0	
61306	chr12	9049110	9050020	910	455.0	
61307	chr12	9064031	9065432	1401	700.0	
61308	chr12	9117921	9118815	894	447.0	
61309	chr12	9240111	9240854	743	372.0	
61310	chr12	9283395	9283873	478	239.0	
61311	chr12	9319245	9319367	122	61.0	
61312	chr12	9331079	9331722	643	322.0	
61313	chr12	9341163	9341628	465	232.0	
61314	chr12	9364293	9365217	924	462.0	
61315	chr12	9367118	9367572	454	227.0	
61316	chr12	9381679	9381955	276	138.0	
61317	chr12	9404427	9404693	266	133.0	
61318	chr12	9411919	9411970	51	26.0	
61319	chr12	9435709	9435802	93	46.0	
61320	chr12	9447600	9448861	1261	630.0	
61321	chr12	9468987	9469377	390	195.0	
61322	chr12	9604320	9604624	304	152.0	
61323	chr12	9606783	9607046	263	132.0	
61324	chr12	9615089	9616236	1147	574.0	
61325	chr12	9633975	9634972	997	498.0	
61326	chr12	9636179	9636479	300	150.0	
61327	chr12	9638627	9639014	387	194.0	
61328	chr12	9642647	9643486	839	420.0	
61329	chr12	9645167	9645250	83	42.0	
61330	chr12	9646879	9651884	5005	2502.0	
61331	chr12	9662697	9662882	185	92.0	
61332	chr12	9667311	9667807	496	248.0	
61333	chr12	9668926	9670015	1089	544.0	
61334	chr12	9670614	9675615	5001	2500.0	
61335	chr12	9677658	9678182	524	262.0	
61336	chr12	9685404	9686318	914	457.0	
61337	chr12	9687253	9687523	270	135.0	
61338	chr12	9698680	9699093	413	206.0	
61339	chr12	9699670	9700273	603	302.0	
61340	chr12	9701665	9702904	1239	620.0	
61341	chr12	9706229	9706414	185	92.0	
61342	chr12	9707380	9708960	1580	790.0	
61343	chr12	9713080	9713542	462	231.0	
61344	chr12	9721483	9722246	763	382.0	
61345	chr12	9731633	9732232	599	300.0	
61346	chr12	9733055	9733359	304	152.0	
61347	chr12	9736847	9737751	904	452.0	
61348	chr12	9739933	9740770	837	418.0	
61349	chr12	9741422	9743671	2249	1124.0	
61350	chr12	9748446	9749150	704	352.0	
61351	chr12	9749934	9762005	12071	6036.0	
61352	chr12	9762931	9763527	596	298.0	
61353	chr12	9764269	9765776	1507	754.0	
61354	chr12	9769426	9769650	224	112.0	
61355	chr12	9773315	9774012	697	348.0	
61356	chr12	9793725	9795119	1394	697.0	
61357	chr12	9796260	9796755	495	248.0	
61358	chr12	9797930	9798477	547	274.0	
61359	chr12	9810545	9811406	861	430.0	
61360	chr12	9813560	9814895	1335	668.0	
61361	chr12	9820676	9820890	214	107.0	
61362	chr12	9827128	9827886	758	379.0	
61363	chr12	9849369	9849987	618	309.0	
61364	chr12	9864878	9865741	863	432.0	
61365	chr12	9866679	9867241	562	281.0	
61366	chr12	9868240	9870598	2358	1179.0	
61367	chr12	9872139	9872404	265	132.0	
61368	chr12	9906688	9907395	707	354.0	
61369	chr12	9925603	9926235	632	316.0	
61370	chr12	9944413	9944777	364	182.0	
61371	chr12	9948468	9949191	723	362.0	
61372	chr12	9950951	9951697	746	373.0	
61373	chr12	9957807	9958260	453	226.0	
61374	chr12	9960628	9961028	400	200.0	
61375	chr12	9970849	9971629	780	390.0	
61376	chr12	9973900	9974342	442	221.0	
61377	chr12	9992365	9992491	126	63.0	
61378	chr12	10009886	10010302	416	208.0	
61379	chr12	10027235	10028297	1062	531.0	
61380	chr12	10034048	10034332	284	142.0	
61381	chr12	10052518	10052640	122	61.0	
61382	chr12	10068040	10069527	1487	744.0	
61383	chr12	10094555	10095379	824	412.0	
61384	chr12	10101891	10102771	880	440.0	
61385	chr12	10119071	10119472	401	200.0	
61386	chr12	10120703	10121819	1116	558.0	
61387	chr12	10128218	10131594	3376	1688.0	
61388	chr12	10132428	10132564	136	68.0	
61389	chr12	10139932	10140444	512	256.0	
61390	chr12	10153101	10154394	1293	646.0	
61391	chr12	10158405	10159684	1279	640.0	
61392	chr12	10160940	10161514	574	287.0	
61393	chr12	10167171	10168315	1144	572.0	
61394	chr12	10170252	10170502	250	125.0	
61395	chr12	10171842	10172561	719	360.0	
61396	chr12	10182366	10183254	888	444.0	
61397	chr12	10184158	10185118	960	480.0	
61398	chr12	10186162	10187427	1265	632.0	
61399	chr12	10190544	10191273	729	364.0	
61400	chr12	10196164	10196717	553	276.0	
61401	chr12	10197877	10198204	327	164.0	
61402	chr12	10201161	10201166	5	2.0	
61403	chr12	10211852	10216480	4628	2314.0	
61404	chr12	10218032	10218426	394	197.0	
61405	chr12	10219956	10221120	1164	582.0	
61406	chr12	10221629	10224460	2831	1416.0	
61407	chr12	10226208	10226985	777	388.0	
61408	chr12	10235534	10236556	1022	511.0	
61409	chr12	10242585	10242836	251	126.0	
61410	chr12	10243751	10244515	764	382.0	
61411	chr12	10247682	10247860	178	89.0	
61412	chr12	10249621	10250487	866	433.0	
61413	chr12	10279910	10280337	427	214.0	
61414	chr12	10285852	10286420	568	284.0	
61415	chr12	10289057	10289400	343	172.0	
61416	chr12	10293112	10294163	1051	526.0	
61417	chr12	10301385	10301518	133	66.0	
61418	chr12	10303972	10304673	701	350.0	
61419	chr12	10305378	10306322	944	472.0	
61420	chr12	10307588	10308527	939	470.0	
61421	chr12	10312368	10312852	484	242.0	
61422	chr12	10331609	10332053	444	222.0	
61423	chr12	10342053	10342217	164	82.0	
61424	chr12	10361192	10361364	172	86.0	
61425	chr12	10362855	10367307	4452	2226.0	
61426	chr12	10369656	10370328	672	336.0	
61427	chr12	10371925	10373019	1094	547.0	
61428	chr12	10373919	10374667	748	374.0	
61429	chr12	10381645	10382484	839	420.0	
61430	chr12	10385286	10385687	401	200.0	
61431	chr12	10389934	10390245	311	156.0	
61432	chr12	10391922	10393082	1160	580.0	
61433	chr12	10394360	10396170	1810	905.0	
61434	chr12	10397245	10397901	656	328.0	
61435	chr12	10406604	10407280	676	338.0	
61436	chr12	10409396	10409737	341	170.0	
61437	chr12	10411153	10411738	585	292.0	
61438	chr12	10453227	10453467	240	120.0	
61439	chr12	10481753	10482306	553	276.0	
61440	chr12	10497475	10498089	614	307.0	
61441	chr12	10499230	10499507	277	138.0	
61442	chr12	10540737	10541138	401	200.0	
61443	chr12	10552979	10553569	590	295.0	
61444	chr12	10554077	10555589	1512	756.0	
61445	chr12	10557485	10557539	54	27.0	
61446	chr12	10559097	10559715	618	309.0	
61447	chr12	10562237	10562737	500	250.0	
61448	chr12	10600977	10601383	406	203.0	
61449	chr12	10602586	10603169	583	292.0	
61450	chr12	10612628	10614440	1812	906.0	
61451	chr12	10615501	10615901	400	200.0	
61452	chr12	10668390	10668987	597	298.0	
61453	chr12	10671882	10675112	3230	1615.0	
61454	chr12	10695930	10697561	1631	816.0	
61455	chr12	10700934	10701846	912	456.0	
61456	chr12	10709125	10709157	32	16.0	
61457	chr12	10709730	10709972	242	121.0	
61458	chr12	10715453	10716140	687	344.0	
61459	chr12	10717839	10718760	921	460.0	
61460	chr12	10719505	10719787	282	141.0	
61461	chr12	10720370	10720476	106	53.0	
61462	chr12	10721062	10724211	3149	1574.0	
61463	chr12	10741820	10742275	455	228.0	
61464	chr12	10749685	10750656	971	486.0	
61465	chr12	10771174	10771483	309	154.0	
61466	chr12	10849574	10849806	232	116.0	
61467	chr12	10982005	10982771	766	383.0	
61468	chr12	11170761	11172339	1578	789.0	
61469	chr12	11486306	11487241	935	468.0	
61470	chr12	11500300	11501218	918	459.0	
61471	chr12	11545238	11546624	1386	693.0	
61472	chr12	11553871	11554418	547	274.0	
61473	chr12	11555712	11556464	752	376.0	
61474	chr12	11576131	11576611	480	240.0	
61475	chr12	11578459	11578765	306	153.0	
61476	chr12	11580352	11581601	1249	624.0	
61477	chr12	11584422	11584971	549	274.0	
61478	chr12	11595007	11595586	579	290.0	
61479	chr12	11596229	11596350	121	60.0	
61480	chr12	11621982	11622433	451	226.0	
61481	chr12	11623522	11623564	42	21.0	
61482	chr12	11648430	11654821	6391	3196.0	
61483	chr12	11655774	11656799	1025	512.0	
61484	chr12	11666187	11667615	1428	714.0	
61485	chr12	11674017	11674952	935	468.0	
61486	chr12	11684404	11686328	1924	962.0	
61487	chr12	11687524	11687805	281	140.0	
61488	chr12	11704225	11704389	164	82.0	
61489	chr12	11711557	11712054	497	248.0	
61490	chr12	11719415	11720302	887	444.0	
61491	chr12	11724765	11726180	1415	708.0	
61492	chr12	11727015	11727686	671	336.0	
61493	chr12	11730375	11732888	2513	1256.0	
61494	chr12	11734597	11734896	299	150.0	
61495	chr12	11745821	11746947	1126	563.0	
61496	chr12	11749929	11750868	939	470.0	
61497	chr12	11752663	11753423	760	380.0	
61498	chr12	11758531	11759887	1356	678.0	
61499	chr12	11762684	11763472	788	394.0	
61500	chr12	11765010	11767008	1998	999.0	
61501	chr12	11770087	11770597	510	255.0	
61502	chr12	11771379	11771755	376	188.0	
61503	chr12	11773608	11774917	1309	654.0	
61504	chr12	11777983	11778350	367	184.0	
61505	chr12	11797370	11797801	431	216.0	
61506	chr12	11798453	11798638	185	92.0	
61507	chr12	11809177	11810553	1376	688.0	
61508	chr12	11812473	11813631	1158	579.0	
61509	chr12	11821959	11822876	917	458.0	
61510	chr12	11827029	11827461	432	216.0	
61511	chr12	11830190	11830541	351	176.0	
61512	chr12	11834227	11835355	1128	564.0	
61513	chr12	11836068	11837140	1072	536.0	
61514	chr12	11839059	11840530	1471	736.0	
61515	chr12	11855006	11856333	1327	664.0	
61516	chr12	11856834	11857553	719	360.0	
61517	chr12	11863927	11864392	465	232.0	
61518	chr12	11880413	11880791	378	189.0	
61519	chr12	11884626	11885603	977	488.0	
61520	chr12	11891549	11891711	162	81.0	
61521	chr12	11894931	11895191	260	130.0	
61522	chr12	11895837	11896102	265	132.0	
61523	chr12	11958698	11958973	275	138.0	
61524	chr12	11962976	11963301	325	162.0	
61525	chr12	11980879	11981988	1109	554.0	
61526	chr12	11998594	11999003	409	204.0	
61527	chr12	12007115	12011722	4607	2304.0	
61528	chr12	12022541	12022887	346	173.0	
61529	chr12	12024791	12025559	768	384.0	
61530	chr12	12032358	12033808	1450	725.0	
61531	chr12	12036166	12036183	17	8.0	
61532	chr12	12070985	12072421	1436	718.0	
61533	chr12	12210964	12211336	372	186.0	
61534	chr12	12266526	12267632	1106	553.0	
61535	chr12	12327672	12328215	543	272.0	
61536	chr12	12334295	12334829	534	267.0	
61537	chr12	12349462	12350930	1468	734.0	
61538	chr12	12356293	12358690	2397	1198.0	
61539	chr12	12365380	12366266	886	443.0	
61540	chr12	12367224	12367748	524	262.0	
61541	chr12	12376555	12377436	881	440.0	
61542	chr12	12378605	12380770	2165	1082.0	
61543	chr12	12384396	12385789	1393	696.0	
61544	chr12	12403838	12404201	363	182.0	
61545	chr12	12408317	12408632	315	158.0	
61546	chr12	12430930	12431405	475	238.0	
61547	chr12	12439515	12440113	598	299.0	
61548	chr12	12440920	12443030	2110	1055.0	
61549	chr12	12446957	12447235	278	139.0	
61550	chr12	12449514	12450094	580	290.0	
61551	chr12	12456557	12457078	521	260.0	
61552	chr12	12465896	12468412	2516	1258.0	
61553	chr12	12474394	12475807	1413	706.0	
61554	chr12	12481662	12483384	1722	861.0	
61555	chr12	12502310	12503914	1604	802.0	
61556	chr12	12505838	12506263	425	212.0	
61557	chr12	12508732	12508875	143	72.0	
61558	chr12	12517753	12518029	276	138.0	
61559	chr12	12527825	12528337	512	256.0	
61560	chr12	12538512	12538865	353	176.0	
61561	chr12	12560637	12564498	3861	1930.0	
61562	chr12	12600621	12601051	430	215.0	
61563	chr12	12606659	12607100	441	220.0	
61564	chr12	12611105	12614029	2924	1462.0	
61565	chr12	12621444	12623086	1642	821.0	
61566	chr12	12645401	12645999	598	299.0	
61567	chr12	12655759	12656385	626	313.0	
61568	chr12	12695665	12697506	1841	920.0	
61569	chr12	12700263	12700663	400	200.0	
61570	chr12	12704501	12705067	566	283.0	
61571	chr12	12705738	12706334	596	298.0	
61572	chr12	12713468	12721775	8307	4154.0	
61573	chr12	12722277	12727186	4909	2454.0	
61574	chr12	12730097	12730098	1	0.0	
61575	chr12	12736210	12737757	1547	774.0	
61576	chr12	12786363	12787736	1373	686.0	
61577	chr12	12788354	12789238	884	442.0	
61578	chr12	12801778	12802005	227	114.0	
61579	chr12	12803201	12803654	453	226.0	
61580	chr12	12807824	12809699	1875	938.0	
61581	chr12	12812790	12813998	1208	604.0	
61582	chr12	12817644	12818085	441	220.0	
61583	chr12	12836951	12837452	501	250.0	
61584	chr12	12846746	12847207	461	230.0	
61585	chr12	12890697	12891775	1078	539.0	
61586	chr12	12903991	12904328	337	168.0	
61587	chr12	12909256	12909608	352	176.0	
61588	chr12	12916136	12916888	752	376.0	
61589	chr12	12983478	12983848	370	185.0	
61590	chr12	12985974	12986438	464	232.0	
61591	chr12	12992333	12993427	1094	547.0	
61592	chr12	12999639	13002011	2372	1186.0	
61593	chr12	13043962	13045111	1149	574.0	
61594	chr12	13060542	13060990	448	224.0	
61595	chr12	13094305	13094782	477	238.0	
61596	chr12	13097290	13104843	7553	3776.0	
61597	chr12	13144251	13144716	465	232.0	
61598	chr12	13154045	13154560	515	258.0	
61599	chr12	13165297	13166138	841	420.0	
61600	chr12	13173476	13173969	493	246.0	
61601	chr12	13179350	13180241	891	446.0	
61602	chr12	13196103	13197197	1094	547.0	
61603	chr12	13197793	13197923	130	65.0	
61604	chr12	13208432	13209459	1027	514.0	
61605	chr12	13211830	13212675	845	422.0	
61606	chr12	13234036	13234422	386	193.0	
61607	chr12	13255618	13256239	621	310.0	
61608	chr12	13278120	13278589	469	234.0	
61609	chr12	13362270	13362598	328	164.0	
61610	chr12	13536437	13536929	492	246.0	
61611	chr12	14111227	14111644	417	208.0	
61612	chr12	14157001	14157758	757	378.0	
61613	chr12	14167019	14167435	416	208.0	
61614	chr12	14185849	14186278	429	214.0	
61615	chr12	14216346	14217138	792	396.0	
61616	chr12	14220908	14221807	899	450.0	
61617	chr12	14238109	14238602	493	246.0	
61618	chr12	14239190	14240674	1484	742.0	
61619	chr12	14252695	14253064	369	184.0	
61620	chr12	14255908	14258763	2855	1428.0	
61621	chr12	14259811	14260925	1114	557.0	
61622	chr12	14264629	14265257	628	314.0	
61623	chr12	14273161	14274332	1171	586.0	
61624	chr12	14275869	14276313	444	222.0	
61625	chr12	14278667	14278958	291	146.0	
61626	chr12	14283467	14283781	314	157.0	
61627	chr12	14291178	14291262	84	42.0	
61628	chr12	14314784	14315330	546	273.0	
61629	chr12	14327673	14328141	468	234.0	
61630	chr12	14362249	14362914	665	332.0	
61631	chr12	14364774	14367869	3095	1548.0	
61632	chr12	14368891	14369747	856	428.0	
61633	chr12	14372306	14372514	208	104.0	
61634	chr12	14373069	14373528	459	230.0	
61635	chr12	14384758	14385789	1031	516.0	
61636	chr12	14387171	14387490	319	160.0	
61637	chr12	14388182	14388631	449	224.0	
61638	chr12	14390827	14391508	681	340.0	
61639	chr12	14394319	14396808	2489	1244.0	
61640	chr12	14399929	14402149	2220	1110.0	
61641	chr12	14403389	14404276	887	444.0	
61642	chr12	14408175	14408727	552	276.0	
61643	chr12	14410913	14411660	747	374.0	
61644	chr12	14414458	14414735	277	138.0	
61645	chr12	14416475	14418988	2513	1256.0	
61646	chr12	14454012	14454587	575	288.0	
61647	chr12	14484607	14484776	169	84.0	
61648	chr12	14519462	14519788	326	163.0	
61649	chr12	14554148	14555095	947	474.0	
61650	chr12	14558284	14558988	704	352.0	
61651	chr12	14562209	14562807	598	299.0	
61652	chr12	14567145	14568534	1389	694.0	
61653	chr12	14577183	14577884	701	350.0	
61654	chr12	14613602	14615320	1718	859.0	
61655	chr12	14619033	14619307	274	137.0	
61656	chr12	14621790	14622390	600	300.0	
61657	chr12	14630016	14630571	555	278.0	
61658	chr12	14643294	14644725	1431	716.0	
61659	chr12	14664420	14664879	459	230.0	
61660	chr12	14691344	14692063	719	360.0	
61661	chr12	14716763	14717244	481	240.0	
61662	chr12	14723605	14724316	711	356.0	
61663	chr12	14756429	14756660	231	116.0	
61664	chr12	14766853	14768129	1276	638.0	
61665	chr12	14768797	14772476	3679	1840.0	
61666	chr12	14773546	14776040	2494	1247.0	
61667	chr12	14776550	14776975	425	212.0	
61668	chr12	14780640	14780649	9	4.0	
61669	chr12	14802451	14804478	2027	1014.0	
61670	chr12	14828900	14829301	401	200.0	
61671	chr12	14845210	14845873	663	332.0	
61672	chr12	14884290	14885089	799	400.0	
61673	chr12	14885928	14886311	383	192.0	
61674	chr12	14920758	14921140	382	191.0	
61675	chr12	14937638	14938148	510	255.0	
61676	chr12	14939174	14939668	494	247.0	
61677	chr12	14947930	14954809	6879	3440.0	
61678	chr12	14955842	14963077	7235	3618.0	
61679	chr12	14975453	14975942	489	244.0	
61680	chr12	14976647	14976822	175	88.0	
61681	chr12	14979514	14979829	315	158.0	
61682	chr12	14980843	14983447	2604	1302.0	
61683	chr12	14988028	14988526	498	249.0	
61684	chr12	14989557	14990184	627	314.0	
61685	chr12	14993765	14994166	401	200.0	
61686	chr12	14995553	14996270	717	358.0	
61687	chr12	15220911	15221817	906	453.0	
61688	chr12	15268912	15269352	440	220.0	
61689	chr12	15276105	15276428	323	162.0	
61690	chr12	15279271	15279694	423	212.0	
61691	chr12	15497634	15498129	495	248.0	
61692	chr12	15522581	15522958	377	188.0	
61693	chr12	15525993	15526409	416	208.0	
61694	chr12	15527007	15527679	672	336.0	
61695	chr12	15532325	15532941	616	308.0	
61696	chr12	15534209	15535494	1285	642.0	
61697	chr12	15544526	15546933	2407	1204.0	
61698	chr12	15547738	15548007	269	134.0	
61699	chr12	15562220	15562706	486	243.0	
61700	chr12	15563552	15564345	793	396.0	
61701	chr12	15570884	15571782	898	449.0	
61702	chr12	15584413	15584847	434	217.0	
61703	chr12	15590038	15590963	925	462.0	
61704	chr12	15601225	15601595	370	185.0	
61705	chr12	15688104	15689026	922	461.0	
61706	chr12	15700502	15701014	512	256.0	
61707	chr12	15701597	15701986	389	194.0	
61708	chr12	15725994	15726340	346	173.0	
61709	chr12	15788105	15790380	2275	1138.0	
61710	chr12	15856338	15856832	494	247.0	
61711	chr12	15863885	15864451	566	283.0	
61712	chr12	15875710	15875866	156	78.0	
61713	chr12	15881438	15883813	2375	1188.0	
61714	chr12	15899221	15899733	512	256.0	
61715	chr12	15910695	15912068	1373	686.0	
61716	chr12	15931788	15931822	34	17.0	
61717	chr12	16148896	16149285	389	194.0	
61718	chr12	16156073	16156253	180	90.0	
61719	chr12	16198876	16199257	381	190.0	
61720	chr12	16347225	16349560	2335	1168.0	
61721	chr12	16353701	16354023	322	161.0	
61722	chr12	16359516	16360278	762	381.0	
61723	chr12	16389594	16390067	473	236.0	
61724	chr12	16393058	16393572	514	257.0	
61725	chr12	16407289	16407811	522	261.0	
61726	chr12	16573646	16573923	277	138.0	
61727	chr12	18139333	18139402	69	34.0	
61728	chr12	18145968	18146818	850	425.0	
61729	chr12	18165582	18165923	341	170.0	
61730	chr12	18683553	18684036	483	242.0	
61731	chr12	18811355	18811663	308	154.0	
61732	chr12	18823492	18824589	1097	548.0	
61733	chr12	18841123	18841354	231	116.0	
61734	chr12	19048993	19049339	346	173.0	
61735	chr12	19125609	19125763	154	77.0	
61736	chr12	19129116	19131394	2278	1139.0	
61737	chr12	19190394	19191198	804	402.0	
61738	chr12	19236727	19236981	254	127.0	
61739	chr12	19273701	19274400	699	350.0	
61740	chr12	19404057	19404856	799	400.0	
61741	chr12	19428291	19428491	200	100.0	
61742	chr12	19434543	19434847	304	152.0	
61743	chr12	19437369	19437829	460	230.0	
61744	chr12	19438876	19441304	2428	1214.0	
61745	chr12	19482357	19483352	995	498.0	
61746	chr12	19573045	19573179	134	67.0	
61747	chr12	19678397	19679020	623	312.0	
61748	chr12	19761405	19761923	518	259.0	
61749	chr12	19894193	19894330	137	68.0	
61750	chr12	19908754	19909758	1004	502.0	
61751	chr12	19915795	19915836	41	20.0	
61752	chr12	19921753	19922115	362	181.0	
61753	chr12	19967577	19967887	310	155.0	
61754	chr12	20187496	20187817	321	160.0	
61755	chr12	20210465	20211294	829	414.0	
61756	chr12	20280756	20280861	105	52.0	
61757	chr12	20368086	20369931	1845	922.0	
61758	chr12	20398742	20399145	403	202.0	
61759	chr12	20404849	20405422	573	286.0	
61760	chr12	20492082	20492774	692	346.0	
61761	chr12	21296767	21296996	229	114.0	
61762	chr12	21437191	21438615	1424	712.0	
61763	chr12	21453399	21453802	403	202.0	
61764	chr12	21456151	21456962	811	406.0	
61765	chr12	21500767	21502595	1828	914.0	
61766	chr12	21509658	21510146	488	244.0	
61767	chr12	21527322	21528339	1017	508.0	
61768	chr12	21607679	21608289	610	305.0	
61769	chr12	21614055	21615883	1828	914.0	
61770	chr12	21656628	21658647	2019	1010.0	
61771	chr12	21659419	21659758	339	170.0	
61772	chr12	21676706	21678158	1452	726.0	
61773	chr12	21678986	21679053	67	34.0	
61774	chr12	21680145	21680792	647	324.0	
61775	chr12	21690782	21691064	282	141.0	
61776	chr12	21697820	21698229	409	204.0	
61777	chr12	22042921	22043379	458	229.0	
61778	chr12	22045820	22047265	1445	722.0	
61779	chr12	22048022	22048329	307	154.0	
61780	chr12	22083173	22083615	442	221.0	
61781	chr12	22100892	22102195	1303	652.0	
61782	chr12	22160638	22160671	33	16.0	
61783	chr12	22164035	22164665	630	315.0	
61784	chr12	22287928	22288454	526	263.0	
61785	chr12	22318124	22318569	445	222.0	
61786	chr12	22321504	22322131	627	314.0	
61787	chr12	22332807	22336244	3437	1718.0	
61788	chr12	22340096	22340746	650	325.0	
61789	chr12	22348186	22348671	485	242.0	
61790	chr12	22360764	22361193	429	214.0	
61791	chr12	22374494	22374897	403	202.0	
61792	chr12	22396089	22397087	998	499.0	
61793	chr12	22408842	22410739	1897	948.0	
61794	chr12	22443180	22443868	688	344.0	
61795	chr12	22459810	22460278	468	234.0	
61796	chr12	22529215	22529721	506	253.0	
61797	chr12	22535573	22535883	310	155.0	
61798	chr12	22538888	22539637	749	374.0	
61799	chr12	22541493	22541918	425	212.0	
61800	chr12	22543178	22545174	1996	998.0	
61801	chr12	22549447	22550047	600	300.0	
61802	chr12	22624474	22627668	3194	1597.0	
61803	chr12	22631464	22632245	781	390.0	
61804	chr12	22653144	22653264	120	60.0	
61805	chr12	22677805	22678972	1167	584.0	
61806	chr12	22684491	22685005	514	257.0	
61807	chr12	22687066	22688104	1038	519.0	
61808	chr12	22691398	22691457	59	30.0	
61809	chr12	22729731	22730492	761	380.0	
61810	chr12	22755762	22755776	14	7.0	
61811	chr12	23205120	23205583	463	232.0	
61812	chr12	24172025	24172418	393	196.0	
61813	chr12	24378980	24378998	18	9.0	
61814	chr12	24405911	24406190	279	140.0	
61815	chr12	24414560	24414818	258	129.0	
61816	chr12	24561682	24563457	1775	888.0	
61817	chr12	24584040	24584345	305	152.0	
61818	chr12	24661462	24662288	826	413.0	
61819	chr12	24664215	24664639	424	212.0	
61820	chr12	24679228	24679559	331	166.0	
61821	chr12	24705635	24706200	565	282.0	
61822	chr12	24719318	24719874	556	278.0	
61823	chr12	24740324	24741055	731	366.0	
61824	chr12	24742239	24742902	663	332.0	
61825	chr12	24795515	24796344	829	414.0	
61826	chr12	24798477	24798633	156	78.0	
61827	chr12	24814157	24815146	989	494.0	
61828	chr12	24836343	24836770	427	214.0	
61829	chr12	24838430	24839749	1319	660.0	
61830	chr12	24898126	24898824	698	349.0	
61831	chr12	24900504	24901496	992	496.0	
61832	chr12	24902108	24904149	2041	1020.0	
61833	chr12	24909483	24910225	742	371.0	
61834	chr12	24922120	24922579	459	230.0	
61835	chr12	24931554	24932134	580	290.0	
61836	chr12	24948274	24949567	1293	646.0	
61837	chr12	24951850	24952331	481	240.0	
61838	chr12	24960182	24960671	489	244.0	
61839	chr12	24966944	24967408	464	232.0	
61840	chr12	24977047	24977634	587	294.0	
61841	chr12	24979187	24979757	570	285.0	
61842	chr12	24991222	24991933	711	356.0	
61843	chr12	24996150	24996388	238	119.0	
61844	chr12	24998012	24998600	588	294.0	
61845	chr12	25005438	25005684	246	123.0	
61846	chr12	25020664	25020993	329	164.0	
61847	chr12	25039133	25039577	444	222.0	
61848	chr12	25051046	25053334	2288	1144.0	
61849	chr12	25054243	25055165	922	461.0	
61850	chr12	25055931	25058002	2071	1036.0	
61851	chr12	25069274	25069580	306	153.0	
61852	chr12	25072977	25073700	723	362.0	
61853	chr12	25130728	25131045	317	158.0	
61854	chr12	25155056	25155513	457	228.0	
61855	chr12	25156141	25156183	42	21.0	
61856	chr12	25157707	25158103	396	198.0	
61857	chr12	25186425	25187431	1006	503.0	
61858	chr12	25194512	25196950	2438	1219.0	
61859	chr12	25202372	25202377	5	2.0	
61860	chr12	25210887	25211287	400	200.0	
61861	chr12	25241115	25241971	856	428.0	
61862	chr12	25249365	25252012	2647	1324.0	
61863	chr12	25253266	25254128	862	431.0	
61864	chr12	25269673	25270059	386	193.0	
61865	chr12	25320048	25320400	352	176.0	
61866	chr12	25322297	25323113	816	408.0	
61867	chr12	25323700	25324136	436	218.0	
61868	chr12	25333569	25334567	998	499.0	
61869	chr12	25365034	25365349	315	158.0	
61870	chr12	25376975	25378231	1256	628.0	
61871	chr12	25381986	25388651	6665	3332.0	
61872	chr12	25436258	25436682	424	212.0	
61873	chr12	25459434	25459925	491	246.0	
61874	chr12	25595689	25595818	129	64.0	
61875	chr12	25859949	25860459	510	255.0	
61876	chr12	25958237	25959248	1011	506.0	
61877	chr12	25960194	25960563	369	184.0	
61878	chr12	26080941	26081249	308	154.0	
61879	chr12	26096975	26097476	501	250.0	
61880	chr12	26113631	26115147	1516	758.0	
61881	chr12	26118433	26118597	164	82.0	
61882	chr12	26119393	26119794	401	200.0	
61883	chr12	26121651	26123764	2113	1056.0	
61884	chr12	26124512	26126958	2446	1223.0	
61885	chr12	26130528	26131318	790	395.0	
61886	chr12	26156097	26156951	854	427.0	
61887	chr12	26195426	26196225	799	400.0	
61888	chr12	26274323	26275624	1301	650.0	
61889	chr12	26298639	26299688	1049	524.0	
61890	chr12	26327967	26328598	631	316.0	
61891	chr12	26334821	26334980	159	80.0	
61892	chr12	26340529	26341180	651	326.0	
61893	chr12	26360178	26360496	318	159.0	
61894	chr12	26434330	26434692	362	181.0	
61895	chr12	26469956	26470016	60	30.0	
61896	chr12	26471284	26472212	928	464.0	
61897	chr12	26473217	26473768	551	276.0	
61898	chr12	26520240	26520532	292	146.0	
61899	chr12	26523564	26524255	691	346.0	
61900	chr12	26525075	26525214	139	70.0	
61901	chr12	26651546	26651981	435	218.0	
61902	chr12	26701863	26701941	78	39.0	
61903	chr12	26704994	26705452	458	229.0	
61904	chr12	26731949	26732615	666	333.0	
61905	chr12	26750564	26751047	483	242.0	
61906	chr12	26770371	26770736	365	182.0	
61907	chr12	26783217	26783220	3	2.0	
61908	chr12	26791006	26792007	1001	500.0	
61909	chr12	26817101	26817621	520	260.0	
61910	chr12	26830730	26834826	4096	2048.0	
61911	chr12	26845053	26845452	399	200.0	
61912	chr12	26846356	26846782	426	213.0	
61913	chr12	26853334	26854397	1063	532.0	
61914	chr12	26867096	26867400	304	152.0	
61915	chr12	26874372	26874929	557	278.0	
61916	chr12	26878796	26879132	336	168.0	
61917	chr12	26884635	26885589	954	477.0	
61918	chr12	26931964	26932682	718	359.0	
61919	chr12	26935631	26941689	6058	3029.0	
61920	chr12	26942249	26942251	2	1.0	
61921	chr12	26953314	26954002	688	344.0	
61922	chr12	26971877	26972411	534	267.0	
61923	chr12	26976710	26977070	360	180.0	
61924	chr12	26987583	26988071	488	244.0	
61925	chr12	26997536	26998116	580	290.0	
61926	chr12	27001233	27002089	856	428.0	
61927	chr12	27008164	27008441	277	138.0	
61928	chr12	27009919	27010358	439	220.0	
61929	chr12	27013503	27016152	2649	1324.0	
61930	chr12	27021332	27023534	2202	1101.0	
61931	chr12	27039443	27039867	424	212.0	
61932	chr12	27064530	27065038	508	254.0	
61933	chr12	27089298	27089706	408	204.0	
61934	chr12	27094749	27095160	411	206.0	
61935	chr12	27123648	27123963	315	158.0	
61936	chr12	27142059	27142533	474	237.0	
61937	chr12	27143476	27143845	369	184.0	
61938	chr12	27176689	27177180	491	246.0	
61939	chr12	27179544	27181335	1791	896.0	
61940	chr12	27185474	27185767	293	146.0	
61941	chr12	27220290	27220617	327	164.0	
61942	chr12	27221651	27222430	779	390.0	
61943	chr12	27225839	27226356	517	258.0	
61944	chr12	27229354	27229806	452	226.0	
61945	chr12	27236419	27236985	566	283.0	
61946	chr12	27237746	27239008	1262	631.0	
61947	chr12	27243396	27245564	2168	1084.0	
61948	chr12	27250911	27251286	375	188.0	
61949	chr12	27261014	27261043	29	14.0	
61950	chr12	27279734	27280174	440	220.0	
61951	chr12	27306268	27306350	82	41.0	
61952	chr12	27331157	27333974	2817	1408.0	
61953	chr12	27383971	27384397	426	213.0	
61954	chr12	27431227	27431631	404	202.0	
61955	chr12	27434864	27435546	682	341.0	
61956	chr12	27437815	27438268	453	226.0	
61957	chr12	27523093	27525808	2715	1358.0	
61958	chr12	27534221	27534966	745	372.0	
61959	chr12	27549219	27550365	1146	573.0	
61960	chr12	27652178	27652562	384	192.0	
61961	chr12	27703558	27704291	733	366.0	
61962	chr12	27710054	27712417	2363	1182.0	
61963	chr12	27733045	27733446	401	200.0	
61964	chr12	27779376	27781120	1744	872.0	
61965	chr12	27786054	27786293	239	120.0	
61966	chr12	27807277	27807278	1	0.0	
61967	chr12	27821154	27822772	1618	809.0	
61968	chr12	27940771	27941147	376	188.0	
61969	chr12	27969920	27970448	528	264.0	
61970	chr12	28189714	28192168	2454	1227.0	
61971	chr12	28222078	28223634	1556	778.0	
61972	chr12	28253103	28253742	639	320.0	
61973	chr12	28294467	28294576	109	54.0	
61974	chr12	28543133	28543698	565	282.0	
61975	chr12	28583948	28584054	106	53.0	
61976	chr12	28770452	28770659	207	104.0	
61977	chr12	28799287	28800581	1294	647.0	
61978	chr12	28870822	28871255	433	216.0	
61979	chr12	29065209	29065529	320	160.0	
61980	chr12	29066187	29066614	427	214.0	
61981	chr12	29067396	29067893	497	248.0	
61982	chr12	29073559	29074094	535	268.0	
61983	chr12	29088580	29088937	357	178.0	
61984	chr12	29102875	29105128	2253	1126.0	
61985	chr12	29148078	29150292	2214	1107.0	
61986	chr12	29152180	29152834	654	327.0	
61987	chr12	29158116	29158943	827	414.0	
61988	chr12	29159614	29160809	1195	598.0	
61989	chr12	29164336	29165459	1123	562.0	
61990	chr12	29169945	29171227	1282	641.0	
61991	chr12	29176876	29177327	451	226.0	
61992	chr12	29204488	29204950	462	231.0	
61993	chr12	29206995	29208473	1478	739.0	
61994	chr12	29223467	29223716	249	124.0	
61995	chr12	29241786	29243404	1618	809.0	
61996	chr12	29254956	29255721	765	382.0	
61997	chr12	29317540	29318318	778	389.0	
61998	chr12	29380295	29381891	1596	798.0	
61999	chr12	29390400	29390852	452	226.0	
62000	chr12	29427909	29429203	1294	647.0	
62001	chr12	29435452	29435921	469	234.0	
62002	chr12	29552339	29552755	416	208.0	
62003	chr12	29559185	29559507	322	161.0	
62004	chr12	29574575	29574871	296	148.0	
62005	chr12	29691316	29691949	633	316.0	
62006	chr12	29694118	29694368	250	125.0	
62007	chr12	29782347	29784569	2222	1111.0	
62008	chr12	30679212	30679613	401	200.0	
62009	chr12	30694016	30696716	2700	1350.0	
62010	chr12	30753275	30755768	2493	1246.0	
62011	chr12	30795090	30796901	1811	906.0	
62012	chr12	30807344	30807862	518	259.0	
62013	chr12	30822232	30823599	1367	684.0	
62014	chr12	30844434	30844964	530	265.0	
62015	chr12	30846970	30847642	672	336.0	
62016	chr12	30851015	30852186	1171	586.0	
62017	chr12	31073179	31074941	1762	881.0	
62018	chr12	31116954	31119917	2963	1482.0	
62019	chr12	31238752	31239183	431	216.0	
62020	chr12	31271833	31272470	637	318.0	
62021	chr12	31300589	31300726	137	68.0	
62022	chr12	31303440	31303772	332	166.0	
62023	chr12	31316955	31320469	3514	1757.0	
62024	chr12	31322728	31328053	5325	2662.0	
62025	chr12	31354353	31354499	146	73.0	
62026	chr12	31362316	31363513	1197	598.0	
62027	chr12	31370505	31370899	394	197.0	
62028	chr12	31403014	31403712	698	349.0	
62029	chr12	31589638	31591801	2163	1082.0	
62030	chr12	31599039	31599517	478	239.0	
62031	chr12	31603414	31603980	566	283.0	
62032	chr12	31631797	31632208	411	206.0	
62033	chr12	31636208	31637438	1230	615.0	
62034	chr12	31645904	31646388	484	242.0	
62035	chr12	31647178	31647567	389	194.0	
62036	chr12	31652147	31652208	61	30.0	
62037	chr12	31652714	31654010	1296	648.0	
62038	chr12	31658579	31660230	1651	826.0	
62039	chr12	31682040	31682692	652	326.0	
62040	chr12	31686877	31687809	932	466.0	
62041	chr12	31715043	31715949	906	453.0	
62042	chr12	31721754	31723926	2172	1086.0	
62043	chr12	31727164	31727560	396	198.0	
62044	chr12	31728065	31730035	1970	985.0	
62045	chr12	31731892	31732264	372	186.0	
62046	chr12	31732896	31734124	1228	614.0	
62047	chr12	31736264	31737087	823	412.0	
62048	chr12	31738584	31738929	345	172.0	
62049	chr12	31742846	31743384	538	269.0	
62050	chr12	31746508	31747290	782	391.0	
62051	chr12	31748899	31750331	1432	716.0	
62052	chr12	31751707	31752993	1286	643.0	
62053	chr12	31765903	31766304	401	200.0	
62054	chr12	31773990	31774235	245	122.0	
62055	chr12	31783844	31784423	579	290.0	
62056	chr12	31807094	31807757	663	332.0	
62057	chr12	31811118	31811340	222	111.0	
62058	chr12	31832560	31833694	1134	567.0	
62059	chr12	31853462	31854217	755	378.0	
62060	chr12	31859546	31860149	603	302.0	
62061	chr12	31874796	31875826	1030	515.0	
62062	chr12	31876534	31877044	510	255.0	
62063	chr12	31886954	31887681	727	364.0	
62064	chr12	31890489	31891488	999	500.0	
62065	chr12	31896042	31898248	2206	1103.0	
62066	chr12	31906478	31907130	652	326.0	
62067	chr12	31928448	31929289	841	420.0	
62068	chr12	31932061	31932832	771	386.0	
62069	chr12	31958563	31961551	2988	1494.0	
62070	chr12	31964822	31968591	3769	1884.0	
62071	chr12	31969167	31969600	433	216.0	
62072	chr12	32025843	32026411	568	284.0	
62073	chr12	32027960	32028338	378	189.0	
62074	chr12	32060478	32061020	542	271.0	
62075	chr12	32106103	32108022	1919	960.0	
62076	chr12	32115735	32116045	310	155.0	
62077	chr12	32134368	32135001	633	316.0	
62078	chr12	32138946	32140291	1345	672.0	
62079	chr12	32217537	32218131	594	297.0	
62080	chr12	32264970	32265360	390	195.0	
62081	chr12	32265904	32266342	438	219.0	
62082	chr12	32273307	32274185	878	439.0	
62083	chr12	32292175	32292527	352	176.0	
62084	chr12	32302196	32302597	401	200.0	
62085	chr12	32312020	32312520	500	250.0	
62086	chr12	32365415	32365872	457	228.0	
62087	chr12	32373811	32374561	750	375.0	
62088	chr12	32390555	32391253	698	349.0	
62089	chr12	32399006	32400250	1244	622.0	
62090	chr12	32402919	32403547	628	314.0	
62091	chr12	32422709	32423137	428	214.0	
62092	chr12	32455508	32456184	676	338.0	
62093	chr12	32475858	32475873	15	8.0	
62094	chr12	32476426	32476757	331	166.0	
62095	chr12	32481358	32482749	1391	696.0	
62096	chr12	32483401	32483995	594	297.0	
62097	chr12	32485292	32486628	1336	668.0	
62098	chr12	32494655	32495093	438	219.0	
62099	chr12	32497844	32498350	506	253.0	
62100	chr12	32507531	32508083	552	276.0	
62101	chr12	32516204	32516622	418	209.0	
62102	chr12	32521142	32521720	578	289.0	
62103	chr12	32522339	32523392	1053	526.0	
62104	chr12	32534054	32536132	2078	1039.0	
62105	chr12	32558733	32559409	676	338.0	
62106	chr12	32587571	32587971	400	200.0	
62107	chr12	32589120	32590010	890	445.0	
62108	chr12	32600669	32601042	373	186.0	
62109	chr12	32657584	32657972	388	194.0	
62110	chr12	32671931	32672299	368	184.0	
62111	chr12	32674417	32675375	958	479.0	
62112	chr12	32678737	32680333	1596	798.0	
62113	chr12	32681300	32681366	66	33.0	
62114	chr12	32754462	32756854	2392	1196.0	
62115	chr12	32761637	32762177	540	270.0	
62116	chr12	32894908	32894911	3	2.0	
62117	chr12	32895658	32897386	1728	864.0	
62118	chr12	32899412	32899983	571	286.0	
62119	chr12	32920775	32920797	22	11.0	
62120	chr12	33529745	33530261	516	258.0	
62121	chr12	33587935	33588814	879	440.0	
62122	chr12	34021215	34023190	1975	988.0	
62123	chr12	34123005	34123489	484	242.0	
62124	chr12	34126077	34126896	819	410.0	
62125	chr12	34218248	34219584	1336	668.0	
62126	chr12	34685850	34686218	368	184.0	
62127	chr12	34688477	34688886	409	204.0	
62128	chr12	34693214	34694069	855	428.0	
62129	chr12	34699626	34699634	8	4.0	
62130	chr12	37622576	37622779	203	102.0	
62131	chr12	38138241	38139298	1057	528.0	
62132	chr12	38316026	38317499	1473	736.0	
62133	chr12	38328331	38328638	307	154.0	
62134	chr12	38350655	38351196	541	270.0	
62135	chr12	38386511	38387082	571	286.0	
62136	chr12	38392439	38393060	621	310.0	
62137	chr12	38586927	38587973	1046	523.0	
62138	chr12	38771802	38772390	588	294.0	
62139	chr12	38903497	38903890	393	196.0	
62140	chr12	38904409	38907386	2977	1488.0	
62141	chr12	38921055	38921425	370	185.0	
62142	chr12	39067847	39068321	474	237.0	
62143	chr12	39103506	39103977	471	236.0	
62144	chr12	39273150	39273564	414	207.0	
62145	chr12	39287765	39288180	415	208.0	
62146	chr12	39318201	39318597	396	198.0	
62147	chr12	39331548	39332303	755	378.0	
62148	chr12	39372792	39373493	701	350.0	
62149	chr12	39441768	39444383	2615	1308.0	
62150	chr12	39467302	39468028	726	363.0	
62151	chr12	39587208	39587677	469	234.0	
62152	chr12	39616447	39616638	191	96.0	
62153	chr12	39617952	39621795	3843	1922.0	
62154	chr12	39622298	39622743	445	222.0	
62155	chr12	39628838	39629313	475	238.0	
62156	chr12	39669328	39670111	783	392.0	
62157	chr12	39683023	39683907	884	442.0	
62158	chr12	39692230	39692618	388	194.0	
62159	chr12	39764983	39765355	372	186.0	
62160	chr12	39990453	39990923	470	235.0	
62161	chr12	40010917	40011966	1049	524.0	
62162	chr12	40104757	40108220	3463	1732.0	
62163	chr12	40137166	40137731	565	282.0	
62164	chr12	40144228	40144352	124	62.0	
62165	chr12	40146897	40147849	952	476.0	
62166	chr12	40152751	40153735	984	492.0	
62167	chr12	40158380	40159246	866	433.0	
62168	chr12	40168996	40169075	79	40.0	
62169	chr12	40171546	40171851	305	152.0	
62170	chr12	40192512	40193130	618	309.0	
62171	chr12	40194832	40195526	694	347.0	
62172	chr12	40202127	40202440	313	156.0	
62173	chr12	40208598	40209478	880	440.0	
62174	chr12	40216860	40217331	471	236.0	
62175	chr12	40222295	40222685	390	195.0	
62176	chr12	40223702	40225351	1649	824.0	
62177	chr12	40226133	40227285	1152	576.0	
62178	chr12	40261960	40262298	338	169.0	
62179	chr12	40325347	40325696	349	174.0	
62180	chr12	41277238	41277422	184	92.0	
62181	chr12	41339722	41340279	557	278.0	
62182	chr12	41521925	41522588	663	332.0	
62183	chr12	41604712	41605220	508	254.0	
62184	chr12	41653653	41654296	643	322.0	
62185	chr12	41697144	41697525	381	190.0	
62186	chr12	41908324	41908516	192	96.0	
62187	chr12	41931596	41933144	1548	774.0	
62188	chr12	42021608	42021785	177	88.0	
62189	chr12	42023925	42024641	716	358.0	
62190	chr12	42056007	42056623	616	308.0	
62191	chr12	42094107	42094687	580	290.0	
62192	chr12	42097797	42098587	790	395.0	
62193	chr12	42125308	42125764	456	228.0	
62194	chr12	42129575	42130029	454	227.0	
62195	chr12	42135267	42135583	316	158.0	
62196	chr12	42141972	42142408	436	218.0	
62197	chr12	42143326	42145866	2540	1270.0	
62198	chr12	42172977	42173117	140	70.0	
62199	chr12	42181292	42181472	180	90.0	
62200	chr12	42235767	42235800	33	16.0	
62201	chr12	42237115	42239364	2249	1124.0	
62202	chr12	42283789	42284490	701	350.0	
62203	chr12	42299578	42300117	539	270.0	
62204	chr12	42324962	42327414	2452	1226.0	
62205	chr12	42330032	42330525	493	246.0	
62206	chr12	42332098	42332731	633	316.0	
62207	chr12	42372117	42372642	525	262.0	
62208	chr12	42382031	42382750	719	360.0	
62209	chr12	42426790	42427145	355	178.0	
62210	chr12	42468572	42469955	1383	692.0	
62211	chr12	42482658	42484757	2099	1050.0	
62212	chr12	42585808	42586190	382	191.0	
62213	chr12	42589035	42590543	1508	754.0	
62214	chr12	42631620	42631869	249	124.0	
62215	chr12	42695607	42695833	226	113.0	
62216	chr12	42696829	42697098	269	134.0	
62217	chr12	42698127	42698761	634	317.0	
62218	chr12	43676209	43676531	322	161.0	
62219	chr12	43758055	43760512	2457	1228.0	
62220	chr12	43761780	43761791	11	6.0	
62221	chr12	43776494	43776890	396	198.0	
62222	chr12	43805288	43807559	2271	1136.0	
62223	chr12	43831373	43833032	1659	830.0	
62224	chr12	43835219	43836999	1780	890.0	
62225	chr12	43882511	43882981	470	235.0	
62226	chr12	43957757	43958112	355	178.0	
62227	chr12	44508793	44509124	331	166.0	
62228	chr12	44774791	44775245	454	227.0	
62229	chr12	44812039	44812484	445	222.0	
62230	chr12	44827684	44828594	910	455.0	
62231	chr12	44835811	44836247	436	218.0	
62232	chr12	44847407	44848973	1566	783.0	
62233	chr12	44863822	44864316	494	247.0	
62234	chr12	44873893	44877298	3405	1702.0	
62235	chr12	44930961	44931399	438	219.0	
62236	chr12	44948622	44949184	562	281.0	
62237	chr12	45131011	45131109	98	49.0	
62238	chr12	45170420	45170900	480	240.0	
62239	chr12	45184166	45185017	851	426.0	
62240	chr12	45191502	45192772	1270	635.0	
62241	chr12	45200128	45201174	1046	523.0	
62242	chr12	45204776	45206450	1674	837.0	
62243	chr12	45214866	45217491	2625	1312.0	
62244	chr12	45234558	45234770	212	106.0	
62245	chr12	45244283	45245375	1092	546.0	
62246	chr12	45257100	45257760	660	330.0	
62247	chr12	45269103	45269248	145	72.0	
62248	chr12	45415336	45415799	463	232.0	
62249	chr12	45435851	45436480	629	314.0	
62250	chr12	45469891	45470292	401	200.0	
62251	chr12	45509160	45509641	481	240.0	
62252	chr12	45518329	45519107	778	389.0	
62253	chr12	45543726	45544268	542	271.0	
62254	chr12	45556838	45557503	665	332.0	
62255	chr12	45575387	45576454	1067	534.0	
62256	chr12	45577124	45577664	540	270.0	
62257	chr12	45622249	45622678	429	214.0	
62258	chr12	45644470	45644925	455	228.0	
62259	chr12	45655154	45656164	1010	505.0	
62260	chr12	45660319	45660707	388	194.0	
62261	chr12	45668846	45669690	844	422.0	
62262	chr12	45670263	45670958	695	348.0	
62263	chr12	45725439	45731521	6082	3041.0	
62264	chr12	45732162	45732688	526	263.0	
62265	chr12	45745865	45746358	493	246.0	
62266	chr12	45762489	45762886	397	198.0	
62267	chr12	45878626	45879440	814	407.0	
62268	chr12	45908054	45908327	273	136.0	
62269	chr12	45914283	45914296	13	6.0	
62270	chr12	45983912	45985348	1436	718.0	
62271	chr12	45986481	45987368	887	444.0	
62272	chr12	45989256	45992530	3274	1637.0	
62273	chr12	46005227	46005336	109	54.0	
62274	chr12	46072053	46072632	579	290.0	
62275	chr12	46108616	46109184	568	284.0	
62276	chr12	46124831	46125727	896	448.0	
62277	chr12	46153264	46153653	389	194.0	
62278	chr12	46174269	46174736	467	234.0	
62279	chr12	46177088	46178565	1477	738.0	
62280	chr12	46180134	46180344	210	105.0	
62281	chr12	46181660	46182322	662	331.0	
62282	chr12	46184848	46185348	500	250.0	
62283	chr12	46187229	46187396	167	84.0	
62284	chr12	46207661	46208022	361	180.0	
62285	chr12	46209236	46211547	2311	1156.0	
62286	chr12	46212536	46212744	208	104.0	
62287	chr12	46214606	46216965	2359	1180.0	
62288	chr12	46217649	46220721	3072	1536.0	
62289	chr12	46221637	46223418	1781	890.0	
62290	chr12	46224213	46224706	493	246.0	
62291	chr12	46227547	46228056	509	254.0	
62292	chr12	46230241	46230630	389	194.0	
62293	chr12	46237327	46237840	513	256.0	
62294	chr12	46244128	46244479	351	176.0	
62295	chr12	46245973	46246842	869	434.0	
62296	chr12	46256573	46256952	379	190.0	
62297	chr12	46259890	46259952	62	31.0	
62298	chr12	46264073	46264306	233	116.0	
62299	chr12	46264965	46270800	5835	2918.0	
62300	chr12	46302971	46303487	516	258.0	
62301	chr12	46342488	46342980	492	246.0	
62302	chr12	46354058	46354889	831	416.0	
62303	chr12	46355458	46362180	6722	3361.0	
62304	chr12	46362858	46363237	379	190.0	
62305	chr12	46365247	46366291	1044	522.0	
62306	chr12	46367369	46369694	2325	1162.0	
62307	chr12	46370652	46374476	3824	1912.0	
62308	chr12	46382560	46384684	2124	1062.0	
62309	chr12	46386830	46388905	2075	1038.0	
62310	chr12	46399402	46399895	493	246.0	
62311	chr12	46430346	46430876	530	265.0	
62312	chr12	46450210	46450757	547	274.0	
62313	chr12	46458617	46460811	2194	1097.0	
62314	chr12	46469958	46470457	499	250.0	
62315	chr12	46473546	46474080	534	267.0	
62316	chr12	46487363	46488338	975	488.0	
62317	chr12	46517170	46517739	569	284.0	
62318	chr12	46523748	46524491	743	372.0	
62319	chr12	46536239	46536673	434	217.0	
62320	chr12	46546860	46547187	327	164.0	
62321	chr12	46549584	46550437	853	426.0	
62322	chr12	46553366	46553518	152	76.0	
62323	chr12	46562186	46563212	1026	513.0	
62324	chr12	46585756	46586249	493	246.0	
62325	chr12	46609281	46609617	336	168.0	
62326	chr12	46660692	46661827	1135	568.0	
62327	chr12	46664639	46665387	748	374.0	
62328	chr12	46677820	46678117	297	148.0	
62329	chr12	46926524	46926920	396	198.0	
62330	chr12	46983953	46984345	392	196.0	
62331	chr12	47021202	47021666	464	232.0	
62332	chr12	47032504	47033194	690	345.0	
62333	chr12	47054591	47055053	462	231.0	
62334	chr12	47071237	47071713	476	238.0	
62335	chr12	47078678	47081612	2934	1467.0	
62336	chr12	47082243	47083301	1058	529.0	
62337	chr12	47084328	47084563	235	118.0	
62338	chr12	47085144	47086276	1132	566.0	
62339	chr12	47131537	47132141	604	302.0	
62340	chr12	47138901	47139740	839	420.0	
62341	chr12	47156097	47156501	404	202.0	
62342	chr12	47160757	47161141	384	192.0	
62343	chr12	47190418	47194415	3997	1998.0	
62344	chr12	47205884	47208998	3114	1557.0	
62345	chr12	47211565	47212837	1272	636.0	
62346	chr12	47213792	47218920	5128	2564.0	
62347	chr12	47220741	47220772	31	16.0	
62348	chr12	47222750	47224038	1288	644.0	
62349	chr12	47229457	47230002	545	272.0	
62350	chr12	47238149	47238602	453	226.0	
62351	chr12	47269003	47269387	384	192.0	
62352	chr12	47276382	47278519	2137	1068.0	
62353	chr12	47306674	47308211	1537	768.0	
62354	chr12	47312726	47313214	488	244.0	
62355	chr12	47317047	47317701	654	327.0	
62356	chr12	47321464	47321807	343	172.0	
62357	chr12	47349665	47350392	727	364.0	
62358	chr12	47355940	47356875	935	468.0	
62359	chr12	47359670	47362706	3036	1518.0	
62360	chr12	47364049	47364072	23	12.0	
62361	chr12	47367862	47368485	623	312.0	
62362	chr12	47379195	47379293	98	49.0	
62363	chr12	47390880	47392234	1354	677.0	
62364	chr12	47392989	47393500	511	256.0	
62365	chr12	47394140	47394996	856	428.0	
62366	chr12	47396941	47398127	1186	593.0	
62367	chr12	47401043	47401764	721	360.0	
62368	chr12	47408155	47408748	593	296.0	
62369	chr12	47410434	47410784	350	175.0	
62370	chr12	47426785	47427391	606	303.0	
62371	chr12	47608609	47609186	577	288.0	
62372	chr12	47637145	47637525	380	190.0	
62373	chr12	47651366	47652840	1474	737.0	
62374	chr12	47686637	47687021	384	192.0	
62375	chr12	47698056	47698475	419	210.0	
62376	chr12	47705097	47707272	2175	1088.0	
62377	chr12	47707832	47708393	561	280.0	
62378	chr12	47709601	47710713	1112	556.0	
62379	chr12	47714789	47715912	1123	562.0	
62380	chr12	47717406	47718272	866	433.0	
62381	chr12	47721229	47722095	866	433.0	
62382	chr12	47732491	47732859	368	184.0	
62383	chr12	47740023	47742846	2823	1412.0	
62384	chr12	47743944	47744427	483	242.0	
62385	chr12	47747162	47747512	350	175.0	
62386	chr12	47750426	47750862	436	218.0	
62387	chr12	47755003	47756165	1162	581.0	
62388	chr12	47757671	47759874	2203	1102.0	
62389	chr12	47763892	47764177	285	142.0	
62390	chr12	47766665	47767595	930	465.0	
62391	chr12	47770005	47770474	469	234.0	
62392	chr12	47772806	47774209	1403	702.0	
62393	chr12	47775154	47775899	745	372.0	
62394	chr12	47776609	47778428	1819	910.0	
62395	chr12	47779029	47780291	1262	631.0	
62396	chr12	47781942	47782615	673	336.0	
62397	chr12	47797407	47797936	529	264.0	
62398	chr12	47799698	47800046	348	174.0	
62399	chr12	47801521	47803823	2302	1151.0	
62400	chr12	47807562	47809444	1882	941.0	
62401	chr12	47809997	47815707	5710	2855.0	
62402	chr12	47816507	47821512	5005	2502.0	
62403	chr12	47823942	47824875	933	466.0	
62404	chr12	47827337	47827773	436	218.0	
62405	chr12	47828865	47829428	563	282.0	
62406	chr12	47832225	47834892	2667	1334.0	
62407	chr12	47835719	47835828	109	54.0	
62408	chr12	47837331	47839121	1790	895.0	
62409	chr12	47868444	47869080	636	318.0	
62410	chr12	47870269	47870907	638	319.0	
62411	chr12	47871642	47872199	557	278.0	
62412	chr12	47881736	47883659	1923	962.0	
62413	chr12	47885051	47885613	562	281.0	
62414	chr12	47888900	47889565	665	332.0	
62415	chr12	47891585	47891662	77	38.0	
62416	chr12	47892357	47892500	143	72.0	
62417	chr12	47900288	47902016	1728	864.0	
62418	chr12	47903321	47906336	3015	1508.0	
62419	chr12	47942136	47942787	651	326.0	
62420	chr12	47946690	47947151	461	230.0	
62421	chr12	47949377	47949889	512	256.0	
62422	chr12	47963026	47964556	1530	765.0	
62423	chr12	47990046	47990940	894	447.0	
62424	chr12	48001445	48004810	3365	1682.0	
62425	chr12	48038082	48038215	133	66.0	
62426	chr12	48105065	48107005	1940	970.0	
62427	chr12	48118942	48119955	1013	506.0	
62428	chr12	48156666	48158426	1760	880.0	
62429	chr12	48165013	48165560	547	274.0	
62430	chr12	48182530	48186602	4072	2036.0	
62431	chr12	48189220	48190140	920	460.0	
62432	chr12	48197281	48201222	3941	1970.0	
62433	chr12	48212443	48213436	993	496.0	
62434	chr12	48216674	48217261	587	294.0	
62435	chr12	48279047	48279808	761	380.0	
62436	chr12	48282789	48283620	831	416.0	
62437	chr12	48286013	48287008	995	498.0	
62438	chr12	48296466	48297197	731	366.0	
62439	chr12	48334771	48335326	555	278.0	
62440	chr12	48336116	48336575	459	230.0	
62441	chr12	48349834	48351691	1857	928.0	
62442	chr12	48409808	48410399	591	296.0	
62443	chr12	48454691	48455061	370	185.0	
62444	chr12	48618384	48618903	519	260.0	
62445	chr12	48677700	48679731	2031	1016.0	
62446	chr12	48681363	48683046	1683	842.0	
62447	chr12	48713747	48713958	211	106.0	
62448	chr12	48715930	48717803	1873	936.0	
62449	chr12	48753385	48753981	596	298.0	
62450	chr12	48765947	48766233	286	143.0	
62451	chr12	48788539	48789325	786	393.0	
62452	chr12	48795442	48796289	847	424.0	
62453	chr12	48813836	48816147	2311	1156.0	
62454	chr12	48817657	48819562	1905	952.0	
62455	chr12	48824136	48824522	386	193.0	
62456	chr12	48850844	48853923	3079	1540.0	
62457	chr12	48857437	48857649	212	106.0	
62458	chr12	48864083	48866489	2406	1203.0	
62459	chr12	48890521	48891481	960	480.0	
62460	chr12	48903687	48904719	1032	516.0	
62461	chr12	48917813	48918598	785	392.0	
62462	chr12	48923462	48923599	137	68.0	
62463	chr12	48924243	48926264	2021	1010.0	
62464	chr12	48932723	48934740	2017	1008.0	
62465	chr12	48936160	48936842	682	341.0	
62466	chr12	48938683	48939184	501	250.0	
62467	chr12	48939895	48940712	817	408.0	
62468	chr12	48954810	48955473	663	332.0	
62469	chr12	48956014	48958485	2471	1236.0	
62470	chr12	48966488	48966882	394	197.0	
62471	chr12	48969218	48974526	5308	2654.0	
62472	chr12	48976457	48982268	5811	2906.0	
62473	chr12	48987703	48988706	1003	502.0	
62474	chr12	48995107	49000269	5162	2581.0	
62475	chr12	49004608	49005146	538	269.0	
62476	chr12	49017728	49021852	4124	2062.0	
62477	chr12	49022418	49022978	560	280.0	
62478	chr12	49028126	49028556	430	215.0	
62479	chr12	49043595	49044588	993	496.0	
62480	chr12	49055690	49061499	5809	2904.0	
62481	chr12	49063670	49064558	888	444.0	
62482	chr12	49068820	49070760	1940	970.0	
62483	chr12	49087832	49088931	1099	550.0	
62484	chr12	49089636	49092898	3262	1631.0	
62485	chr12	49093675	49095287	1612	806.0	
62486	chr12	49097278	49098645	1367	684.0	
62487	chr12	49105275	49106621	1346	673.0	
62488	chr12	49108575	49111671	3096	1548.0	
62489	chr12	49121046	49121506	460	230.0	
62490	chr12	49126509	49127588	1079	540.0	
62491	chr12	49129357	49132405	3048	1524.0	
62492	chr12	49160421	49161838	1417	708.0	
62493	chr12	49182226	49185375	3149	1574.0	
62494	chr12	49186283	49189765	3482	1741.0	
62495	chr12	49195722	49196192	470	235.0	
62496	chr12	49201075	49202099	1024	512.0	
62497	chr12	49220795	49221346	551	276.0	
62498	chr12	49222329	49223009	680	340.0	
62499	chr12	49230636	49231491	855	428.0	
62500	chr12	49233060	49235797	2737	1368.0	
62501	chr12	49244307	49244442	135	68.0	
62502	chr12	49264086	49266533	2447	1224.0	
62503	chr12	49268611	49269140	529	264.0	
62504	chr12	49274063	49274184	121	60.0	
62505	chr12	49275029	49275220	191	96.0	
62506	chr12	49279622	49280152	530	265.0	
62507	chr12	49288244	49288929	685	342.0	
62508	chr12	49295076	49295607	531	266.0	
62509	chr12	49296406	49298414	2008	1004.0	
62510	chr12	49306202	49306467	265	132.0	
62511	chr12	49321879	49323966	2087	1044.0	
62512	chr12	49331574	49332238	664	332.0	
62513	chr12	49333068	49333348	280	140.0	
62514	chr12	49335975	49338573	2598	1299.0	
62515	chr12	49341084	49344123	3039	1520.0	
62516	chr12	49344978	49348120	3142	1571.0	
62517	chr12	49358529	49359231	702	351.0	
62518	chr12	49364874	49365400	526	263.0	
62519	chr12	49366136	49368180	2044	1022.0	
62520	chr12	49369610	49370315	705	352.0	
62521	chr12	49388873	49389556	683	342.0	
62522	chr12	49429209	49429694	485	242.0	
62523	chr12	49513982	49514510	528	264.0	
62524	chr12	49529401	49529802	401	200.0	
62525	chr12	49536386	49540958	4572	2286.0	
62526	chr12	49543403	49543511	108	54.0	
62527	chr12	49548605	49549706	1101	550.0	
62528	chr12	49553446	49553970	524	262.0	
62529	chr12	49567237	49569162	1925	962.0	
62530	chr12	49580434	49580974	540	270.0	
62531	chr12	49588602	49588948	346	173.0	
62532	chr12	49621957	49626672	4715	2358.0	
62533	chr12	49636808	49637522	714	357.0	
62534	chr12	49644153	49645687	1534	767.0	
62535	chr12	49661133	49661596	463	232.0	
62536	chr12	49662534	49663846	1312	656.0	
62537	chr12	49664643	49665087	444	222.0	
62538	chr12	49670429	49674679	4250	2125.0	
62539	chr12	49675220	49675531	311	156.0	
62540	chr12	49684000	49684395	395	198.0	
62541	chr12	49690769	49690929	160	80.0	
62542	chr12	49698422	49699694	1272	636.0	
62543	chr12	49703114	49704136	1022	511.0	
62544	chr12	49705075	49708188	3113	1556.0	
62545	chr12	49731769	49732278	509	254.0	
62546	chr12	49740837	49743215	2378	1189.0	
62547	chr12	49744505	49745095	590	295.0	
62548	chr12	49746487	49747066	579	290.0	
62549	chr12	49748426	49748447	21	10.0	
62550	chr12	49749654	49751132	1478	739.0	
62551	chr12	49753540	49754459	919	460.0	
62552	chr12	49762154	49763749	1595	798.0	
62553	chr12	49765678	49766553	875	438.0	
62554	chr12	49776243	49777272	1029	514.0	
62555	chr12	49778051	49778579	528	264.0	
62556	chr12	49779740	49779988	248	124.0	
62557	chr12	49784175	49784826	651	326.0	
62558	chr12	49797151	49797860	709	354.0	
62559	chr12	49820850	49821733	883	442.0	
62560	chr12	49824291	49829315	5024	2512.0	
62561	chr12	49838889	49839469	580	290.0	
62562	chr12	49841775	49843836	2061	1030.0	
62563	chr12	49866882	49867692	810	405.0	
62564	chr12	49903675	49904365	690	345.0	
62565	chr12	49945243	49946023	780	390.0	
62566	chr12	49948894	49949261	367	184.0	
62567	chr12	49956276	49956405	129	64.0	
62568	chr12	49961165	49961679	514	257.0	
62569	chr12	49966596	49968148	1552	776.0	
62570	chr12	49974227	49975115	888	444.0	
62571	chr12	49982393	49983021	628	314.0	
62572	chr12	49983769	49984226	457	228.0	
62573	chr12	49987554	49988099	545	272.0	
62574	chr12	49990232	49990886	654	327.0	
62575	chr12	50017112	50017395	283	142.0	
62576	chr12	50024710	50026130	1420	710.0	
62577	chr12	50032714	50033782	1068	534.0	
62578	chr12	50039141	50039773	632	316.0	
62579	chr12	50050272	50051561	1289	644.0	
62580	chr12	50053628	50053955	327	164.0	
62581	chr12	50055691	50058360	2669	1334.0	
62582	chr12	50058879	50059056	177	88.0	
62583	chr12	50059733	50060251	518	259.0	
62584	chr12	50066464	50066865	401	200.0	
62585	chr12	50070246	50071091	845	422.0	
62586	chr12	50074881	50075937	1056	528.0	
62587	chr12	50084502	50086691	2189	1094.0	
62588	chr12	50088322	50089063	741	370.0	
62589	chr12	50110250	50113105	2855	1428.0	
62590	chr12	50129265	50129736	471	236.0	
62591	chr12	50132512	50132898	386	193.0	
62592	chr12	50166255	50168091	1836	918.0	
62593	chr12	50170425	50170557	132	66.0	
62594	chr12	50175199	50175863	664	332.0	
62595	chr12	50188910	50189275	365	182.0	
62596	chr12	50211764	50212439	675	338.0	
62597	chr12	50220388	50222970	2582	1291.0	
62598	chr12	50224387	50224705	318	159.0	
62599	chr12	50282829	50284227	1398	699.0	
62600	chr12	50400201	50402058	1857	928.0	
62601	chr12	50504340	50506395	2055	1028.0	"repeat_region	sequence_feature"
62602	chr12	50507928	50509503	1575	788.0	
62603	chr12	50514516	50516041	1525	762.0	
62604	chr12	50517202	50518460	1258	629.0	
62605	chr12	50520238	50520870	632	316.0	
62606	chr12	50529442	50529469	27	14.0	
62607	chr12	50531303	50533502	2199	1100.0	
62608	chr12	50534611	50534831	220	110.0	
62609	chr12	50537592	50538657	1065	532.0	
62610	chr12	50564275	50564612	337	168.0	
62611	chr12	50572126	50572730	604	302.0	
62612	chr12	50579711	50580078	367	184.0	
62613	chr12	50597450	50597881	431	216.0	
62614	chr12	50625255	50625273	18	9.0	
62615	chr12	50625909	50626422	513	256.0	
62616	chr12	50637626	50638321	695	348.0	
62617	chr12	50734648	50735019	371	186.0	
62618	chr12	50745656	50746330	674	337.0	
62619	chr12	50760592	50761777	1185	592.0	
62620	chr12	50763174	50766060	2886	1443.0	
62621	chr12	50824937	50825879	942	471.0	
62622	chr12	50923598	50925665	2067	1034.0	
62623	chr12	50927207	50927287	80	40.0	
62624	chr12	50934331	50935282	951	476.0	
62625	chr12	50986940	50987351	411	206.0	
62626	chr12	51008797	51009585	788	394.0	
62627	chr12	51021642	51022202	560	280.0	
62628	chr12	51024108	51026976	2868	1434.0	
62629	chr12	51028041	51028561	520	260.0	
62630	chr12	51047435	51049630	2195	1098.0	
62631	chr12	51082350	51084149	1799	900.0	
62632	chr12	51085731	51086102	371	186.0	
62633	chr12	51171811	51174339	2528	1264.0	
62634	chr12	51199399	51199624	225	112.0	
62635	chr12	51216874	51219056	2182	1091.0	
62636	chr12	51237789	51240329	2540	1270.0	
62637	chr12	51241936	51243521	1585	792.0	
62638	chr12	51244231	51244647	416	208.0	
62639	chr12	51245484	51246984	1500	750.0	
62640	chr12	51252528	51252858	330	165.0	
62641	chr12	51262649	51263161	512	256.0	
62642	chr12	51264927	51265536	609	304.0	
62643	chr12	51268910	51271351	2441	1220.0	
62644	chr12	51291644	51292501	857	428.0	
62645	chr12	51307749	51308023	274	137.0	
62646	chr12	51318128	51319610	1482	741.0	
62647	chr12	51320790	51321404	614	307.0	
62648	chr12	51322482	51325485	3003	1502.0	
62649	chr12	51326277	51327580	1303	652.0	
62650	chr12	51329100	51330288	1188	594.0	
62651	chr12	51335856	51336396	540	270.0	
62652	chr12	51341079	51341873	794	397.0	
62653	chr12	51351835	51352455	620	310.0	
62654	chr12	51357214	51357847	633	316.0	
62655	chr12	51368401	51370039	1638	819.0	
62656	chr12	51373115	51373690	575	288.0	
62657	chr12	51387937	51395915	7978	3989.0	
62658	chr12	51403725	51404432	707	354.0	
62659	chr12	51421202	51421712	510	255.0	
62660	chr12	51424195	51425618	1423	712.0	
62661	chr12	51482933	51483548	615	308.0	
62662	chr12	51531680	51532364	684	342.0	
62663	chr12	51590204	51591920	1716	858.0	
62664	chr12	51593424	51593826	402	201.0	
62665	chr12	51721568	51721921	353	176.0	
62666	chr12	51773462	51773746	284	142.0	
62667	chr12	51813810	51815219	1409	704.0	
62668	chr12	51820020	51822380	2360	1180.0	
62669	chr12	51823847	51824485	638	319.0	
62670	chr12	51827521	51828526	1005	502.0	
62671	chr12	51832644	51833186	542	271.0	
62672	chr12	51846660	51848317	1657	828.0	
62673	chr12	51851164	51852425	1261	630.0	
62674	chr12	51863323	51864633	1310	655.0	
62675	chr12	51868885	51871574	2689	1344.0	
62676	chr12	51875165	51875683	518	259.0	
62677	chr12	51881912	51882465	553	276.0	
62678	chr12	51885763	51886577	814	407.0	
62679	chr12	51888053	51888181	128	64.0	
62680	chr12	51905726	51905926	200	100.0	
62681	chr12	51907395	51907647	252	126.0	
62682	chr12	51911175	51912803	1628	814.0	
62683	chr12	51922461	51923968	1507	754.0	
62684	chr12	51926754	51927102	348	174.0	
62685	chr12	51950915	51953622	2707	1354.0	
62686	chr12	51954596	51955392	796	398.0	
62687	chr12	51970761	51973456	2695	1348.0	
62688	chr12	51976450	51977198	748	374.0	
62689	chr12	51980047	51980952	905	452.0	
62690	chr12	51989988	51990452	464	232.0	
62691	chr12	51992852	51993745	893	446.0	
62692	chr12	52002317	52002690	373	186.0	
62693	chr12	52003644	52028160	24516	12258.0	
62694	chr12	52029156	52035251	6095	3048.0	
62695	chr12	52035818	52043301	7483	3742.0	
62696	chr12	52045084	52047545	2461	1230.0	
62697	chr12	52048458	52071252	22794	11397.0	
62698	chr12	52073825	52074461	636	318.0	
62699	chr12	52076770	52077327	557	278.0	
62700	chr12	52079071	52079680	609	304.0	
62701	chr12	52080282	52084015	3733	1866.0	
62702	chr12	52088468	52088806	338	169.0	
62703	chr12	52104440	52104875	435	218.0	
62704	chr12	52116463	52116983	520	260.0	
62705	chr12	52118192	52118998	806	403.0	
62706	chr12	52119701	52120441	740	370.0	
62707	chr12	52121786	52122251	465	232.0	
62708	chr12	52132804	52133227	423	212.0	
62709	chr12	52139478	52139891	413	206.0	
62710	chr12	52147242	52147738	496	248.0	
62711	chr12	52151778	52152720	942	471.0	
62712	chr12	52155245	52155930	685	342.0	
62713	chr12	52156684	52157223	539	270.0	
62714	chr12	52163814	52164491	677	338.0	
62715	chr12	52165339	52165905	566	283.0	
62716	chr12	52171942	52172350	408	204.0	
62717	chr12	52176259	52176569	310	155.0	
62718	chr12	52186074	52186854	780	390.0	
62719	chr12	52189053	52189273	220	110.0	
62720	chr12	52192105	52192680	575	288.0	
62721	chr12	52194124	52194627	503	252.0	
62722	chr12	52197613	52199203	1590	795.0	
62723	chr12	52202662	52203888	1226	613.0	
62724	chr12	52210611	52211031	420	210.0	
62725	chr12	52213228	52214119	891	446.0	
62726	chr12	52221981	52222676	695	348.0	
62727	chr12	52227588	52228059	471	236.0	
62728	chr12	52243835	52244871	1036	518.0	
62729	chr12	52278894	52279403	509	254.0	
62730	chr12	52280104	52280762	658	329.0	
62731	chr12	52288167	52288507	340	170.0	
62732	chr12	52295688	52296061	373	186.0	
62733	chr12	52304885	52305304	419	210.0	
62734	chr12	52308190	52308889	699	350.0	
62735	chr12	52327247	52328153	906	453.0	
62736	chr12	52351587	52352161	574	287.0	
62737	chr12	52358511	52359155	644	322.0	
62738	chr12	52361708	52361736	28	14.0	
62739	chr12	52372513	52372965	452	226.0	
62740	chr12	52507023	52507458	435	218.0	
62741	chr12	52526512	52526923	411	206.0	
62742	chr12	52531564	52532055	491	246.0	
62743	chr12	52555494	52556117	623	312.0	
62744	chr12	52558730	52560328	1598	799.0	
62745	chr12	52566311	52567749	1438	719.0	
62746	chr12	52582902	52583468	566	283.0	
62747	chr12	52585899	52586570	671	336.0	
62748	chr12	52603339	52603702	363	182.0	
62749	chr12	52610203	52611038	835	418.0	
62750	chr12	52615187	52615807	620	310.0	
62751	chr12	52633321	52633722	401	200.0	
62752	chr12	52636249	52636614	365	182.0	
62753	chr12	52644965	52646275	1310	655.0	
62754	chr12	52681492	52681906	414	207.0	
62755	chr12	52690897	52691808	911	456.0	
62756	chr12	52714176	52714505	329	164.0	
62757	chr12	52741427	52741763	336	168.0	
62758	chr12	52835967	52836398	431	216.0	
62759	chr12	52860144	52860245	101	50.0	
62760	chr12	52865357	52865702	345	172.0	
62761	chr12	52867514	52868172	658	329.0	
62762	chr12	52870097	52871802	1705	852.0	
62763	chr12	52873651	52874981	1330	665.0	
62764	chr12	52879207	52880369	1162	581.0	
62765	chr12	52884561	52885258	697	348.0	
62766	chr12	52903250	52904256	1006	503.0	
62767	chr12	52907747	52908530	783	392.0	
62768	chr12	52948571	52949343	772	386.0	"locus_control_region	locus_control_region	region	enhancer	insulator	mobile_genetic_element	promoter	promoter	protein_binding_site	promoter	region	protein_binding_site	promoter"
62769	chr12	52980595	52981497	902	451.0	
62770	chr12	53005575	53007501	1926	963.0	
62771	chr12	53038581	53039286	705	352.0	
62772	chr12	53046232	53052612	6380	3190.0	
62773	chr12	53053118	53055658	2540	1270.0	
62774	chr12	53061744	53062094	350	175.0	
62775	chr12	53062824	53062948	124	62.0	
62776	chr12	53065675	53066706	1031	516.0	
62777	chr12	53067629	53067956	327	164.0	
62778	chr12	53072704	53073321	617	308.0	
62779	chr12	53078612	53080200	1588	794.0	
62780	chr12	53093674	53094336	662	331.0	
62781	chr12	53097074	53099871	2797	1398.0	
62782	chr12	53102409	53104409	2000	1000.0	
62783	chr12	53129183	53129773	590	295.0	
62784	chr12	53159090	53160142	1052	526.0	
62785	chr12	53175004	53175373	369	184.0	
62786	chr12	53179711	53181731	2020	1010.0	
62787	chr12	53182671	53183308	637	318.0	
62788	chr12	53190027	53190649	622	311.0	
62789	chr12	53197550	53199210	1660	830.0	
62790	chr12	53200310	53201371	1061	530.0	
62791	chr12	53205575	53207582	2007	1004.0	
62792	chr12	53208293	53209710	1417	708.0	
62793	chr12	53211759	53212172	413	206.0	
62794	chr12	53213045	53214115	1070	535.0	
62795	chr12	53215809	53224855	9046	4523.0	
62796	chr12	53229391	53229394	3	2.0	
62797	chr12	53230292	53235004	4712	2356.0	
62798	chr12	53235909	53237040	1131	566.0	
62799	chr12	53251150	53253016	1866	933.0	
62800	chr12	53255933	53256516	583	292.0	
62801	chr12	53267318	53269044	1726	863.0	
62802	chr12	53287490	53288314	824	412.0	
62803	chr12	53294961	53296165	1204	602.0	
62804	chr12	53297782	53300640	2858	1429.0	
62805	chr12	53314032	53314387	355	178.0	
62806	chr12	53320632	53322154	1522	761.0	
62807	chr12	53323738	53326244	2506	1253.0	
62808	chr12	53327442	53327832	390	195.0	
62809	chr12	53336120	53336887	767	384.0	
62810	chr12	53338062	53338424	362	181.0	
62811	chr12	53343888	53345839	1951	976.0	
62812	chr12	53352340	53353385	1045	522.0	
62813	chr12	53365152	53366696	1544	772.0	
62814	chr12	53370477	53372731	2254	1127.0	
62815	chr12	53378816	53382541	3725	1862.0	
62816	chr12	53417318	53417895	577	288.0	
62817	chr12	53421250	53422190	940	470.0	
62818	chr12	53440821	53442866	2045	1022.0	
62819	chr12	53451409	53453507	2098	1049.0	
62820	chr12	53454385	53454996	611	306.0	
62821	chr12	53457266	53458387	1121	560.0	
62822	chr12	53464655	53466101	1446	723.0	
62823	chr12	53466733	53467497	764	382.0	
62824	chr12	53468266	53468709	443	222.0	
62825	chr12	53469772	53470375	603	302.0	
62826	chr12	53471302	53471502	200	100.0	
62827	chr12	53472147	53473564	1417	708.0	
62828	chr12	53474716	53475317	601	300.0	
62829	chr12	53476354	53477273	919	460.0	
62830	chr12	53478724	53479450	726	363.0	
62831	chr12	53480363	53488333	7970	3985.0	
62832	chr12	53489299	53490976	1677	838.0	
62833	chr12	53491843	53494045	2202	1101.0	
62834	chr12	53496263	53496670	407	204.0	
62835	chr12	53498346	53502168	3822	1911.0	
62836	chr12	53508302	53509321	1019	510.0	
62837	chr12	53543402	53543903	501	250.0	
62838	chr12	53544884	53545305	421	210.0	
62839	chr12	53575364	53577035	1671	836.0	
62840	chr12	53579336	53579976	640	320.0	
62841	chr12	53618277	53619566	1289	644.0	
62842	chr12	53625229	53627178	1949	974.0	
62843	chr12	53675416	53677711	2295	1148.0	
62844	chr12	53694977	53697481	2504	1252.0	
62845	chr12	53701505	53702388	883	442.0	
62846	chr12	53726301	53728416	2115	1058.0	
62847	chr12	53738252	53740158	1906	953.0	
62848	chr12	53743176	53744213	1037	518.0	"region	enhancer"
62849	chr12	53746195	53747916	1721	860.0	
62850	chr12	53750489	53752338	1849	924.0	
62851	chr12	53753657	53754523	866	433.0	
62852	chr12	53756762	53757756	994	497.0	
62853	chr12	53758441	53758442	1	0.0	
62854	chr12	53791972	53792009	37	18.0	
62855	chr12	53955244	53955286	42	21.0	
62856	chr12	53956451	53957210	759	380.0	
62857	chr12	53965979	53966082	103	52.0	
62858	chr12	53966640	53966771	131	66.0	
62859	chr12	53968206	53968240	34	17.0	
62860	chr12	53973460	53975203	1743	872.0	"recombination_feature	recombination_feature"
62861	chr12	53983534	53986493	2959	1480.0	
62862	chr12	53988913	53989805	892	446.0	
62863	chr12	53990781	53991017	236	118.0	
62864	chr12	53994262	53996637	2375	1188.0	
62865	chr12	53997156	53998487	1331	666.0	
62866	chr12	53999504	54000755	1251	626.0	
62867	chr12	54005548	54007875	2327	1164.0	
62868	chr12	54008394	54011607	3213	1606.0	
62869	chr12	54013029	54013406	377	188.0	
62870	chr12	54014272	54014585	313	156.0	
62871	chr12	54017231	54018635	1404	702.0	enhancer
62872	chr12	54021444	54021781	337	168.0	enhancer
62873	chr12	54027025	54027424	399	200.0	
62874	chr12	54028397	54029067	670	335.0	
62875	chr12	54032302	54034735	2433	1216.0	enhancer
62876	chr12	54046926	54047435	509	254.0	
62877	chr12	54052737	54054761	2024	1012.0	
62878	chr12	54080852	54082968	2116	1058.0	
62879	chr12	54090505	54090588	83	42.0	
62880	chr12	54123971	54124372	401	200.0	
62881	chr12	54125915	54127414	1499	750.0	
62882	chr12	54159186	54159471	285	142.0	
62883	chr12	54173186	54173721	535	268.0	
62884	chr12	54175382	54175830	448	224.0	
62885	chr12	54188529	54189655	1126	563.0	
62886	chr12	54191247	54192209	962	481.0	
62887	chr12	54195517	54196905	1388	694.0	
62888	chr12	54201075	54201919	844	422.0	
62889	chr12	54207410	54208248	838	419.0	
62890	chr12	54214304	54218217	3913	1956.0	
62891	chr12	54219789	54220612	823	412.0	
62892	chr12	54227926	54228342	416	208.0	
62893	chr12	54250991	54252096	1105	552.0	
62894	chr12	54259379	54259968	589	294.0	
62895	chr12	54277897	54278363	466	233.0	
62896	chr12	54278989	54284779	5790	2895.0	
62897	chr12	54285373	54290169	4796	2398.0	
62898	chr12	54291370	54291922	552	276.0	
62899	chr12	54293955	54294985	1030	515.0	
62900	chr12	54296559	54298407	1848	924.0	
62901	chr12	54299069	54299206	137	68.0	
62902	chr12	54300132	54301477	1345	672.0	
62903	chr12	54303749	54304842	1093	546.0	
62904	chr12	54306922	54308111	1189	594.0	
62905	chr12	54315289	54315717	428	214.0	
62906	chr12	54323364	54323487	123	62.0	
62907	chr12	54324300	54325757	1457	728.0	
62908	chr12	54328241	54328891	650	325.0	
62909	chr12	54336410	54336878	468	234.0	
62910	chr12	54351935	54352610	675	338.0	
62911	chr12	54357778	54361275	3497	1748.0	
62912	chr12	54363591	54365085	1494	747.0	
62913	chr12	54367924	54370871	2947	1474.0	
62914	chr12	54372103	54372254	151	76.0	
62915	chr12	54378822	54380320	1498	749.0	
62916	chr12	54382827	54385918	3091	1546.0	
62917	chr12	54387905	54388467	562	281.0	
62918	chr12	54389024	54391848	2824	1412.0	
62919	chr12	54393200	54394711	1511	756.0	
62920	chr12	54399209	54400081	872	436.0	
62921	chr12	54404041	54405026	985	492.0	
62922	chr12	54407416	54408078	662	331.0	
62923	chr12	54411152	54414189	3037	1518.0	
62924	chr12	54415142	54421435	6293	3146.0	
62925	chr12	54423059	54423637	578	289.0	
62926	chr12	54428374	54429271	897	448.0	
62927	chr12	54432672	54433234	562	281.0	
62928	chr12	54439399	54440226	827	414.0	
62929	chr12	54462993	54463475	482	241.0	
62930	chr12	54473417	54473864	447	224.0	
62931	chr12	54497094	54499005	1911	956.0	
62932	chr12	54502576	54502922	346	173.0	
62933	chr12	54526966	54527427	461	230.0	
62934	chr12	54548842	54550531	1689	844.0	
62935	chr12	54558160	54558224	64	32.0	
62936	chr12	54559818	54561736	1918	959.0	
62937	chr12	54579432	54580320	888	444.0	
62938	chr12	54588480	54588778	298	149.0	
62939	chr12	54596426	54596870	444	222.0	
62940	chr12	54603126	54603710	584	292.0	
62941	chr12	54617055	54617111	56	28.0	
62942	chr12	54658673	54659002	329	164.0	
62943	chr12	54680434	54680762	328	164.0	
62944	chr12	54702156	54702598	442	221.0	
62945	chr12	54704242	54704552	310	155.0	
62946	chr12	54708754	54709289	535	268.0	
62947	chr12	54716309	54716856	547	274.0	
62948	chr12	54723578	54724081	503	252.0	
62949	chr12	54725218	54725619	401	200.0	
62950	chr12	54740822	54741270	448	224.0	
62951	chr12	54749099	54749830	731	366.0	
62952	chr12	54759785	54760090	305	152.0	
62953	chr12	54777162	54777167	5	2.0	
62954	chr12	54847004	54847404	400	200.0	
62955	chr12	54853852	54854397	545	272.0	
62956	chr12	54857494	54857726	232	116.0	
62957	chr12	54858566	54858675	109	54.0	
62958	chr12	54882070	54882596	526	263.0	
62959	chr12	54933367	54933752	385	192.0	
62960	chr12	54935165	54936001	836	418.0	
62961	chr12	54956241	54958485	2244	1122.0	
62962	chr12	54968308	54968753	445	222.0	
62963	chr12	54977960	54978114	154	77.0	
62964	chr12	54980291	54980751	460	230.0	
62965	chr12	54981766	54982210	444	222.0	
62966	chr12	54983213	54985655	2442	1221.0	
62967	chr12	54990888	54992384	1496	748.0	
62968	chr12	54993011	54993866	855	428.0	
62969	chr12	54999167	54999494	327	164.0	
62970	chr12	55001397	55001845	448	224.0	
62971	chr12	55019726	55020249	523	262.0	
62972	chr12	55036324	55036802	478	239.0	
62973	chr12	55037513	55038027	514	257.0	
62974	chr12	55041408	55042041	633	316.0	
62975	chr12	55043146	55044026	880	440.0	
62976	chr12	55060497	55060848	351	176.0	
62977	chr12	55068309	55068896	587	294.0	
62978	chr12	55071883	55073476	1593	796.0	
62979	chr12	55188960	55189385	425	212.0	
62980	chr12	55619359	55620164	805	402.0	
62981	chr12	55629146	55629367	221	110.0	
62982	chr12	55637424	55637881	457	228.0	
62983	chr12	55641845	55643092	1247	624.0	
62984	chr12	55645820	55647222	1402	701.0	
62985	chr12	55650561	55651301	740	370.0	
62986	chr12	55656302	55656949	647	324.0	
62987	chr12	55659807	55660125	318	159.0	
62988	chr12	55667183	55667716	533	266.0	
62989	chr12	55673581	55674117	536	268.0	
62990	chr12	55676574	55677199	625	312.0	
62991	chr12	55681036	55682018	982	491.0	
62992	chr12	55705832	55706233	401	200.0	
62993	chr12	55707265	55709267	2002	1001.0	
62994	chr12	55715433	55718001	2568	1284.0	
62995	chr12	55720714	55721631	917	458.0	
62996	chr12	55724423	55725921	1498	749.0	
62997	chr12	55726984	55730911	3927	1964.0	
62998	chr12	55736917	55739471	2554	1277.0	
62999	chr12	55742060	55745617	3557	1778.0	
63000	chr12	55816961	55818866	1905	952.0	
63001	chr12	55827266	55827457	191	96.0	
63002	chr12	55828498	55831820	3322	1661.0	
63003	chr12	55842879	55843123	244	122.0	
63004	chr12	55847098	55848403	1305	652.0	
63005	chr12	55849027	55849077	50	25.0	
63006	chr12	55925891	55933621	7730	3865.0	
63007	chr12	55935569	55936339	770	385.0	
63008	chr12	55939782	55940866	1084	542.0	
63009	chr12	55955241	55956467	1226	613.0	
63010	chr12	55965981	55967719	1738	869.0	
63011	chr12	55972689	55974877	2188	1094.0	
63012	chr12	55983502	55983913	411	206.0	
63013	chr12	55996022	55997925	1903	952.0	
63014	chr12	56003441	56003760	319	160.0	
63015	chr12	56007050	56008463	1413	706.0	
63016	chr12	56020670	56022039	1369	684.0	
63017	chr12	56029671	56030106	435	218.0	
63018	chr12	56034580	56034868	288	144.0	
63019	chr12	56041081	56042831	1750	875.0	
63020	chr12	56046705	56047738	1033	516.0	
63021	chr12	56078849	56080819	1970	985.0	
63022	chr12	56102888	56105631	2743	1372.0	
63023	chr12	56115609	56119978	4369	2184.0	
63024	chr12	56125833	56130544	4711	2356.0	
63025	chr12	56138323	56139287	964	482.0	
63026	chr12	56141861	56142535	674	337.0	
63027	chr12	56143191	56143646	455	228.0	
63028	chr12	56146975	56147164	189	94.0	
63029	chr12	56150539	56153640	3101	1550.0	
63030	chr12	56157022	56165871	8849	4424.0	
63031	chr12	56167650	56168179	529	264.0	
63032	chr12	56169538	56169794	256	128.0	
63033	chr12	56182343	56182415	72	36.0	
63034	chr12	56187196	56190989	3793	1896.0	
63035	chr12	56192864	56193596	732	366.0	
63036	chr12	56206441	56206959	518	259.0	
63037	chr12	56208026	56208436	410	205.0	
63038	chr12	56220317	56225144	4827	2414.0	
63039	chr12	56225819	56226098	279	140.0	
63040	chr12	56236568	56236755	187	94.0	
63041	chr12	56257529	56259109	1580	790.0	
63042	chr12	56266254	56268020	1766	883.0	
63043	chr12	56271092	56271502	410	205.0	
63044	chr12	56291379	56291762	383	192.0	
63045	chr12	56296321	56296681	360	180.0	
63046	chr12	56298956	56301278	2322	1161.0	
63047	chr12	56301996	56302986	990	495.0	
63048	chr12	56315112	56316899	1787	894.0	
63049	chr12	56320827	56321546	719	360.0	
63050	chr12	56332933	56335072	2139	1070.0	
63051	chr12	56336527	56340047	3520	1760.0	
63052	chr12	56346705	56347040	335	168.0	
63053	chr12	56358622	56361107	2485	1242.0	
63054	chr12	56375706	56376291	585	292.0	
63055	chr12	56448609	56449951	1342	671.0	
63056	chr12	56464059	56464936	877	438.0	
63057	chr12	56467820	56469847	2027	1014.0	
63058	chr12	56487403	56488966	1563	782.0	
63059	chr12	56496663	56497176	513	256.0	
63060	chr12	56501165	56501573	408	204.0	
63061	chr12	56513670	56514309	639	320.0	
63062	chr12	56518609	56519010	401	200.0	
63063	chr12	56520667	56522457	1790	895.0	
63064	chr12	56565496	56566100	604	302.0	
63065	chr12	56569771	56570852	1081	540.0	
63066	chr12	56573099	56573834	735	368.0	
63067	chr12	56581480	56582329	849	424.0	
63068	chr12	56590233	56590429	196	98.0	
63069	chr12	56593908	56594594	686	343.0	
63070	chr12	56601414	56601829	415	208.0	
63071	chr12	56626868	56626977	109	54.0	
63072	chr12	56628334	56630969	2635	1318.0	
63073	chr12	56631746	56637675	5929	2964.0	
63074	chr12	56644751	56646785	2034	1017.0	
63075	chr12	56658998	56659374	376	188.0	
63076	chr12	56676807	56677575	768	384.0	
63077	chr12	56679173	56679256	83	42.0	
63078	chr12	56679952	56680663	711	356.0	
63079	chr12	56682780	56690118	7338	3669.0	
63080	chr12	56699000	56699467	467	234.0	
63081	chr12	56700338	56701269	931	466.0	
63082	chr12	56705953	56706463	510	255.0	
63083	chr12	56716171	56716175	4	2.0	
63084	chr12	56719118	56719407	289	144.0	
63085	chr12	56720226	56721622	1396	698.0	
63086	chr12	56723774	56726079	2305	1152.0	
63087	chr12	56749287	56749943	656	328.0	
63088	chr12	56751178	56752915	1737	868.0	
63089	chr12	56757197	56758100	903	452.0	
63090	chr12	56763282	56763445	163	82.0	
63091	chr12	56766342	56767091	749	374.0	
63092	chr12	56775637	56775994	357	178.0	
63093	chr12	56837094	56837191	97	48.0	
63094	chr12	56839878	56840209	331	166.0	
63095	chr12	56931360	56931849	489	244.0	
63096	chr12	56932757	56933265	508	254.0	
63097	chr12	56987296	56988001	705	352.0	
63098	chr12	56991454	56991835	381	190.0	
63099	chr12	56999163	56999246	83	42.0	
63100	chr12	57001224	57001870	646	323.0	
63101	chr12	57005736	57008720	2984	1492.0	
63102	chr12	57011242	57011955	713	356.0	
63103	chr12	57031085	57031568	483	242.0	
63104	chr12	57046069	57048032	1963	982.0	
63105	chr12	57049205	57049598	393	196.0	
63106	chr12	57055801	57056358	557	278.0	
63107	chr12	57060913	57061350	437	218.0	
63108	chr12	57062471	57063080	609	304.0	
63109	chr12	57063825	57064773	948	474.0	
63110	chr12	57069194	57070153	959	480.0	
63111	chr12	57077842	57079471	1629	814.0	
63112	chr12	57085944	57090421	4477	2238.0	
63113	chr12	57092998	57094967	1969	984.0	
63114	chr12	57101865	57103051	1186	593.0	
63115	chr12	57109723	57112909	3186	1593.0	
63116	chr12	57118654	57119411	757	378.0	
63117	chr12	57124037	57124920	883	442.0	
63118	chr12	57126966	57130424	3458	1729.0	
63119	chr12	57131045	57131400	355	178.0	
63120	chr12	57138785	57139272	487	244.0	
63121	chr12	57147568	57147942	374	187.0	
63122	chr12	57148624	57149484	860	430.0	
63123	chr12	57150031	57150424	393	196.0	
63124	chr12	57152417	57153836	1419	710.0	
63125	chr12	57154693	57155153	460	230.0	
63126	chr12	57156688	57157089	401	200.0	
63127	chr12	57157769	57158276	507	254.0	
63128	chr12	57162451	57163008	557	278.0	
63129	chr12	57172949	57173360	411	206.0	
63130	chr12	57175612	57176280	668	334.0	
63131	chr12	57182737	57183602	865	432.0	
63132	chr12	57191202	57191729	527	264.0	
63133	chr12	57210967	57211314	347	174.0	
63134	chr12	57212825	57219080	6255	3128.0	
63135	chr12	57220554	57223949	3395	1698.0	
63136	chr12	57224556	57227186	2630	1315.0	
63137	chr12	57228948	57230562	1614	807.0	
63138	chr12	57234395	57235381	986	493.0	
63139	chr12	57235973	57244323	8350	4175.0	
63140	chr12	57245209	57245610	401	200.0	
63141	chr12	57248741	57249515	774	387.0	
63142	chr12	57263753	57264187	434	217.0	
63143	chr12	57280081	57280856	775	388.0	
63144	chr12	57330903	57331477	574	287.0	
63145	chr12	57340032	57340525	493	246.0	
63146	chr12	57429444	57431728	2284	1142.0	
63147	chr12	57435268	57435714	446	223.0	
63148	chr12	57452806	57453350	544	272.0	
63149	chr12	57455718	57456577	859	430.0	
63150	chr12	57458582	57466337	7755	3878.0	
63151	chr12	57467329	57468266	937	468.0	
63152	chr12	57469336	57471668	2332	1166.0	
63153	chr12	57474433	57480989	6556	3278.0	
63154	chr12	57487324	57488791	1467	734.0	
63155	chr12	57514701	57524554	9853	4926.0	
63156	chr12	57546108	57547860	1752	876.0	
63157	chr12	57549445	57550466	1021	510.0	
63158	chr12	57583014	57585083	2069	1034.0	
63159	chr12	57590551	57592272	1721	860.0	
63160	chr12	57603424	57603790	366	183.0	
63161	chr12	57604386	57605565	1179	590.0	
63162	chr12	57610426	57612002	1576	788.0	
63163	chr12	57614223	57614940	717	358.0	
63164	chr12	57619462	57622352	2890	1445.0	
63165	chr12	57627388	57628031	643	322.0	
63166	chr12	57631991	57633828	1837	918.0	
63167	chr12	57693236	57694997	1761	880.0	
63168	chr12	57724614	57725378	764	382.0	
63169	chr12	57739448	57739930	482	241.0	
63170	chr12	57740616	57742817	2201	1100.0	
63171	chr12	57744048	57745995	1947	974.0	
63172	chr12	57746571	57746766	195	98.0	
63173	chr12	57751310	57757352	6042	3021.0	
63174	chr12	57759164	57759819	655	328.0	
63175	chr12	57764439	57767340	2901	1450.0	
63176	chr12	57771145	57773362	2217	1108.0	
63177	chr12	57775478	57776208	730	365.0	
63178	chr12	57781068	57783516	2448	1224.0	
63179	chr12	57797895	57798254	359	180.0	
63180	chr12	57803289	57803690	401	200.0	
63181	chr12	57816670	57817199	529	264.0	
63182	chr12	57831146	57832327	1181	590.0	
63183	chr12	57833022	57833158	136	68.0	
63184	chr12	57835362	57839358	3996	1998.0	
63185	chr12	57842557	57848809	6252	3126.0	
63186	chr12	57850959	57851442	483	242.0	
63187	chr12	57852297	57853024	727	364.0	
63188	chr12	57864903	57865896	993	496.0	
63189	chr12	57874083	57874528	445	222.0	
63190	chr12	57896236	57897275	1039	520.0	
63191	chr12	57898336	57899841	1505	752.0	
63192	chr12	57905013	57905933	920	460.0	
63193	chr12	57935645	57936634	989	494.0	
63194	chr12	57939249	57939815	566	283.0	
63195	chr12	57940399	57942672	2273	1136.0	
63196	chr12	57943755	57943845	90	45.0	
63197	chr12	59078993	59079400	407	204.0	
63198	chr12	59150032	59150390	358	179.0	
63199	chr12	59382941	59383384	443	222.0	
63200	chr12	59403276	59403640	364	182.0	
63201	chr12	59472301	59472659	358	179.0	
63202	chr12	59491855	59492276	421	210.0	
63203	chr12	59595334	59598210	2876	1438.0	
63204	chr12	59612957	59613518	561	280.0	
63205	chr12	59619998	59620953	955	478.0	
63206	chr12	59675455	59675751	296	148.0	
63207	chr12	59698556	59698988	432	216.0	
63208	chr12	59699497	59700202	705	352.0	
63209	chr12	59808312	59808756	444	222.0	
63210	chr12	61870742	61871554	812	406.0	
63211	chr12	61915422	61915810	388	194.0	
63212	chr12	61991846	61991937	91	46.0	
63213	chr12	61993694	61994182	488	244.0	
63214	chr12	62003381	62003472	91	46.0	
63215	chr12	62075950	62076223	273	136.0	
63216	chr12	62106742	62107303	561	280.0	
63217	chr12	62123659	62124098	439	220.0	
63218	chr12	62146275	62146736	461	230.0	
63219	chr12	62158694	62159260	566	283.0	
63220	chr12	62190082	62193102	3020	1510.0	
63221	chr12	62196192	62196518	326	163.0	
63222	chr12	62210321	62210771	450	225.0	
63223	chr12	62211366	62211951	585	292.0	
63224	chr12	62214817	62216122	1305	652.0	
63225	chr12	62250626	62251914	1288	644.0	
63226	chr12	62256780	62257328	548	274.0	
63227	chr12	62258890	62261711	2821	1410.0	
63228	chr12	62263939	62265308	1369	684.0	
63229	chr12	62267396	62267942	546	273.0	
63230	chr12	62282065	62282744	679	340.0	
63231	chr12	62292173	62293073	900	450.0	
63232	chr12	62297108	62297698	590	295.0	
63233	chr12	62318932	62319459	527	264.0	
63234	chr12	62335756	62336131	375	188.0	
63235	chr12	62434517	62436317	1800	900.0	
63236	chr12	62438071	62438541	470	235.0	
63237	chr12	62465630	62467892	2262	1131.0	
63238	chr12	62517052	62517213	161	80.0	
63239	chr12	62581676	62582177	501	250.0	
63240	chr12	62601937	62605311	3374	1687.0	
63241	chr12	62606652	62607002	350	175.0	
63242	chr12	62625195	62625772	577	288.0	
63243	chr12	62631643	62632872	1229	614.0	
63244	chr12	62640819	62641426	607	304.0	
63245	chr12	62703606	62703888	282	141.0	
63246	chr12	62709965	62710312	347	174.0	
63247	chr12	62728663	62729197	534	267.0	
63248	chr12	62731098	62731482	384	192.0	
63249	chr12	62732785	62733414	629	314.0	
63250	chr12	62744499	62745639	1140	570.0	
63251	chr12	62748934	62749105	171	86.0	
63252	chr12	62774745	62775211	466	233.0	
63253	chr12	62785801	62786426	625	312.0	
63254	chr12	62787699	62787971	272	136.0	
63255	chr12	62793756	62794396	640	320.0	
63256	chr12	62799088	62799563	475	238.0	
63257	chr12	62813121	62813629	508	254.0	
63258	chr12	62841878	62842239	361	180.0	
63259	chr12	62859347	62859370	23	12.0	
63260	chr12	62886878	62887210	332	166.0	
63261	chr12	62888523	62889101	578	289.0	
63262	chr12	62898537	62898971	434	217.0	
63263	chr12	62914267	62914756	489	244.0	
63264	chr12	62931286	62931873	587	294.0	
63265	chr12	62933581	62935474	1893	946.0	
63266	chr12	63152107	63152209	102	51.0	
63267	chr12	63420350	63420463	113	56.0	
63268	chr12	63668204	63669201	997	498.0	
63269	chr12	63777327	63777739	412	206.0	
63270	chr12	63779222	63780792	1570	785.0	
63271	chr12	63814854	63815299	445	222.0	
63272	chr12	63821922	63821973	51	26.0	
63273	chr12	63825966	63826389	423	212.0	
63274	chr12	63839370	63839794	424	212.0	
63275	chr12	63843292	63845268	1976	988.0	
63276	chr12	63884065	63884472	407	204.0	
63277	chr12	63894070	63894554	484	242.0	
63278	chr12	63916514	63916989	475	238.0	
63279	chr12	63917648	63919132	1484	742.0	
63280	chr12	63955695	63956469	774	387.0	
63281	chr12	63963876	63964255	379	190.0	
63282	chr12	64088298	64088802	504	252.0	
63283	chr12	64218645	64218964	319	160.0	
63284	chr12	64221386	64223116	1730	865.0	
63285	chr12	64252825	64253323	498	249.0	
63286	chr12	64256139	64256604	465	232.0	
63287	chr12	64273721	64274079	358	179.0	
63288	chr12	64293894	64294434	540	270.0	
63289	chr12	64384880	64385783	903	452.0	
63290	chr12	64390126	64390951	825	412.0	
63291	chr12	64392238	64392628	390	195.0	
63292	chr12	64399926	64400483	557	278.0	
63293	chr12	64403808	64405869	2061	1030.0	
63294	chr12	64450213	64453414	3201	1600.0	
63295	chr12	64456118	64456331	213	106.0	
63296	chr12	64457030	64457804	774	387.0	
63297	chr12	64458851	64460081	1230	615.0	
63298	chr12	64500466	64500877	411	206.0	
63299	chr12	64549432	64550058	626	313.0	
63300	chr12	64560650	64561276	626	313.0	
63301	chr12	64568625	64568636	11	6.0	
63302	chr12	64583550	64584292	742	371.0	
63303	chr12	64585158	64585423	265	132.0	
63304	chr12	64595066	64596855	1789	894.0	
63305	chr12	64598768	64599872	1104	552.0	
63306	chr12	64608384	64612780	4396	2198.0	
63307	chr12	64613700	64614117	417	208.0	
63308	chr12	64615530	64615865	335	168.0	
63309	chr12	64617725	64618048	323	162.0	
63310	chr12	64618995	64620159	1164	582.0	
63311	chr12	64621100	64622123	1023	512.0	
63312	chr12	64625090	64626138	1048	524.0	
63313	chr12	64631210	64631582	372	186.0	
63314	chr12	64633306	64634287	981	490.0	
63315	chr12	64638662	64639292	630	315.0	
63316	chr12	64657461	64659183	1722	861.0	
63317	chr12	64665324	64666593	1269	634.0	
63318	chr12	64667821	64671771	3950	1975.0	
63319	chr12	64672415	64676283	3868	1934.0	
63320	chr12	64676813	64677433	620	310.0	
63321	chr12	64678243	64680579	2336	1168.0	
63322	chr12	64681129	64682820	1691	846.0	
63323	chr12	64683650	64685486	1836	918.0	
63324	chr12	64687762	64688870	1108	554.0	
63325	chr12	64697784	64698689	905	452.0	
63326	chr12	64699333	64701693	2360	1180.0	
63327	chr12	64713343	64715308	1965	982.0	
63328	chr12	64716190	64717272	1082	541.0	
63329	chr12	64729916	64731123	1207	604.0	
63330	chr12	64746602	64747053	451	226.0	
63331	chr12	64749415	64750227	812	406.0	
63332	chr12	64755440	64755840	400	200.0	
63333	chr12	64756433	64756726	293	146.0	
63334	chr12	64757551	64761287	3736	1868.0	
63335	chr12	64772220	64772613	393	196.0	
63336	chr12	64780257	64782910	2653	1326.0	
63337	chr12	64796154	64796693	539	270.0	
63338	chr12	64800535	64801123	588	294.0	
63339	chr12	64802141	64802629	488	244.0	
63340	chr12	64807103	64807449	346	173.0	
63341	chr12	64824434	64824990	556	278.0	
63342	chr12	64826350	64826682	332	166.0	
63343	chr12	64890846	64891310	464	232.0	
63344	chr12	65121076	65121859	783	392.0	
63345	chr12	65123570	65123791	221	110.0	
63346	chr12	65125333	65125427	94	47.0	
63347	chr12	65156108	65157158	1050	525.0	
63348	chr12	65163781	65164086	305	152.0	
63349	chr12	65168633	65173175	4542	2271.0	
63350	chr12	65188287	65188717	430	215.0	
63351	chr12	65189379	65189391	12	6.0	
63352	chr12	65193144	65193420	276	138.0	
63353	chr12	65209697	65209943	246	123.0	
63354	chr12	65232623	65232872	249	124.0	
63355	chr12	65277180	65277237	57	28.0	
63356	chr12	65278372	65279629	1257	628.0	
63357	chr12	65296428	65296970	542	271.0	
63358	chr12	65300894	65301026	132	66.0	
63359	chr12	65306663	65307147	484	242.0	
63360	chr12	65410430	65410831	401	200.0	
63361	chr12	65556676	65557127	451	226.0	
63362	chr12	65602518	65602901	383	192.0	
63363	chr12	65699230	65699625	395	198.0	
63364	chr12	65740958	65742340	1382	691.0	
63365	chr12	65823761	65826285	2524	1262.0	
63366	chr12	65868337	65868666	329	164.0	
63367	chr12	65881240	65882590	1350	675.0	
63368	chr12	65902652	65902843	191	96.0	
63369	chr12	65907424	65907795	371	186.0	
63370	chr12	65918076	65918413	337	168.0	
63371	chr12	65922086	65922405	319	160.0	
63372	chr12	65923286	65923565	279	140.0	
63373	chr12	65925578	65926956	1378	689.0	
63374	chr12	65983680	65984014	334	167.0	
63375	chr12	66004055	66004246	191	96.0	
63376	chr12	66047430	66047700	270	135.0	
63377	chr12	66055970	66056211	241	120.0	
63378	chr12	66066783	66067251	468	234.0	
63379	chr12	66071484	66072556	1072	536.0	
63380	chr12	66087361	66087814	453	226.0	
63381	chr12	66092497	66093075	578	289.0	
63382	chr12	66107284	66107937	653	326.0	
63383	chr12	66129926	66131720	1794	897.0	
63384	chr12	66144753	66145584	831	416.0	
63385	chr12	66149912	66150546	634	317.0	
63386	chr12	66163248	66163683	435	218.0	
63387	chr12	66168309	66170695	2386	1193.0	
63388	chr12	66172386	66173141	755	378.0	
63389	chr12	66186963	66191792	4829	2414.0	
63390	chr12	66193635	66194468	833	416.0	
63391	chr12	66195441	66195751	310	155.0	
63392	chr12	66196741	66197253	512	256.0	
63393	chr12	66210798	66211229	431	216.0	
63394	chr12	66217311	66217712	401	200.0	
63395	chr12	66233945	66236348	2403	1202.0	
63396	chr12	66236885	66237419	534	267.0	
63397	chr12	66240053	66240532	479	240.0	
63398	chr12	66241326	66242083	757	378.0	
63399	chr12	66268118	66270179	2061	1030.0	
63400	chr12	66279102	66279582	480	240.0	
63401	chr12	66280566	66280962	396	198.0	
63402	chr12	66287640	66288729	1089	544.0	
63403	chr12	66290522	66291367	845	422.0	
63404	chr12	66301699	66305094	3395	1698.0	
63405	chr12	66312163	66312370	207	104.0	
63406	chr12	66321307	66321908	601	300.0	
63407	chr12	66352201	66352588	387	194.0	
63408	chr12	66366132	66366211	79	40.0	
63409	chr12	66379617	66379992	375	188.0	
63410	chr12	66388426	66389024	598	299.0	
63411	chr12	66399009	66399299	290	145.0	
63412	chr12	66407425	66407857	432	216.0	
63413	chr12	66409057	66409720	663	332.0	
63414	chr12	66662134	66662579	445	222.0	
63415	chr12	66688839	66689231	392	196.0	
63416	chr12	66692100	66692619	519	260.0	
63417	chr12	66693843	66694344	501	250.0	
63418	chr12	66709013	66709530	517	258.0	
63419	chr12	66776865	66777583	718	359.0	
63420	chr12	66829673	66830070	397	198.0	
63421	chr12	66861097	66861547	450	225.0	
63422	chr12	66901148	66901609	461	230.0	
63423	chr12	66964384	66965137	753	376.0	
63424	chr12	67068396	67069904	1508	754.0	
63425	chr12	67161410	67161464	54	27.0	
63426	chr12	67268162	67270746	2584	1292.0	
63427	chr12	67355762	67356386	624	312.0	
63428	chr12	67441635	67442220	585	292.0	
63429	chr12	67449443	67450111	668	334.0	
63430	chr12	67451979	67452562	583	292.0	
63431	chr12	67457852	67458218	366	183.0	
63432	chr12	67482906	67484302	1396	698.0	
63433	chr12	67484816	67485156	340	170.0	
63434	chr12	67515484	67516420	936	468.0	
63435	chr12	67555094	67555790	696	348.0	
63436	chr12	67578877	67579940	1063	532.0	
63437	chr12	67590230	67590867	637	318.0	
63438	chr12	67592574	67593247	673	336.0	
63439	chr12	67629974	67631417	1443	722.0	
63440	chr12	67633752	67634830	1078	539.0	
63441	chr12	67647240	67651955	4715	2358.0	
63442	chr12	67678930	67679023	93	46.0	
63443	chr12	67697486	67697897	411	206.0	
63444	chr12	67698451	67699763	1312	656.0	
63445	chr12	67710597	67710952	355	178.0	
63446	chr12	67755342	67755605	263	132.0	
63447	chr12	67758120	67758539	419	210.0	
63448	chr12	67804104	67804569	465	232.0	
63449	chr12	67943258	67943741	483	242.0	
63450	chr12	67989154	67989637	483	242.0	
63451	chr12	67991079	67991635	556	278.0	
63452	chr12	68012825	68013112	287	144.0	
63453	chr12	68032259	68032462	203	102.0	
63454	chr12	68036565	68037126	561	280.0	
63455	chr12	68040396	68041148	752	376.0	
63456	chr12	68042409	68042653	244	122.0	
63457	chr12	68080549	68081005	456	228.0	
63458	chr12	68113642	68114056	414	207.0	
63459	chr12	68118157	68118608	451	226.0	
63460	chr12	68119351	68120403	1052	526.0	
63461	chr12	68121226	68121419	193	96.0	
63462	chr12	68137510	68137545	35	18.0	
63463	chr12	68156932	68157765	833	416.0	
63464	chr12	68158402	68160338	1936	968.0	
63465	chr12	68163410	68164183	773	386.0	
63466	chr12	68175252	68176622	1370	685.0	
63467	chr12	68180816	68181727	911	456.0	
63468	chr12	68189684	68190375	691	346.0	
63469	chr12	68198363	68198755	392	196.0	
63470	chr12	68203444	68203869	425	212.0	
63471	chr12	68222886	68223773	887	444.0	
63472	chr12	68225671	68225979	308	154.0	
63473	chr12	68236189	68237456	1267	634.0	
63474	chr12	68240740	68241643	903	452.0	
63475	chr12	68290068	68290627	559	280.0	
63476	chr12	68317051	68317461	410	205.0	
63477	chr12	68326582	68327167	585	292.0	
63478	chr12	68331499	68333179	1680	840.0	
63479	chr12	68334013	68334634	621	310.0	
63480	chr12	68356343	68356660	317	158.0	
63481	chr12	68357329	68357997	668	334.0	
63482	chr12	68358498	68360204	1706	853.0	
63483	chr12	68363522	68366637	3115	1558.0	
63484	chr12	68367183	68368824	1641	820.0	
63485	chr12	68370050	68370274	224	112.0	
63486	chr12	68372886	68374974	2088	1044.0	
63487	chr12	68379131	68379674	543	272.0	
63488	chr12	68381144	68381299	155	78.0	
63489	chr12	68384034	68384546	512	256.0	
63490	chr12	68405788	68406660	872	436.0	
63491	chr12	68417634	68418039	405	202.0	
63492	chr12	68420261	68420950	689	344.0	
63493	chr12	68422190	68422266	76	38.0	
63494	chr12	68447447	68447946	499	250.0	
63495	chr12	68450669	68452210	1541	770.0	
63496	chr12	68452892	68453051	159	80.0	
63497	chr12	68455878	68456405	527	264.0	
63498	chr12	68462568	68463270	702	351.0	
63499	chr12	68482634	68483138	504	252.0	
63500	chr12	68496874	68498083	1209	604.0	
63501	chr12	68506221	68506357	136	68.0	
63502	chr12	68530339	68530675	336	168.0	
63503	chr12	68533397	68533814	417	208.0	
63504	chr12	68536148	68536628	480	240.0	
63505	chr12	68538725	68540256	1531	766.0	
63506	chr12	68559857	68560665	808	404.0	
63507	chr12	68587155	68588010	855	428.0	
63508	chr12	68591402	68592575	1173	586.0	
63509	chr12	68598773	68599637	864	432.0	
63510	chr12	68609873	68615024	5151	2576.0	
63511	chr12	68615607	68616685	1078	539.0	
63512	chr12	68617527	68619128	1601	800.0	
63513	chr12	68620241	68622622	2381	1190.0	
63514	chr12	68624682	68625084	402	201.0	
63515	chr12	68626074	68626087	13	6.0	
63516	chr12	68626888	68628204	1316	658.0	
63517	chr12	68628892	68631279	2387	1194.0	
63518	chr12	68632227	68634556	2329	1164.0	
63519	chr12	68635443	68636847	1404	702.0	
63520	chr12	68637367	68637715	348	174.0	
63521	chr12	68639438	68640324	886	443.0	
63522	chr12	68640948	68641608	660	330.0	
63523	chr12	68645439	68645788	349	174.0	
63524	chr12	68647145	68648555	1410	705.0	
63525	chr12	68673655	68674238	583	292.0	
63526	chr12	68675135	68676465	1330	665.0	
63527	chr12	68686248	68687692	1444	722.0	
63528	chr12	68745450	68747259	1809	904.0	
63529	chr12	68772740	68773161	421	210.0	
63530	chr12	68783776	68784528	752	376.0	
63531	chr12	68785334	68785838	504	252.0	
63532	chr12	68787206	68788118	912	456.0	
63533	chr12	68792894	68793396	502	251.0	
63534	chr12	68807165	68809438	2273	1136.0	
63535	chr12	68829995	68830644	649	324.0	
63536	chr12	68863847	68864248	401	200.0	
63537	chr12	68872018	68872416	398	199.0	
63538	chr12	68889830	68889971	141	70.0	
63539	chr12	68897191	68897539	348	174.0	
63540	chr12	68904536	68905022	486	243.0	
63541	chr12	68932104	68933918	1814	907.0	
63542	chr12	68951684	68952174	490	245.0	
63543	chr12	68958343	68958675	332	166.0	
63544	chr12	68963007	68964130	1123	562.0	
63545	chr12	68978337	68979097	760	380.0	
63546	chr12	68997981	68998437	456	228.0	
63547	chr12	69006918	69009057	2139	1070.0	
63548	chr12	69026295	69026827	532	266.0	
63549	chr12	69027946	69027949	3	2.0	
63550	chr12	69039578	69040487	909	454.0	
63551	chr12	69055522	69056269	747	374.0	
63552	chr12	69059465	69059932	467	234.0	
63553	chr12	69070284	69070771	487	244.0	
63554	chr12	69102813	69103301	488	244.0	
63555	chr12	69154330	69155027	697	348.0	
63556	chr12	69156727	69157622	895	448.0	
63557	chr12	69238706	69241065	2359	1180.0	
63558	chr12	69242840	69244102	1262	631.0	
63559	chr12	69253885	69254574	689	344.0	
63560	chr12	69275380	69276063	683	342.0	
63561	chr12	69284058	69284694	636	318.0	
63562	chr12	69290746	69291467	721	360.0	
63563	chr12	69325022	69325500	478	239.0	
63564	chr12	69329681	69332320	2639	1320.0	
63565	chr12	69337594	69338722	1128	564.0	
63566	chr12	69341289	69341768	479	240.0	
63567	chr12	69342625	69342805	180	90.0	
63568	chr12	69343312	69343964	652	326.0	
63569	chr12	69347593	69349063	1470	735.0	
63570	chr12	69354744	69355189	445	222.0	
63571	chr12	69357164	69358109	945	472.0	
63572	chr12	69359178	69360759	1581	790.0	
63573	chr12	69464430	69464776	346	173.0	
63574	chr12	69467133	69467802	669	334.0	
63575	chr12	69469872	69471235	1363	682.0	
63576	chr12	69497357	69498040	683	342.0	
63577	chr12	69570730	69571249	519	260.0	
63578	chr12	69584925	69586415	1490	745.0	
63579	chr12	69616037	69616344	307	154.0	
63580	chr12	69639354	69639837	483	242.0	
63581	chr12	69738146	69740281	2135	1068.0	
63582	chr12	69879316	69879783	467	234.0	
63583	chr12	69885665	69886031	366	183.0	
63584	chr12	69900601	69901004	403	202.0	
63585	chr12	69908138	69908632	494	247.0	
63586	chr12	69913637	69913804	167	84.0	
63587	chr12	69927132	69927717	585	292.0	
63588	chr12	70049765	70050601	836	418.0	
63589	chr12	70052882	70053447	565	282.0	
63590	chr12	70080535	70081014	479	240.0	
63591	chr12	70240582	70241067	485	242.0	
63592	chr12	70242363	70244876	2513	1256.0	
63593	chr12	70246464	70246650	186	93.0	
63594	chr12	70247214	70248217	1003	502.0	
63595	chr12	70260878	70260990	112	56.0	
63596	chr12	70264334	70264646	312	156.0	
63597	chr12	70304764	70305483	719	360.0	
63598	chr12	70317670	70318253	583	292.0	
63599	chr12	70319529	70320099	570	285.0	
63600	chr12	70353764	70355202	1438	719.0	
63601	chr12	70365121	70367773	2652	1326.0	
63602	chr12	70577020	70577428	408	204.0	
63603	chr12	70589953	70590312	359	180.0	
63604	chr12	70609837	70610250	413	206.0	
63605	chr12	70645798	70646170	372	186.0	
63606	chr12	70719829	70719979	150	75.0	
63607	chr12	70730235	70730365	130	65.0	
63608	chr12	71415648	71416044	396	198.0	
63609	chr12	71610011	71610669	658	329.0	
63610	chr12	71626064	71626516	452	226.0	
63611	chr12	71636549	71637090	541	270.0	
63612	chr12	71639370	71639917	547	274.0	
63613	chr12	71645247	71645668	421	210.0	
63614	chr12	71649481	71649748	267	134.0	
63615	chr12	71650927	71651319	392	196.0	
63616	chr12	71662296	71665153	2857	1428.0	
63617	chr12	71665826	71665948	122	61.0	
63618	chr12	71683966	71684614	648	324.0	
63619	chr12	71685468	71687075	1607	804.0	
63620	chr12	71687916	71688492	576	288.0	
63621	chr12	71694501	71694626	125	62.0	
63622	chr12	71746922	71747670	748	374.0	
63623	chr12	71754075	71756445	2370	1185.0	
63624	chr12	71757203	71757378	175	88.0	
63625	chr12	71772732	71773152	420	210.0	
63626	chr12	71780168	71780805	637	318.0	
63627	chr12	71782059	71782313	254	127.0	
63628	chr12	71838886	71841003	2117	1058.0	
63629	chr12	71842307	71843144	837	418.0	
63630	chr12	71844809	71845488	679	340.0	
63631	chr12	71846095	71846773	678	339.0	
63632	chr12	71870399	71870907	508	254.0	
63633	chr12	71938698	71939137	439	220.0	
63634	chr12	72017013	72017446	433	216.0	
63635	chr12	72747394	72747936	542	271.0	
63636	chr12	74482398	74482437	39	20.0	
63637	chr12	74490383	74490917	534	267.0	
63638	chr12	74535473	74535987	514	257.0	
63639	chr12	74537057	74541126	4069	2034.0	
63640	chr12	74900377	74900617	240	120.0	
63641	chr12	75257637	75257689	52	26.0	
63642	chr12	75329690	75330683	993	496.0	
63643	chr12	75334036	75335144	1108	554.0	
63644	chr12	75346273	75346510	237	118.0	
63645	chr12	75364984	75365238	254	127.0	
63646	chr12	75388671	75391925	3254	1627.0	
63647	chr12	75437492	75438538	1046	523.0	
63648	chr12	75457347	75458146	799	400.0	
63649	chr12	75471852	75472734	882	441.0	
63650	chr12	75478031	75485672	7641	3820.0	
63651	chr12	75488497	75488988	491	246.0	
63652	chr12	75493420	75493658	238	119.0	
63653	chr12	75505698	75506205	507	254.0	
63654	chr12	75507150	75507460	310	155.0	
63655	chr12	75510435	75512253	1818	909.0	
63656	chr12	75526649	75527359	710	355.0	
63657	chr12	75640966	75641498	532	266.0	
63658	chr12	75702673	75702869	196	98.0	
63659	chr12	75722636	75723093	457	228.0	
63660	chr12	75815329	75815742	413	206.0	
63661	chr12	75934279	75935065	786	393.0	
63662	chr12	75943968	75945027	1059	530.0	
63663	chr12	75964068	75964701	633	316.0	
63664	chr12	75969498	75970694	1196	598.0	
63665	chr12	75974231	75974784	553	276.0	
63666	chr12	75977473	75979665	2192	1096.0	
63667	chr12	75981856	75982155	299	150.0	
63668	chr12	76019951	76021545	1594	797.0	
63669	chr12	76024965	76025970	1005	502.0	
63670	chr12	76027608	76027769	161	80.0	
63671	chr12	76028545	76029200	655	328.0	
63672	chr12	76029816	76033115	3299	1650.0	
63673	chr12	76037021	76037695	674	337.0	
63674	chr12	76046925	76047284	359	180.0	
63675	chr12	76057056	76057539	483	242.0	
63676	chr12	76060990	76061159	169	84.0	
63677	chr12	76068580	76070769	2189	1094.0	
63678	chr12	76071657	76071744	87	44.0	
63679	chr12	76074769	76075121	352	176.0	
63680	chr12	76079622	76086656	7034	3517.0	
63681	chr12	76092506	76092763	257	128.0	
63682	chr12	76143613	76144573	960	480.0	
63683	chr12	76151601	76152682	1081	540.0	
63684	chr12	76155774	76156430	656	328.0	
63685	chr12	76158384	76159419	1035	518.0	
63686	chr12	76172072	76173043	971	486.0	
63687	chr12	76183440	76183831	391	196.0	
63688	chr12	76340798	76341004	206	103.0	
63689	chr12	76347034	76349117	2083	1042.0	
63690	chr12	76450762	76451070	308	154.0	
63691	chr12	76455712	76456101	389	194.0	
63692	chr12	76470554	76470932	378	189.0	
63693	chr12	76510985	76511717	732	366.0	
63694	chr12	76518247	76519954	1707	854.0	
63695	chr12	76542173	76543328	1155	578.0	
63696	chr12	76551296	76551820	524	262.0	
63697	chr12	76552371	76552943	572	286.0	
63698	chr12	76554341	76555047	706	353.0	
63699	chr12	76556255	76556823	568	284.0	
63700	chr12	76558469	76560632	2163	1082.0	
63701	chr12	76569731	76570222	491	246.0	
63702	chr12	76586755	76587406	651	326.0	
63703	chr12	76588688	76589421	733	366.0	
63704	chr12	76611644	76612045	401	200.0	
63705	chr12	76621407	76621957	550	275.0	
63706	chr12	76666017	76666349	332	166.0	
63707	chr12	76763274	76765272	1998	999.0	
63708	chr12	76768592	76768953	361	180.0	
63709	chr12	76777540	76778133	593	296.0	
63710	chr12	76790942	76791368	426	213.0	
63711	chr12	76878211	76879912	1701	850.0	
63712	chr12	77010922	77011320	398	199.0	
63713	chr12	77049729	77050204	475	238.0	
63714	chr12	77060373	77060886	513	256.0	
63715	chr12	77064895	77066369	1474	737.0	
63716	chr12	77746169	77746365	196	98.0	
63717	chr12	77925586	77925838	252	126.0	
63718	chr12	77998974	78000426	1452	726.0	
63719	chr12	78004618	78005177	559	280.0	
63720	chr12	78033985	78034419	434	217.0	
63721	chr12	78419048	78419313	265	132.0	
63722	chr12	78457957	78458297	340	170.0	
63723	chr12	78636478	78636774	296	148.0	
63724	chr12	78977472	78977862	390	195.0	
63725	chr12	79127305	79127604	299	150.0	
63726	chr12	79688663	79691546	2883	1442.0	
63727	chr12	79871535	79872077	542	271.0	
63728	chr12	79873272	79873294	22	11.0	
63729	chr12	79886856	79887349	493	246.0	
63730	chr12	79918487	79918919	432	216.0	
63731	chr12	79927784	79928722	938	469.0	
63732	chr12	79933381	79936435	3054	1527.0	
63733	chr12	79997193	79997511	318	159.0	
63734	chr12	80083808	80084365	557	278.0	
63735	chr12	80186615	80187076	461	230.0	
63736	chr12	80936481	80938125	1644	822.0	
63737	chr12	80939477	80940100	623	312.0	
63738	chr12	81644560	81644918	358	179.0	
63739	chr12	81758649	81759667	1018	509.0	
63740	chr12	81810082	81811506	1424	712.0	
63741	chr12	81942493	81943085	592	296.0	
63742	chr12	81949407	81950204	797	398.0	
63743	chr12	81955539	81956079	540	270.0	
63744	chr12	81992441	81992844	403	202.0	
63745	chr12	82027895	82028296	401	200.0	
63746	chr12	82040960	82041376	416	208.0	
63747	chr12	82357636	82359560	1924	962.0	
63748	chr12	82650778	82650877	99	50.0	
63749	chr12	82682780	82683311	531	266.0	
63750	chr12	82685537	82688620	3083	1542.0	
63751	chr12	82832071	82832509	438	219.0	
63752	chr12	82845899	82846173	274	137.0	
63753	chr12	82894214	82894216	2	1.0	
63754	chr12	82955105	82955409	304	152.0	
63755	chr12	82966102	82966621	519	260.0	
63756	chr12	83004674	83004977	303	152.0	
63757	chr12	84508277	84508678	401	200.0	
63758	chr12	84874568	84874897	329	164.0	
63759	chr12	85424719	85425033	314	157.0	
63760	chr12	85468615	85469042	427	214.0	
63761	chr12	85909652	85909994	342	171.0	
63762	chr12	87280362	87280739	377	188.0	
63763	chr12	87995674	87995957	283	142.0	
63764	chr12	88034978	88036380	1402	701.0	
63765	chr12	88141403	88143183	1780	890.0	
63766	chr12	88388605	88388980	375	188.0	
63767	chr12	88434278	88434847	569	284.0	
63768	chr12	88580242	88580697	455	228.0	
63769	chr12	88638905	88639515	610	305.0	
63770	chr12	88644918	88645413	495	248.0	
63771	chr12	89017093	89017596	503	252.0	
63772	chr12	89019316	89020035	719	360.0	
63773	chr12	89040067	89040806	739	370.0	
63774	chr12	89050996	89051522	526	263.0	
63775	chr12	89136032	89136413	381	190.0	
63776	chr12	89155838	89157435	1597	798.0	
63777	chr12	89160308	89163377	3069	1534.0	
63778	chr12	89166335	89167219	884	442.0	
63779	chr12	89179955	89180480	525	262.0	
63780	chr12	89184099	89184463	364	182.0	
63781	chr12	89206386	89206774	388	194.0	
63782	chr12	89225232	89226177	945	472.0	
63783	chr12	89235414	89236024	610	305.0	
63784	chr12	89237149	89237168	19	10.0	
63785	chr12	89243682	89245631	1949	974.0	
63786	chr12	89266731	89267132	401	200.0	
63787	chr12	89280739	89281621	882	441.0	
63788	chr12	89306843	89307555	712	356.0	
63789	chr12	89333709	89334379	670	335.0	
63790	chr12	89344780	89344972	192	96.0	
63791	chr12	89345704	89347899	2195	1098.0	
63792	chr12	89348848	89355175	6327	3164.0	
63793	chr12	89375642	89376294	652	326.0	
63794	chr12	89382293	89382783	490	245.0	
63795	chr12	89383303	89384709	1406	703.0	
63796	chr12	89389742	89390482	740	370.0	
63797	chr12	89391402	89391460	58	29.0	
63798	chr12	89397915	89398832	917	458.0	
63799	chr12	89417527	89417682	155	78.0	
63800	chr12	89418217	89418598	381	190.0	
63801	chr12	89424344	89424801	457	228.0	
63802	chr12	89427438	89428336	898	449.0	
63803	chr12	89453651	89453806	155	78.0	
63804	chr12	89461502	89462460	958	479.0	
63805	chr12	89468547	89469807	1260	630.0	
63806	chr12	89470693	89471190	497	248.0	
63807	chr12	89477654	89478033	379	190.0	
63808	chr12	89494410	89494760	350	175.0	
63809	chr12	89514651	89515147	496	248.0	
63810	chr12	89524060	89527187	3127	1564.0	
63811	chr12	89528430	89528820	390	195.0	
63812	chr12	89529493	89530205	712	356.0	
63813	chr12	89542706	89543541	835	418.0	
63814	chr12	89657039	89657808	769	384.0	
63815	chr12	89661622	89662153	531	266.0	
63816	chr12	89663449	89664414	965	482.0	
63817	chr12	89671466	89672579	1113	556.0	
63818	chr12	89674507	89674690	183	92.0	
63819	chr12	89683327	89683560	233	116.0	
63820	chr12	89685376	89685477	101	50.0	
63821	chr12	89695110	89695321	211	106.0	
63822	chr12	89697166	89698155	989	494.0	
63823	chr12	89698734	89698829	95	48.0	
63824	chr12	89699730	89700311	581	290.0	
63825	chr12	89706734	89711139	4405	2202.0	
63826	chr12	89721265	89722208	943	472.0	
63827	chr12	89731379	89732204	825	412.0	
63828	chr12	89733470	89734141	671	336.0	
63829	chr12	89756069	89757559	1490	745.0	
63830	chr12	89760674	89761213	539	270.0	
63831	chr12	89762326	89763066	740	370.0	
63832	chr12	89768804	89769820	1016	508.0	
63833	chr12	89781084	89781598	514	257.0	
63834	chr12	89783462	89784221	759	380.0	
63835	chr12	89787913	89788105	192	96.0	
63836	chr12	89789729	89790406	677	338.0	
63837	chr12	89801314	89801606	292	146.0	
63838	chr12	89840455	89840670	215	108.0	
63839	chr12	89846659	89847032	373	186.0	
63840	chr12	89856319	89856918	599	300.0	
63841	chr12	89857582	89858134	552	276.0	
63842	chr12	89859739	89859846	107	54.0	
63843	chr12	89862522	89864531	2009	1004.0	
63844	chr12	89879188	89879288	100	50.0	
63845	chr12	89880445	89881370	925	462.0	
63846	chr12	89882026	89882427	401	200.0	
63847	chr12	89902212	89902578	366	183.0	
63848	chr12	89924099	89924670	571	286.0	
63849	chr12	89927062	89927783	721	360.0	
63850	chr12	89942636	89943285	649	324.0	
63851	chr12	89947991	89948246	255	128.0	
63852	chr12	89949680	89951573	1893	946.0	
63853	chr12	89960018	89960702	684	342.0	
63854	chr12	89968301	89968660	359	180.0	
63855	chr12	89980196	89980709	513	256.0	
63856	chr12	90013439	90013763	324	162.0	
63857	chr12	90091164	90091723	559	280.0	
63858	chr12	90103006	90103467	461	230.0	
63859	chr12	90217043	90217050	7	4.0	
63860	chr12	90253614	90254262	648	324.0	
63861	chr12	90299117	90299518	401	200.0	
63862	chr12	90941042	90941130	88	44.0	
63863	chr12	90959568	90959917	349	174.0	
63864	chr12	91355340	91355814	474	237.0	
63865	chr12	91361760	91362149	389	194.0	
63866	chr12	91381346	91382511	1165	582.0	
63867	chr12	91562194	91563004	810	405.0	
63868	chr12	91577820	91578277	457	228.0	
63869	chr12	91687298	91687817	519	260.0	
63870	chr12	91778406	91779442	1036	518.0	
63871	chr12	91811538	91812135	597	298.0	
63872	chr12	91852083	91852499	416	208.0	
63873	chr12	91870866	91872308	1442	721.0	
63874	chr12	91875906	91878414	2508	1254.0	
63875	chr12	91947349	91948023	674	337.0	
63876	chr12	91977961	91978843	882	441.0	
63877	chr12	91991383	91991797	414	207.0	
63878	chr12	92000534	92001058	524	262.0	
63879	chr12	92029937	92031379	1442	721.0	
63880	chr12	92034595	92035764	1169	584.0	
63881	chr12	92041739	92042177	438	219.0	
63882	chr12	92047113	92047119	6	3.0	
63883	chr12	92049458	92049853	395	198.0	
63884	chr12	92055817	92056272	455	228.0	
63885	chr12	92058709	92059110	401	200.0	
63886	chr12	92060040	92060353	313	156.0	
63887	chr12	92064981	92065976	995	498.0	
63888	chr12	92070945	92071549	604	302.0	
63889	chr12	92078194	92078419	225	112.0	
63890	chr12	92080048	92080830	782	391.0	
63891	chr12	92088628	92089207	579	290.0	
63892	chr12	92092016	92092413	397	198.0	
63893	chr12	92094308	92094761	453	226.0	
63894	chr12	92096681	92097096	415	208.0	
63895	chr12	92097732	92097882	150	75.0	
63896	chr12	92098948	92101060	2112	1056.0	
63897	chr12	92103137	92103214	77	38.0	
63898	chr12	92104839	92113661	8822	4411.0	
63899	chr12	92114845	92115269	424	212.0	
63900	chr12	92115921	92116925	1004	502.0	
63901	chr12	92118748	92119881	1133	566.0	
63902	chr12	92120801	92148056	27255	13628.0	
63903	chr12	92156978	92157395	417	208.0	
63904	chr12	92158571	92159591	1020	510.0	
63905	chr12	92172337	92173278	941	470.0	
63906	chr12	92184887	92186349	1462	731.0	
63907	chr12	92208040	92209226	1186	593.0	
63908	chr12	92210151	92210500	349	174.0	
63909	chr12	92217645	92219141	1496	748.0	
63910	chr12	92231954	92232355	401	200.0	
63911	chr12	92233341	92233784	443	222.0	
63912	chr12	92234503	92234931	428	214.0	
63913	chr12	92297654	92298518	864	432.0	
63914	chr12	92300684	92301685	1001	500.0	
63915	chr12	92340935	92341605	670	335.0	
63916	chr12	92360312	92361057	745	372.0	
63917	chr12	92362676	92364550	1874	937.0	
63918	chr12	92378839	92379516	677	338.0	
63919	chr12	92398260	92400627	2367	1184.0	
63920	chr12	92402413	92402711	298	149.0	
63921	chr12	92403363	92404762	1399	700.0	
63922	chr12	92405689	92406409	720	360.0	
63923	chr12	92407945	92408556	611	306.0	
63924	chr12	92418405	92418763	358	179.0	
63925	chr12	92431151	92431629	478	239.0	
63926	chr12	92432876	92433191	315	158.0	
63927	chr12	92434739	92435166	427	214.0	
63928	chr12	92437453	92437793	340	170.0	
63929	chr12	92442808	92443119	311	156.0	
63930	chr12	92444555	92446213	1658	829.0	
63931	chr12	92461907	92462551	644	322.0	
63932	chr12	92466382	92467382	1000	500.0	
63933	chr12	92470662	92470868	206	103.0	
63934	chr12	92488757	92489145	388	194.0	
63935	chr12	92502318	92503405	1087	544.0	
63936	chr12	92504613	92506352	1739	870.0	
63937	chr12	92524550	92524565	15	8.0	
63938	chr12	92538947	92541361	2414	1207.0	
63939	chr12	92551833	92552308	475	238.0	
63940	chr12	92553502	92553622	120	60.0	
63941	chr12	92556078	92556705	627	314.0	
63942	chr12	92569886	92570971	1085	542.0	
63943	chr12	92574385	92574837	452	226.0	
63944	chr12	92591547	92595460	3913	1956.0	
63945	chr12	92601177	92602838	1661	830.0	
63946	chr12	92603749	92604136	387	194.0	
63947	chr12	92608375	92608899	524	262.0	
63948	chr12	92649545	92650397	852	426.0	
63949	chr12	92702743	92703339	596	298.0	
63950	chr12	92769110	92769830	720	360.0	
63951	chr12	92785019	92785566	547	274.0	
63952	chr12	92827844	92828231	387	194.0	
63953	chr12	92899356	92900047	691	346.0	
63954	chr12	92908061	92908496	435	218.0	
63955	chr12	92911295	92912582	1287	644.0	
63956	chr12	92926752	92930274	3522	1761.0	
63957	chr12	92941049	92941593	544	272.0	
63958	chr12	92970798	92971592	794	397.0	
63959	chr12	92973506	92974076	570	285.0	
63960	chr12	92987237	92988527	1290	645.0	
63961	chr12	92995506	92995951	445	222.0	
63962	chr12	93060042	93060754	712	356.0	
63963	chr12	93089820	93090498	678	339.0	
63964	chr12	93097978	93098712	734	367.0	
63965	chr12	93127611	93128304	693	346.0	
63966	chr12	93134483	93135640	1157	578.0	
63967	chr12	93136754	93136933	179	90.0	
63968	chr12	93137997	93139659	1662	831.0	
63969	chr12	93166872	93167211	339	170.0	
63970	chr12	93167776	93168085	309	154.0	
63971	chr12	93184141	93185019	878	439.0	
63972	chr12	93186262	93186471	209	104.0	
63973	chr12	93238484	93238825	341	170.0	
63974	chr12	93243547	93244892	1345	672.0	
63975	chr12	93245522	93245943	421	210.0	
63976	chr12	93249383	93250082	699	350.0	
63977	chr12	93274030	93274350	320	160.0	
63978	chr12	93363908	93364435	527	264.0	
63979	chr12	93376396	93381204	4808	2404.0	
63980	chr12	93389974	93390999	1025	512.0	
63981	chr12	93396520	93397192	672	336.0	
63982	chr12	93399048	93399599	551	276.0	
63983	chr12	93402498	93403319	821	410.0	
63984	chr12	93404318	93404673	355	178.0	
63985	chr12	93405235	93406388	1153	576.0	
63986	chr12	93407086	93407749	663	332.0	
63987	chr12	93412991	93413580	589	294.0	
63988	chr12	93416187	93416893	706	353.0	
63989	chr12	93419177	93421275	2098	1049.0	
63990	chr12	93425937	93426663	726	363.0	
63991	chr12	93434058	93434688	630	315.0	
63992	chr12	93435944	93439457	3513	1756.0	
63993	chr12	93440287	93443200	2913	1456.0	
63994	chr12	93447553	93448319	766	383.0	
63995	chr12	93460914	93461315	401	200.0	
63996	chr12	93466861	93468367	1506	753.0	
63997	chr12	93502981	93503473	492	246.0	
63998	chr12	93568962	93574118	5156	2578.0	
63999	chr12	93587649	93587983	334	167.0	
64000	chr12	93591023	93592070	1047	524.0	
64001	chr12	93676647	93678447	1800	900.0	
64002	chr12	93741592	93743079	1487	744.0	
64003	chr12	93767083	93767931	848	424.0	
64004	chr12	93772034	93773739	1705	852.0	
64005	chr12	93777279	93777680	401	200.0	
64006	chr12	93783833	93785868	2035	1018.0	
64007	chr12	93847361	93849369	2008	1004.0	
64008	chr12	93851264	93851827	563	282.0	
64009	chr12	93853664	93854466	802	401.0	
64010	chr12	93855465	93855577	112	56.0	
64011	chr12	93889813	93890178	365	182.0	
64012	chr12	93979259	93979512	253	126.0	
64013	chr12	94007702	94008272	570	285.0	
64014	chr12	94012512	94013034	522	261.0	
64015	chr12	94013842	94014277	435	218.0	
64016	chr12	94025766	94026222	456	228.0	
64017	chr12	94033127	94033523	396	198.0	
64018	chr12	94075279	94075718	439	220.0	
64019	chr12	94101209	94102892	1683	842.0	
64020	chr12	94112000	94112629	629	314.0	
64021	chr12	94122647	94124511	1864	932.0	
64022	chr12	94125811	94126612	801	400.0	
64023	chr12	94127524	94127566	42	21.0	
64024	chr12	94128236	94128639	403	202.0	
64025	chr12	94133982	94134688	706	353.0	
64026	chr12	94140535	94141010	475	238.0	
64027	chr12	94145575	94146021	446	223.0	
64028	chr12	94147484	94151267	3783	1892.0	
64029	chr12	94152189	94152751	562	281.0	
64030	chr12	94158050	94158495	445	222.0	
64031	chr12	94171950	94175114	3164	1582.0	
64032	chr12	94175899	94176587	688	344.0	
64033	chr12	94178924	94179280	356	178.0	
64034	chr12	94180347	94181430	1083	542.0	
64035	chr12	94202828	94203073	245	122.0	
64036	chr12	94204769	94205170	401	200.0	
64037	chr12	94205671	94206365	694	347.0	
64038	chr12	94207558	94209028	1470	735.0	
64039	chr12	94231660	94232029	369	184.0	
64040	chr12	94239891	94240683	792	396.0	
64041	chr12	94242927	94243228	301	150.0	
64042	chr12	94244115	94245376	1261	630.0	
64043	chr12	94261941	94264346	2405	1202.0	
64044	chr12	94266286	94267522	1236	618.0	
64045	chr12	94271467	94271612	145	72.0	
64046	chr12	94272245	94272571	326	163.0	
64047	chr12	94282523	94283507	984	492.0	
64048	chr12	94297366	94297676	310	155.0	
64049	chr12	94318155	94318586	431	216.0	
64050	chr12	94336660	94336899	239	120.0	
64051	chr12	94458745	94460962	2217	1108.0	
64052	chr12	94472721	94473109	388	194.0	
64053	chr12	94488436	94488839	403	202.0	
64054	chr12	94532730	94533417	687	344.0	
64055	chr12	94546140	94546609	469	234.0	
64056	chr12	94551091	94551198	107	54.0	
64057	chr12	94603384	94603907	523	262.0	
64058	chr12	94618999	94619175	176	88.0	
64059	chr12	94621289	94622382	1093	546.0	
64060	chr12	94640122	94641141	1019	510.0	
64061	chr12	94643524	94645141	1617	808.0	
64062	chr12	94649437	94651005	1568	784.0	
64063	chr12	94663136	94664087	951	476.0	
64064	chr12	94674766	94678539	3773	1886.0	
64065	chr12	94682615	94683114	499	250.0	
64066	chr12	94689146	94689706	560	280.0	
64067	chr12	94699850	94700193	343	172.0	
64068	chr12	94710910	94711303	393	196.0	
64069	chr12	94721080	94721625	545	272.0	
64070	chr12	94725769	94726163	394	197.0	
64071	chr12	94764169	94764635	466	233.0	
64072	chr12	94769016	94769438	422	211.0	
64073	chr12	94792658	94793099	441	220.0	
64074	chr12	94818058	94818712	654	327.0	
64075	chr12	94830939	94831905	966	483.0	
64076	chr12	94832905	94833445	540	270.0	
64077	chr12	94873083	94874012	929	464.0	
64078	chr12	94875607	94875960	353	176.0	
64079	chr12	94938794	94938991	197	98.0	
64080	chr12	94941340	94942036	696	348.0	
64081	chr12	94942735	94943043	308	154.0	
64082	chr12	94943652	94944254	602	301.0	
64083	chr12	94980637	94980963	326	163.0	
64084	chr12	94987550	94988898	1348	674.0	
64085	chr12	95002982	95005049	2067	1034.0	
64086	chr12	95010031	95010125	94	47.0	
64087	chr12	95072437	95074202	1765	882.0	
64088	chr12	95095792	95096201	409	204.0	
64089	chr12	95103119	95104297	1178	589.0	
64090	chr12	95116885	95117704	819	410.0	
64091	chr12	95126720	95127047	327	164.0	
64092	chr12	95131813	95133307	1494	747.0	
64093	chr12	95185856	95186216	360	180.0	
64094	chr12	95204341	95204807	466	233.0	
64095	chr12	95205314	95206012	698	349.0	
64096	chr12	95215880	95219262	3382	1691.0	
64097	chr12	95334358	95334808	450	225.0	
64098	chr12	95428412	95428892	480	240.0	
64099	chr12	95473074	95475138	2064	1032.0	
64100	chr12	95534308	95534872	564	282.0	
64101	chr12	95547764	95549561	1797	898.0	
64102	chr12	95552149	95552491	342	171.0	
64103	chr12	95571380	95571762	382	191.0	
64104	chr12	95574155	95574472	317	158.0	
64105	chr12	95654231	95654537	306	153.0	
64106	chr12	95789595	95791621	2026	1013.0	
64107	chr12	95805674	95806347	673	336.0	
64108	chr12	95851612	95851875	263	132.0	
64109	chr12	95857798	95859980	2182	1091.0	
64110	chr12	95918420	95918944	524	262.0	
64111	chr12	95942205	95943956	1751	876.0	
64112	chr12	95951462	95951861	399	200.0	
64113	chr12	95995514	95996806	1292	646.0	
64114	chr12	95998379	95999324	945	472.0	
64115	chr12	96020210	96020790	580	290.0	
64116	chr12	96029685	96030239	554	277.0	
64117	chr12	96034510	96038023	3513	1756.0	
64118	chr12	96044214	96045997	1783	892.0	
64119	chr12	96046989	96048432	1443	722.0	
64120	chr12	96053884	96055637	1753	876.0	
64121	chr12	96061627	96062666	1039	520.0	
64122	chr12	96064342	96064735	393	196.0	
64123	chr12	96100002	96100336	334	167.0	
64124	chr12	96108209	96108741	532	266.0	
64125	chr12	96120582	96121878	1296	648.0	
64126	chr12	96132800	96133194	394	197.0	
64127	chr12	96136650	96137183	533	266.0	
64128	chr12	96143323	96143952	629	314.0	
64129	chr12	96170443	96170541	98	49.0	
64130	chr12	96176850	96177567	717	358.0	
64131	chr12	96190367	96190901	534	267.0	
64132	chr12	96191690	96197161	5471	2736.0	
64133	chr12	96197971	96199506	1535	768.0	
64134	chr12	96205612	96206427	815	408.0	
64135	chr12	96208626	96209636	1010	505.0	
64136	chr12	96210181	96210923	742	371.0	
64137	chr12	96211916	96212851	935	468.0	
64138	chr12	96214790	96215893	1103	552.0	
64139	chr12	96236138	96238529	2391	1196.0	
64140	chr12	96240549	96243509	2960	1480.0	
64141	chr12	96249560	96250837	1277	638.0	
64142	chr12	96255174	96257037	1863	932.0	
64143	chr12	96257805	96258920	1115	558.0	
64144	chr12	96260951	96261158	207	104.0	
64145	chr12	96294976	96294978	2	1.0	
64146	chr12	96315674	96316680	1006	503.0	
64147	chr12	96327444	96328223	779	390.0	
64148	chr12	96335259	96335624	365	182.0	
64149	chr12	96343403	96343992	589	294.0	
64150	chr12	96346698	96347733	1035	518.0	
64151	chr12	96350878	96351551	673	336.0	
64152	chr12	96352102	96352635	533	266.0	
64153	chr12	96360577	96360883	306	153.0	
64154	chr12	96368223	96368621	398	199.0	
64155	chr12	96373135	96373853	718	359.0	
64156	chr12	96377425	96378635	1210	605.0	
64157	chr12	96382858	96382864	6	3.0	
64158	chr12	96384348	96385297	949	474.0	
64159	chr12	96386282	96387309	1027	514.0	
64160	chr12	96390023	96390085	62	31.0	
64161	chr12	96393320	96393497	177	88.0	
64162	chr12	96395687	96396033	346	173.0	
64163	chr12	96398187	96402129	3942	1971.0	
64164	chr12	96407413	96408315	902	451.0	
64165	chr12	96409733	96410080	347	174.0	
64166	chr12	96416402	96416900	498	249.0	
64167	chr12	96419897	96420241	344	172.0	
64168	chr12	96420841	96421585	744	372.0	
64169	chr12	96433829	96434990	1161	580.0	
64170	chr12	96441762	96442264	502	251.0	
64171	chr12	96445285	96446800	1515	758.0	
64172	chr12	96455706	96456012	306	153.0	
64173	chr12	96456521	96457060	539	270.0	
64174	chr12	96473292	96473832	540	270.0	
64175	chr12	96474369	96474446	77	38.0	
64176	chr12	96484967	96485836	869	434.0	
64177	chr12	96489064	96490203	1139	570.0	
64178	chr12	96495921	96496199	278	139.0	
64179	chr12	96500981	96501701	720	360.0	
64180	chr12	96516458	96517156	698	349.0	
64181	chr12	96578521	96578922	401	200.0	
64182	chr12	96719959	96720710	751	376.0	
64183	chr12	96902045	96902451	406	203.0	
64184	chr12	96906293	96909004	2711	1356.0	
64185	chr12	96910200	96910732	532	266.0	
64186	chr12	96985398	96986128	730	365.0	
64187	chr12	97148949	97149341	392	196.0	
64188	chr12	97306252	97306486	234	117.0	
64189	chr12	97308596	97308997	401	200.0	
64190	chr12	98188598	98188901	303	152.0	
64191	chr12	98397134	98398149	1015	508.0	
64192	chr12	98399321	98399981	660	330.0	
64193	chr12	98408445	98409385	940	470.0	
64194	chr12	98416859	98417768	909	454.0	
64195	chr12	98424718	98425243	525	262.0	
64196	chr12	98437792	98440734	2942	1471.0	
64197	chr12	98446666	98447411	745	372.0	
64198	chr12	98456136	98457429	1293	646.0	
64199	chr12	98464025	98464648	623	312.0	
64200	chr12	98466130	98466378	248	124.0	
64201	chr12	98470929	98471316	387	194.0	
64202	chr12	98490576	98491628	1052	526.0	
64203	chr12	98497160	98497680	520	260.0	
64204	chr12	98502527	98505137	2610	1305.0	
64205	chr12	98513897	98517205	3308	1654.0	
64206	chr12	98517718	98519174	1456	728.0	
64207	chr12	98520186	98520734	548	274.0	
64208	chr12	98532663	98533165	502	251.0	
64209	chr12	98566751	98567465	714	357.0	
64210	chr12	98592502	98596726	4224	2112.0	
64211	chr12	98599745	98599756	11	6.0	
64212	chr12	98600473	98600486	13	6.0	
64213	chr12	98602105	98603518	1413	706.0	
64214	chr12	98605498	98605899	401	200.0	
64215	chr12	98606504	98607936	1432	716.0	
64216	chr12	98612625	98613480	855	428.0	
64217	chr12	98618869	98619472	603	302.0	
64218	chr12	98643658	98647028	3370	1685.0	
64219	chr12	98653790	98654346	556	278.0	
64220	chr12	98698784	98699995	1211	606.0	
64221	chr12	98743571	98743724	153	76.0	
64222	chr12	98745634	98746163	529	264.0	
64223	chr12	99130881	99132281	1400	700.0	
64224	chr12	99136952	99137875	923	462.0	
64225	chr12	99146153	99146591	438	219.0	
64226	chr12	99147230	99147478	248	124.0	
64227	chr12	100116415	100116447	32	16.0	
64228	chr12	100127846	100128937	1091	546.0	
64229	chr12	100137930	100139080	1150	575.0	
64230	chr12	100141518	100143651	2133	1066.0	
64231	chr12	100154486	100155432	946	473.0	
64232	chr12	100163731	100164528	797	398.0	
64233	chr12	100185285	100185682	397	198.0	
64234	chr12	100199124	100201512	2388	1194.0	
64235	chr12	100202532	100203446	914	457.0	
64236	chr12	100215223	100215307	84	42.0	
64237	chr12	100229883	100230201	318	159.0	
64238	chr12	100234710	100235039	329	164.0	
64239	chr12	100266209	100268361	2152	1076.0	
64240	chr12	100269101	100269474	373	186.0	
64241	chr12	100320037	100320449	412	206.0	
64242	chr12	100567123	100567700	577	288.0	
64243	chr12	100573176	100574631	1455	728.0	
64244	chr12	100576380	100577223	843	422.0	
64245	chr12	100603036	100603355	319	160.0	
64246	chr12	100608671	100609178	507	254.0	
64247	chr12	100610466	100611134	668	334.0	
64248	chr12	100668963	100669296	333	166.0	
64249	chr12	100672045	100672381	336	168.0	
64250	chr12	100699242	100699587	345	172.0	
64251	chr12	100987838	100988336	498	249.0	
64252	chr12	101279340	101280735	1395	698.0	
64253	chr12	101323708	101324069	361	180.0	
64254	chr12	101356811	101357155	344	172.0	
64255	chr12	101406851	101408886	2035	1018.0	
64256	chr12	101414509	101414956	447	224.0	
64257	chr12	101441821	101442169	348	174.0	
64258	chr12	101455609	101456176	567	284.0	
64259	chr12	101615629	101616668	1039	520.0	
64260	chr12	101620606	101621009	403	202.0	
64261	chr12	101634571	101635222	651	326.0	
64262	chr12	101669912	101672291	2379	1190.0	
64263	chr12	101696637	101699103	2466	1233.0	
64264	chr12	101715052	101715402	350	175.0	
64265	chr12	101743608	101744588	980	490.0	
64266	chr12	101747684	101748146	462	231.0	
64267	chr12	101759431	101759891	460	230.0	
64268	chr12	101763125	101763798	673	336.0	
64269	chr12	101771981	101772382	401	200.0	
64270	chr12	101773492	101774179	687	344.0	
64271	chr12	101777430	101778011	581	290.0	
64272	chr12	101780526	101781227	701	350.0	
64273	chr12	101792565	101792974	409	204.0	
64274	chr12	101795802	101796190	388	194.0	
64275	chr12	101799726	101800214	488	244.0	
64276	chr12	101804130	101804142	12	6.0	
64277	chr12	101806286	101806525	239	120.0	
64278	chr12	101811529	101811550	21	10.0	
64279	chr12	101823398	101824567	1169	584.0	
64280	chr12	101826790	101827225	435	218.0	
64281	chr12	101828414	101831676	3262	1631.0	
64282	chr12	101838471	101840373	1902	951.0	
64283	chr12	101850121	101850596	475	238.0	
64284	chr12	101854801	101855072	271	136.0	
64285	chr12	101856349	101856389	40	20.0	
64286	chr12	101857056	101857722	666	333.0	
64287	chr12	101859788	101859991	203	102.0	
64288	chr12	101865898	101866371	473	236.0	
64289	chr12	101874159	101874537	378	189.0	
64290	chr12	101875652	101875885	233	116.0	
64291	chr12	101876504	101878995	2491	1246.0	
64292	chr12	101880061	101880616	555	278.0	
64293	chr12	101887422	101887820	398	199.0	
64294	chr12	101889185	101889815	630	315.0	
64295	chr12	101891551	101891936	385	192.0	
64296	chr12	101902409	101903060	651	326.0	
64297	chr12	101909551	101910103	552	276.0	
64298	chr12	101917426	101918171	745	372.0	
64299	chr12	101925346	101926050	704	352.0	
64300	chr12	101931752	101932227	475	238.0	
64301	chr12	101936147	101936556	409	204.0	
64302	chr12	101939756	101940177	421	210.0	
64303	chr12	101941617	101941974	357	178.0	
64304	chr12	101967612	101967777	165	82.0	
64305	chr12	102010134	102010900	766	383.0	
64306	chr12	102044003	102044250	247	124.0	
64307	chr12	102059415	102059675	260	130.0	
64308	chr12	102060897	102062715	1818	909.0	
64309	chr12	102095820	102095854	34	17.0	
64310	chr12	102119483	102121334	1851	926.0	
64311	chr12	102170064	102170277	213	106.0	
64312	chr12	102478672	102479397	725	362.0	
64313	chr12	102484265	102484882	617	308.0	
64314	chr12	102498393	102499026	633	316.0	
64315	chr12	102503157	102503754	597	298.0	
64316	chr12	102504275	102504725	450	225.0	
64317	chr12	102735222	102735500	278	139.0	
64318	chr12	102769584	102769919	335	168.0	
64319	chr12	102917167	102917570	403	202.0	
64320	chr12	102948896	102949210	314	157.0	
64321	chr12	103269060	103269461	401	200.0	
64322	chr12	103399992	103400399	407	204.0	
64323	chr12	103441229	103442235	1006	503.0	
64324	chr12	103442909	103443173	264	132.0	
64325	chr12	103455278	103455811	533	266.0	
64326	chr12	103494555	103496584	2029	1014.0	
64327	chr12	103503802	103504345	543	272.0	
64328	chr12	103548600	103549033	433	216.0	
64329	chr12	103575244	103575819	575	288.0	
64330	chr12	103632588	103632891	303	152.0	
64331	chr12	103698162	103698192	30	15.0	
64332	chr12	103698831	103699084	253	126.0	
64333	chr12	103771455	103771819	364	182.0	
64334	chr12	103799404	103800236	832	416.0	
64335	chr12	103802142	103802187	45	22.0	
64336	chr12	103806599	103807341	742	371.0	
64337	chr12	103829051	103829500	449	224.0	
64338	chr12	103831442	103832774	1332	666.0	
64339	chr12	103840295	103842531	2236	1118.0	
64340	chr12	103877371	103878388	1017	508.0	
64341	chr12	103880675	103880940	265	132.0	
64342	chr12	103884224	103884688	464	232.0	
64343	chr12	103901491	103902248	757	378.0	
64344	chr12	103925428	103925541	113	56.0	
64345	chr12	103928209	103931797	3588	1794.0	
64346	chr12	103936406	103937043	637	318.0	
64347	chr12	103949090	103949395	305	152.0	
64348	chr12	103950439	103950463	24	12.0	
64349	chr12	103956265	103957998	1733	866.0	
64350	chr12	103964966	103966759	1793	896.0	
64351	chr12	104050036	104050160	124	62.0	
64352	chr12	104057646	104058212	566	283.0	
64353	chr12	104063520	104065491	1971	986.0	
64354	chr12	104108746	104109613	867	434.0	
64355	chr12	104136952	104138953	2001	1000.0	
64356	chr12	104154300	104154705	405	202.0	
64357	chr12	104177527	104177928	401	200.0	
64358	chr12	104201148	104201645	497	248.0	
64359	chr12	104215306	104216736	1430	715.0	
64360	chr12	104219949	104220373	424	212.0	
64361	chr12	104253417	104253774	357	178.0	
64362	chr12	104276202	104276564	362	181.0	
64363	chr12	104286100	104289985	3885	1942.0	
64364	chr12	104294232	104294542	310	155.0	
64365	chr12	104300131	104300485	354	177.0	
64366	chr12	104302499	104304535	2036	1018.0	
64367	chr12	104314132	104314581	449	224.0	
64368	chr12	104358123	104358950	827	414.0	
64369	chr12	104372020	104372505	485	242.0	
64370	chr12	104381611	104382597	986	493.0	
64371	chr12	104427436	104428001	565	282.0	
64372	chr12	104455557	104461712	6155	3078.0	
64373	chr12	104462628	104464308	1680	840.0	
64374	chr12	104465156	104465792	636	318.0	
64375	chr12	104467317	104467969	652	326.0	
64376	chr12	104469544	104469906	362	181.0	
64377	chr12	104473236	104474200	964	482.0	
64378	chr12	104477459	104479141	1682	841.0	
64379	chr12	104480788	104481533	745	372.0	
64380	chr12	104482138	104482534	396	198.0	
64381	chr12	104485430	104486232	802	401.0	
64382	chr12	104490116	104491198	1082	541.0	
64383	chr12	104493965	104495310	1345	672.0	
64384	chr12	104497293	104498821	1528	764.0	
64385	chr12	104511190	104511333	143	72.0	
64386	chr12	104519039	104519826	787	394.0	
64387	chr12	104520355	104520797	442	221.0	
64388	chr12	104523121	104523930	809	404.0	
64389	chr12	104536891	104537040	149	74.0	
64390	chr12	104546435	104547047	612	306.0	
64391	chr12	104551612	104552003	391	196.0	
64392	chr12	104553396	104553747	351	176.0	
64393	chr12	104568081	104571870	3789	1894.0	
64394	chr12	104580149	104580322	173	86.0	
64395	chr12	104582661	104583232	571	286.0	
64396	chr12	104596180	104596552	372	186.0	
64397	chr12	104603537	104605081	1544	772.0	
64398	chr12	104605629	104606226	597	298.0	
64399	chr12	104637446	104638740	1294	647.0	
64400	chr12	104640965	104645125	4160	2080.0	
64401	chr12	104648717	104650494	1777	888.0	
64402	chr12	104651860	104652031	171	86.0	
64403	chr12	104652852	104654152	1300	650.0	
64404	chr12	104666927	104667638	711	356.0	
64405	chr12	104668247	104668297	50	25.0	
64406	chr12	104669615	104672866	3251	1626.0	
64407	chr12	104679993	104681011	1018	509.0	
64408	chr12	104682345	104683574	1229	614.0	
64409	chr12	104687423	104688599	1176	588.0	
64410	chr12	104689540	104690068	528	264.0	
64411	chr12	104691665	104692384	719	360.0	
64412	chr12	104695252	104696238	986	493.0	
64413	chr12	104699577	104699898	321	160.0	
64414	chr12	104718920	104721623	2703	1352.0	
64415	chr12	104727829	104728575	746	373.0	
64416	chr12	104733717	104734054	337	168.0	
64417	chr12	104738452	104739474	1022	511.0	
64418	chr12	104740400	104741544	1144	572.0	
64419	chr12	104748831	104749265	434	217.0	
64420	chr12	104749829	104750685	856	428.0	
64421	chr12	104751556	104752032	476	238.0	
64422	chr12	104763082	104763659	577	288.0	
64423	chr12	104764419	104765060	641	320.0	
64424	chr12	104790488	104790930	442	221.0	
64425	chr12	104823842	104824356	514	257.0	
64426	chr12	104865068	104865633	565	282.0	
64427	chr12	104877105	104877475	370	185.0	
64428	chr12	104957082	104959216	2134	1067.0	
64429	chr12	104974451	104975240	789	394.0	
64430	chr12	104977238	104977576	338	169.0	
64431	chr12	104985595	104987104	1509	754.0	
64432	chr12	104997489	104997950	461	230.0	
64433	chr12	105031031	105031481	450	225.0	
64434	chr12	105052959	105053584	625	312.0	
64435	chr12	105083542	105084941	1399	700.0	
64436	chr12	105099348	105099654	306	153.0	
64437	chr12	105106978	105110218	3240	1620.0	
64438	chr12	105226192	105226574	382	191.0	
64439	chr12	105235132	105237018	1886	943.0	
64440	chr12	105279451	105279915	464	232.0	
64441	chr12	105319825	105320145	320	160.0	
64442	chr12	105321217	105321551	334	167.0	
64443	chr12	105326574	105327255	681	340.0	
64444	chr12	105328461	105328843	382	191.0	
64445	chr12	105329838	105332373	2535	1268.0	
64446	chr12	105335973	105336121	148	74.0	
64447	chr12	105358759	105359214	455	228.0	
64448	chr12	105383294	105383751	457	228.0	
64449	chr12	105420637	105421038	401	200.0	
64450	chr12	105738139	105738270	131	66.0	
64451	chr12	105783995	105784770	775	388.0	
64452	chr12	106113205	106113318	113	56.0	
64453	chr12	106136150	106136572	422	211.0	
64454	chr12	106138357	106139813	1456	728.0	
64455	chr12	106223872	106224587	715	358.0	
64456	chr12	106226754	106228127	1373	686.0	
64457	chr12	106234445	106234947	502	251.0	
64458	chr12	106245768	106250253	4485	2242.0	
64459	chr12	106251515	106251949	434	217.0	
64460	chr12	106269083	106269479	396	198.0	
64461	chr12	106273534	106273882	348	174.0	
64462	chr12	106281881	106282860	979	490.0	
64463	chr12	106288381	106288834	453	226.0	
64464	chr12	106301304	106304809	3505	1752.0	
64465	chr12	106305450	106306056	606	303.0	
64466	chr12	106310245	106310931	686	343.0	
64467	chr12	106332562	106332909	347	174.0	
64468	chr12	106336420	106336633	213	106.0	
64469	chr12	106345791	106346210	419	210.0	
64470	chr12	106357188	106358898	1710	855.0	
64471	chr12	106386106	106386612	506	253.0	
64472	chr12	106454996	106455589	593	296.0	
64473	chr12	106736372	106736857	485	242.0	
64474	chr12	106740826	106741203	377	188.0	
64475	chr12	106747454	106748712	1258	629.0	
64476	chr12	106753398	106754040	642	321.0	
64477	chr12	106759893	106760701	808	404.0	
64478	chr12	106773389	106775502	2113	1056.0	
64479	chr12	106841757	106841908	151	76.0	
64480	chr12	106903472	106904019	547	274.0	
64481	chr12	106910158	106910782	624	312.0	
64482	chr12	106919887	106920315	428	214.0	
64483	chr12	106952883	106953099	216	108.0	
64484	chr12	106954496	106957754	3258	1629.0	
64485	chr12	106986310	106987841	1531	766.0	
64486	chr12	107014059	107014490	431	216.0	
64487	chr12	107027242	107028191	949	474.0	
64488	chr12	107032324	107032657	333	166.0	
64489	chr12	107066753	107067026	273	136.0	
64490	chr12	107078870	107079645	775	388.0	
64491	chr12	107086424	107086732	308	154.0	
64492	chr12	107091835	107094671	2836	1418.0	
64493	chr12	107104452	107105161	709	354.0	
64494	chr12	107126916	107127017	101	50.0	
64495	chr12	107131781	107132209	428	214.0	
64496	chr12	107134512	107135021	509	254.0	
64497	chr12	107178656	107179311	655	328.0	
64498	chr12	107277806	107278195	389	194.0	
64499	chr12	107287711	107288057	346	173.0	
64500	chr12	107309025	107309465	440	220.0	
64501	chr12	107317442	107322524	5082	2541.0	
64502	chr12	107328416	107330228	1812	906.0	
64503	chr12	107337307	107337675	368	184.0	
64504	chr12	107351964	107353139	1175	588.0	
64505	chr12	107368381	107370897	2516	1258.0	
64506	chr12	107371949	107374682	2733	1366.0	
64507	chr12	107400919	107401503	584	292.0	
64508	chr12	107402304	107402865	561	280.0	
64509	chr12	107404993	107405399	406	203.0	
64510	chr12	107441977	107442194	217	108.0	
64511	chr12	107607440	107607935	495	248.0	
64512	chr12	107660117	107660667	550	275.0	
64513	chr12	107662437	107662761	324	162.0	
64514	chr12	107663434	107663539	105	52.0	
64515	chr12	107670988	107671455	467	234.0	
64516	chr12	107676145	107676856	711	356.0	
64517	chr12	107684930	107686527	1597	798.0	
64518	chr12	107731409	107731716	307	154.0	
64519	chr12	107736776	107737396	620	310.0	
64520	chr12	107759724	107762130	2406	1203.0	
64521	chr12	107775223	107775612	389	194.0	
64522	chr12	107778536	107779883	1347	674.0	
64523	chr12	107783743	107784071	328	164.0	
64524	chr12	107885013	107885527	514	257.0	
64525	chr12	107903254	107904057	803	402.0	
64526	chr12	107912271	107913089	818	409.0	
64527	chr12	108119277	108119677	400	200.0	
64528	chr12	108129322	108129777	455	228.0	
64529	chr12	108234211	108234526	315	158.0	
64530	chr12	108268417	108268802	385	192.0	
64531	chr12	108297889	108298644	755	378.0	
64532	chr12	108300791	108301305	514	257.0	
64533	chr12	108305577	108307421	1844	922.0	
64534	chr12	108312226	108314552	2326	1163.0	
64535	chr12	108315544	108315913	369	184.0	
64536	chr12	108317661	108318163	502	251.0	
64537	chr12	108320530	108320931	401	200.0	
64538	chr12	108332583	108334853	2270	1135.0	
64539	chr12	108335794	108336050	256	128.0	
64540	chr12	108337278	108338028	750	375.0	
64541	chr12	108339006	108339819	813	406.0	
64542	chr12	108367291	108368073	782	391.0	
64543	chr12	108457201	108457635	434	217.0	
64544	chr12	108495032	108495302	270	135.0	
64545	chr12	108511664	108512549	885	442.0	
64546	chr12	108514458	108516966	2508	1254.0	
64547	chr12	108517844	108517871	27	14.0	
64548	chr12	108519604	108519894	290	145.0	
64549	chr12	108541097	108541843	746	373.0	
64550	chr12	108547480	108548149	669	334.0	
64551	chr12	108559091	108559291	200	100.0	
64552	chr12	108559947	108564168	4221	2110.0	
64553	chr12	108565982	108566445	463	232.0	
64554	chr12	108567297	108569360	2063	1032.0	
64555	chr12	108570801	108571105	304	152.0	
64556	chr12	108575587	108576033	446	223.0	
64557	chr12	108578925	108579168	243	122.0	
64558	chr12	108612076	108612626	550	275.0	
64559	chr12	108613546	108613793	247	124.0	
64560	chr12	108616606	108618906	2300	1150.0	
64561	chr12	108620292	108620750	458	229.0	
64562	chr12	108622151	108623199	1048	524.0	
64563	chr12	108628141	108636511	8370	4185.0	
64564	chr12	108637197	108637733	536	268.0	
64565	chr12	108638306	108638902	596	298.0	
64566	chr12	108640991	108642833	1842	921.0	
64567	chr12	108646201	108646230	29	14.0	
64568	chr12	108664291	108665503	1212	606.0	
64569	chr12	108667229	108667925	696	348.0	
64570	chr12	108689698	108690384	686	343.0	
64571	chr12	108690933	108692853	1920	960.0	
64572	chr12	108696302	108696749	447	224.0	
64573	chr12	108702051	108702559	508	254.0	
64574	chr12	108712327	108712848	521	260.0	
64575	chr12	108714181	108714642	461	230.0	
64576	chr12	108722959	108724965	2006	1003.0	
64577	chr12	108729866	108732955	3089	1544.0	
64578	chr12	108734142	108735556	1414	707.0	
64579	chr12	108743917	108744526	609	304.0	
64580	chr12	108768610	108769311	701	350.0	
64581	chr12	108803306	108803953	647	324.0	
64582	chr12	108820651	108820960	309	154.0	
64583	chr12	108821937	108822986	1049	524.0	
64584	chr12	108825584	108827064	1480	740.0	
64585	chr12	108831665	108832066	401	200.0	
64586	chr12	108838070	108840170	2100	1050.0	
64587	chr12	108846438	108846825	387	194.0	
64588	chr12	108850675	108851349	674	337.0	
64589	chr12	108853796	108854959	1163	582.0	
64590	chr12	108855880	108859506	3626	1813.0	
64591	chr12	108860497	108860949	452	226.0	
64592	chr12	108861607	108862721	1114	557.0	
64593	chr12	108884188	108885239	1051	526.0	
64594	chr12	108903266	108904134	868	434.0	
64595	chr12	108905666	108906222	556	278.0	
64596	chr12	108907962	108908368	406	203.0	
64597	chr12	108913984	108914669	685	342.0	
64598	chr12	108939533	108940023	490	245.0	
64599	chr12	108948334	108948769	435	218.0	
64600	chr12	108951008	108951562	554	277.0	
64601	chr12	109020816	109021155	339	170.0	
64602	chr12	109051931	109054584	2653	1326.0	
64603	chr12	109062718	109063338	620	310.0	
64604	chr12	109092803	109094098	1295	648.0	
64605	chr12	109097348	109099819	2471	1236.0	
64606	chr12	109110846	109112270	1424	712.0	
64607	chr12	109142929	109143114	185	92.0	
64608	chr12	109153990	109155569	1579	790.0	
64609	chr12	109170191	109170794	603	302.0	
64610	chr12	109309944	109309952	8	4.0	
64611	chr12	109385488	109385778	290	145.0	
64612	chr12	109393728	109394148	420	210.0	
64613	chr12	109427955	109428485	530	265.0	
64614	chr12	109432708	109433405	697	348.0	
64615	chr12	109446832	109447292	460	230.0	
64616	chr12	109450343	109450513	170	85.0	
64617	chr12	109451041	109451521	480	240.0	
64618	chr12	109460976	109461616	640	320.0	
64619	chr12	109463436	109463531	95	48.0	
64620	chr12	109467903	109468449	546	273.0	
64621	chr12	109476451	109478267	1816	908.0	
64622	chr12	109495077	109495338	261	130.0	
64623	chr12	109518726	109519175	449	224.0	
64624	chr12	109545047	109545534	487	244.0	
64625	chr12	109572583	109574432	1849	924.0	
64626	chr12	109595234	109595845	611	306.0	
64627	chr12	109597468	109598173	705	352.0	
64628	chr12	109689442	109689838	396	198.0	
64629	chr12	109712070	109721129	9059	4530.0	
64630	chr12	109722131	109722584	453	226.0	
64631	chr12	109723481	109723775	294	147.0	
64632	chr12	109724442	109724500	58	29.0	
64633	chr12	109725263	109733106	7843	3922.0	
64634	chr12	109734101	109737432	3331	1666.0	
64635	chr12	109738424	109740085	1661	830.0	
64636	chr12	109741025	109742336	1311	656.0	
64637	chr12	109743168	109744510	1342	671.0	
64638	chr12	109745595	109745719	124	62.0	
64639	chr12	109763014	109763586	572	286.0	
64640	chr12	109775184	109775706	522	261.0	
64641	chr12	109777514	109777950	436	218.0	
64642	chr12	109779215	109779774	559	280.0	
64643	chr12	109797987	109798339	352	176.0	
64644	chr12	109805037	109805907	870	435.0	
64645	chr12	109817580	109817981	401	200.0	
64646	chr12	109827740	109829038	1298	649.0	
64647	chr12	109833241	109833394	153	76.0	
64648	chr12	109838153	109838270	117	58.0	
64649	chr12	109845004	109847945	2941	1470.0	
64650	chr12	109849916	109850056	140	70.0	
64651	chr12	109852877	109853603	726	363.0	
64652	chr12	109864071	109864768	697	348.0	
64653	chr12	109875774	109875985	211	106.0	
64654	chr12	109878666	109881288	2622	1311.0	
64655	chr12	109887982	109889611	1629	814.0	
64656	chr12	109892569	109893929	1360	680.0	
64657	chr12	109899641	109901380	1739	870.0	
64658	chr12	109910961	109911217	256	128.0	
64659	chr12	109927534	109927996	462	231.0	
64660	chr12	109944850	109945323	473	236.0	
64661	chr12	109946495	109946929	434	217.0	
64662	chr12	109947601	109947949	348	174.0	
64663	chr12	109952308	109952921	613	306.0	
64664	chr12	109967610	109968412	802	401.0	
64665	chr12	109973483	109973797	314	157.0	
64666	chr12	109978921	109979563	642	321.0	
64667	chr12	109994126	109996887	2761	1380.0	
64668	chr12	109998586	110000650	2064	1032.0	
64669	chr12	110004646	110005721	1075	538.0	
64670	chr12	110007761	110008448	687	344.0	
64671	chr12	110011107	110012900	1793	896.0	
64672	chr12	110015004	110015675	671	336.0	
64673	chr12	110039281	110040687	1406	703.0	
64674	chr12	110042921	110043712	791	396.0	
64675	chr12	110047891	110049476	1585	792.0	
64676	chr12	110055608	110055878	270	135.0	
64677	chr12	110073032	110073920	888	444.0	
64678	chr12	110079111	110080416	1305	652.0	
64679	chr12	110088090	110089506	1416	708.0	
64680	chr12	110099950	110100967	1017	508.0	
64681	chr12	110102214	110102703	489	244.0	
64682	chr12	110122432	110122827	395	198.0	
64683	chr12	110123622	110125153	1531	766.0	
64684	chr12	110149070	110149498	428	214.0	
64685	chr12	110234518	110234909	391	196.0	
64686	chr12	110235447	110235564	117	58.0	
64687	chr12	110245459	110245915	456	228.0	
64688	chr12	110249255	110249381	126	63.0	
64689	chr12	110253169	110254272	1103	552.0	
64690	chr12	110256538	110257346	808	404.0	
64691	chr12	110262731	110263117	386	193.0	
64692	chr12	110267099	110267371	272	136.0	
64693	chr12	110280213	110283643	3430	1715.0	
64694	chr12	110286563	110287432	869	434.0	
64695	chr12	110299516	110300096	580	290.0	
64696	chr12	110301232	110301760	528	264.0	
64697	chr12	110304216	110304742	526	263.0	
64698	chr12	110307335	110307467	132	66.0	
64699	chr12	110312544	110313598	1054	527.0	
64700	chr12	110314551	110314641	90	45.0	
64701	chr12	110316441	110317264	823	412.0	
64702	chr12	110345148	110345755	607	304.0	
64703	chr12	110349200	110350315	1115	558.0	
64704	chr12	110355098	110355419	321	160.0	
64705	chr12	110371396	110371629	233	116.0	
64706	chr12	110402590	110404523	1933	966.0	
64707	chr12	110417086	110417467	381	190.0	
64708	chr12	110431116	110432092	976	488.0	
64709	chr12	110449285	110450998	1713	856.0	
64710	chr12	110455649	110457038	1389	694.0	
64711	chr12	110467478	110470042	2564	1282.0	
64712	chr12	110499027	110499749	722	361.0	
64713	chr12	110501021	110502813	1792	896.0	
64714	chr12	110512360	110512856	496	248.0	
64715	chr12	110551972	110552916	944	472.0	
64716	chr12	110561902	110564346	2444	1222.0	
64717	chr12	110577453	110580139	2686	1343.0	
64718	chr12	110581091	110584067	2976	1488.0	
64719	chr12	110584957	110585757	800	400.0	
64720	chr12	110590600	110591591	991	496.0	
64721	chr12	110599139	110600683	1544	772.0	
64722	chr12	110601939	110602645	706	353.0	
64723	chr12	110605269	110606353	1084	542.0	
64724	chr12	110613385	110614750	1365	682.0	
64725	chr12	110619644	110620587	943	472.0	
64726	chr12	110627755	110628245	490	245.0	
64727	chr12	110639603	110640117	514	257.0	
64728	chr12	110647513	110648235	722	361.0	
64729	chr12	110661117	110662302	1185	592.0	
64730	chr12	110668726	110670539	1813	906.0	
64731	chr12	110677042	110678166	1124	562.0	
64732	chr12	110687807	110690484	2677	1338.0	
64733	chr12	110691104	110691772	668	334.0	
64734	chr12	110693659	110695120	1461	730.0	
64735	chr12	110697386	110699071	1685	842.0	
64736	chr12	110718195	110718668	473	236.0	
64737	chr12	110727665	110728282	617	308.0	
64738	chr12	110737252	110738989	1737	868.0	
64739	chr12	110739825	110740226	401	200.0	
64740	chr12	110741239	110744480	3241	1620.0	
64741	chr12	110744983	110744984	1	0.0	
64742	chr12	110760154	110760466	312	156.0	
64743	chr12	110780403	110780850	447	224.0	
64744	chr12	110826458	110827322	864	432.0	
64745	chr12	110846670	110847370	700	350.0	
64746	chr12	110849365	110850118	753	376.0	
64747	chr12	110860822	110861210	388	194.0	
64748	chr12	110868947	110869553	606	303.0	
64749	chr12	110887539	110888503	964	482.0	
64750	chr12	110894118	110895686	1568	784.0	
64751	chr12	110913333	110913985	652	326.0	
64752	chr12	110937007	110937488	481	240.0	
64753	chr12	111024141	111024607	466	233.0	
64754	chr12	111056406	111057834	1428	714.0	enhancer
64755	chr12	111068281	111068669	388	194.0	
64756	chr12	111126258	111126836	578	289.0	
64757	chr12	111170283	111171659	1376	688.0	
64758	chr12	111174614	111174870	256	128.0	
64759	chr12	111181090	111181493	403	202.0	
64760	chr12	111186341	111186683	342	171.0	
64761	chr12	111196522	111196939	417	208.0	
64762	chr12	111248212	111248732	520	260.0	
64763	chr12	111298819	111299179	360	180.0	
64764	chr12	111313683	111314285	602	301.0	
64765	chr12	111314933	111315448	515	258.0	
64766	chr12	111323786	111324474	688	344.0	
64767	chr12	111325055	111325720	665	332.0	
64768	chr12	111326343	111326779	436	218.0	
64769	chr12	111331179	111331615	436	218.0	
64770	chr12	111355251	111355604	353	176.0	
64771	chr12	111359537	111359983	446	223.0	
64772	chr12	111368197	111370137	1940	970.0	
64773	chr12	111389721	111390125	404	202.0	
64774	chr12	111393313	111394441	1128	564.0	
64775	chr12	111396657	111400045	3388	1694.0	
64776	chr12	111402740	111415342	12602	6301.0	
64777	chr12	111420505	111420605	100	50.0	
64778	chr12	111424255	111439251	14996	7498.0	
64779	chr12	111442590	111445858	3268	1634.0	
64780	chr12	111451266	111452282	1016	508.0	
64781	chr12	111462466	111462734	268	134.0	
64782	chr12	111505490	111505899	409	204.0	
64783	chr12	111529363	111529879	516	258.0	
64784	chr12	111596960	111600388	3428	1714.0	
64785	chr12	111662435	111662772	337	168.0	
64786	chr12	111685077	111687487	2410	1205.0	
64787	chr12	111753183	111753585	402	201.0	
64788	chr12	111757618	111758313	695	348.0	
64789	chr12	111765491	111767597	2106	1053.0	
64790	chr12	111773605	111774530	925	462.0	
64791	chr12	111775209	111776320	1111	556.0	
64792	chr12	111777095	111778150	1055	528.0	
64793	chr12	111780202	111780546	344	172.0	
64794	chr12	111788187	111788548	361	180.0	
64795	chr12	111812866	111813595	729	364.0	
64796	chr12	111823165	111823208	43	22.0	
64797	chr12	111824546	111824661	115	58.0	
64798	chr12	111834616	111835580	964	482.0	
64799	chr12	111841117	111843268	2151	1076.0	
64800	chr12	111888382	111888707	325	162.0	
64801	chr12	111915049	111915389	340	170.0	
64802	chr12	111945081	111945665	584	292.0	
64803	chr12	111950967	111951321	354	177.0	
64804	chr12	111971752	111972262	510	255.0	
64805	chr12	111992034	111992508	474	237.0	
64806	chr12	111993121	111995265	2144	1072.0	
64807	chr12	112001721	112003048	1327	664.0	
64808	chr12	112011884	112015254	3370	1685.0	
64809	chr12	112029405	112029689	284	142.0	
64810	chr12	112075637	112076004	367	184.0	
64811	chr12	112096169	112096477	308	154.0	
64812	chr12	112107752	112109929	2177	1088.0	
64813	chr12	112116458	112117466	1008	504.0	
64814	chr12	112124957	112126613	1656	828.0	
64815	chr12	112128909	112129218	309	154.0	
64816	chr12	112129957	112131352	1395	698.0	
64817	chr12	112140298	112141177	879	440.0	
64818	chr12	112158716	112159239	523	262.0	
64819	chr12	112170374	112170733	359	180.0	
64820	chr12	112198128	112198555	427	214.0	
64821	chr12	112239948	112240177	229	114.0	
64822	chr12	112303082	112303521	439	220.0	
64823	chr12	112332116	112332147	31	16.0	
64824	chr12	112381137	112383085	1948	974.0	
64825	chr12	112386817	112388069	1252	626.0	
64826	chr12	112408392	112410377	1985	992.0	
64827	chr12	112411401	112411972	571	286.0	
64828	chr12	112418121	112420421	2300	1150.0	
64829	chr12	112598216	112599084	868	434.0	
64830	chr12	112599826	112600399	573	286.0	
64831	chr12	112606947	112607364	417	208.0	
64832	chr12	112716476	112716870	394	197.0	
64833	chr12	112849071	112849456	385	192.0	
64834	chr12	112870503	112871076	573	286.0	
64835	chr12	112885152	112885663	511	256.0	
64836	chr12	112887421	112888148	727	364.0	
64837	chr12	112892800	112893249	449	224.0	
64838	chr12	112893917	112894432	515	258.0	
64839	chr12	112900215	112900757	542	271.0	
64840	chr12	112902205	112902713	508	254.0	
64841	chr12	112906431	112908106	1675	838.0	
64842	chr12	112908787	112908883	96	48.0	
64843	chr12	112935883	112939096	3213	1606.0	
64844	chr12	112939635	112940519	884	442.0	
64845	chr12	112973739	112974105	366	183.0	
64846	chr12	112977600	112979948	2348	1174.0	
64847	chr12	112980449	112981272	823	412.0	
64848	chr12	112988208	112988671	463	232.0	
64849	chr12	112992438	112993290	852	426.0	
64850	chr12	112998978	112999483	505	252.0	
64851	chr12	113030912	113031363	451	226.0	
64852	chr12	113040401	113041498	1097	548.0	
64853	chr12	113048586	113049300	714	357.0	
64854	chr12	113050044	113051054	1010	505.0	
64855	chr12	113056163	113058135	1972	986.0	
64856	chr12	113062619	113062811	192	96.0	
64857	chr12	113065213	113065607	394	197.0	
64858	chr12	113069915	113070740	825	412.0	
64859	chr12	113075020	113075878	858	429.0	
64860	chr12	113083043	113083049	6	3.0	
64861	chr12	113083899	113084190	291	146.0	
64862	chr12	113086291	113088187	1896	948.0	
64863	chr12	113089120	113090143	1023	512.0	
64864	chr12	113090764	113091054	290	145.0	
64865	chr12	113092722	113093514	792	396.0	
64866	chr12	113098097	113098954	857	428.0	
64867	chr12	113103530	113104565	1035	518.0	
64868	chr12	113109727	113110633	906	453.0	
64869	chr12	113130435	113130525	90	45.0	
64870	chr12	113135274	113136575	1301	650.0	
64871	chr12	113141974	113143426	1452	726.0	
64872	chr12	113149543	113149816	273	136.0	
64873	chr12	113152434	113154793	2359	1180.0	
64874	chr12	113174260	113175171	911	456.0	
64875	chr12	113184305	113186833	2528	1264.0	
64876	chr12	113196717	113197568	851	426.0	
64877	chr12	113200068	113200462	394	197.0	
64878	chr12	113202406	113202936	530	265.0	
64879	chr12	113207440	113209199	1759	880.0	
64880	chr12	113214706	113215493	787	394.0	
64881	chr12	113217381	113217705	324	162.0	
64882	chr12	113220457	113223595	3138	1569.0	
64883	chr12	113227173	113227282	109	54.0	
64884	chr12	113229629	113230575	946	473.0	
64885	chr12	113232655	113233977	1322	661.0	
64886	chr12	113236585	113238158	1573	786.0	
64887	chr12	113240304	113242420	2116	1058.0	
64888	chr12	113261796	113262347	551	276.0	
64889	chr12	113271740	113272452	712	356.0	
64890	chr12	113302832	113303419	587	294.0	
64891	chr12	113310699	113310785	86	43.0	
64892	chr12	113312453	113312932	479	240.0	
64893	chr12	113322207	113322888	681	340.0	
64894	chr12	113333789	113336479	2690	1345.0	
64895	chr12	113341532	113341920	388	194.0	
64896	chr12	113346358	113346752	394	197.0	
64897	chr12	113357907	113360545	2638	1319.0	
64898	chr12	113361690	113361950	260	130.0	
64899	chr12	113403768	113404592	824	412.0	
64900	chr12	113405774	113406095	321	160.0	
64901	chr12	113408225	113408316	91	46.0	
64902	chr12	113415957	113416830	873	436.0	
64903	chr12	113418156	113418657	501	250.0	
64904	chr12	113421740	113422739	999	500.0	
64905	chr12	113425283	113425777	494	247.0	
64906	chr12	113445601	113446255	654	327.0	
64907	chr12	113462305	113462852	547	274.0	
64908	chr12	113862661	113863269	608	304.0	
64909	chr12	113912689	113913100	411	206.0	
64910	chr12	113962369	113962870	501	250.0	
64911	chr12	113965608	113967140	1532	766.0	
64912	chr12	113980490	113980935	445	222.0	
64913	chr12	114508532	114508884	352	176.0	
64914	chr12	114684159	114684626	467	234.0	"promoter	protein_binding_site	protein_binding_site"
64915	chr12	114762723	114762902	179	90.0	
64916	chr12	114768397	114768868	471	236.0	
64917	chr12	114806398	114807239	841	420.0	
64918	chr12	114813082	114813778	696	348.0	
64919	chr12	115354104	115354383	279	140.0	
64920	chr12	115917105	115917592	487	244.0	
64921	chr12	115949622	115949713	91	46.0	
64922	chr12	115998018	115998680	662	331.0	
64923	chr12	116053744	116054305	561	280.0	
64924	chr12	116060470	116061274	804	402.0	
64925	chr12	116066598	116067075	477	238.0	
64926	chr12	116071795	116072206	411	206.0	
64927	chr12	116087590	116088353	763	382.0	
64928	chr12	116123334	116124029	695	348.0	
64929	chr12	116133232	116133858	626	313.0	
64930	chr12	116143324	116144256	932	466.0	
64931	chr12	116164512	116164717	205	102.0	
64932	chr12	116172186	116172832	646	323.0	
64933	chr12	116182171	116182666	495	248.0	
64934	chr12	116185534	116186265	731	366.0	
64935	chr12	116188584	116188835	251	126.0	
64936	chr12	116194821	116195684	863	432.0	
64937	chr12	116236137	116236618	481	240.0	
64938	chr12	116243903	116244383	480	240.0	
64939	chr12	116261770	116261779	9	4.0	
64940	chr12	116263911	116264269	358	179.0	
64941	chr12	116265346	116265759	413	206.0	
64942	chr12	116266390	116266418	28	14.0	
64943	chr12	116275730	116279207	3477	1738.0	
64944	chr12	116280458	116281354	896	448.0	
64945	chr12	116282376	116283068	692	346.0	
64946	chr12	116284318	116284879	561	280.0	
64947	chr12	116285905	116286463	558	279.0	
64948	chr12	116299140	116299526	386	193.0	
64949	chr12	116302585	116304361	1776	888.0	
64950	chr12	116314390	116314827	437	218.0	
64951	chr12	116319852	116320696	844	422.0	
64952	chr12	116323989	116325824	1835	918.0	
64953	chr12	116331919	116332188	269	134.0	
64954	chr12	116333983	116334516	533	266.0	
64955	chr12	116336132	116337379	1247	624.0	
64956	chr12	116339101	116339370	269	134.0	
64957	chr12	116358547	116359995	1448	724.0	
64958	chr12	116360767	116361674	907	454.0	
64959	chr12	116379762	116379810	48	24.0	
64960	chr12	116385107	116385527	420	210.0	
64961	chr12	116400558	116401470	912	456.0	
64962	chr12	116406471	116407068	597	298.0	
64963	chr12	116410622	116411433	811	406.0	
64964	chr12	116441306	116441658	352	176.0	
64965	chr12	116443935	116444749	814	407.0	
64966	chr12	116455294	116456077	783	392.0	
64967	chr12	116508189	116509083	894	447.0	
64968	chr12	116515672	116516075	403	202.0	
64969	chr12	116520938	116521312	374	187.0	
64970	chr12	116532911	116534755	1844	922.0	
64971	chr12	116537215	116538293	1078	539.0	
64972	chr12	116538885	116539417	532	266.0	
64973	chr12	116539998	116540166	168	84.0	
64974	chr12	116547709	116548549	840	420.0	
64975	chr12	116551634	116553039	1405	702.0	
64976	chr12	116558285	116560379	2094	1047.0	
64977	chr12	116560885	116561642	757	378.0	
64978	chr12	116592686	116593132	446	223.0	
64979	chr12	116594023	116595015	992	496.0	
64980	chr12	116599593	116600140	547	274.0	
64981	chr12	116601523	116602331	808	404.0	
64982	chr12	116605028	116605424	396	198.0	
64983	chr12	116609763	116610044	281	140.0	
64984	chr12	116611189	116611485	296	148.0	
64985	chr12	116635398	116635906	508	254.0	
64986	chr12	116637775	116638186	411	206.0	
64987	chr12	116677312	116677758	446	223.0	
64988	chr12	116687834	116688361	527	264.0	
64989	chr12	116703169	116703646	477	238.0	
64990	chr12	116708838	116709374	536	268.0	
64991	chr12	116736345	116738875	2530	1265.0	
64992	chr12	116759672	116760123	451	226.0	
64993	chr12	116802926	116803424	498	249.0	
64994	chr12	116817448	116820589	3141	1570.0	
64995	chr12	116857840	116858478	638	319.0	
64996	chr12	116861328	116861753	425	212.0	
64997	chr12	116880878	116881382	504	252.0	
64998	chr12	116885218	116885905	687	344.0	
64999	chr12	116910539	116911572	1033	516.0	
65000	chr12	116916510	116917242	732	366.0	
65001	chr12	116919389	116919738	349	174.0	
65002	chr12	116924388	116925337	949	474.0	
65003	chr12	116955886	116955887	1	0.0	
65004	chr12	117025402	117026127	725	362.0	
65005	chr12	117057613	117058051	438	219.0	
65006	chr12	117060279	117061240	961	480.0	
65007	chr12	117062785	117064144	1359	680.0	
65008	chr12	117069087	117069500	413	206.0	
65009	chr12	117070158	117070643	485	242.0	
65010	chr12	117098172	117100699	2527	1264.0	
65011	chr12	117105758	117106373	615	308.0	
65012	chr12	117112258	117112397	139	70.0	
65013	chr12	117119663	117120141	478	239.0	
65014	chr12	117133916	117134631	715	358.0	
65015	chr12	117150606	117151190	584	292.0	
65016	chr12	117155097	117155811	714	357.0	
65017	chr12	117189350	117191072	1722	861.0	
65018	chr12	117212579	117212950	371	186.0	
65019	chr12	117521281	117521693	412	206.0	
65020	chr12	117837233	117837592	359	180.0	
65021	chr12	117857731	117858042	311	156.0	
65022	chr12	117874815	117876362	1547	774.0	
65023	chr12	117968866	117969494	628	314.0	
65024	chr12	118016033	118017373	1340	670.0	
65025	chr12	118052670	118053686	1016	508.0	
65026	chr12	118054999	118055573	574	287.0	
65027	chr12	118058852	118062906	4054	2027.0	
65028	chr12	118063842	118063935	93	46.0	
65029	chr12	118064448	118065839	1391	696.0	
65030	chr12	118103183	118104542	1359	680.0	
65031	chr12	118120707	118121455	748	374.0	
65032	chr12	118135285	118137161	1876	938.0	
65033	chr12	118175942	118176551	609	304.0	
65034	chr12	118181553	118182684	1131	566.0	
65035	chr12	118236954	118237651	697	348.0	
65036	chr12	118306909	118308464	1555	778.0	
65037	chr12	118327883	118328172	289	144.0	
65038	chr12	118330277	118330822	545	272.0	
65039	chr12	118332533	118332933	400	200.0	
65040	chr12	118346901	118347337	436	218.0	
65041	chr12	118356678	118358133	1455	728.0	
65042	chr12	118358864	118359967	1103	552.0	
65043	chr12	118361810	118362353	543	272.0	
65044	chr12	118364749	118365011	262	131.0	
65045	chr12	118368881	118369157	276	138.0	
65046	chr12	118371197	118373760	2563	1282.0	
65047	chr12	118375818	118378507	2689	1344.0	
65048	chr12	118404877	118405291	414	207.0	
65049	chr12	119545027	119545382	355	178.0	
65050	chr12	119659257	119660565	1308	654.0	
65051	chr12	119666351	119668868	2517	1258.0	
65052	chr12	119682557	119683196	639	320.0	
65053	chr12	119876584	119877978	1394	697.0	
65054	chr12	119901953	119902477	524	262.0	
65055	chr12	119937845	119938460	615	308.0	
65056	chr12	119988207	119990875	2668	1334.0	
65057	chr12	120006591	120008071	1480	740.0	
65058	chr12	120010764	120011011	247	124.0	
65059	chr12	120011753	120015835	4082	2041.0	
65060	chr12	120041344	120041675	331	166.0	
65061	chr12	120048301	120048589	288	144.0	
65062	chr12	120074934	120075531	597	298.0	
65063	chr12	120086501	120087905	1404	702.0	
65064	chr12	120093783	120094078	295	148.0	
65065	chr12	120097535	120097991	456	228.0	
65066	chr12	120101156	120101752	596	298.0	
65067	chr12	120102566	120102952	386	193.0	
65068	chr12	120110247	120111637	1390	695.0	
65069	chr12	120114960	120119971	5011	2506.0	
65070	chr12	120121643	120122323	680	340.0	
65071	chr12	120123695	120124273	578	289.0	
65072	chr12	120126288	120127278	990	495.0	
65073	chr12	120132820	120133466	646	323.0	
65074	chr12	120156748	120157041	293	146.0	
65075	chr12	120194084	120197282	3198	1599.0	
65076	chr12	120198169	120199281	1112	556.0	
65077	chr12	120199883	120202471	2588	1294.0	
65078	chr12	120224550	120226468	1918	959.0	
65079	chr12	120227972	120236398	8426	4213.0	
65080	chr12	120237505	120239156	1651	826.0	
65081	chr12	120248219	120251036	2817	1408.0	
65082	chr12	120251677	120255142	3465	1732.0	
65083	chr12	120262127	120263446	1319	660.0	
65084	chr12	120263953	120266511	2558	1279.0	
65085	chr12	120288188	120288190	2	1.0	
65086	chr12	120289326	120293891	4565	2282.0	
65087	chr12	120301918	120302968	1050	525.0	
65088	chr12	120316861	120318390	1529	764.0	
65089	chr12	120325215	120326280	1065	532.0	
65090	chr12	120335442	120335838	396	198.0	
65091	chr12	120356447	120357043	596	298.0	
65092	chr12	120368919	120369386	467	234.0	
65093	chr12	120430328	120431208	880	440.0	
65094	chr12	120437249	120438964	1715	858.0	
65095	chr12	120439488	120440357	869	434.0	
65096	chr12	120445638	120447371	1733	866.0	
65097	chr12	120453872	120454531	659	330.0	
65098	chr12	120457194	120457510	316	158.0	
65099	chr12	120466470	120466986	516	258.0	
65100	chr12	120468132	120470612	2480	1240.0	
65101	chr12	120474557	120475033	476	238.0	
65102	chr12	120480713	120481628	915	458.0	
65103	chr12	120483842	120483942	100	50.0	
65104	chr12	120495357	120497612	2255	1128.0	
65105	chr12	120498718	120498959	241	120.0	
65106	chr12	120528326	120530543	2217	1108.0	
65107	chr12	120533759	120536853	3094	1547.0	
65108	chr12	120538121	120539369	1248	624.0	
65109	chr12	120540441	120540976	535	268.0	
65110	chr12	120550061	120550562	501	250.0	
65111	chr12	120551778	120552869	1091	546.0	
65112	chr12	120579410	120579485	75	38.0	
65113	chr12	120580709	120582325	1616	808.0	
65114	chr12	120583125	120585157	2032	1016.0	
65115	chr12	120599021	120599589	568	284.0	
65116	chr12	120602236	120602984	748	374.0	
65117	chr12	120611631	120611898	267	134.0	
65118	chr12	120625716	120625936	220	110.0	
65119	chr12	120640031	120641856	1825	912.0	
65120	chr12	120646664	120647561	897	448.0	
65121	chr12	120648857	120650262	1405	702.0	
65122	chr12	120651689	120652245	556	278.0	
65123	chr12	120654113	120654422	309	154.0	
65124	chr12	120662845	120663324	479	240.0	
65125	chr12	120669372	120669868	496	248.0	
65126	chr12	120674098	120674553	455	228.0	
65127	chr12	120677622	120678614	992	496.0	
65128	chr12	120680178	120680613	435	218.0	
65129	chr12	120684188	120689272	5084	2542.0	
65130	chr12	120698565	120699195	630	315.0	
65131	chr12	120709816	120711795	1979	990.0	
65132	chr12	120713486	120714348	862	431.0	
65133	chr12	120720558	120720969	411	206.0	
65134	chr12	120725212	120726492	1280	640.0	
65135	chr12	120760488	120760972	484	242.0	
65136	chr12	120783350	120783415	65	32.0	
65137	chr12	120847772	120848181	409	204.0	
65138	chr12	120851309	120851871	562	281.0	
65139	chr12	120853788	120854313	525	262.0	
65140	chr12	120856945	120857420	475	238.0	
65141	chr12	120873292	120873535	243	122.0	
65142	chr12	120886100	120886861	761	380.0	
65143	chr12	120892095	120892783	688	344.0	
65144	chr12	120901119	120901841	722	361.0	
65145	chr12	120902717	120905216	2499	1250.0	
65146	chr12	120935762	120937510	1748	874.0	
65147	chr12	120939422	120940418	996	498.0	
65148	chr12	120944506	120945116	610	305.0	
65149	chr12	120959660	120960355	695	348.0	
65150	chr12	120971542	120972337	795	398.0	
65151	chr12	121005274	121005744	470	235.0	
65152	chr12	121015811	121017145	1334	667.0	
65153	chr12	121018071	121018664	593	296.0	
65154	chr12	121019358	121019361	3	2.0	
65155	chr12	121024761	121025262	501	250.0	
65156	chr12	121026571	121027029	458	229.0	
65157	chr12	121033274	121039830	6556	3278.0	
65158	chr12	121046498	121046964	466	233.0	
65159	chr12	121048483	121048545	62	31.0	
65160	chr12	121049454	121049661	207	104.0	
65161	chr12	121059573	121061185	1612	806.0	
65162	chr12	121087765	121088241	476	238.0	
65163	chr12	121092483	121093551	1068	534.0	
65164	chr12	121095524	121096887	1363	682.0	
65165	chr12	121110054	121110765	711	356.0	
65166	chr12	121124501	121124735	234	117.0	
65167	chr12	121127773	121129991	2218	1109.0	
65168	chr12	121132511	121133679	1168	584.0	
65169	chr12	121143553	121146083	2530	1265.0	
65170	chr12	121159435	121159924	489	244.0	
65171	chr12	121167259	121167563	304	152.0	
65172	chr12	121175327	121175874	547	274.0	
65173	chr12	121185199	121185933	734	367.0	
65174	chr12	121190312	121191121	809	404.0	
65175	chr12	121196650	121197386	736	368.0	
65176	chr12	121204743	121205044	301	150.0	
65177	chr12	121209440	121212182	2742	1371.0	
65178	chr12	121214077	121215613	1536	768.0	
65179	chr12	121222795	121225064	2269	1134.0	
65180	chr12	121230065	121230861	796	398.0	
65181	chr12	121233374	121233380	6	3.0	
65182	chr12	121238605	121241747	3142	1571.0	
65183	chr12	121276483	121279147	2664	1332.0	
65184	chr12	121287138	121288854	1716	858.0	
65185	chr12	121292269	121292833	564	282.0	
65186	chr12	121293503	121293957	454	227.0	
65187	chr12	121295085	121298117	3032	1516.0	
65188	chr12	121301857	121302346	489	244.0	
65189	chr12	121306155	121306598	443	222.0	
65190	chr12	121314284	121314878	594	297.0	
65191	chr12	121325843	121326496	653	326.0	
65192	chr12	121334530	121335208	678	339.0	
65193	chr12	121351591	121353314	1723	862.0	
65194	chr12	121388415	121388964	549	274.0	
65195	chr12	121391583	121392362	779	390.0	
65196	chr12	121399136	121401329	2193	1096.0	
65197	chr12	121425020	121425898	878	439.0	
65198	chr12	121443138	121443914	776	388.0	
65199	chr12	121450291	121453069	2778	1389.0	
65200	chr12	121457320	121457809	489	244.0	
65201	chr12	121460988	121461534	546	273.0	
65202	chr12	121465698	121469100	3402	1701.0	
65203	chr12	121470586	121470940	354	177.0	
65204	chr12	121478872	121479317	445	222.0	
65205	chr12	121490195	121491452	1257	628.0	
65206	chr12	121494126	121494804	678	339.0	
65207	chr12	121499826	121500491	665	332.0	
65208	chr12	121501934	121502172	238	119.0	
65209	chr12	121513693	121514940	1247	624.0	
65210	chr12	121520453	121520957	504	252.0	
65211	chr12	121530431	121532015	1584	792.0	
65212	chr12	121534250	121538985	4735	2368.0	
65213	chr12	121546879	121547880	1001	500.0	
65214	chr12	121551619	121553213	1594	797.0	
65215	chr12	121557345	121558511	1166	583.0	
65216	chr12	121560081	121561051	970	485.0	
65217	chr12	121568984	121569446	462	231.0	
65218	chr12	121571527	121571588	61	30.0	
65219	chr12	121577037	121577416	379	190.0	
65220	chr12	121578420	121582818	4398	2199.0	
65221	chr12	121589554	121591874	2320	1160.0	
65222	chr12	121611329	121611712	383	192.0	
65223	chr12	121614735	121615572	837	418.0	
65224	chr12	121620267	121620675	408	204.0	
65225	chr12	121624523	121630676	6153	3076.0	
65226	chr12	121632811	121633036	225	112.0	
65227	chr12	121634746	121636099	1353	676.0	
65228	chr12	121637040	121639102	2062	1031.0	
65229	chr12	121640862	121641564	702	351.0	
65230	chr12	121649278	121650537	1259	630.0	
65231	chr12	121658313	121660502	2189	1094.0	
65232	chr12	121663597	121665435	1838	919.0	
65233	chr12	121666739	121667240	501	250.0	
65234	chr12	121668629	121669412	783	392.0	
65235	chr12	121671333	121673528	2195	1098.0	
65236	chr12	121674665	121675023	358	179.0	
65237	chr12	121681758	121682689	931	466.0	
65238	chr12	121686644	121687903	1259	630.0	
65239	chr12	121689698	121690392	694	347.0	
65240	chr12	121697051	121697706	655	328.0	
65241	chr12	121711470	121714225	2755	1378.0	
65242	chr12	121741871	121741877	6	3.0	
65243	chr12	121750264	121751476	1212	606.0	
65244	chr12	121772983	121773864	881	440.0	
65245	chr12	121775079	121777071	1992	996.0	
65246	chr12	121778955	121779561	606	303.0	
65247	chr12	121781566	121783279	1713	856.0	
65248	chr12	121783789	121795918	12129	6064.0	
65249	chr12	121796969	121806966	9997	4998.0	
65250	chr12	121807662	121807998	336	168.0	
65251	chr12	121810281	121813913	3632	1816.0	
65252	chr12	121826658	121827040	382	191.0	
65253	chr12	121827991	121828026	35	18.0	
65254	chr12	121829252	121829273	21	10.0	
65255	chr12	121831800	121832346	546	273.0	
65256	chr12	121838978	121840564	1586	793.0	
65257	chr12	121849638	121850188	550	275.0	
65258	chr12	121855583	121856312	729	364.0	
65259	chr12	121874049	121874388	339	170.0	
65260	chr12	121876401	121876570	169	84.0	
65261	chr12	121888139	121889692	1553	776.0	
65262	chr12	121916837	121917136	299	150.0	
65263	chr12	121917740	121919164	1424	712.0	
65264	chr12	121921169	121921573	404	202.0	
65265	chr12	121926932	121928068	1136	568.0	
65266	chr12	121939151	121939517	366	183.0	
65267	chr12	121968792	121969239	447	224.0	
65268	chr12	121980060	121981139	1079	540.0	
65269	chr12	121983485	121984195	710	355.0	
65270	chr12	121991997	121992604	607	304.0	
65271	chr12	122004075	122005068	993	496.0	
65272	chr12	122006448	122006816	368	184.0	
65273	chr12	122021274	122024037	2763	1382.0	
65274	chr12	122029076	122029630	554	277.0	
65275	chr12	122031545	122032022	477	238.0	
65276	chr12	122054226	122054961	735	368.0	
65277	chr12	122062961	122064491	1530	765.0	
65278	chr12	122067739	122068522	783	392.0	
65279	chr12	122076826	122083410	6584	3292.0	
65280	chr12	122083967	122084376	409	204.0	
65281	chr12	122086173	122086410	237	118.0	
65282	chr12	122087357	122087577	220	110.0	
65283	chr12	122097701	122098716	1015	508.0	
65284	chr12	122099252	122100293	1041	520.0	
65285	chr12	122104798	122106058	1260	630.0	
65286	chr12	122108398	122109066	668	334.0	
65287	chr12	122122907	122123828	921	460.0	
65288	chr12	122130941	122131540	599	300.0	
65289	chr12	122147597	122147894	297	148.0	
65290	chr12	122161629	122162195	566	283.0	
65291	chr12	122166491	122167066	575	288.0	
65292	chr12	122182831	122183714	883	442.0	
65293	chr12	122184421	122185027	606	303.0	
65294	chr12	122190737	122191331	594	297.0	
65295	chr12	122203128	122207263	4135	2068.0	
65296	chr12	122208219	122208419	200	100.0	
65297	chr12	122224548	122228317	3769	1884.0	
65298	chr12	122235792	122235955	163	82.0	
65299	chr12	122243870	122245673	1803	902.0	
65300	chr12	122265393	122267532	2139	1070.0	
65301	chr12	122336035	122336425	390	195.0	
65302	chr12	122356091	122356731	640	320.0	
65303	chr12	122393676	122394209	533	266.0	
65304	chr12	122399197	122401196	1999	1000.0	
65305	chr12	122413489	122414130	641	320.0	
65306	chr12	122421247	122424141	2894	1447.0	
65307	chr12	122449387	122449686	299	150.0	
65308	chr12	122452879	122454440	1561	780.0	
65309	chr12	122457835	122458089	254	127.0	
65310	chr12	122464189	122465198	1009	504.0	
65311	chr12	122471372	122472041	669	334.0	
65312	chr12	122499643	122502930	3287	1644.0	
65313	chr12	122505409	122505728	319	160.0	
65314	chr12	122523241	122524762	1521	760.0	
65315	chr12	122525342	122528046	2704	1352.0	
65316	chr12	122637761	122638265	504	252.0	
65317	chr12	122646397	122647599	1202	601.0	
65318	chr12	122649983	122650942	959	480.0	
65319	chr12	122659600	122659967	367	184.0	
65320	chr12	122680207	122680372	165	82.0	
65321	chr12	122681552	122682514	962	481.0	
65322	chr12	122703065	122703775	710	355.0	
65323	chr12	122711201	122711604	403	202.0	
65324	chr12	122713878	122714268	390	195.0	
65325	chr12	122716529	122717220	691	346.0	
65326	chr12	122720135	122720975	840	420.0	
65327	chr12	122722276	122722754	478	239.0	
65328	chr12	122725858	122726491	633	316.0	
65329	chr12	122732148	122732549	401	200.0	
65330	chr12	122733599	122733870	271	136.0	
65331	chr12	122742902	122743248	346	173.0	
65332	chr12	122743886	122744626	740	370.0	
65333	chr12	122747253	122747580	327	164.0	
65334	chr12	122752122	122753659	1537	768.0	
65335	chr12	122773839	122775612	1773	886.0	
65336	chr12	122793598	122794096	498	249.0	
65337	chr12	122813270	122813825	555	278.0	
65338	chr12	122820687	122821295	608	304.0	
65339	chr12	122826337	122826346	9	4.0	
65340	chr12	122834258	122837439	3181	1590.0	
65341	chr12	122856086	122856910	824	412.0	
65342	chr12	122859350	122863632	4282	2141.0	
65343	chr12	122864468	122865027	559	280.0	
65344	chr12	122865599	122866239	640	320.0	
65345	chr12	122866771	122866839	68	34.0	
65346	chr12	122867601	122867987	386	193.0	
65347	chr12	122871013	122874625	3612	1806.0	
65348	chr12	122875479	122876379	900	450.0	
65349	chr12	122877590	122879672	2082	1041.0	
65350	chr12	122880659	122881577	918	459.0	
65351	chr12	122883089	122883649	560	280.0	
65352	chr12	122887090	122890761	3671	1836.0	
65353	chr12	122891600	122892521	921	460.0	
65354	chr12	122893459	122893606	147	74.0	
65355	chr12	122894195	122897061	2866	1433.0	
65356	chr12	122897801	122899433	1632	816.0	
65357	chr12	122901091	122902130	1039	520.0	
65358	chr12	122903614	122903745	131	66.0	
65359	chr12	122904608	122905183	575	288.0	
65360	chr12	122926760	122927424	664	332.0	
65361	chr12	122942510	122943439	929	464.0	
65362	chr12	122946424	122947984	1560	780.0	
65363	chr12	122951898	122952948	1050	525.0	
65364	chr12	122965746	122967877	2131	1066.0	
65365	chr12	122973878	122976303	2425	1212.0	
65366	chr12	122979659	122983116	3457	1728.0	
65367	chr12	122984109	122985876	1767	884.0	
65368	chr12	122991275	122991581	306	153.0	
65369	chr12	123033870	123034387	517	258.0	
65370	chr12	123043300	123044255	955	478.0	
65371	chr12	123062807	123063985	1178	589.0	
65372	chr12	123064602	123064615	13	6.0	
65373	chr12	123067725	123068021	296	148.0	
65374	chr12	123071984	123072269	285	142.0	
65375	chr12	123075004	123077184	2180	1090.0	
65376	chr12	123083607	123084013	406	203.0	
65377	chr12	123089161	123090065	904	452.0	
65378	chr12	123091742	123092016	274	137.0	
65379	chr12	123106447	123107541	1094	547.0	
65380	chr12	123111766	123112167	401	200.0	
65381	chr12	123114938	123115985	1047	524.0	
65382	chr12	123119856	123121155	1299	650.0	
65383	chr12	123131682	123132527	845	422.0	
65384	chr12	123143172	123143670	498	249.0	
65385	chr12	123149786	123151985	2199	1100.0	
65386	chr12	123152889	123153265	376	188.0	
65387	chr12	123223088	123223836	748	374.0	
65388	chr12	123232164	123234446	2282	1141.0	
65389	chr12	123237466	123238707	1241	620.0	
65390	chr12	123242056	123242805	749	374.0	
65391	chr12	123264641	123264990	349	174.0	
65392	chr12	123267867	123272418	4551	2276.0	
65393	chr12	123277977	123278810	833	416.0	
65394	chr12	123336589	123336837	248	124.0	
65395	chr12	123346958	123347247	289	144.0	
65396	chr12	123352179	123352541	362	181.0	
65397	chr12	123363223	123366137	2914	1457.0	
65398	chr12	123382502	123384980	2478	1239.0	
65399	chr12	123387853	123391464	3611	1806.0	
65400	chr12	123421278	123421649	371	186.0	
65401	chr12	123422472	123423535	1063	532.0	
65402	chr12	123425031	123425729	698	349.0	
65403	chr12	123426878	123428911	2033	1016.0	
65404	chr12	123431210	123437486	6276	3138.0	
65405	chr12	123442707	123443457	750	375.0	
65406	chr12	123443980	123445028	1048	524.0	
65407	chr12	123445572	123446366	794	397.0	
65408	chr12	123447873	123449693	1820	910.0	
65409	chr12	123450619	123452634	2015	1008.0	
65410	chr12	123453137	123454818	1681	840.0	
65411	chr12	123457822	123460306	2484	1242.0	
65412	chr12	123468748	123469259	511	256.0	
65413	chr12	123474937	123475380	443	222.0	
65414	chr12	123531983	123534641	2658	1329.0	
65415	chr12	123559518	123559831	313	156.0	
65416	chr12	123581888	123582756	868	434.0	
65417	chr12	123583405	123585362	1957	978.0	
65418	chr12	123601207	123603075	1868	934.0	
65419	chr12	123618355	123618939	584	292.0	
65420	chr12	123633118	123634535	1417	708.0	
65421	chr12	123670660	123671800	1140	570.0	
65422	chr12	123681658	123682055	397	198.0	
65423	chr12	123711506	123714574	3068	1534.0	
65424	chr12	123737170	123737446	276	138.0	
65425	chr12	123742126	123743351	1225	612.0	
65426	chr12	123761748	123762728	980	490.0	
65427	chr12	123767545	123768158	613	306.0	
65428	chr12	123841924	123842285	361	180.0	
65429	chr12	123905285	123905782	497	248.0	
65430	chr12	123931568	123932331	763	382.0	
65431	chr12	123934811	123935235	424	212.0	
65432	chr12	123937497	123938843	1346	673.0	
65433	chr12	123941331	123942059	728	364.0	
65434	chr12	123971532	123974297	2765	1382.0	
65435	chr12	123983797	123984297	500	250.0	
65436	chr12	124006215	124006958	743	372.0	
65437	chr12	124008215	124008269	54	27.0	
65438	chr12	124032262	124032634	372	186.0	
65439	chr12	124036530	124036987	457	228.0	
65440	chr12	124109756	124110113	357	178.0	
65441	chr12	124171465	124172065	600	300.0	
65442	chr12	124223934	124224059	125	62.0	
65443	chr12	124234386	124234603	217	108.0	
65444	chr12	124240439	124240803	364	182.0	
65445	chr12	124242457	124243115	658	329.0	
65446	chr12	124246651	124247160	509	254.0	
65447	chr12	124250602	124251227	625	312.0	
65448	chr12	124259896	124259946	50	25.0	
65449	chr12	124273635	124274056	421	210.0	
65450	chr12	124320882	124321795	913	456.0	
65451	chr12	124323586	124324197	611	306.0	
65452	chr12	124345733	124346161	428	214.0	
65453	chr12	124347901	124348718	817	408.0	
65454	chr12	124352828	124352891	63	32.0	
65455	chr12	124379749	124382514	2765	1382.0	
65456	chr12	124384366	124384434	68	34.0	
65457	chr12	124388435	124393426	4991	2496.0	
65458	chr12	124399595	124400092	497	248.0	
65459	chr12	124423699	124424525	826	413.0	
65460	chr12	124428509	124428848	339	170.0	
65461	chr12	124432080	124433893	1813	906.0	
65462	chr12	124450901	124451219	318	159.0	
65463	chr12	124452796	124455682	2886	1443.0	
65464	chr12	124456360	124458525	2165	1082.0	
65465	chr12	124464200	124464441	241	120.0	
65466	chr12	124465345	124467071	1726	863.0	enhancer
65467	chr12	124469161	124469972	811	406.0	
65468	chr12	124477005	124477540	535	268.0	
65469	chr12	124480128	124480996	868	434.0	
65470	chr12	124482219	124482233	14	7.0	
65471	chr12	124484682	124484826	144	72.0	
65472	chr12	124493875	124494434	559	280.0	
65473	chr12	124498393	124498949	556	278.0	
65474	chr12	124505998	124507098	1100	550.0	
65475	chr12	124508824	124509049	225	112.0	
65476	chr12	124518137	124519813	1676	838.0	
65477	chr12	124538087	124539171	1084	542.0	
65478	chr12	124543066	124544394	1328	664.0	
65479	chr12	124545413	124546339	926	463.0	
65480	chr12	124548690	124549364	674	337.0	
65481	chr12	124550494	124552095	1601	800.0	
65482	chr12	124561079	124561731	652	326.0	
65483	chr12	124564586	124564795	209	104.0	
65484	chr12	124565779	124569330	3551	1776.0	
65485	chr12	124581941	124582625	684	342.0	
65486	chr12	124588906	124589422	516	258.0	
65487	chr12	124592240	124593419	1179	590.0	
65488	chr12	124599029	124599328	299	150.0	
65489	chr12	124603170	124603658	488	244.0	
65490	chr12	124608264	124609909	1645	822.0	
65491	chr12	124616560	124617257	697	348.0	
65492	chr12	124622410	124622915	505	252.0	
65493	chr12	124625753	124626870	1117	558.0	
65494	chr12	124633478	124634535	1057	528.0	
65495	chr12	124636087	124636719	632	316.0	
65496	chr12	124640095	124640589	494	247.0	
65497	chr12	124646326	124647051	725	362.0	
65498	chr12	124651473	124652311	838	419.0	
65499	chr12	124652979	124653857	878	439.0	
65500	chr12	124655553	124656465	912	456.0	
65501	chr12	124664608	124665096	488	244.0	
65502	chr12	124668595	124669814	1219	610.0	
65503	chr12	124676099	124676916	817	408.0	
65504	chr12	124681175	124682009	834	417.0	
65505	chr12	124682607	124682975	368	184.0	
65506	chr12	124684504	124685303	799	400.0	
65507	chr12	124687510	124688311	801	400.0	
65508	chr12	124689638	124690161	523	262.0	
65509	chr12	124694210	124695311	1101	550.0	
65510	chr12	124703798	124704417	619	310.0	
65511	chr12	124712839	124714476	1637	818.0	
65512	chr12	124719801	124720418	617	308.0	
65513	chr12	124720983	124721732	749	374.0	
65514	chr12	124726847	124727908	1061	530.0	
65515	chr12	124734126	124735080	954	477.0	
65516	chr12	124736089	124736432	343	172.0	
65517	chr12	124740220	124741254	1034	517.0	
65518	chr12	124745804	124746537	733	366.0	
65519	chr12	124747408	124747895	487	244.0	
65520	chr12	124752631	124752952	321	160.0	
65521	chr12	124754870	124757297	2427	1214.0	
65522	chr12	124759802	124760607	805	402.0	
65523	chr12	124763603	124764779	1176	588.0	
65524	chr12	124766564	124767585	1021	510.0	
65525	chr12	124769110	124769518	408	204.0	
65526	chr12	124771602	124772441	839	420.0	
65527	chr12	124773869	124775589	1720	860.0	
65528	chr12	124815197	124815653	456	228.0	
65529	chr12	124842997	124843335	338	169.0	
65530	chr12	124852059	124853421	1362	681.0	
65531	chr12	124856467	124856825	358	179.0	
65532	chr12	124862242	124862253	11	6.0	
65533	chr12	124862798	124864667	1869	934.0	
65534	chr12	124868745	124869913	1168	584.0	
65535	chr12	124880996	124881659	663	332.0	
65536	chr12	124884731	124885237	506	253.0	
65537	chr12	124898215	124899006	791	396.0	
65538	chr12	124904562	124905197	635	318.0	
65539	chr12	124906444	124907372	928	464.0	
65540	chr12	124908950	124911911	2961	1480.0	
65541	chr12	124912921	124915715	2794	1397.0	
65542	chr12	124916250	124922424	6174	3087.0	
65543	chr12	124925318	124925326	8	4.0	
65544	chr12	124926590	124928740	2150	1075.0	
65545	chr12	124938074	124941432	3358	1679.0	
65546	chr12	124945798	124946560	762	381.0	
65547	chr12	124987940	124989650	1710	855.0	
65548	chr12	124992664	124995548	2884	1442.0	
65549	chr12	124996957	124997463	506	253.0	
65550	chr12	125000168	125000418	250	125.0	
65551	chr12	125049057	125050359	1302	651.0	
65552	chr12	125064705	125066326	1621	810.0	
65553	chr12	125067027	125067245	218	109.0	
65554	chr12	125149991	125150074	83	42.0	
65555	chr12	125183111	125183588	477	238.0	
65556	chr12	125186092	125186528	436	218.0	
65557	chr12	126384269	126384419	150	75.0	
65558	chr12	126512805	126512995	190	95.0	
65559	chr12	126708654	126708763	109	54.0	
65560	chr12	126747503	126747954	451	226.0	
65561	chr12	126763438	126763751	313	156.0	
65562	chr12	126768385	126769108	723	362.0	
65563	chr12	126770298	126770446	148	74.0	
65564	chr12	126771882	126773127	1245	622.0	
65565	chr12	126784317	126784694	377	188.0	
65566	chr12	126874386	126874801	415	208.0	
65567	chr12	127083267	127083791	524	262.0	
65568	chr12	127108638	127108995	357	178.0	
65569	chr12	127145784	127146653	869	434.0	
65570	chr12	127162681	127163763	1082	541.0	
65571	chr12	127165754	127166948	1194	597.0	
65572	chr12	127237074	127238703	1629	814.0	
65573	chr12	127268287	127268451	164	82.0	
65574	chr12	127270117	127270809	692	346.0	
65575	chr12	127275484	127275846	362	181.0	
65576	chr12	127280598	127281128	530	265.0	
65577	chr12	127293525	127293949	424	212.0	
65578	chr12	127559381	127560199	818	409.0	
65579	chr12	128387829	128389206	1377	688.0	
65580	chr12	128570016	128570821	805	402.0	
65581	chr12	128644764	128645110	346	173.0	
65582	chr12	128693103	128693516	413	206.0	
65583	chr12	128745903	128746723	820	410.0	
65584	chr12	128763359	128763937	578	289.0	
65585	chr12	128771442	128772170	728	364.0	
65586	chr12	128782077	128783915	1838	919.0	
65587	chr12	128789200	128789823	623	312.0	
65588	chr12	128791600	128792754	1154	577.0	
65589	chr12	128794426	128797502	3076	1538.0	
65590	chr12	128798547	128798857	310	155.0	
65591	chr12	128806856	128807891	1035	518.0	
65592	chr12	128810100	128812240	2140	1070.0	
65593	chr12	128813981	128814155	174	87.0	
65594	chr12	128814739	128815033	294	147.0	
65595	chr12	128817112	128818663	1551	776.0	
65596	chr12	128820445	128824915	4470	2235.0	
65597	chr12	128829546	128831128	1582	791.0	
65598	chr12	128840829	128841474	645	322.0	
65599	chr12	128843414	128844535	1121	560.0	
65600	chr12	128852549	128854802	2253	1126.0	
65601	chr12	128857057	128858001	944	472.0	
65602	chr12	128914809	128915393	584	292.0	
65603	chr12	128920418	128920912	494	247.0	
65604	chr12	128969594	128970154	560	280.0	
65605	chr12	130031602	130031802	200	100.0	
65606	chr12	130086387	130086558	171	86.0	
65607	chr12	130748108	130748538	430	215.0	
65608	chr12	130754497	130754748	251	126.0	
65609	chr12	130761645	130762222	577	288.0	
65610	chr12	130776099	130776858	759	380.0	
65611	chr12	130796719	130797757	1038	519.0	
65612	chr12	130818173	130819567	1394	697.0	
65613	chr12	130826043	130826734	691	346.0	
65614	chr12	130832758	130833224	466	233.0	
65615	chr12	130838152	130840045	1893	946.0	
65616	chr12	130868262	130869036	774	387.0	
65617	chr12	130870566	130873223	2657	1328.0	
65618	chr12	130873890	130874112	222	111.0	
65619	chr12	130879086	130881157	2071	1036.0	
65620	chr12	130916133	130916603	470	235.0	
65621	chr12	130953647	130954342	695	348.0	
65622	chr12	130965626	130966915	1289	644.0	
65623	chr12	130979547	130980454	907	454.0	
65624	chr12	131047433	131047735	302	151.0	
65625	chr12	131092783	131093738	955	478.0	
65626	chr12	131101746	131102415	669	334.0	
65627	chr12	131104583	131105129	546	273.0	
65628	chr12	131105711	131106336	625	312.0	
65629	chr12	131132262	131132831	569	284.0	
65630	chr12	131452651	131452704	53	26.0	
65631	chr12	131454747	131455002	255	128.0	
65632	chr12	131511209	131511962	753	376.0	
65633	chr12	131536242	131536819	577	288.0	
65634	chr12	131589330	131589633	303	152.0	
65635	chr12	131592892	131593372	480	240.0	
65636	chr12	131599034	131599663	629	314.0	
65637	chr12	131603481	131604899	1418	709.0	
65638	chr12	131606564	131606959	395	198.0	
65639	chr12	131607498	131608161	663	332.0	
65640	chr12	131608871	131609748	877	438.0	
65641	chr12	131626292	131628080	1788	894.0	
65642	chr12	131632219	131632254	35	18.0	
65643	chr12	131667043	131667438	395	198.0	
65644	chr12	131673308	131674014	706	353.0	
65645	chr12	131681889	131684455	2566	1283.0	
65646	chr12	131709904	131712141	2237	1118.0	
65647	chr12	131755272	131755716	444	222.0	
65648	chr12	131766476	131766726	250	125.0	
65649	chr12	131773540	131774352	812	406.0	
65650	chr12	131776222	131776671	449	224.0	
65651	chr12	131804290	131804685	395	198.0	
65652	chr12	131808663	131809204	541	270.0	
65653	chr12	131818954	131819778	824	412.0	
65654	chr12	131827858	131831532	3674	1837.0	
65655	chr12	131851164	131851665	501	250.0	
65656	chr12	131852739	131853260	521	260.0	
65657	chr12	131860370	131861556	1186	593.0	
65658	chr12	131863271	131863319	48	24.0	
65659	chr12	131867528	131867861	333	166.0	
65660	chr12	131872136	131873098	962	481.0	
65661	chr12	131878290	131880011	1721	860.0	
65662	chr12	131883033	131883553	520	260.0	
65663	chr12	131892841	131897265	4424	2212.0	
65664	chr12	131902090	131902293	203	102.0	
65665	chr12	131918016	131920297	2281	1140.0	
65666	chr12	131921883	131921940	57	28.0	
65667	chr12	131922533	131922708	175	88.0	
65668	chr12	131923282	131923785	503	252.0	
65669	chr12	131924448	131925276	828	414.0	
65670	chr12	131927794	131930700	2906	1453.0	
65671	chr12	131947565	131951389	3824	1912.0	
65672	chr12	131958139	131958426	287	144.0	
65673	chr12	131963449	131963735	286	143.0	
65674	chr12	131985082	131985960	878	439.0	
65675	chr12	132001552	132001867	315	158.0	
65676	chr12	132064934	132065622	688	344.0	
65677	chr12	132066191	132066757	566	283.0	
65678	chr12	132070989	132071938	949	474.0	
65679	chr12	132083541	132085737	2196	1098.0	
65680	chr12	132143230	132145705	2475	1238.0	
65681	chr12	132151812	132151921	109	54.0	
65682	chr12	132153439	132155866	2427	1214.0	
65683	chr12	132156505	132156793	288	144.0	
65684	chr12	132161065	132164261	3196	1598.0	
65685	chr12	132173256	132173451	195	98.0	
65686	chr12	132178271	132179358	1087	544.0	
65687	chr12	132185545	132187591	2046	1023.0	
65688	chr12	132188145	132190647	2502	1251.0	
65689	chr12	132218910	132219386	476	238.0	
65690	chr12	132414617	132415550	933	466.0	
65691	chr12	132423337	132423624	287	144.0	
65692	chr12	132428442	132431048	2606	1303.0	
65693	chr12	132433579	132434226	647	324.0	
65694	chr12	132437113	132438482	1369	684.0	
65695	chr12	132439275	132440038	763	382.0	
65696	chr12	132444606	132446800	2194	1097.0	
65697	chr12	132447973	132448372	399	200.0	
65698	chr12	132449563	132450043	480	240.0	
65699	chr12	132451161	132451659	498	249.0	
65700	chr12	132460604	132460939	335	168.0	
65701	chr12	132462768	132463229	461	230.0	
65702	chr12	132467496	132468300	804	402.0	
65703	chr12	132469321	132469875	554	277.0	
65704	chr12	132470847	132471675	828	414.0	
65705	chr12	132474266	132478194	3928	1964.0	
65706	chr12	132478714	132479397	683	342.0	
65707	chr12	132481305	132482435	1130	565.0	
65708	chr12	132486380	132494031	7651	3826.0	
65709	chr12	132494580	132495466	886	443.0	
65710	chr12	132496039	132496040	1	0.0	
65711	chr12	132500077	132501698	1621	810.0	
65712	chr12	132502394	132503042	648	324.0	
65713	chr12	132503626	132503770	144	72.0	
65714	chr12	132504679	132508461	3782	1891.0	
65715	chr12	132509076	132511281	2205	1102.0	
65716	chr12	132512655	132512846	191	96.0	
65717	chr12	132514441	132514734	293	146.0	
65718	chr12	132519321	132519696	375	188.0	
65719	chr12	132521409	132524431	3022	1511.0	
65720	chr12	132529873	132530395	522	261.0	
65721	chr12	132537031	132537378	347	174.0	
65722	chr12	132538426	132538543	117	58.0	
65723	chr12	132558232	132562144	3912	1956.0	
65724	chr12	132593901	132594362	461	230.0	
65725	chr12	132597728	132599208	1480	740.0	
65726	chr12	132600233	132601244	1011	506.0	
65727	chr12	132614819	132615454	635	318.0	
65728	chr12	132618526	132618877	351	176.0	
65729	chr12	132632871	132633272	401	200.0	
65730	chr12	132686564	132688315	1751	876.0	
65731	chr12	132709870	132711644	1774	887.0	
65732	chr12	132760024	132762887	2863	1432.0	
65733	chr12	132766548	132767308	760	380.0	
65734	chr12	132767818	132768999	1181	590.0	
65735	chr12	132769941	132770726	785	392.0	
65736	chr12	132771340	132774144	2804	1402.0	
65737	chr12	132809400	132809782	382	191.0	
65738	chr12	132810512	132810852	340	170.0	
65739	chr12	132818376	132820508	2132	1066.0	
65740	chr12	132827702	132829680	1978	989.0	
65741	chr12	132834019	132834872	853	426.0	
65742	chr12	132847389	132847629	240	120.0	
65743	chr12	132866953	132867374	421	210.0	
65744	chr12	132872610	132873367	757	378.0	
65745	chr12	132886827	132888577	1750	875.0	
65746	chr12	132904446	132905538	1092	546.0	
65747	chr12	132907864	132909602	1738	869.0	
65748	chr12	133129435	133131296	1861	930.0	
65749	chr12	133181051	133182109	1058	529.0	
65750	chr13	19564720	19565286	566	283.0	
65751	chr13	19586616	19588056	1440	720.0	
65752	chr13	19591916	19592296	380	190.0	
65753	chr13	19601652	19602426	774	387.0	
65754	chr13	19619045	19619276	231	116.0	
65755	chr13	19632979	19634849	1870	935.0	
65756	chr13	19766587	19766908	321	160.0	
65757	chr13	19776078	19776830	752	376.0	
65758	chr13	19780914	19783682	2768	1384.0	
65759	chr13	19794107	19794635	528	264.0	
65760	chr13	19818215	19818609	394	197.0	
65761	chr13	19845646	19846126	480	240.0	
65762	chr13	19861003	19865535	4532	2266.0	
65763	chr13	19927129	19927500	371	186.0	
65764	chr13	19956966	19961943	4977	2488.0	
65765	chr13	19984653	19985372	719	360.0	
65766	chr13	20049639	20050136	497	248.0	
65767	chr13	20073760	20074378	618	309.0	
65768	chr13	20104945	20105526	581	290.0	
65769	chr13	20118144	20121470	3326	1663.0	
65770	chr13	20126419	20129029	2610	1305.0	
65771	chr13	20136776	20137114	338	169.0	
65772	chr13	20157437	20157537	100	50.0	
65773	chr13	20160284	20162109	1825	912.0	
65774	chr13	20163138	20163882	744	372.0	
65775	chr13	20170557	20171411	854	427.0	
65776	chr13	20174551	20175658	1107	554.0	
65777	chr13	20182166	20182708	542	271.0	
65778	chr13	20188881	20189614	733	366.0	
65779	chr13	20191780	20194713	2933	1466.0	
65780	chr13	20197214	20197762	548	274.0	
65781	chr13	20219548	20219908	360	180.0	
65782	chr13	20221623	20222283	660	330.0	
65783	chr13	20231163	20232765	1602	801.0	
65784	chr13	20337797	20338574	777	388.0	
65785	chr13	20339421	20339887	466	233.0	
65786	chr13	20351299	20351590	291	146.0	
65787	chr13	20353923	20354437	514	257.0	
65788	chr13	20363199	20363575	376	188.0	
65789	chr13	20411890	20412352	462	231.0	
65790	chr13	20419474	20420120	646	323.0	
65791	chr13	20471010	20471321	311	156.0	
65792	chr13	20475487	20476821	1334	667.0	
65793	chr13	20489150	20489620	470	235.0	
65794	chr13	20492636	20493055	419	210.0	
65795	chr13	20494823	20496055	1232	616.0	
65796	chr13	20500812	20501505	693	346.0	
65797	chr13	20524983	20527062	2079	1040.0	
65798	chr13	20538676	20538984	308	154.0	
65799	chr13	20544203	20544741	538	269.0	
65800	chr13	20546462	20546967	505	252.0	
65801	chr13	20566282	20567911	1629	814.0	
65802	chr13	20669060	20669679	619	310.0	
65803	chr13	20702470	20705178	2708	1354.0	
65804	chr13	20712366	20713081	715	358.0	
65805	chr13	20721752	20722250	498	249.0	
65806	chr13	20772569	20774581	2012	1006.0	
65807	chr13	20798086	20798303	217	108.0	
65808	chr13	20801784	20802147	363	182.0	
65809	chr13	20828434	20829158	724	362.0	
65810	chr13	20891069	20892274	1205	602.0	
65811	chr13	20901871	20903511	1640	820.0	
65812	chr13	20924748	20925220	472	236.0	
65813	chr13	20942993	20944303	1310	655.0	
65814	chr13	20945810	20946459	649	324.0	
65815	chr13	20993753	20994154	401	200.0	
65816	chr13	21010708	21010980	272	136.0	
65817	chr13	21016815	21017932	1117	558.0	
65818	chr13	21022185	21022502	317	158.0	
65819	chr13	21025627	21025851	224	112.0	
65820	chr13	21031928	21032242	314	157.0	
65821	chr13	21033265	21033631	366	183.0	
65822	chr13	21034157	21034179	22	11.0	
65823	chr13	21038993	21039680	687	344.0	
65824	chr13	21040760	21041149	389	194.0	
65825	chr13	21045129	21045507	378	189.0	
65826	chr13	21050221	21050791	570	285.0	
65827	chr13	21060115	21062192	2077	1038.0	
65828	chr13	21065549	21066249	700	350.0	
65829	chr13	21066947	21067375	428	214.0	
65830	chr13	21069459	21070117	658	329.0	
65831	chr13	21074207	21076624	2417	1208.0	
65832	chr13	21079758	21080023	265	132.0	
65833	chr13	21110669	21111371	702	351.0	
65834	chr13	21137742	21138107	365	182.0	
65835	chr13	21139525	21141541	2016	1008.0	
65836	chr13	21147919	21148246	327	164.0	
65837	chr13	21175871	21177465	1594	797.0	
65838	chr13	21180616	21181149	533	266.0	
65839	chr13	21218716	21219115	399	200.0	
65840	chr13	21296922	21298965	2043	1022.0	
65841	chr13	21325954	21326705	751	376.0	
65842	chr13	21330633	21330897	264	132.0	
65843	chr13	21344424	21345425	1001	500.0	
65844	chr13	21365347	21366157	810	405.0	
65845	chr13	21434430	21436478	2048	1024.0	
65846	chr13	21450945	21451404	459	230.0	
65847	chr13	21453345	21453986	641	320.0	
65848	chr13	21457991	21460112	2121	1060.0	
65849	chr13	21476751	21477490	739	370.0	
65850	chr13	21478678	21479567	889	444.0	
65851	chr13	21579706	21580437	731	366.0	
65852	chr13	21595731	21596363	632	316.0	
65853	chr13	21602754	21604951	2197	1098.0	
65854	chr13	21637277	21638640	1363	682.0	
65855	chr13	21668729	21672252	3523	1762.0	
65856	chr13	21672852	21676044	3192	1596.0	
65857	chr13	21849328	21849755	427	214.0	
65858	chr13	21884986	21885550	564	282.0	
65859	chr13	22009383	22010073	690	345.0	
65860	chr13	22017057	22017657	600	300.0	
65861	chr13	22040730	22041443	713	356.0	
65862	chr13	22060973	22063480	2507	1254.0	
65863	chr13	22077095	22077096	1	0.0	
65864	chr13	22082503	22082833	330	165.0	
65865	chr13	22114351	22115584	1233	616.0	
65866	chr13	22126550	22127020	470	235.0	
65867	chr13	22161842	22163503	1661	830.0	
65868	chr13	22214224	22214498	274	137.0	
65869	chr13	22278294	22278751	457	228.0	
65870	chr13	22800955	22801499	544	272.0	
65871	chr13	23020265	23020635	370	185.0	
65872	chr13	23146514	23147644	1130	565.0	
65873	chr13	23320963	23322079	1116	558.0	
65874	chr13	23372411	23372783	372	186.0	
65875	chr13	23374792	23376407	1615	808.0	
65876	chr13	23377975	23378915	940	470.0	
65877	chr13	23384033	23384633	600	300.0	
65878	chr13	23406836	23407295	459	230.0	
65879	chr13	23460227	23461017	790	395.0	
65880	chr13	23466004	23467153	1149	574.0	
65881	chr13	23558814	23559285	471	236.0	
65882	chr13	23570437	23570750	313	156.0	
65883	chr13	23578363	23580316	1953	976.0	
65884	chr13	23608778	23610105	1327	664.0	
65885	chr13	23651986	23652248	262	131.0	
65886	chr13	23695599	23696500	901	450.0	
65887	chr13	23743190	23743704	514	257.0	
65888	chr13	23754638	23755095	457	228.0	
65889	chr13	23777318	23777701	383	192.0	
65890	chr13	23807630	23807840	210	105.0	
65891	chr13	23811132	23811200	68	34.0	
65892	chr13	23848789	23848944	155	78.0	
65893	chr13	23870873	23870955	82	41.0	
65894	chr13	23888378	23890382	2004	1002.0	
65895	chr13	23899523	23899972	449	224.0	
65896	chr13	23903399	23904069	670	335.0	
65897	chr13	23921356	23921807	451	226.0	
65898	chr13	23922485	23922850	365	182.0	
65899	chr13	23960540	23960905	365	182.0	
65900	chr13	23966478	23967486	1008	504.0	
65901	chr13	23979422	23980770	1348	674.0	
65902	chr13	24012830	24012953	123	62.0	
65903	chr13	24053347	24054027	680	340.0	
65904	chr13	24059699	24059700	1	0.0	
65905	chr13	24074653	24075101	448	224.0	
65906	chr13	24152222	24152652	430	215.0	
65907	chr13	24159960	24161883	1923	962.0	
65908	chr13	24187062	24187919	857	428.0	
65909	chr13	24192269	24192598	329	164.0	
65910	chr13	24203908	24204287	379	190.0	
65911	chr13	24207855	24208054	199	100.0	
65912	chr13	24214580	24214884	304	152.0	
65913	chr13	24217512	24217973	461	230.0	
65914	chr13	24219898	24220754	856	428.0	
65915	chr13	24223776	24224667	891	446.0	
65916	chr13	24228806	24229486	680	340.0	
65917	chr13	24230083	24231076	993	496.0	
65918	chr13	24243272	24243755	483	242.0	
65919	chr13	24249617	24255772	6155	3078.0	enhancer
65920	chr13	24257827	24257867	40	20.0	
65921	chr13	24258947	24259171	224	112.0	
65922	chr13	24261034	24262086	1052	526.0	
65923	chr13	24263692	24265837	2145	1072.0	
65924	chr13	24266874	24268127	1253	626.0	
65925	chr13	24269785	24273316	3531	1766.0	
65926	chr13	24274041	24277265	3224	1612.0	
65927	chr13	24279026	24281501	2475	1238.0	
65928	chr13	24288803	24289412	609	304.0	
65929	chr13	24307502	24308208	706	353.0	
65930	chr13	24510683	24513383	2700	1350.0	
65931	chr13	24541355	24542387	1032	516.0	
65932	chr13	24555056	24555263	207	104.0	
65933	chr13	24580275	24580710	435	218.0	
65934	chr13	24583817	24584228	411	206.0	
65935	chr13	24591876	24592092	216	108.0	
65936	chr13	24598058	24598412	354	177.0	
65937	chr13	24605777	24606473	696	348.0	
65938	chr13	24617826	24619323	1497	748.0	
65939	chr13	24625362	24626935	1573	786.0	
65940	chr13	24628138	24628229	91	46.0	
65941	chr13	24630851	24631585	734	367.0	
65942	chr13	24670909	24671766	857	428.0	
65943	chr13	24680120	24681023	903	452.0	
65944	chr13	24683774	24685130	1356	678.0	
65945	chr13	24694040	24694549	509	254.0	
65946	chr13	24708951	24710049	1098	549.0	
65947	chr13	24727715	24728451	736	368.0	
65948	chr13	24900570	24900806	236	118.0	
65949	chr13	24905379	24905538	159	80.0	
65950	chr13	24911154	24911468	314	157.0	
65951	chr13	24922189	24923982	1793	896.0	
65952	chr13	24968413	24968657	244	122.0	
65953	chr13	24982330	24982720	390	195.0	
65954	chr13	24995179	24995650	471	236.0	
65955	chr13	25017927	25018664	737	368.0	
65956	chr13	25037197	25037624	427	214.0	
65957	chr13	25114182	25114552	370	185.0	
65958	chr13	25218058	25218373	315	158.0	
65959	chr13	25232918	25233357	439	220.0	
65960	chr13	25247994	25248446	452	226.0	
65961	chr13	25249068	25249543	475	238.0	
65962	chr13	25252197	25252604	407	204.0	
65963	chr13	25266970	25267056	86	43.0	
65964	chr13	25267675	25268141	466	233.0	
65965	chr13	25281420	25282342	922	461.0	
65966	chr13	25285592	25285606	14	7.0	
65967	chr13	25286164	25288188	2024	1012.0	
65968	chr13	25289005	25289406	401	200.0	
65969	chr13	25292261	25292727	466	233.0	
65970	chr13	25300656	25302894	2238	1119.0	
65971	chr13	25306235	25306872	637	318.0	
65972	chr13	25309972	25310752	780	390.0	
65973	chr13	25375526	25376112	586	293.0	
65974	chr13	25574446	25574786	340	170.0	
65975	chr13	25737802	25738768	966	483.0	
65976	chr13	25753116	25753521	405	202.0	
65977	chr13	25829728	25830055	327	164.0	
65978	chr13	25846889	25848701	1812	906.0	
65979	chr13	25871335	25871753	418	209.0	
65980	chr13	25872954	25873162	208	104.0	
65981	chr13	25874662	25875467	805	402.0	
65982	chr13	25882879	25883305	426	213.0	
65983	chr13	25888106	25888792	686	343.0	
65984	chr13	25901495	25903542	2047	1024.0	
65985	chr13	25906188	25906737	549	274.0	
65986	chr13	25971301	25971937	636	318.0	
65987	chr13	25973347	25973910	563	282.0	
65988	chr13	26012085	26012938	853	426.0	
65989	chr13	26017578	26017961	383	192.0	
65990	chr13	26049965	26050248	283	142.0	
65991	chr13	26051388	26052399	1011	506.0	
65992	chr13	26062865	26063218	353	176.0	
65993	chr13	26184456	26187665	3209	1604.0	
65994	chr13	26221260	26223334	2074	1037.0	
65995	chr13	26253369	26255539	2170	1085.0	
65996	chr13	26482248	26483033	785	392.0	
65997	chr13	26496533	26497053	520	260.0	
65998	chr13	26557374	26557894	520	260.0	
65999	chr13	26677473	26677493	20	10.0	
66000	chr13	26698460	26699136	676	338.0	
66001	chr13	26707681	26708133	452	226.0	
66002	chr13	26721097	26722050	953	476.0	
66003	chr13	26784960	26786505	1545	772.0	
66004	chr13	26872867	26873229	362	181.0	
66005	chr13	26914600	26915107	507	254.0	
66006	chr13	26930208	26930669	461	230.0	
66007	chr13	26972129	26972662	533	266.0	
66008	chr13	26977585	26977979	394	197.0	
66009	chr13	26982895	26983673	778	389.0	
66010	chr13	26985025	26985772	747	374.0	
66011	chr13	27044873	27045579	706	353.0	
66012	chr13	27130843	27131837	994	497.0	
66013	chr13	27132601	27132936	335	168.0	
66014	chr13	27147522	27148126	604	302.0	
66015	chr13	27167913	27168533	620	310.0	
66016	chr13	27169098	27173160	4062	2031.0	
66017	chr13	27174753	27175236	483	242.0	
66018	chr13	27176684	27177273	589	294.0	
66019	chr13	27177776	27177998	222	111.0	
66020	chr13	27212450	27212885	435	218.0	
66021	chr13	27218905	27219241	336	168.0	
66022	chr13	27250641	27254734	4093	2046.0	
66023	chr13	27255474	27255898	424	212.0	
66024	chr13	27257325	27257449	124	62.0	
66025	chr13	27259597	27260533	936	468.0	
66026	chr13	27266904	27268092	1188	594.0	
66027	chr13	27270180	27271901	1721	860.0	
66028	chr13	27284127	27284508	381	190.0	
66029	chr13	27294148	27294559	411	206.0	
66030	chr13	27302916	27303090	174	87.0	
66031	chr13	27339308	27339688	380	190.0	
66032	chr13	27359146	27359610	464	232.0	
66033	chr13	27361868	27362749	881	440.0	
66034	chr13	27374551	27375119	568	284.0	
66035	chr13	27375676	27376151	475	238.0	
66036	chr13	27379906	27380386	480	240.0	
66037	chr13	27401151	27401666	515	258.0	
66038	chr13	27406242	27406851	609	304.0	
66039	chr13	27423427	27428152	4725	2362.0	
66040	chr13	27432482	27433027	545	272.0	
66041	chr13	27442022	27442932	910	455.0	
66042	chr13	27446862	27447584	722	361.0	
66043	chr13	27449308	27451836	2528	1264.0	
66044	chr13	27455203	27455957	754	377.0	
66045	chr13	27477165	27477793	628	314.0	
66046	chr13	27481783	27482139	356	178.0	
66047	chr13	27482682	27483702	1020	510.0	
66048	chr13	27522862	27523694	832	416.0	
66049	chr13	27533025	27533763	738	369.0	
66050	chr13	27559663	27560178	515	258.0	
66051	chr13	27619564	27622668	3104	1552.0	
66052	chr13	27635288	27635646	358	179.0	
66053	chr13	27704655	27705060	405	202.0	
66054	chr13	27789173	27790125	952	476.0	
66055	chr13	27792233	27792925	692	346.0	
66056	chr13	27826297	27827018	721	360.0	
66057	chr13	27829686	27830441	755	378.0	
66058	chr13	27919786	27920155	369	184.0	
66059	chr13	27953272	27954683	1411	706.0	
66060	chr13	27960279	27961164	885	442.0	
66061	chr13	27984184	27984697	513	256.0	
66062	chr13	27994004	27994358	354	177.0	
66063	chr13	28031246	28032389	1143	572.0	
66064	chr13	28037578	28037720	142	71.0	
66065	chr13	28043242	28043640	398	199.0	
66066	chr13	28047741	28048235	494	247.0	
66067	chr13	28059067	28059593	526	263.0	
66068	chr13	28093700	28094614	914	457.0	
66069	chr13	28099726	28101128	1402	701.0	
66070	chr13	28108610	28108659	49	24.0	
66071	chr13	28122179	28122703	524	262.0	
66072	chr13	28136793	28140777	3984	1992.0	
66073	chr13	28141658	28141982	324	162.0	
66074	chr13	28248384	28248505	121	60.0	
66075	chr13	28251405	28251950	545	272.0	
66076	chr13	28268603	28269291	688	344.0	
66077	chr13	28295668	28295975	307	154.0	
66078	chr13	28324156	28324647	491	246.0	
66079	chr13	28355855	28356258	403	202.0	
66080	chr13	28357937	28358565	628	314.0	
66081	chr13	28373761	28374298	537	268.0	
66082	chr13	28394335	28394901	566	283.0	
66083	chr13	28401497	28402273	776	388.0	
66084	chr13	28415871	28416547	676	338.0	
66085	chr13	28421680	28422086	406	203.0	
66086	chr13	28422818	28423726	908	454.0	
66087	chr13	28429607	28430438	831	416.0	
66088	chr13	28466988	28468877	1889	944.0	
66089	chr13	28471155	28471920	765	382.0	
66090	chr13	28474412	28474868	456	228.0	
66091	chr13	28476076	28476563	487	244.0	
66092	chr13	28485837	28486386	549	274.0	
66093	chr13	28488892	28488912	20	10.0	
66094	chr13	28489870	28490447	577	288.0	
66095	chr13	28492464	28492934	470	235.0	
66096	chr13	28493824	28496605	2781	1390.0	
66097	chr13	28505591	28505928	337	168.0	
66098	chr13	28523902	28524452	550	275.0	
66099	chr13	28527580	28528116	536	268.0	
66100	chr13	28530934	28531698	764	382.0	
66101	chr13	28532281	28533123	842	421.0	
66102	chr13	28537241	28537623	382	191.0	
66103	chr13	28568307	28568633	326	163.0	
66104	chr13	28570284	28570753	469	234.0	
66105	chr13	28573851	28575199	1348	674.0	
66106	chr13	28582544	28583267	723	362.0	
66107	chr13	28585238	28586022	784	392.0	
66108	chr13	28587097	28587510	413	206.0	
66109	chr13	28590396	28590868	472	236.0	
66110	chr13	28611558	28612248	690	345.0	
66111	chr13	28621380	28622891	1511	756.0	
66112	chr13	28623772	28624272	500	250.0	
66113	chr13	28628265	28628671	406	203.0	
66114	chr13	28636593	28637292	699	350.0	
66115	chr13	28657740	28660487	2747	1374.0	
66116	chr13	28671182	28671768	586	293.0	
66117	chr13	28679875	28679985	110	55.0	
66118	chr13	28705003	28705120	117	58.0	
66119	chr13	28707886	28708489	603	302.0	
66120	chr13	28716752	28719762	3010	1505.0	
66121	chr13	28741152	28741553	401	200.0	
66122	chr13	28744068	28744999	931	466.0	
66123	chr13	28755020	28755652	632	316.0	
66124	chr13	28796606	28797039	433	216.0	
66125	chr13	28819731	28820429	698	349.0	
66126	chr13	29080958	29081484	526	263.0	
66127	chr13	29125951	29126313	362	181.0	
66128	chr13	29362982	29363362	380	190.0	
66129	chr13	29369126	29369234	108	54.0	
66130	chr13	29434520	29434837	317	158.0	
66131	chr13	29471513	29472750	1237	618.0	
66132	chr13	29495100	29496923	1823	912.0	
66133	chr13	29507880	29508585	705	352.0	
66134	chr13	29529699	29530201	502	251.0	
66135	chr13	29573170	29573691	521	260.0	
66136	chr13	29593918	29596506	2588	1294.0	
66137	chr13	29707854	29708297	443	222.0	
66138	chr13	29758405	29759415	1010	505.0	
66139	chr13	29771158	29771633	475	238.0	
66140	chr13	29817917	29818397	480	240.0	
66141	chr13	29835737	29835784	47	24.0	
66142	chr13	29841667	29842256	589	294.0	
66143	chr13	29846800	29851463	4663	2332.0	
66144	chr13	29860039	29860273	234	117.0	
66145	chr13	29901834	29902946	1112	556.0	
66146	chr13	29905755	29906173	418	209.0	
66147	chr13	29924030	29924596	566	283.0	
66148	chr13	29935112	29938216	3104	1552.0	
66149	chr13	29954067	29954941	874	437.0	
66150	chr13	29958431	29958913	482	241.0	
66151	chr13	30047481	30047859	378	189.0	
66152	chr13	30103491	30103814	323	162.0	
66153	chr13	30107005	30108095	1090	545.0	
66154	chr13	30112134	30113587	1453	726.0	
66155	chr13	30114371	30115601	1230	615.0	
66156	chr13	30119451	30119852	401	200.0	
66157	chr13	30132309	30133320	1011	506.0	
66158	chr13	30142363	30143172	809	404.0	
66159	chr13	30143986	30144413	427	214.0	
66160	chr13	30146437	30146857	420	210.0	
66161	chr13	30147403	30149222	1819	910.0	
66162	chr13	30151301	30151759	458	229.0	
66163	chr13	30153676	30154380	704	352.0	
66164	chr13	30156261	30156417	156	78.0	
66165	chr13	30156994	30158014	1020	510.0	
66166	chr13	30158533	30159202	669	334.0	
66167	chr13	30303576	30304166	590	295.0	
66168	chr13	30306432	30308038	1606	803.0	
66169	chr13	30308644	30308954	310	155.0	
66170	chr13	30315386	30315502	116	58.0	
66171	chr13	30335039	30335504	465	232.0	
66172	chr13	30346064	30347103	1039	520.0	
66173	chr13	30354862	30355786	924	462.0	
66174	chr13	30366149	30366492	343	172.0	
66175	chr13	30371327	30372659	1332	666.0	
66176	chr13	30373351	30377547	4196	2098.0	
66177	chr13	30388141	30389851	1710	855.0	
66178	chr13	30394379	30396812	2433	1216.0	
66179	chr13	30408007	30409416	1409	704.0	
66180	chr13	30413828	30414249	421	210.0	
66181	chr13	30419281	30419331	50	25.0	
66182	chr13	30420636	30423012	2376	1188.0	
66183	chr13	30430224	30430592	368	184.0	
66184	chr13	30443838	30444252	414	207.0	
66185	chr13	30445371	30446271	900	450.0	
66186	chr13	30453722	30454146	424	212.0	
66187	chr13	30461580	30462102	522	261.0	
66188	chr13	30463667	30467323	3656	1828.0	
66189	chr13	30477805	30478255	450	225.0	
66190	chr13	30548108	30548406	298	149.0	
66191	chr13	30551159	30551646	487	244.0	
66192	chr13	30567195	30567328	133	66.0	
66193	chr13	30569885	30570214	329	164.0	
66194	chr13	30572638	30573406	768	384.0	
66195	chr13	30576463	30577979	1516	758.0	
66196	chr13	30581535	30581894	359	180.0	
66197	chr13	30607168	30608457	1289	644.0	
66198	chr13	30615422	30619301	3879	1940.0	
66199	chr13	30627569	30628185	616	308.0	
66200	chr13	30654452	30654635	183	92.0	
66201	chr13	30662297	30663154	857	428.0	
66202	chr13	30673483	30674962	1479	740.0	
66203	chr13	30675652	30676107	455	228.0	
66204	chr13	30679650	30680211	561	280.0	
66205	chr13	30681777	30682346	569	284.0	
66206	chr13	30689989	30691215	1226	613.0	
66207	chr13	30696185	30697822	1637	818.0	
66208	chr13	30712650	30714009	1359	680.0	
66209	chr13	30714528	30715425	897	448.0	
66210	chr13	30718766	30719360	594	297.0	
66211	chr13	30720376	30721124	748	374.0	
66212	chr13	30734699	30736154	1455	728.0	
66213	chr13	30736733	30738915	2182	1091.0	
66214	chr13	30739747	30740875	1128	564.0	
66215	chr13	30742862	30745105	2243	1122.0	
66216	chr13	30745832	30746634	802	401.0	
66217	chr13	30747766	30748275	509	254.0	
66218	chr13	30767102	30767754	652	326.0	
66219	chr13	30772257	30772634	377	188.0	
66220	chr13	30773782	30774854	1072	536.0	
66221	chr13	30776635	30776994	359	180.0	
66222	chr13	30784973	30785750	777	388.0	
66223	chr13	30796113	30796567	454	227.0	
66224	chr13	30802450	30803567	1117	558.0	
66225	chr13	30806837	30807132	295	148.0	
66226	chr13	30845479	30846131	652	326.0	
66227	chr13	30865250	30865815	565	282.0	
66228	chr13	30870290	30870938	648	324.0	
66229	chr13	31039148	31039668	520	260.0	
66230	chr13	31042969	31043151	182	91.0	
66231	chr13	31044143	31046239	2096	1048.0	
66232	chr13	31050818	31051061	243	122.0	
66233	chr13	31131357	31132481	1124	562.0	
66234	chr13	31133486	31134720	1234	617.0	
66235	chr13	31135712	31135996	284	142.0	
66236	chr13	31137925	31138127	202	101.0	
66237	chr13	31141299	31141592	293	146.0	
66238	chr13	31142438	31142878	440	220.0	
66239	chr13	31159364	31163290	3926	1963.0	
66240	chr13	31177956	31178102	146	73.0	
66241	chr13	31199414	31201380	1966	983.0	
66242	chr13	31209273	31209919	646	323.0	
66243	chr13	31236261	31236392	131	66.0	
66244	chr13	31424083	31424574	491	246.0	
66245	chr13	31431629	31432098	469	234.0	
66246	chr13	31742068	31742533	465	232.0	
66247	chr13	31798060	31798641	581	290.0	
66248	chr13	31803346	31803745	399	200.0	
66249	chr13	31805839	31807858	2019	1010.0	
66250	chr13	31814426	31814953	527	264.0	
66251	chr13	31824915	31825520	605	302.0	
66252	chr13	31844989	31845016	27	14.0	
66253	chr13	31845975	31847500	1525	762.0	
66254	chr13	31898464	31898601	137	68.0	
66255	chr13	31903048	31903482	434	217.0	
66256	chr13	31908675	31910683	2008	1004.0	
66257	chr13	31920412	31920730	318	159.0	
66258	chr13	31923406	31923578	172	86.0	
66259	chr13	31927934	31928548	614	307.0	
66260	chr13	31931012	31931276	264	132.0	
66261	chr13	31944902	31945882	980	490.0	
66262	chr13	31950090	31951859	1769	884.0	
66263	chr13	31955675	31956216	541	270.0	
66264	chr13	31957718	31958173	455	228.0	
66265	chr13	31965658	31966033	375	188.0	
66266	chr13	31968396	31968931	535	268.0	
66267	chr13	31982441	31983054	613	306.0	
66268	chr13	31987453	31987937	484	242.0	
66269	chr13	32001058	32001894	836	418.0	
66270	chr13	32015761	32016133	372	186.0	
66271	chr13	32017414	32017947	533	266.0	
66272	chr13	32019585	32020013	428	214.0	
66273	chr13	32030724	32032025	1301	650.0	
66274	chr13	32033866	32033881	15	8.0	
66275	chr13	32035709	32037110	1401	700.0	
66276	chr13	32046175	32046860	685	342.0	
66277	chr13	32047774	32048231	457	228.0	
66278	chr13	32048885	32049404	519	260.0	
66279	chr13	32098453	32098568	115	58.0	
66280	chr13	32107521	32107825	304	152.0	
66281	chr13	32115277	32115426	149	74.0	
66282	chr13	32116211	32116634	423	212.0	
66283	chr13	32117666	32118156	490	245.0	
66284	chr13	32124753	32126078	1325	662.0	
66285	chr13	32164638	32165038	400	200.0	
66286	chr13	32246342	32246820	478	239.0	
66287	chr13	32267813	32268268	455	228.0	
66288	chr13	32309449	32310712	1263	632.0	
66289	chr13	32314447	32316811	2364	1182.0	"protein_binding_site	silencer	mobile_genetic_element	region	protein_binding_site	promoter	protein_binding_site	protein_binding_site"
66290	chr13	32317933	32318543	610	305.0	
66291	chr13	32334622	32335081	459	230.0	
66292	chr13	32340984	32341250	266	133.0	
66293	chr13	32381546	32381984	438	219.0	
66294	chr13	32390011	32390482	471	236.0	
66295	chr13	32414988	32415444	456	228.0	
66296	chr13	32423692	32424464	772	386.0	
66297	chr13	32425504	32429674	4170	2085.0	
66298	chr13	32430264	32430664	400	200.0	
66299	chr13	32443066	32444274	1208	604.0	
66300	chr13	32446786	32447468	682	341.0	
66301	chr13	32453145	32453541	396	198.0	
66302	chr13	32467372	32467783	411	206.0	
66303	chr13	32530654	32532042	1388	694.0	
66304	chr13	32537622	32539631	2009	1004.0	
66305	chr13	32548528	32549287	759	380.0	
66306	chr13	32585430	32588229	2799	1400.0	
66307	chr13	32588773	32589079	306	153.0	
66308	chr13	32639453	32639958	505	252.0	
66309	chr13	32645801	32646298	497	248.0	
66310	chr13	32648107	32648246	139	70.0	
66311	chr13	32650629	32651191	562	281.0	
66312	chr13	32669013	32669501	488	244.0	
66313	chr13	32726621	32726731	110	55.0	
66314	chr13	32736693	32737716	1023	512.0	
66315	chr13	32783353	32783356	3	2.0	
66316	chr13	32791574	32792251	677	338.0	
66317	chr13	32811378	32811720	342	171.0	
66318	chr13	32911556	32911881	325	162.0	
66319	chr13	33016251	33018044	1793	896.0	
66320	chr13	33033183	33033889	706	353.0	
66321	chr13	33034851	33035260	409	204.0	
66322	chr13	33105326	33105898	572	286.0	
66323	chr13	33110855	33111403	548	274.0	
66324	chr13	33123204	33124044	840	420.0	
66325	chr13	33204401	33204421	20	10.0	
66326	chr13	33207434	33207913	479	240.0	
66327	chr13	33228516	33229167	651	326.0	
66328	chr13	33262908	33263375	467	234.0	
66329	chr13	33285018	33286072	1054	527.0	
66330	chr13	33340596	33341033	437	218.0	
66331	chr13	33349852	33350939	1087	544.0	
66332	chr13	33353012	33353795	783	392.0	
66333	chr13	33355353	33355971	618	309.0	
66334	chr13	33363179	33363863	684	342.0	
66335	chr13	33367807	33368372	565	282.0	
66336	chr13	33375542	33375771	229	114.0	
66337	chr13	33487826	33488273	447	224.0	
66338	chr13	33537780	33537781	1	0.0	
66339	chr13	33541811	33543945	2134	1067.0	
66340	chr13	33548066	33548506	440	220.0	
66341	chr13	33610318	33611265	947	474.0	
66342	chr13	33678913	33679796	883	442.0	
66343	chr13	33717538	33717878	340	170.0	
66344	chr13	33722803	33722889	86	43.0	
66345	chr13	33723598	33724263	665	332.0	
66346	chr13	33728380	33729169	789	394.0	
66347	chr13	33729932	33731027	1095	548.0	
66348	chr13	33743546	33745294	1748	874.0	
66349	chr13	33757611	33758108	497	248.0	
66350	chr13	33786737	33787751	1014	507.0	
66351	chr13	33797681	33798467	786	393.0	
66352	chr13	33800207	33800566	359	180.0	
66353	chr13	33817518	33818928	1410	705.0	
66354	chr13	33918532	33918937	405	202.0	
66355	chr13	34157069	34157271	202	101.0	
66356	chr13	34256309	34256481	172	86.0	
66357	chr13	34257891	34258407	516	258.0	
66358	chr13	34941550	34943980	2430	1215.0	
66359	chr13	35139876	35139877	1	0.0	
66360	chr13	35144413	35144851	438	219.0	
66361	chr13	35157147	35157503	356	178.0	
66362	chr13	35164327	35164684	357	178.0	
66363	chr13	35356648	35356969	321	160.0	
66364	chr13	35475545	35476580	1035	518.0	"sequence_feature	repeat_region"
66365	chr13	35496997	35497206	209	104.0	
66366	chr13	35720958	35721299	341	170.0	
66367	chr13	35958091	35958336	245	122.0	
66368	chr13	36282848	36283201	353	176.0	
66369	chr13	36297244	36298509	1265	632.0	
66370	chr13	36343983	36347469	3486	1743.0	
66371	chr13	36395566	36395571	5	2.0	
66372	chr13	36417873	36418391	518	259.0	
66373	chr13	36420303	36420966	663	332.0	
66374	chr13	36431356	36432623	1267	634.0	
66375	chr13	36436817	36437220	403	202.0	
66376	chr13	36815039	36815438	399	200.0	
66377	chr13	36818453	36820669	2216	1108.0	
66378	chr13	36920091	36920464	373	186.0	
66379	chr13	36973666	36973982	316	158.0	
66380	chr13	36981174	36981536	362	181.0	
66381	chr13	36998480	37001898	3418	1709.0	
66382	chr13	37058696	37060405	1709	854.0	
66383	chr13	37074738	37074857	119	60.0	
66384	chr13	37087427	37087898	471	236.0	
66385	chr13	37090896	37091218	322	161.0	
66386	chr13	38167487	38167621	134	67.0	
66387	chr13	38180709	38181033	324	162.0	
66388	chr13	38348449	38350678	2229	1114.0	
66389	chr13	38361619	38361889	270	135.0	
66390	chr13	38398796	38399140	344	172.0	
66391	chr13	39016779	39017105	326	163.0	
66392	chr13	39036267	39039575	3308	1654.0	
66393	chr13	39262994	39263316	322	161.0	
66394	chr13	39400982	39401564	582	291.0	
66395	chr13	39451679	39452471	792	396.0	
66396	chr13	39602524	39603717	1193	596.0	
66397	chr13	39612026	39612396	370	185.0	
66398	chr13	39616077	39616521	444	222.0	
66399	chr13	39641669	39642007	338	169.0	
66400	chr13	39655020	39656617	1597	798.0	
66401	chr13	39684534	39684918	384	192.0	
66402	chr13	39777633	39778069	436	218.0	
66403	chr13	39779369	39779755	386	193.0	
66404	chr13	39810938	39811568	630	315.0	
66405	chr13	39942537	39943217	680	340.0	
66406	chr13	39958076	39958714	638	319.0	
66407	chr13	39998168	39998500	332	166.0	
66408	chr13	40026144	40026818	674	337.0	
66409	chr13	40069075	40069772	697	348.0	
66410	chr13	40115969	40116478	509	254.0	
66411	chr13	40127346	40127964	618	309.0	
66412	chr13	40146660	40147069	409	204.0	
66413	chr13	40148072	40148481	409	204.0	
66414	chr13	40186604	40188756	2152	1076.0	
66415	chr13	40189446	40189850	404	202.0	
66416	chr13	40190533	40191380	847	424.0	
66417	chr13	40206134	40207603	1469	734.0	
66418	chr13	40208596	40208811	215	108.0	
66419	chr13	40220422	40220638	216	108.0	
66420	chr13	40221192	40222600	1408	704.0	
66421	chr13	40315282	40316046	764	382.0	
66422	chr13	40373725	40373984	259	130.0	
66423	chr13	40383810	40384141	331	166.0	
66424	chr13	40388393	40390054	1661	830.0	
66425	chr13	40394354	40394519	165	82.0	
66426	chr13	40399766	40400265	499	250.0	
66427	chr13	40401890	40402887	997	498.0	
66428	chr13	40428321	40428822	501	250.0	
66429	chr13	40432055	40432454	399	200.0	
66430	chr13	40433546	40434058	512	256.0	
66431	chr13	40435000	40435232	232	116.0	
66432	chr13	40438309	40439649	1340	670.0	
66433	chr13	40445302	40446080	778	389.0	
66434	chr13	40452365	40452680	315	158.0	
66435	chr13	40477570	40478362	792	396.0	
66436	chr13	40480588	40481198	610	305.0	
66437	chr13	40484942	40486674	1732	866.0	
66438	chr13	40488681	40490565	1884	942.0	
66439	chr13	40494152	40495609	1457	728.0	
66440	chr13	40508154	40508165	11	6.0	
66441	chr13	40514830	40515174	344	172.0	
66442	chr13	40518377	40518967	590	295.0	
66443	chr13	40539518	40540277	759	380.0	
66444	chr13	40553316	40553319	3	2.0	
66445	chr13	40562626	40563626	1000	500.0	
66446	chr13	40564605	40565510	905	452.0	
66447	chr13	40573919	40574238	319	160.0	
66448	chr13	40576370	40576768	398	199.0	
66449	chr13	40589254	40590259	1005	502.0	
66450	chr13	40596463	40597088	625	312.0	
66451	chr13	40599776	40600605	829	414.0	
66452	chr13	40611734	40611988	254	127.0	
66453	chr13	40612704	40616728	4024	2012.0	
66454	chr13	40617946	40618388	442	221.0	
66455	chr13	40619067	40619069	2	1.0	
66456	chr13	40619805	40620182	377	188.0	
66457	chr13	40624321	40625456	1135	568.0	
66458	chr13	40626294	40626979	685	342.0	
66459	chr13	40628360	40628805	445	222.0	
66460	chr13	40629645	40630589	944	472.0	
66461	chr13	40631538	40632420	882	441.0	
66462	chr13	40633943	40634869	926	463.0	
66463	chr13	40635544	40636365	821	410.0	
66464	chr13	40637584	40638036	452	226.0	
66465	chr13	40638680	40641461	2781	1390.0	
66466	chr13	40642358	40642473	115	58.0	
66467	chr13	40644811	40645354	543	272.0	
66468	chr13	40649019	40649240	221	110.0	
66469	chr13	40650035	40650230	195	98.0	
66470	chr13	40651022	40651154	132	66.0	
66471	chr13	40652133	40654329	2196	1098.0	
66472	chr13	40660148	40660222	74	37.0	
66473	chr13	40662883	40663004	121	60.0	
66474	chr13	40663528	40668756	5228	2614.0	
66475	chr13	40682717	40683584	867	434.0	
66476	chr13	40764855	40764861	6	3.0	
66477	chr13	40770309	40772050	1741	870.0	
66478	chr13	40776231	40778060	1829	914.0	
66479	chr13	40781642	40782162	520	260.0	
66480	chr13	40784078	40784459	381	190.0	
66481	chr13	40788500	40790391	1891	946.0	
66482	chr13	40798358	40798903	545	272.0	
66483	chr13	40804396	40804446	50	25.0	
66484	chr13	40812056	40812341	285	142.0	
66485	chr13	40814074	40814592	518	259.0	
66486	chr13	40839754	40840072	318	159.0	
66487	chr13	40882883	40883049	166	83.0	
66488	chr13	40920920	40922403	1483	742.0	
66489	chr13	40928069	40928383	314	157.0	
66490	chr13	40933463	40934186	723	362.0	
66491	chr13	40940873	40940889	16	8.0	
66492	chr13	40953840	40953855	15	8.0	
66493	chr13	40957674	40957795	121	60.0	
66494	chr13	40960725	40964943	4218	2109.0	
66495	chr13	40966190	40967308	1118	559.0	
66496	chr13	40968631	40970726	2095	1048.0	
66497	chr13	40971249	40971650	401	200.0	
66498	chr13	40972787	40972830	43	22.0	
66499	chr13	40973351	40975500	2149	1074.0	
66500	chr13	40976149	40986608	10459	5230.0	
66501	chr13	40990627	40991242	615	308.0	
66502	chr13	40992643	40993572	929	464.0	
66503	chr13	40994121	40995577	1456	728.0	
66504	chr13	40996384	40997363	979	490.0	
66505	chr13	41001800	41001902	102	51.0	
66506	chr13	41004696	41006611	1915	958.0	
66507	chr13	41007291	41008813	1522	761.0	
66508	chr13	41014347	41014362	15	8.0	
66509	chr13	41015109	41019977	4868	2434.0	
66510	chr13	41025193	41025360	167	84.0	
66511	chr13	41032621	41033841	1220	610.0	
66512	chr13	41034931	41035192	261	130.0	
66513	chr13	41048614	41050576	1962	981.0	
66514	chr13	41053186	41055649	2463	1232.0	
66515	chr13	41058384	41058774	390	195.0	
66516	chr13	41059521	41062569	3048	1524.0	
66517	chr13	41075044	41075492	448	224.0	
66518	chr13	41130554	41130786	232	116.0	
66519	chr13	41131975	41133557	1582	791.0	
66520	chr13	41177381	41178467	1086	543.0	
66521	chr13	41193870	41195093	1223	612.0	
66522	chr13	41199080	41199970	890	445.0	
66523	chr13	41222168	41222686	518	259.0	
66524	chr13	41262759	41264174	1415	708.0	
66525	chr13	41271740	41272228	488	244.0	
66526	chr13	41282151	41282766	615	308.0	
66527	chr13	41286480	41286876	396	198.0	
66528	chr13	41289638	41289760	122	61.0	
66529	chr13	41310436	41312599	2163	1082.0	
66530	chr13	41313854	41313855	1	0.0	
66531	chr13	41314526	41315912	1386	693.0	
66532	chr13	41324336	41325463	1127	564.0	
66533	chr13	41328013	41328135	122	61.0	
66534	chr13	41352778	41353845	1067	534.0	
66535	chr13	41355758	41357470	1712	856.0	
66536	chr13	41361741	41361844	103	52.0	
66537	chr13	41383720	41383784	64	32.0	
66538	chr13	41398732	41399133	401	200.0	
66539	chr13	41411617	41411932	315	158.0	
66540	chr13	41427953	41428709	756	378.0	
66541	chr13	41435130	41435496	366	183.0	
66542	chr13	41452351	41453182	831	416.0	
66543	chr13	41454127	41473977	19850	9925.0	
66544	chr13	41487909	41488578	669	334.0	
66545	chr13	41492279	41493831	1552	776.0	
66546	chr13	41500558	41501641	1083	542.0	
66547	chr13	41502635	41503064	429	214.0	
66548	chr13	41512386	41512849	463	232.0	
66549	chr13	41519894	41520450	556	278.0	
66550	chr13	41540250	41540618	368	184.0	
66551	chr13	41577378	41577823	445	222.0	
66552	chr13	41584957	41585076	119	60.0	
66553	chr13	41587541	41587814	273	136.0	
66554	chr13	41588759	41589310	551	276.0	
66555	chr13	41645350	41645621	271	136.0	
66556	chr13	41651689	41652050	361	180.0	
66557	chr13	41652737	41653151	414	207.0	
66558	chr13	41654488	41655446	958	479.0	
66559	chr13	41668027	41668605	578	289.0	
66560	chr13	41694789	41695310	521	260.0	
66561	chr13	41809990	41810337	347	174.0	
66562	chr13	41811520	41812054	534	267.0	
66563	chr13	41837759	41837838	79	40.0	
66564	chr13	41848659	41848749	90	45.0	
66565	chr13	41864448	41865130	682	341.0	
66566	chr13	41905586	41906000	414	207.0	
66567	chr13	41916535	41917005	470	235.0	
66568	chr13	41955552	41956056	504	252.0	
66569	chr13	41960256	41961761	1505	752.0	
66570	chr13	41971763	41972205	442	221.0	
66571	chr13	41974498	41974871	373	186.0	
66572	chr13	42038428	42038552	124	62.0	
66573	chr13	42039267	42042147	2880	1440.0	
66574	chr13	42047372	42049855	2483	1242.0	
66575	chr13	42068959	42069192	233	116.0	
66576	chr13	42071788	42072056	268	134.0	
66577	chr13	42110290	42111014	724	362.0	
66578	chr13	42271038	42273267	2229	1114.0	
66579	chr13	42274722	42275519	797	398.0	
66580	chr13	42334428	42334429	1	0.0	
66581	chr13	42354293	42355791	1498	749.0	
66582	chr13	42377434	42378777	1343	672.0	
66583	chr13	42380315	42381202	887	444.0	
66584	chr13	42392655	42393720	1065	532.0	
66585	chr13	42394871	42395314	443	222.0	
66586	chr13	42396435	42396938	503	252.0	
66587	chr13	42405663	42406729	1066	533.0	
66588	chr13	42544311	42544618	307	154.0	
66589	chr13	42548662	42549212	550	275.0	
66590	chr13	42574052	42575429	1377	688.0	
66591	chr13	42594950	42595357	407	204.0	enhancer
66592	chr13	42720336	42721048	712	356.0	
66593	chr13	42875948	42877282	1334	667.0	
66594	chr13	42969476	42970168	692	346.0	
66595	chr13	42970700	42971383	683	342.0	
66596	chr13	42977095	42977544	449	224.0	
66597	chr13	42984704	42985140	436	218.0	
66598	chr13	42988478	42988819	341	170.0	
66599	chr13	42990386	42993482	3096	1548.0	
66600	chr13	42996577	42996900	323	162.0	
66601	chr13	43023000	43024385	1385	692.0	
66602	chr13	43045219	43045970	751	376.0	
66603	chr13	43049243	43050212	969	484.0	
66604	chr13	43054748	43056055	1307	654.0	
66605	chr13	43057545	43058684	1139	570.0	
66606	chr13	43075129	43075524	395	198.0	
66607	chr13	43085424	43085825	401	200.0	
66608	chr13	43087945	43088654	709	354.0	
66609	chr13	43307728	43308502	774	387.0	
66610	chr13	43367882	43368379	497	248.0	
66611	chr13	43374656	43374958	302	151.0	
66612	chr13	43378082	43378315	233	116.0	
66613	chr13	43391072	43391382	310	155.0	
66614	chr13	43401338	43401739	401	200.0	
66615	chr13	43769197	43769268	71	36.0	
66616	chr13	43786834	43787314	480	240.0	
66617	chr13	43804513	43804814	301	150.0	
66618	chr13	43830653	43830991	338	169.0	
66619	chr13	43848182	43848670	488	244.0	
66620	chr13	43874542	43874955	413	206.0	
66621	chr13	43877697	43880549	2852	1426.0	
66622	chr13	43905346	43905924	578	289.0	
66623	chr13	43908407	43908820	413	206.0	
66624	chr13	43924621	43925298	677	338.0	
66625	chr13	44050469	44050795	326	163.0	
66626	chr13	44088929	44089532	603	302.0	
66627	chr13	44112593	44113357	764	382.0	
66628	chr13	44116772	44117739	967	484.0	
66629	chr13	44132616	44133189	573	286.0	
66630	chr13	44141148	44142981	1833	916.0	
66631	chr13	44191352	44192277	925	462.0	
66632	chr13	44236711	44237868	1157	578.0	
66633	chr13	44243177	44243691	514	257.0	
66634	chr13	44258629	44260298	1669	834.0	
66635	chr13	44273898	44275385	1487	744.0	
66636	chr13	44275993	44276511	518	259.0	
66637	chr13	44292582	44295337	2755	1378.0	
66638	chr13	44301164	44301733	569	284.0	
66639	chr13	44306595	44307010	415	208.0	
66640	chr13	44352212	44353097	885	442.0	
66641	chr13	44373581	44374094	513	256.0	
66642	chr13	44389025	44389408	383	192.0	
66643	chr13	44416309	44416816	507	254.0	
66644	chr13	44434642	44438597	3955	1978.0	
66645	chr13	44470963	44471280	317	158.0	
66646	chr13	44483617	44484128	511	256.0	
66647	chr13	44484687	44485121	434	217.0	
66648	chr13	44574064	44574633	569	284.0	
66649	chr13	44575159	44578584	3425	1712.0	
66650	chr13	44593781	44594506	725	362.0	
66651	chr13	44768220	44768576	356	178.0	
66652	chr13	44822121	44822167	46	23.0	
66653	chr13	44833592	44834015	423	212.0	
66654	chr13	44917093	44919143	2050	1025.0	
66655	chr13	44969818	44970264	446	223.0	
66656	chr13	44972983	44973384	401	200.0	
66657	chr13	44974146	44974785	639	320.0	
66658	chr13	44988742	44990395	1653	826.0	
66659	chr13	45046860	45048062	1202	601.0	
66660	chr13	45058448	45058909	461	230.0	
66661	chr13	45108788	45109092	304	152.0	
66662	chr13	45119228	45121667	2439	1220.0	
66663	chr13	45132400	45132962	562	281.0	
66664	chr13	45253556	45253871	315	158.0	
66665	chr13	45276918	45277487	569	284.0	
66666	chr13	45281067	45281380	313	156.0	
66667	chr13	45297879	45298557	678	339.0	
66668	chr13	45309202	45309883	681	340.0	
66669	chr13	45310643	45312017	1374	687.0	
66670	chr13	45319938	45320347	409	204.0	
66671	chr13	45321033	45321807	774	387.0	
66672	chr13	45325685	45326310	625	312.0	
66673	chr13	45327302	45328278	976	488.0	
66674	chr13	45329283	45342652	13369	6684.0	
66675	chr13	45353897	45354358	461	230.0	
66676	chr13	45362944	45363383	439	220.0	
66677	chr13	45367047	45368409	1362	681.0	
66678	chr13	45370830	45371504	674	337.0	
66679	chr13	45393973	45394405	432	216.0	
66680	chr13	45395819	45397029	1210	605.0	
66681	chr13	45398790	45399456	666	333.0	
66682	chr13	45410044	45410375	331	166.0	
66683	chr13	45414385	45414829	444	222.0	
66684	chr13	45416678	45419214	2536	1268.0	
66685	chr13	45421846	45423452	1606	803.0	
66686	chr13	45426230	45426859	629	314.0	
66687	chr13	45441609	45441999	390	195.0	
66688	chr13	45464130	45466143	2013	1006.0	
66689	chr13	45467309	45467772	463	232.0	
66690	chr13	45473646	45474046	400	200.0	
66691	chr13	45490133	45490501	368	184.0	
66692	chr13	45511324	45512157	833	416.0	
66693	chr13	45521186	45521792	606	303.0	
66694	chr13	45623507	45623656	149	74.0	
66695	chr13	45695064	45695599	535	268.0	
66696	chr13	45782181	45782489	308	154.0	
66697	chr13	45807505	45807873	368	184.0	
66698	chr13	45824668	45824989	321	160.0	
66699	chr13	45828337	45828579	242	121.0	
66700	chr13	45847420	45848397	977	488.0	
66701	chr13	45850588	45851992	1404	702.0	
66702	chr13	45932517	45933398	881	440.0	
66703	chr13	45950278	45951479	1201	600.0	
66704	chr13	46015322	46015811	489	244.0	
66705	chr13	46051719	46053468	1749	874.0	
66706	chr13	46079855	46080115	260	130.0	
66707	chr13	46100374	46100591	217	108.0	
66708	chr13	46101714	46102379	665	332.0	
66709	chr13	46107085	46107246	161	80.0	
66710	chr13	46113480	46115068	1588	794.0	
66711	chr13	46124193	46127329	3136	1568.0	
66712	chr13	46159807	46162557	2750	1375.0	
66713	chr13	46165414	46166522	1108	554.0	
66714	chr13	46167096	46175790	8694	4347.0	
66715	chr13	46176497	46178668	2171	1086.0	
66716	chr13	46179252	46180505	1253	626.0	
66717	chr13	46181398	46185516	4118	2059.0	
66718	chr13	46195232	46195373	141	70.0	
66719	chr13	46197575	46197706	131	66.0	
66720	chr13	46199847	46200582	735	368.0	
66721	chr13	46202114	46202709	595	298.0	
66722	chr13	46210744	46212509	1765	882.0	
66723	chr13	46288781	46289592	811	406.0	
66724	chr13	46295212	46297610	2398	1199.0	
66725	chr13	46303645	46304505	860	430.0	
66726	chr13	46313059	46314282	1223	612.0	
66727	chr13	46318859	46322233	3374	1687.0	
66728	chr13	46332314	46332601	287	144.0	
66729	chr13	46334043	46334486	443	222.0	
66730	chr13	46338779	46339757	978	489.0	
66731	chr13	46340837	46341982	1145	572.0	
66732	chr13	46352671	46353283	612	306.0	
66733	chr13	46354157	46355270	1113	556.0	
66734	chr13	46369708	46370230	522	261.0	
66735	chr13	46374381	46375308	927	464.0	
66736	chr13	46376891	46378947	2056	1028.0	
66737	chr13	46379859	46380215	356	178.0	
66738	chr13	46382076	46382698	622	311.0	
66739	chr13	46386583	46387977	1394	697.0	
66740	chr13	46389772	46390708	936	468.0	
66741	chr13	46401444	46401855	411	206.0	
66742	chr13	46403665	46405900	2235	1118.0	
66743	chr13	46492969	46493238	269	134.0	
66744	chr13	46535910	46536115	205	102.0	
66745	chr13	46551210	46556776	5566	2783.0	
66746	chr13	46588103	46588148	45	22.0	
66747	chr13	46593204	46594047	843	422.0	
66748	chr13	46595066	46596920	1854	927.0	
66749	chr13	46598450	46599133	683	342.0	
66750	chr13	46600595	46601036	441	220.0	
66751	chr13	46606128	46606733	605	302.0	
66752	chr13	46630435	46631035	600	300.0	
66753	chr13	46640863	46641641	778	389.0	
66754	chr13	46648149	46648425	276	138.0	
66755	chr13	46655599	46655737	138	69.0	
66756	chr13	46665683	46666089	406	203.0	
66757	chr13	46667668	46668858	1190	595.0	
66758	chr13	46679199	46680512	1313	656.0	
66759	chr13	46683991	46684102	111	56.0	
66760	chr13	46721122	46721539	417	208.0	
66761	chr13	46736566	46736895	329	164.0	
66762	chr13	46751460	46752563	1103	552.0	
66763	chr13	46753942	46754009	67	34.0	
66764	chr13	46756905	46757535	630	315.0	
66765	chr13	46759536	46760195	659	330.0	
66766	chr13	46796217	46797988	1771	886.0	
66767	chr13	46831602	46831960	358	179.0	
66768	chr13	46855086	46855557	471	236.0	
66769	chr13	46866036	46866583	547	274.0	
66770	chr13	46893933	46894666	733	366.0	
66771	chr13	46896731	46897037	306	153.0	
66772	chr13	46953689	46953715	26	13.0	
66773	chr13	46961699	46962168	469	234.0	
66774	chr13	46983055	46984288	1233	616.0	
66775	chr13	47480976	47481306	330	165.0	
66776	chr13	47497851	47498633	782	391.0	
66777	chr13	47499650	47500225	575	288.0	
66778	chr13	47774153	47774535	382	191.0	
66779	chr13	47875331	47875548	217	108.0	
66780	chr13	47903823	47904691	868	434.0	
66781	chr13	47933332	47933707	375	188.0	
66782	chr13	48000363	48002165	1802	901.0	
66783	chr13	48004142	48004612	470	235.0	
66784	chr13	48037024	48039380	2356	1178.0	
66785	chr13	48078126	48078627	501	250.0	
66786	chr13	48094317	48095801	1484	742.0	
66787	chr13	48126779	48127641	862	431.0	
66788	chr13	48142217	48142936	719	360.0	
66789	chr13	48144282	48145294	1012	506.0	
66790	chr13	48151242	48151900	658	329.0	
66791	chr13	48155139	48157032	1893	946.0	
66792	chr13	48158250	48159560	1310	655.0	
66793	chr13	48160623	48162693	2070	1035.0	
66794	chr13	48174356	48175491	1135	568.0	
66795	chr13	48181444	48182083	639	320.0	
66796	chr13	48185683	48186786	1103	552.0	
66797	chr13	48188183	48188504	321	160.0	
66798	chr13	48192446	48192797	351	176.0	
66799	chr13	48193630	48194837	1207	604.0	
66800	chr13	48210184	48210569	385	192.0	
66801	chr13	48214429	48215182	753	376.0	
66802	chr13	48220070	48223351	3281	1640.0	
66803	chr13	48232079	48237611	5532	2766.0	
66804	chr13	48241675	48242025	350	175.0	
66805	chr13	48265210	48265721	511	256.0	
66806	chr13	48286832	48287320	488	244.0	
66807	chr13	48302393	48306575	4182	2091.0	
66808	chr13	48308371	48308610	239	120.0	
66809	chr13	48317184	48321454	4270	2135.0	
66810	chr13	48334465	48334958	493	246.0	
66811	chr13	48400807	48401534	727	364.0	
66812	chr13	48402991	48404328	1337	668.0	
66813	chr13	48406010	48406289	279	140.0	
66814	chr13	48410254	48410637	383	192.0	
66815	chr13	48411431	48413525	2094	1047.0	
66816	chr13	48446736	48446750	14	7.0	
66817	chr13	48448868	48449290	422	211.0	
66818	chr13	48476302	48476491	189	94.0	
66819	chr13	48488889	48489970	1081	540.0	
66820	chr13	48491194	48493801	2607	1304.0	
66821	chr13	48496749	48497270	521	260.0	
66822	chr13	48500317	48501399	1082	541.0	
66823	chr13	48504649	48506612	1963	982.0	
66824	chr13	48526203	48526779	576	288.0	
66825	chr13	48531499	48534358	2859	1430.0	
66826	chr13	48535707	48536244	537	268.0	
66827	chr13	48542849	48543174	325	162.0	
66828	chr13	48561395	48563052	1657	828.0	
66829	chr13	48567517	48568735	1218	609.0	
66830	chr13	48570164	48570621	457	228.0	
66831	chr13	48571488	48571824	336	168.0	
66832	chr13	48574049	48574505	456	228.0	
66833	chr13	48575056	48575583	527	264.0	
66834	chr13	48578856	48580640	1784	892.0	
66835	chr13	48586702	48587069	367	184.0	
66836	chr13	48595545	48596094	549	274.0	
66837	chr13	48614979	48615464	485	242.0	
66838	chr13	48624990	48625327	337	168.0	
66839	chr13	48625991	48626399	408	204.0	
66840	chr13	48650133	48650412	279	140.0	
66841	chr13	48652924	48654600	1676	838.0	
66842	chr13	48656605	48657025	420	210.0	
66843	chr13	48658918	48659245	327	164.0	
66844	chr13	48660230	48661172	942	471.0	
66845	chr13	48678511	48679093	582	291.0	
66846	chr13	48681136	48681445	309	154.0	
66847	chr13	48682419	48682888	469	234.0	
66848	chr13	48707410	48707809	399	200.0	
66849	chr13	48731157	48732421	1264	632.0	
66850	chr13	48749617	48750193	576	288.0	
66851	chr13	48768990	48769744	754	377.0	
66852	chr13	48782846	48784092	1246	623.0	
66853	chr13	48791573	48792339	766	383.0	
66854	chr13	48817137	48817562	425	212.0	
66855	chr13	48829615	48829934	319	160.0	
66856	chr13	48859423	48860156	733	366.0	
66857	chr13	48862492	48863041	549	274.0	
66858	chr13	48884237	48884898	661	330.0	
66859	chr13	48896304	48896798	494	247.0	
66860	chr13	48901592	48902840	1248	624.0	
66861	chr13	48974919	48977608	2689	1344.0	
66862	chr13	48979774	48980436	662	331.0	
66863	chr13	48994682	48995017	335	168.0	
66864	chr13	49062500	49062707	207	104.0	
66865	chr13	49099237	49099626	389	194.0	
66866	chr13	49108126	49108603	477	238.0	
66867	chr13	49109891	49110908	1017	508.0	
66868	chr13	49113245	49113961	716	358.0	
66869	chr13	49132477	49132848	371	186.0	
66870	chr13	49146767	49147507	740	370.0	
66871	chr13	49185339	49185767	428	214.0	
66872	chr13	49214733	49215546	813	406.0	
66873	chr13	49216393	49216785	392	196.0	
66874	chr13	49219720	49221409	1689	844.0	
66875	chr13	49225543	49226045	502	251.0	
66876	chr13	49239953	49240622	669	334.0	
66877	chr13	49247088	49249113	2025	1012.0	
66878	chr13	49257811	49258821	1010	505.0	
66879	chr13	49281036	49281539	503	252.0	
66880	chr13	49300910	49301917	1007	504.0	
66881	chr13	49371819	49372401	582	291.0	
66882	chr13	49401303	49401679	376	188.0	
66883	chr13	49418266	49418568	302	151.0	
66884	chr13	49421479	49421840	361	180.0	
66885	chr13	49428394	49428787	393	196.0	
66886	chr13	49443070	49446081	3011	1506.0	
66887	chr13	49454650	49455103	453	226.0	
66888	chr13	49494578	49498946	4368	2184.0	
66889	chr13	49500111	49500763	652	326.0	
66890	chr13	49530043	49530922	879	440.0	
66891	chr13	49533587	49534010	423	212.0	
66892	chr13	49536480	49536767	287	144.0	
66893	chr13	49540587	49540746	159	80.0	
66894	chr13	49551139	49551379	240	120.0	
66895	chr13	49584678	49586411	1733	866.0	
66896	chr13	49606729	49607707	978	489.0	
66897	chr13	49620154	49620544	390	195.0	
66898	chr13	49626105	49626395	290	145.0	
66899	chr13	49628026	49630010	1984	992.0	
66900	chr13	49635331	49636305	974	487.0	
66901	chr13	49641613	49643728	2115	1058.0	
66902	chr13	49652680	49653092	412	206.0	
66903	chr13	49669680	49670131	451	226.0	
66904	chr13	49690452	49692169	1717	858.0	
66905	chr13	49694446	49694757	311	156.0	
66906	chr13	49791209	49793900	2691	1346.0	
66907	chr13	49828427	49828828	401	200.0	
66908	chr13	49847725	49848426	701	350.0	
66909	chr13	49935376	49937430	2054	1027.0	
66910	chr13	49938256	49938746	490	245.0	
66911	chr13	49976414	49977110	696	348.0	
66912	chr13	49995306	49998340	3034	1517.0	
66913	chr13	50027153	50027412	259	130.0	
66914	chr13	50033667	50033707	40	20.0	
66915	chr13	50075709	50076160	451	226.0	
66916	chr13	50080059	50083612	3553	1776.0	
66917	chr13	50084975	50085436	461	230.0	
66918	chr13	50091871	50092320	449	224.0	
66919	chr13	50106383	50107775	1392	696.0	
66920	chr13	50115342	50115432	90	45.0	
66921	chr13	50116625	50116981	356	178.0	
66922	chr13	50121400	50133098	11698	5849.0	
66923	chr13	50140989	50142238	1249	624.0	
66924	chr13	50152188	50153270	1082	541.0	
66925	chr13	50198422	50198996	574	287.0	
66926	chr13	50208569	50209425	856	428.0	
66927	chr13	50220863	50221467	604	302.0	
66928	chr13	50222361	50223228	867	434.0	
66929	chr13	50230187	50230898	711	356.0	
66930	chr13	50235445	50236108	663	332.0	
66931	chr13	50236693	50237441	748	374.0	
66932	chr13	50245078	50245479	401	200.0	
66933	chr13	50248600	50249141	541	270.0	
66934	chr13	50250360	50250825	465	232.0	
66935	chr13	50255547	50256951	1404	702.0	
66936	chr13	50284534	50285031	497	248.0	
66937	chr13	50290002	50290690	688	344.0	
66938	chr13	50292038	50292522	484	242.0	
66939	chr13	50319806	50320283	477	238.0	
66940	chr13	50333990	50334697	707	354.0	
66941	chr13	50355807	50356005	198	99.0	
66942	chr13	50361243	50361634	391	196.0	
66943	chr13	50365279	50367251	1972	986.0	
66944	chr13	50370215	50370768	553	276.0	
66945	chr13	50387042	50387411	369	184.0	
66946	chr13	50422005	50422659	654	327.0	
66947	chr13	50427361	50428049	688	344.0	
66948	chr13	50457417	50457830	413	206.0	
66949	chr13	50511829	50513236	1407	704.0	
66950	chr13	50519961	50520227	266	133.0	
66951	chr13	50587701	50587946	245	122.0	
66952	chr13	50594302	50594976	674	337.0	
66953	chr13	50625959	50626687	728	364.0	
66954	chr13	50635132	50636433	1301	650.0	
66955	chr13	50643121	50643421	300	150.0	
66956	chr13	50654336	50654695	359	180.0	
66957	chr13	50676462	50676919	457	228.0	
66958	chr13	50708471	50708690	219	110.0	
66959	chr13	50713533	50716104	2571	1286.0	
66960	chr13	50721636	50721984	348	174.0	
66961	chr13	50756014	50756543	529	264.0	
66962	chr13	50800277	50801804	1527	764.0	
66963	chr13	50810985	50811538	553	276.0	
66964	chr13	50884333	50884376	43	22.0	
66965	chr13	50892094	50894149	2055	1028.0	
66966	chr13	50909153	50912652	3499	1750.0	
66967	chr13	50914938	50915931	993	496.0	
66968	chr13	50916502	50917548	1046	523.0	
66969	chr13	50919354	50919458	104	52.0	
66970	chr13	50920347	50920386	39	20.0	
66971	chr13	50935048	50935268	220	110.0	
66972	chr13	50936629	50937109	480	240.0	
66973	chr13	50979144	50979650	506	253.0	
66974	chr13	50991661	50992691	1030	515.0	
66975	chr13	51065992	51066982	990	495.0	
66976	chr13	51067765	51067967	202	101.0	
66977	chr13	51069927	51070506	579	290.0	
66978	chr13	51125697	51126166	469	234.0	
66979	chr13	51133140	51133559	419	210.0	
66980	chr13	51153796	51154714	918	459.0	
66981	chr13	51221835	51222945	1110	555.0	
66982	chr13	51241670	51242071	401	200.0	
66983	chr13	51258991	51259531	540	270.0	
66984	chr13	51286301	51286803	502	251.0	
66985	chr13	51330704	51331130	426	213.0	
66986	chr13	51396338	51396737	399	200.0	
66987	chr13	51418879	51419659	780	390.0	
66988	chr13	51420830	51421622	792	396.0	
66989	chr13	51422543	51422620	77	38.0	
66990	chr13	51432925	51433281	356	178.0	
66991	chr13	51434979	51435434	455	228.0	
66992	chr13	51437747	51437933	186	93.0	
66993	chr13	51440505	51441053	548	274.0	
66994	chr13	51441597	51442804	1207	604.0	
66995	chr13	51444180	51444418	238	119.0	
66996	chr13	51450027	51454727	4700	2350.0	
66997	chr13	51457431	51457715	284	142.0	
66998	chr13	51518749	51519201	452	226.0	
66999	chr13	51523085	51523679	594	297.0	
67000	chr13	51534095	51534875	780	390.0	
67001	chr13	51548951	51549543	592	296.0	
67002	chr13	51550251	51550285	34	17.0	
67003	chr13	51559910	51560786	876	438.0	
67004	chr13	51562075	51562733	658	329.0	
67005	chr13	51583333	51586113	2780	1390.0	
67006	chr13	51595528	51595570	42	21.0	
67007	chr13	51599766	51600228	462	231.0	
67008	chr13	51601920	51602529	609	304.0	
67009	chr13	51609039	51609266	227	114.0	
67010	chr13	51614239	51615106	867	434.0	
67011	chr13	51620635	51620988	353	176.0	
67012	chr13	51624665	51625126	461	230.0	
67013	chr13	51631095	51631583	488	244.0	
67014	chr13	51633006	51633296	290	145.0	
67015	chr13	51635270	51635915	645	322.0	
67016	chr13	51643101	51646771	3670	1835.0	
67017	chr13	51669891	51670032	141	70.0	
67018	chr13	51714513	51715041	528	264.0	
67019	chr13	51729926	51729947	21	10.0	
67020	chr13	51764132	51765277	1145	572.0	
67021	chr13	51781305	51781678	373	186.0	
67022	chr13	51785986	51786381	395	198.0	
67023	chr13	51793468	51794491	1023	512.0	
67024	chr13	51797484	51798197	713	356.0	
67025	chr13	51801582	51807399	5817	2908.0	
67026	chr13	51811763	51812501	738	369.0	
67027	chr13	51814654	51815765	1111	556.0	
67028	chr13	51818909	51819677	768	384.0	
67029	chr13	51820899	51822937	2038	1019.0	
67030	chr13	51824537	51827830	3293	1646.0	
67031	chr13	51828752	51829189	437	218.0	
67032	chr13	51832209	51833054	845	422.0	
67033	chr13	51844838	51845657	819	410.0	
67034	chr13	51849605	51850076	471	236.0	
67035	chr13	51896300	51896691	391	196.0	
67036	chr13	51942101	51942549	448	224.0	
67037	chr13	51950699	51951148	449	224.0	
67038	chr13	52001056	52001601	545	272.0	
67039	chr13	52010829	52012842	2013	1006.0	
67040	chr13	52127534	52129509	1975	988.0	
67041	chr13	52158678	52160050	1372	686.0	
67042	chr13	52174025	52174439	414	207.0	
67043	chr13	52187526	52187661	135	68.0	
67044	chr13	52193545	52196111	2566	1283.0	
67045	chr13	52201265	52201814	549	274.0	
67046	chr13	52203909	52204314	405	202.0	
67047	chr13	52236179	52236636	457	228.0	
67048	chr13	52343612	52343630	18	9.0	
67049	chr13	52404404	52404629	225	112.0	
67050	chr13	52405595	52406547	952	476.0	
67051	chr13	52448030	52451255	3225	1612.0	
67052	chr13	52454256	52456456	2200	1100.0	
67053	chr13	52599802	52600597	795	398.0	
67054	chr13	52609278	52609761	483	242.0	
67055	chr13	52615802	52618304	2502	1251.0	
67056	chr13	52623728	52624355	627	314.0	
67057	chr13	52651803	52653707	1904	952.0	
67058	chr13	52665344	52665739	395	198.0	
67059	chr13	52713835	52714369	534	267.0	
67060	chr13	52738835	52739286	451	226.0	
67061	chr13	52809301	52809691	390	195.0	
67062	chr13	52846959	52847360	401	200.0	
67063	chr13	52850649	52851040	391	196.0	
67064	chr13	52910260	52910796	536	268.0	
67065	chr13	52921045	52921856	811	406.0	
67066	chr13	52945316	52945731	415	208.0	
67067	chr13	52947815	52948352	537	268.0	
67068	chr13	52968045	52968549	504	252.0	
67069	chr13	52999343	52999384	41	20.0	
67070	chr13	53151775	53151906	131	66.0	
67071	chr13	57629461	57630241	780	390.0	
67072	chr13	57631791	57632257	466	233.0	
67073	chr13	58324179	58324391	212	106.0	
67074	chr13	58587136	58587571	435	218.0	
67075	chr13	59391556	59392215	659	330.0	
67076	chr13	59452270	59452597	327	164.0	
67077	chr13	59531531	59531857	326	163.0	
67078	chr13	59666589	59666806	217	108.0	
67079	chr13	59678188	59678579	391	196.0	
67080	chr13	59680469	59680586	117	58.0	
67081	chr13	60019526	60019994	468	234.0	
67082	chr13	60028069	60028508	439	220.0	
67083	chr13	60148932	60149239	307	154.0	
67084	chr13	60163157	60164839	1682	841.0	
67085	chr13	60267440	60268262	822	411.0	
67086	chr13	60370327	60370733	406	203.0	
67087	chr13	60395728	60398683	2955	1478.0	
67088	chr13	60427299	60427621	322	161.0	
67089	chr13	60431054	60431533	479	240.0	
67090	chr13	60435712	60436108	396	198.0	
67091	chr13	60473715	60473995	280	140.0	
67092	chr13	65293809	65293883	74	37.0	
67093	chr13	66887136	66887445	309	154.0	
67094	chr13	66994200	66994593	393	196.0	
67095	chr13	67224156	67224635	479	240.0	
67096	chr13	67229453	67231581	2128	1064.0	
67097	chr13	67238311	67238669	358	179.0	
67098	chr13	67632718	67632885	167	84.0	
67099	chr13	67642670	67643061	391	196.0	
67100	chr13	68588882	68588962	80	40.0	
67101	chr13	71274959	71275679	720	360.0	
67102	chr13	71285745	71286139	394	197.0	
67103	chr13	71290747	71292195	1448	724.0	
67104	chr13	71378863	71379343	480	240.0	
67105	chr13	71591413	71591763	350	175.0	
67106	chr13	71610894	71611178	284	142.0	
67107	chr13	71613109	71613759	650	325.0	
67108	chr13	71797644	71798021	377	188.0	
67109	chr13	71807153	71807238	85	42.0	
67110	chr13	71820720	71821121	401	200.0	
67111	chr13	71828153	71828495	342	171.0	
67112	chr13	71864187	71867676	3489	1744.0	
67113	chr13	71879154	71879657	503	252.0	
67114	chr13	72383709	72384028	319	160.0	
67115	chr13	72726642	72728643	2001	1000.0	
67116	chr13	72780712	72782997	2285	1142.0	
67117	chr13	72805722	72806300	578	289.0	
67118	chr13	72808881	72809315	434	217.0	
67119	chr13	72839819	72840203	384	192.0	
67120	chr13	73000043	73000419	376	188.0	
67121	chr13	73058322	73062482	4160	2080.0	
67122	chr13	73224625	73225244	619	310.0	
67123	chr13	73228512	73229098	586	293.0	
67124	chr13	73230630	73231201	571	286.0	
67125	chr13	73256415	73256603	188	94.0	
67126	chr13	73334635	73335635	1000	500.0	
67127	chr13	73338495	73338694	199	100.0	
67128	chr13	73520712	73521562	850	425.0	
67129	chr13	73625891	73626352	461	230.0	
67130	chr13	73702205	73703229	1024	512.0	
67131	chr13	73708335	73708811	476	238.0	
67132	chr13	73714691	73716333	1642	821.0	
67133	chr13	73717513	73717942	429	214.0	
67134	chr13	73754664	73755161	497	248.0	
67135	chr13	73765165	73768136	2971	1486.0	
67136	chr13	73835100	73835820	720	360.0	
67137	chr13	73849232	73849653	421	210.0	
67138	chr13	73859733	73860445	712	356.0	
67139	chr13	73861185	73861189	4	2.0	
67140	chr13	73924725	73924905	180	90.0	
67141	chr13	73929804	73929840	36	18.0	
67142	chr13	73939727	73940122	395	198.0	
67143	chr13	73943223	73944135	912	456.0	
67144	chr13	73948425	73949300	875	438.0	
67145	chr13	73967761	73968304	543	272.0	
67146	chr13	73973189	73973540	351	176.0	
67147	chr13	73984695	73986092	1397	698.0	
67148	chr13	74005844	74006105	261	130.0	
67149	chr13	74024867	74025177	310	155.0	
67150	chr13	74026643	74027597	954	477.0	
67151	chr13	74037776	74038190	414	207.0	
67152	chr13	74040175	74040620	445	222.0	
67153	chr13	74051292	74051628	336	168.0	
67154	chr13	74061821	74063349	1528	764.0	
67155	chr13	74069831	74070905	1074	537.0	
67156	chr13	74080824	74081160	336	168.0	
67157	chr13	74090782	74091633	851	426.0	
67158	chr13	74092905	74093076	171	86.0	
67159	chr13	74129355	74130551	1196	598.0	
67160	chr13	74131220	74131311	91	46.0	
67161	chr13	74131838	74137147	5309	2654.0	
67162	chr13	74174810	74175187	377	188.0	
67163	chr13	74230627	74231758	1131	566.0	
67164	chr13	74243431	74244676	1245	622.0	
67165	chr13	74246390	74246914	524	262.0	
67166	chr13	74251882	74252448	566	283.0	
67167	chr13	74258051	74258443	392	196.0	
67168	chr13	74286612	74289020	2408	1204.0	
67169	chr13	74290233	74290911	678	339.0	
67170	chr13	74299508	74300216	708	354.0	
67171	chr13	74306554	74306908	354	177.0	
67172	chr13	74550130	74550412	282	141.0	
67173	chr13	74575623	74576124	501	250.0	
67174	chr13	75219634	75220190	556	278.0	
67175	chr13	75310175	75310607	432	216.0	
67176	chr13	75318065	75318456	391	196.0	
67177	chr13	75319295	75319596	301	150.0	
67178	chr13	75325903	75327503	1600	800.0	
67179	chr13	75357823	75358367	544	272.0	
67180	chr13	75365743	75366278	535	268.0	
67181	chr13	75372369	75372845	476	238.0	
67182	chr13	75395144	75395411	267	134.0	
67183	chr13	75415835	75416163	328	164.0	
67184	chr13	75480679	75482950	2271	1136.0	
67185	chr13	75489493	75490397	904	452.0	
67186	chr13	75505014	75505772	758	379.0	
67187	chr13	75507571	75508086	515	258.0	
67188	chr13	75512118	75512691	573	286.0	
67189	chr13	75513286	75513633	347	174.0	
67190	chr13	75537223	75538526	1303	652.0	
67191	chr13	75541154	75541808	654	327.0	
67192	chr13	75548819	75550692	1873	936.0	
67193	chr13	75554666	75554756	90	45.0	
67194	chr13	75635054	75637369	2315	1158.0	
67195	chr13	75695764	75696300	536	268.0	
67196	chr13	75702575	75702655	80	40.0	
67197	chr13	75760114	75760869	755	378.0	
67198	chr13	75761416	75761795	379	190.0	
67199	chr13	75762317	75763090	773	386.0	
67200	chr13	75766538	75767102	564	282.0	
67201	chr13	75803148	75803448	300	150.0	
67202	chr13	75869913	75870753	840	420.0	
67203	chr13	75873033	75873631	598	299.0	
67204	chr13	75876205	75876810	605	302.0	
67205	chr13	76440618	76440886	268	134.0	
67206	chr13	76473468	76473978	510	255.0	
67207	chr13	76656070	76656911	841	420.0	
67208	chr13	76667519	76667927	408	204.0	
67209	chr13	76687560	76687764	204	102.0	
67210	chr13	76711529	76712033	504	252.0	
67211	chr13	76720603	76721237	634	317.0	
67212	chr13	76723393	76723971	578	289.0	
67213	chr13	76732566	76732674	108	54.0	
67214	chr13	76744935	76746219	1284	642.0	
67215	chr13	76750144	76750559	415	208.0	
67216	chr13	76756691	76756839	148	74.0	
67217	chr13	76764221	76765093	872	436.0	
67218	chr13	76792719	76793102	383	192.0	
67219	chr13	76797898	76798494	596	298.0	
67220	chr13	76799502	76800114	612	306.0	
67221	chr13	76803852	76804264	412	206.0	
67222	chr13	76804872	76805115	243	122.0	
67223	chr13	76812245	76812333	88	44.0	
67224	chr13	76814020	76814178	158	79.0	
67225	chr13	76822677	76823097	420	210.0	
67226	chr13	76848644	76848991	347	174.0	
67227	chr13	76874434	76874947	513	256.0	
67228	chr13	76879120	76880339	1219	610.0	
67229	chr13	76882333	76882846	513	256.0	
67230	chr13	76884165	76887341	3176	1588.0	
67231	chr13	76894511	76894812	301	150.0	
67232	chr13	76903474	76903999	525	262.0	
67233	chr13	76937180	76937878	698	349.0	
67234	chr13	76939126	76939653	527	264.0	
67235	chr13	76944405	76944847	442	221.0	
67236	chr13	76948203	76948662	459	230.0	
67237	chr13	76950084	76950499	415	208.0	
67238	chr13	76972435	76972779	344	172.0	
67239	chr13	76976673	76976835	162	81.0	
67240	chr13	76979979	76980576	597	298.0	
67241	chr13	76990743	76993340	2597	1298.0	
67242	chr13	77002592	77002972	380	190.0	
67243	chr13	77022185	77022776	591	296.0	
67244	chr13	77023374	77023568	194	97.0	
67245	chr13	77025112	77027800	2688	1344.0	
67246	chr13	77048602	77049884	1282	641.0	
67247	chr13	77065432	77066122	690	345.0	
67248	chr13	77184321	77184972	651	326.0	
67249	chr13	77298294	77298835	541	270.0	
67250	chr13	77300186	77301194	1008	504.0	
67251	chr13	77305254	77305680	426	213.0	
67252	chr13	77308616	77308877	261	130.0	
67253	chr13	77316468	77316901	433	216.0	
67254	chr13	77323108	77324423	1315	658.0	
67255	chr13	77324978	77327760	2782	1391.0	
67256	chr13	77328580	77330612	2032	1016.0	
67257	chr13	77338590	77339797	1207	604.0	
67258	chr13	77345222	77345918	696	348.0	
67259	chr13	77349349	77349776	427	214.0	
67260	chr13	77351380	77351693	313	156.0	
67261	chr13	77353961	77354400	439	220.0	
67262	chr13	77360265	77360657	392	196.0	
67263	chr13	77386918	77387706	788	394.0	
67264	chr13	77415449	77415780	331	166.0	
67265	chr13	77429272	77429807	535	268.0	
67266	chr13	77448696	77449123	427	214.0	
67267	chr13	77456238	77456735	497	248.0	
67268	chr13	77460054	77460857	803	402.0	
67269	chr13	77477936	77479032	1096	548.0	
67270	chr13	77513822	77513891	69	34.0	
67271	chr13	77558738	77559208	470	235.0	
67272	chr13	77593018	77593488	470	235.0	
67273	chr13	77695716	77699417	3701	1850.0	
67274	chr13	77721193	77721303	110	55.0	
67275	chr13	77724111	77724443	332	166.0	
67276	chr13	77729590	77730322	732	366.0	
67277	chr13	77751638	77752272	634	317.0	
67278	chr13	77767273	77767709	436	218.0	
67279	chr13	77779427	77780356	929	464.0	
67280	chr13	77789423	77789720	297	148.0	
67281	chr13	77831899	77833944	2045	1022.0	enhancer
67282	chr13	77836282	77837122	840	420.0	
67283	chr13	77846172	77846562	390	195.0	
67284	chr13	77859669	77859728	59	30.0	
67285	chr13	77860725	77861067	342	171.0	
67286	chr13	77861718	77862156	438	219.0	
67287	chr13	77868771	77869081	310	155.0	
67288	chr13	77891307	77891724	417	208.0	
67289	chr13	77918494	77919684	1190	595.0	"promoter	promoter	protein_binding_site	protein_binding_site	protein_binding_site	region"
67290	chr13	77928905	77929280	375	188.0	
67291	chr13	78022073	78022690	617	308.0	
67292	chr13	78085568	78086196	628	314.0	
67293	chr13	78102164	78102720	556	278.0	
67294	chr13	78120125	78120526	401	200.0	
67295	chr13	78121473	78121879	406	203.0	
67296	chr13	78137560	78138253	693	346.0	
67297	chr13	78460376	78460622	246	123.0	
67298	chr13	78595958	78596301	343	172.0	
67299	chr13	78599969	78600203	234	117.0	
67300	chr13	78601438	78603968	2530	1265.0	
67301	chr13	78607516	78607993	477	238.0	
67302	chr13	78608539	78609621	1082	541.0	
67303	chr13	78650021	78650422	401	200.0	
67304	chr13	78658167	78660704	2537	1268.0	
67305	chr13	78978407	78978792	385	192.0	
67306	chr13	79191018	79191634	616	308.0	
67307	chr13	79194166	79194990	824	412.0	
67308	chr13	79336992	79337284	292	146.0	
67309	chr13	79382473	79383032	559	280.0	
67310	chr13	79385753	79386825	1072	536.0	
67311	chr13	79389067	79389431	364	182.0	
67312	chr13	79391074	79391783	709	354.0	
67313	chr13	79392767	79394485	1718	859.0	
67314	chr13	79401454	79402102	648	324.0	
67315	chr13	79403359	79407022	3663	1832.0	
67316	chr13	79423976	79424448	472	236.0	
67317	chr13	79446343	79446404	61	30.0	
67318	chr13	79448401	79448857	456	228.0	
67319	chr13	79451397	79452221	824	412.0	
67320	chr13	79478044	79482174	4130	2065.0	
67321	chr13	79541407	79541882	475	238.0	
67322	chr13	79779841	79780152	311	156.0	
67323	chr13	79802832	79802913	81	40.0	
67324	chr13	79803948	79804404	456	228.0	
67325	chr13	79812233	79813641	1408	704.0	
67326	chr13	79867240	79867680	440	220.0	
67327	chr13	79880751	79881280	529	264.0	
67328	chr13	80036620	80037345	725	362.0	
67329	chr13	80038963	80039427	464	232.0	
67330	chr13	80040931	80041021	90	45.0	
67331	chr13	80048691	80049335	644	322.0	
67332	chr13	80167946	80169461	1515	758.0	
67333	chr13	80173089	80173676	587	294.0	
67334	chr13	80235187	80235453	266	133.0	
67335	chr13	80276197	80276811	614	307.0	
67336	chr13	80338706	80343511	4805	2402.0	
67337	chr13	80361934	80362294	360	180.0	
67338	chr13	80386074	80386288	214	107.0	
67339	chr13	80399348	80400545	1197	598.0	
67340	chr13	80428418	80428738	320	160.0	
67341	chr13	80441977	80442310	333	166.0	
67342	chr13	80444082	80445023	941	470.0	
67343	chr13	80451961	80452241	280	140.0	
67344	chr13	80454072	80454855	783	392.0	
67345	chr13	80469818	80470204	386	193.0	
67346	chr13	80477922	80478468	546	273.0	
67347	chr13	80873532	80874058	526	263.0	
67348	chr13	82688551	82688926	375	188.0	
67349	chr13	84126656	84127337	681	340.0	
67350	chr13	84136498	84137871	1373	686.0	
67351	chr13	86757058	86758218	1160	580.0	
67352	chr13	86760338	86761119	781	390.0	
67353	chr13	86765388	86765874	486	243.0	
67354	chr13	87670955	87673069	2114	1057.0	
67355	chr13	87677382	87678612	1230	615.0	
67356	chr13	88622210	88622942	732	366.0	
67357	chr13	88920098	88920221	123	62.0	
67358	chr13	88979796	88980124	328	164.0	
67359	chr13	89066916	89067226	310	155.0	
67360	chr13	89401217	89401655	438	219.0	
67361	chr13	89968435	89968918	483	242.0	
67362	chr13	89982100	89983154	1054	527.0	
67363	chr13	90713448	90713829	381	190.0	
67364	chr13	90768317	90768369	52	26.0	
67365	chr13	90800342	90800864	522	261.0	
67366	chr13	90866706	90867779	1073	536.0	
67367	chr13	91134195	91135170	975	488.0	
67368	chr13	91143935	91144578	643	322.0	
67369	chr13	91145550	91145961	411	206.0	
67370	chr13	91154526	91155683	1157	578.0	
67371	chr13	91278959	91279227	268	134.0	
67372	chr13	91313029	91313515	486	243.0	
67373	chr13	91346541	91349678	3137	1568.0	
67374	chr13	91356911	91358882	1971	986.0	
67375	chr13	91375051	91375540	489	244.0	
67376	chr13	91398124	91400386	2262	1131.0	
67377	chr13	91406611	91407057	446	223.0	
67378	chr13	92158408	92158423	15	8.0	
67379	chr13	94168847	94169190	343	172.0	
67380	chr13	94182156	94182775	619	310.0	
67381	chr13	94192644	94192822	178	89.0	
67382	chr13	94312608	94313235	627	314.0	
67383	chr13	94323662	94324489	827	414.0	
67384	chr13	94327226	94327944	718	359.0	
67385	chr13	94329926	94329941	15	8.0	
67386	chr13	94330655	94331134	479	240.0	
67387	chr13	94345588	94345762	174	87.0	
67388	chr13	94362332	94362870	538	269.0	
67389	chr13	94419159	94419796	637	318.0	
67390	chr13	94435586	94436033	447	224.0	
67391	chr13	94480830	94481036	206	103.0	
67392	chr13	94507249	94507660	411	206.0	
67393	chr13	94548401	94550482	2081	1040.0	
67394	chr13	94558597	94559619	1022	511.0	
67395	chr13	94595012	94596905	1893	946.0	
67396	chr13	94601095	94602594	1499	750.0	
67397	chr13	94617359	94617828	469	234.0	
67398	chr13	94620308	94620678	370	185.0	
67399	chr13	94711175	94711580	405	202.0	
67400	chr13	94860864	94861282	418	209.0	
67401	chr13	95137226	95137485	259	130.0	
67402	chr13	95145994	95146317	323	162.0	
67403	chr13	95176626	95176987	361	180.0	
67404	chr13	95185423	95186465	1042	521.0	
67405	chr13	95188971	95190015	1044	522.0	
67406	chr13	95191690	95192341	651	326.0	
67407	chr13	95204266	95204812	546	273.0	
67408	chr13	95213188	95213297	109	54.0	
67409	chr13	95226876	95227835	959	480.0	
67410	chr13	95245096	95245279	183	92.0	
67411	chr13	95285779	95286300	521	260.0	
67412	chr13	95289107	95289207	100	50.0	
67413	chr13	95296541	95296923	382	191.0	
67414	chr13	95300480	95302335	1855	928.0	
67415	chr13	95380442	95381199	757	378.0	
67416	chr13	95387329	95387651	322	161.0	
67417	chr13	95388698	95388808	110	55.0	
67418	chr13	95403558	95404897	1339	670.0	
67419	chr13	95478241	95480768	2527	1264.0	
67420	chr13	95494073	95494441	368	184.0	
67421	chr13	95509592	95510388	796	398.0	
67422	chr13	95524244	95524556	312	156.0	
67423	chr13	95552470	95554725	2255	1128.0	
67424	chr13	95564595	95565466	871	436.0	
67425	chr13	95620008	95620466	458	229.0	
67426	chr13	95623927	95624371	444	222.0	
67427	chr13	95644533	95644918	385	192.0	
67428	chr13	95650670	95651136	466	233.0	
67429	chr13	95661015	95661399	384	192.0	
67430	chr13	95675620	95680262	4642	2321.0	
67431	chr13	95683786	95684763	977	488.0	
67432	chr13	95698165	95698456	291	146.0	
67433	chr13	95703272	95703399	127	64.0	
67434	chr13	95704540	95704735	195	98.0	
67435	chr13	95706390	95708731	2341	1170.0	
67436	chr13	95712827	95713187	360	180.0	
67437	chr13	95714316	95714863	547	274.0	
67438	chr13	95834124	95834628	504	252.0	
67439	chr13	95858694	95859043	349	174.0	
67440	chr13	96020142	96020417	275	138.0	
67441	chr13	96052568	96053822	1254	627.0	
67442	chr13	96982598	96983239	641	320.0	
67443	chr13	96983951	96984427	476	238.0	
67444	chr13	96993990	96994556	566	283.0	
67445	chr13	97001589	97002100	511	256.0	
67446	chr13	97004137	97004523	386	193.0	
67447	chr13	97015758	97016006	248	124.0	
67448	chr13	97017986	97018454	468	234.0	
67449	chr13	97028641	97029116	475	238.0	
67450	chr13	97076797	97077651	854	427.0	
67451	chr13	97082284	97082639	355	178.0	
67452	chr13	97100815	97101274	459	230.0	
67453	chr13	97109551	97110516	965	482.0	
67454	chr13	97210173	97210954	781	390.0	
67455	chr13	97212820	97213122	302	151.0	
67456	chr13	97215320	97215688	368	184.0	
67457	chr13	97221596	97227771	6175	3088.0	
67458	chr13	97238481	97239263	782	391.0	
67459	chr13	97257747	97258445	698	349.0	
67460	chr13	97261588	97262378	790	395.0	
67461	chr13	97344521	97344949	428	214.0	
67462	chr13	97359224	97359903	679	340.0	
67463	chr13	97367327	97367423	96	48.0	
67464	chr13	97369013	97369903	890	445.0	
67465	chr13	97379618	97379707	89	44.0	
67466	chr13	97384378	97384779	401	200.0	
67467	chr13	97386985	97388710	1725	862.0	
67468	chr13	97432203	97436162	3959	1980.0	
67469	chr13	97459977	97460527	550	275.0	
67470	chr13	97975325	97977585	2260	1130.0	
67471	chr13	97986790	97987302	512	256.0	
67472	chr13	98134027	98134091	64	32.0	
67473	chr13	98142382	98143071	689	344.0	
67474	chr13	98279729	98280304	575	288.0	
67475	chr13	98411615	98411943	328	164.0	
67476	chr13	98445073	98446351	1278	639.0	
67477	chr13	98448570	98448635	65	32.0	
67478	chr13	98450805	98450820	15	8.0	
67479	chr13	98466634	98467038	404	202.0	
67480	chr13	98475488	98477175	1687	844.0	
67481	chr13	98478129	98478623	494	247.0	
67482	chr13	98481015	98481284	269	134.0	
67483	chr13	98482603	98482645	42	21.0	
67484	chr13	98484333	98485581	1248	624.0	
67485	chr13	98488761	98489136	375	188.0	
67486	chr13	98495935	98496585	650	325.0	
67487	chr13	98504319	98504907	588	294.0	
67488	chr13	98509111	98510301	1190	595.0	
67489	chr13	98511435	98511919	484	242.0	
67490	chr13	98517413	98518119	706	353.0	
67491	chr13	98520221	98520566	345	172.0	
67492	chr13	98523489	98524696	1207	604.0	
67493	chr13	98525441	98526461	1020	510.0	
67494	chr13	98541647	98542025	378	189.0	
67495	chr13	98542548	98544030	1482	741.0	
67496	chr13	98548894	98549615	721	360.0	
67497	chr13	98553984	98554308	324	162.0	
67498	chr13	98556844	98558623	1779	890.0	
67499	chr13	98561589	98562155	566	283.0	
67500	chr13	98562899	98564798	1899	950.0	
67501	chr13	98565952	98566595	643	322.0	
67502	chr13	98567507	98572984	5477	2738.0	
67503	chr13	98574166	98578320	4154	2077.0	
67504	chr13	98579058	98579349	291	146.0	
67505	chr13	98581380	98582383	1003	502.0	
67506	chr13	98596376	98596777	401	200.0	
67507	chr13	98609996	98610092	96	48.0	
67508	chr13	98649224	98649713	489	244.0	
67509	chr13	98650689	98651108	419	210.0	
67510	chr13	98653143	98653856	713	356.0	
67511	chr13	98672995	98673640	645	322.0	
67512	chr13	98840081	98840534	453	226.0	
67513	chr13	98842824	98843317	493	246.0	
67514	chr13	98853820	98854120	300	150.0	
67515	chr13	98875173	98875489	316	158.0	
67516	chr13	98910437	98910850	413	206.0	
67517	chr13	98918846	98919049	203	102.0	
67518	chr13	98930217	98930429	212	106.0	
67519	chr13	98974182	98974261	79	40.0	
67520	chr13	98976231	98976765	534	267.0	
67521	chr13	98981729	98982012	283	142.0	
67522	chr13	98994865	98995420	555	278.0	
67523	chr13	98998666	98999418	752	376.0	
67524	chr13	99016284	99016464	180	90.0	
67525	chr13	99028815	99029294	479	240.0	
67526	chr13	99033897	99034148	251	126.0	
67527	chr13	99041899	99042065	166	83.0	
67528	chr13	99045633	99047096	1463	732.0	
67529	chr13	99051147	99052479	1332	666.0	
67530	chr13	99055223	99055643	420	210.0	
67531	chr13	99064023	99064351	328	164.0	
67532	chr13	99066179	99066617	438	219.0	
67533	chr13	99075260	99076420	1160	580.0	
67534	chr13	99083970	99088619	4649	2324.0	
67535	chr13	99101937	99101943	6	3.0	
67536	chr13	99124722	99125400	678	339.0	
67537	chr13	99144355	99144708	353	176.0	
67538	chr13	99154032	99154464	432	216.0	
67539	chr13	99176312	99177344	1032	516.0	
67540	chr13	99178473	99179181	708	354.0	
67541	chr13	99192250	99192362	112	56.0	
67542	chr13	99196401	99197634	1233	616.0	
67543	chr13	99199420	99202563	3143	1572.0	
67544	chr13	99203475	99205616	2141	1070.0	
67545	chr13	99214182	99216248	2066	1033.0	
67546	chr13	99217149	99219687	2538	1269.0	
67547	chr13	99220482	99220970	488	244.0	
67548	chr13	99221536	99221638	102	51.0	
67549	chr13	99222214	99222318	104	52.0	
67550	chr13	99223700	99224380	680	340.0	
67551	chr13	99225010	99225534	524	262.0	
67552	chr13	99227697	99232245	4548	2274.0	
67553	chr13	99238149	99239164	1015	508.0	
67554	chr13	99251966	99252439	473	236.0	
67555	chr13	99256294	99257201	907	454.0	
67556	chr13	99257845	99259590	1745	872.0	
67557	chr13	99263956	99264517	561	280.0	
67558	chr13	99265499	99266294	795	398.0	
67559	chr13	99269548	99271529	1981	990.0	
67560	chr13	99273048	99273779	731	366.0	
67561	chr13	99274917	99275497	580	290.0	
67562	chr13	99276683	99278610	1927	964.0	
67563	chr13	99279606	99280843	1237	618.0	
67564	chr13	99281393	99283973	2580	1290.0	
67565	chr13	99288134	99288602	468	234.0	
67566	chr13	99289214	99291419	2205	1102.0	
67567	chr13	99293090	99293674	584	292.0	
67568	chr13	99294944	99297762	2818	1409.0	
67569	chr13	99299604	99300254	650	325.0	
67570	chr13	99301113	99304917	3804	1902.0	
67571	chr13	99305528	99308374	2846	1423.0	
67572	chr13	99310088	99311441	1353	676.0	
67573	chr13	99312257	99315567	3310	1655.0	
67574	chr13	99317032	99317200	168	84.0	
67575	chr13	99320630	99323302	2672	1336.0	
67576	chr13	99332528	99332696	168	84.0	
67577	chr13	99335560	99335974	414	207.0	
67578	chr13	99339704	99340436	732	366.0	
67579	chr13	99341212	99341443	231	116.0	
67580	chr13	99342923	99343014	91	46.0	
67581	chr13	99351177	99358471	7294	3647.0	
67582	chr13	99359634	99361899	2265	1132.0	
67583	chr13	99363454	99363551	97	48.0	
67584	chr13	99365975	99368433	2458	1229.0	
67585	chr13	99370515	99371267	752	376.0	
67586	chr13	99371916	99372583	667	334.0	
67587	chr13	99374535	99376709	2174	1087.0	
67588	chr13	99379283	99379718	435	218.0	
67589	chr13	99380488	99384889	4401	2200.0	
67590	chr13	99387068	99387916	848	424.0	
67591	chr13	99403336	99404051	715	358.0	
67592	chr13	99406634	99407421	787	394.0	
67593	chr13	99413442	99413971	529	264.0	
67594	chr13	99415876	99417900	2024	1012.0	
67595	chr13	99419756	99421158	1402	701.0	
67596	chr13	99421739	99422796	1057	528.0	
67597	chr13	99424899	99426571	1672	836.0	
67598	chr13	99431787	99435308	3521	1760.0	
67599	chr13	99436454	99437659	1205	602.0	
67600	chr13	99442208	99442732	524	262.0	
67601	chr13	99460831	99461232	401	200.0	
67602	chr13	99464437	99465057	620	310.0	
67603	chr13	99469185	99469309	124	62.0	
67604	chr13	99472162	99472348	186	93.0	
67605	chr13	99484153	99484948	795	398.0	
67606	chr13	99489110	99489371	261	130.0	
67607	chr13	99495664	99499544	3880	1940.0	
67608	chr13	99500695	99502496	1801	900.0	
67609	chr13	99503478	99503630	152	76.0	
67610	chr13	99505734	99507232	1498	749.0	
67611	chr13	99507930	99508336	406	203.0	
67612	chr13	99528514	99528970	456	228.0	
67613	chr13	99542648	99543443	795	398.0	
67614	chr13	99548493	99548897	404	202.0	
67615	chr13	99575047	99575328	281	140.0	
67616	chr13	99600331	99600655	324	162.0	
67617	chr13	99601295	99602068	773	386.0	
67618	chr13	99605664	99607321	1657	828.0	
67619	chr13	99614416	99614958	542	271.0	
67620	chr13	99617442	99617718	276	138.0	
67621	chr13	99655649	99659062	3413	1706.0	
67622	chr13	99817789	99818698	909	454.0	
67623	chr13	99859688	99860206	518	259.0	
67624	chr13	99895256	99896325	1069	534.0	
67625	chr13	99900304	99900771	467	234.0	
67626	chr13	99916416	99916919	503	252.0	
67627	chr13	99956427	99957544	1117	558.0	
67628	chr13	99959975	99960244	269	134.0	
67629	chr13	99967821	99971190	3369	1684.0	
67630	chr13	99971866	99971962	96	48.0	
67631	chr13	99978601	99982961	4360	2180.0	
67632	chr13	99985004	99985304	300	150.0	
67633	chr13	99988982	99990375	1393	696.0	
67634	chr13	100088477	100090133	1656	828.0	
67635	chr13	100124230	100124649	419	210.0	
67636	chr13	100129587	100130019	432	216.0	
67637	chr13	100199824	100200134	310	155.0	
67638	chr13	100203649	100204133	484	242.0	
67639	chr13	100210528	100211482	954	477.0	
67640	chr13	100213112	100213554	442	221.0	
67641	chr13	100235290	100236011	721	360.0	
67642	chr13	100269887	100270174	287	144.0	
67643	chr13	100273546	100273918	372	186.0	
67644	chr13	100392650	100393390	740	370.0	
67645	chr13	100423261	100423879	618	309.0	
67646	chr13	100484103	100484108	5	2.0	
67647	chr13	100484740	100485077	337	168.0	
67648	chr13	100491101	100491636	535	268.0	
67649	chr13	100493498	100493798	300	150.0	
67650	chr13	100506111	100507408	1297	648.0	
67651	chr13	100514749	100515270	521	260.0	
67652	chr13	100542639	100543240	601	300.0	
67653	chr13	100572972	100573498	526	263.0	
67654	chr13	100584812	100585426	614	307.0	
67655	chr13	100587799	100589456	1657	828.0	
67656	chr13	100605302	100605708	406	203.0	
67657	chr13	100608808	100609415	607	304.0	
67658	chr13	100610356	100610804	448	224.0	
67659	chr13	100611927	100612854	927	464.0	
67660	chr13	100629757	100630122	365	182.0	
67661	chr13	100658233	100658779	546	273.0	
67662	chr13	100673322	100676014	2692	1346.0	
67663	chr13	100721947	100722249	302	151.0	
67664	chr13	101145051	101145138	87	44.0	
67665	chr13	101514725	101515059	334	167.0	
67666	chr13	101520711	101521132	421	210.0	
67667	chr13	101618400	101619132	732	366.0	
67668	chr13	101623893	101625457	1564	782.0	
67669	chr13	101626814	101627772	958	479.0	
67670	chr13	101706553	101707059	506	253.0	
67671	chr13	101757455	101757816	361	180.0	
67672	chr13	102393875	102395224	1349	674.0	
67673	chr13	102399685	102402741	3056	1528.0	
67674	chr13	102457330	102457752	422	211.0	
67675	chr13	102580451	102580983	532	266.0	
67676	chr13	102582275	102582605	330	165.0	
67677	chr13	102584323	102584919	596	298.0	
67678	chr13	102591607	102592931	1324	662.0	
67679	chr13	102593565	102593676	111	56.0	
67680	chr13	102594925	102598619	3694	1847.0	
67681	chr13	102599438	102600036	598	299.0	
67682	chr13	102604798	102605774	976	488.0	
67683	chr13	102680480	102681523	1043	522.0	
67684	chr13	102721623	102722208	585	292.0	
67685	chr13	102724856	102725211	355	178.0	
67686	chr13	102771466	102771718	252	126.0	
67687	chr13	102772565	102774652	2087	1044.0	
67688	chr13	102779324	102780279	955	478.0	
67689	chr13	102798393	102801082	2689	1344.0	
67690	chr13	102844903	102848194	3291	1646.0	
67691	chr13	102854697	102855054	357	178.0	
67692	chr13	102870281	102871029	748	374.0	
67693	chr13	102915979	102916452	473	236.0	
67694	chr13	103007213	103007278	65	32.0	
67695	chr13	104869532	104869856	324	162.0	
67696	chr13	104875073	104875498	425	212.0	
67697	chr13	104984195	104984966	771	386.0	
67698	chr13	105139083	105140614	1531	766.0	
67699	chr13	105177188	105178005	817	408.0	
67700	chr13	105272606	105273162	556	278.0	
67701	chr13	106490959	106491202	243	122.0	
67702	chr13	106493422	106494007	585	292.0	
67703	chr13	106500025	106500186	161	80.0	
67704	chr13	106532822	106536901	4079	2040.0	
67705	chr13	106561704	106562306	602	301.0	
67706	chr13	106564693	106568917	4224	2112.0	
67707	chr13	106570246	106571003	757	378.0	
67708	chr13	106619901	106620337	436	218.0	
67709	chr13	106917513	106918465	952	476.0	
67710	chr13	107205359	107205628	269	134.0	
67711	chr13	107211051	107211352	301	150.0	
67712	chr13	108155482	108155888	406	203.0	
67713	chr13	108185342	108185381	39	20.0	
67714	chr13	108212828	108213211	383	192.0	
67715	chr13	108214327	108216063	1736	868.0	
67716	chr13	108217688	108221439	3751	1876.0	
67717	chr13	108225427	108226606	1179	590.0	
67718	chr13	108227589	108228077	488	244.0	
67719	chr13	108266244	108267783	1539	770.0	
67720	chr13	108268593	108270806	2213	1106.0	
67721	chr13	108273776	108273808	32	16.0	
67722	chr13	108281852	108282329	477	238.0	
67723	chr13	108306877	108307180	303	152.0	
67724	chr13	108322161	108322822	661	330.0	
67725	chr13	108326227	108326745	518	259.0	
67726	chr13	108342320	108343327	1007	504.0	
67727	chr13	108368209	108368980	771	386.0	
67728	chr13	108508309	108508617	308	154.0	
67729	chr13	108915615	108916316	701	350.0	
67730	chr13	108944765	108945131	366	183.0	
67731	chr13	108961462	108961968	506	253.0	
67732	chr13	109131574	109132357	783	392.0	
67733	chr13	109145551	109145937	386	193.0	
67734	chr13	109162085	109162697	612	306.0	
67735	chr13	109361524	109362003	479	240.0	
67736	chr13	109383891	109384014	123	62.0	
67737	chr13	109384692	109385574	882	441.0	
67738	chr13	109387431	109387839	408	204.0	
67739	chr13	109389641	109390551	910	455.0	
67740	chr13	109397990	109398486	496	248.0	
67741	chr13	109400151	109400682	531	266.0	
67742	chr13	109402922	109403405	483	242.0	
67743	chr13	109412524	109412745	221	110.0	
67744	chr13	109418101	109418487	386	193.0	
67745	chr13	109422323	109422486	163	82.0	
67746	chr13	109512064	109512248	184	92.0	
67747	chr13	109570224	109570722	498	249.0	
67748	chr13	109610487	109610927	440	220.0	
67749	chr13	109651746	109652922	1176	588.0	
67750	chr13	109654278	109655928	1650	825.0	
67751	chr13	109667801	109667889	88	44.0	
67752	chr13	109700313	109700317	4	2.0	
67753	chr13	109704617	109706015	1398	699.0	
67754	chr13	109708066	109708644	578	289.0	
67755	chr13	109715786	109716346	560	280.0	
67756	chr13	109725277	109725685	408	204.0	
67757	chr13	109731669	109732416	747	374.0	
67758	chr13	109733986	109734246	260	130.0	
67759	chr13	109743898	109744020	122	61.0	
67760	chr13	109744827	109745013	186	93.0	
67761	chr13	109745886	109746016	130	65.0	
67762	chr13	109747479	109748174	695	348.0	
67763	chr13	109748724	109752961	4237	2118.0	
67764	chr13	109755568	109757265	1697	848.0	
67765	chr13	109758807	109761383	2576	1288.0	
67766	chr13	109761917	109763159	1242	621.0	
67767	chr13	109764108	109765547	1439	720.0	
67768	chr13	109766913	109767735	822	411.0	
67769	chr13	109768791	109770748	1957	978.0	
67770	chr13	109776735	109776749	14	7.0	
67771	chr13	109777943	109789303	11360	5680.0	
67772	chr13	109790933	109791776	843	422.0	
67773	chr13	110113541	110113594	53	26.0	
67774	chr13	110115975	110116448	473	236.0	
67775	chr13	110137024	110139018	1994	997.0	
67776	chr13	110154340	110154995	655	328.0	
67777	chr13	110160219	110161899	1680	840.0	
67778	chr13	110222138	110222635	497	248.0	
67779	chr13	110340805	110342041	1236	618.0	
67780	chr13	110412052	110412674	622	311.0	
67781	chr13	110422004	110422035	31	16.0	
67782	chr13	110445211	110445592	381	190.0	
67783	chr13	110447021	110447279	258	129.0	
67784	chr13	110455793	110456491	698	349.0	
67785	chr13	110463865	110464926	1061	530.0	
67786	chr13	110470273	110472364	2091	1046.0	
67787	chr13	110509974	110510641	667	334.0	
67788	chr13	110520169	110522424	2255	1128.0	
67789	chr13	110524498	110524905	407	204.0	
67790	chr13	110525643	110526122	479	240.0	
67791	chr13	110528168	110528864	696	348.0	
67792	chr13	110531629	110532552	923	462.0	
67793	chr13	110536037	110537200	1163	582.0	
67794	chr13	110538652	110539043	391	196.0	
67795	chr13	110555711	110556252	541	270.0	
67796	chr13	110559394	110560045	651	326.0	
67797	chr13	110560571	110562658	2087	1044.0	
67798	chr13	110575307	110576257	950	475.0	
67799	chr13	110593411	110593915	504	252.0	
67800	chr13	110611174	110611357	183	92.0	
67801	chr13	110614890	110617116	2226	1113.0	
67802	chr13	110629725	110630194	469	234.0	
67803	chr13	110644678	110645500	822	411.0	
67804	chr13	110657890	110659007	1117	558.0	
67805	chr13	110663731	110666547	2816	1408.0	
67806	chr13	110675672	110677981	2309	1154.0	
67807	chr13	110680888	110681148	260	130.0	
67808	chr13	110683150	110683623	473	236.0	
67809	chr13	110697855	110698314	459	230.0	
67810	chr13	110699388	110699897	509	254.0	
67811	chr13	110704845	110707243	2398	1199.0	
67812	chr13	110711627	110716717	5090	2545.0	
67813	chr13	110717430	110717517	87	44.0	
67814	chr13	110726208	110727190	982	491.0	
67815	chr13	110727726	110728383	657	328.0	
67816	chr13	110801118	110801397	279	140.0	
67817	chr13	110819220	110819907	687	344.0	
67818	chr13	110857608	110857645	37	18.0	
67819	chr13	110870049	110870625	576	288.0	
67820	chr13	110874376	110875586	1210	605.0	
67821	chr13	110887447	110887572	125	62.0	
67822	chr13	110912005	110916873	4868	2434.0	
67823	chr13	110925248	110925600	352	176.0	
67824	chr13	110937851	110938319	468	234.0	
67825	chr13	111046873	111047126	253	126.0	
67826	chr13	111067109	111068168	1059	530.0	
67827	chr13	111114378	111115685	1307	654.0	
67828	chr13	111152792	111154689	1897	948.0	
67829	chr13	111162255	111162295	40	20.0	
67830	chr13	111166803	111167377	574	287.0	
67831	chr13	111176798	111178184	1386	693.0	
67832	chr13	111179945	111180737	792	396.0	
67833	chr13	111183136	111185486	2350	1175.0	
67834	chr13	111188879	111189988	1109	554.0	
67835	chr13	111193322	111193493	171	86.0	
67836	chr13	111201542	111201914	372	186.0	
67837	chr13	111202689	111203178	489	244.0	
67838	chr13	111204048	111204255	207	104.0	
67839	chr13	111214329	111214842	513	256.0	
67840	chr13	111216195	111216573	378	189.0	
67841	chr13	111223336	111223823	487	244.0	
67842	chr13	111281930	111282301	371	186.0	
67843	chr13	111304282	111304505	223	112.0	
67844	chr13	112066486	112067095	609	304.0	
67845	chr13	112574720	112575408	688	344.0	
67846	chr13	112583306	112584116	810	405.0	
67847	chr13	112586558	112588812	2254	1127.0	
67848	chr13	112605923	112606983	1060	530.0	
67849	chr13	112616958	112617325	367	184.0	
67850	chr13	112640689	112641176	487	244.0	
67851	chr13	112688128	112691890	3762	1881.0	
67852	chr13	112693952	112694653	701	350.0	
67853	chr13	112716004	112716358	354	177.0	
67854	chr13	112725702	112726169	467	234.0	
67855	chr13	112767646	112769451	1805	902.0	
67856	chr13	112869898	112870016	118	59.0	
67857	chr13	112873243	112874956	1713	856.0	
67858	chr13	112885670	112886281	611	306.0	
67859	chr13	112892871	112895302	2431	1216.0	
67860	chr13	112908399	112908743	344	172.0	
67861	chr13	112942489	112944013	1524	762.0	
67862	chr13	112968188	112969995	1807	904.0	
67863	chr13	113005447	113005824	377	188.0	
67864	chr13	113029444	113029868	424	212.0	
67865	chr13	113110013	113111022	1009	504.0	
67866	chr13	113129995	113130226	231	116.0	
67867	chr13	113152150	113155674	3524	1762.0	
67868	chr13	113161200	113161847	647	324.0	
67869	chr13	113162712	113163524	812	406.0	
67870	chr13	113175675	113176932	1257	628.0	
67871	chr13	113179885	113180358	473	236.0	
67872	chr13	113184797	113185483	686	343.0	
67873	chr13	113186059	113187733	1674	837.0	
67874	chr13	113207852	113210606	2754	1377.0	
67875	chr13	113220885	113221275	390	195.0	
67876	chr13	113272629	113274240	1611	806.0	
67877	chr13	113275295	113275716	421	210.0	
67878	chr13	113292001	113292843	842	421.0	
67879	chr13	113296393	113298730	2337	1168.0	
67880	chr13	113299942	113300337	395	198.0	
67881	chr13	113363519	113364332	813	406.0	
67882	chr13	113385484	113385862	378	189.0	
67883	chr13	113393514	113394596	1082	541.0	
67884	chr13	113446065	113446372	307	154.0	
67885	chr13	113449106	113449716	610	305.0	
67886	chr13	113474102	113474817	715	358.0	
67887	chr13	113489615	113492012	2397	1198.0	
67888	chr13	113493012	113493778	766	383.0	
67889	chr13	113506106	113506325	219	110.0	
67890	chr13	113508254	113508963	709	354.0	
67891	chr13	113527573	113527865	292	146.0	
67892	chr13	113552964	113553500	536	268.0	
67893	chr13	113558880	113559005	125	62.0	
67894	chr13	113562397	113562817	420	210.0	
67895	chr13	113584202	113585703	1501	750.0	
67896	chr13	113586833	113587355	522	261.0	
67897	chr13	113588587	113589140	553	276.0	
67898	chr13	113592232	113592734	502	251.0	
67899	chr13	113606637	113608621	1984	992.0	
67900	chr13	113616247	113617505	1258	629.0	
67901	chr13	113623641	113624202	561	280.0	
67902	chr13	113724418	113725483	1065	532.0	
67903	chr13	113726296	113727152	856	428.0	
67904	chr13	113730831	113730876	45	22.0	
67905	chr13	113732310	113732664	354	177.0	
67906	chr13	113741357	113742482	1125	562.0	
67907	chr13	113758471	113760055	1584	792.0	
67908	chr13	113771916	113772356	440	220.0	
67909	chr13	113815335	113817847	2512	1256.0	
67910	chr13	113846490	113846984	494	247.0	
67911	chr13	113854739	113855118	379	190.0	
67912	chr13	113862946	113864323	1377	688.0	
67913	chr13	113875747	113877139	1392	696.0	
67914	chr13	113930830	113931769	939	470.0	
67915	chr13	113971413	113972741	1328	664.0	
67916	chr13	113973464	113974039	575	288.0	
67917	chr13	113974660	113975172	512	256.0	
67918	chr13	113976667	113976767	100	50.0	
67919	chr13	113978706	113980634	1928	964.0	
67920	chr13	113981278	113982399	1121	560.0	
67921	chr13	113990185	113990533	348	174.0	
67922	chr13	113991953	113991968	15	8.0	
67923	chr13	113994738	113995614	876	438.0	
67924	chr13	113996193	113998102	1909	954.0	
67925	chr13	114001403	114003295	1892	946.0	
67926	chr13	114004970	114005634	664	332.0	
67927	chr13	114010610	114012643	2033	1016.0	
67928	chr13	114015720	114015837	117	58.0	
67929	chr13	114018598	114019788	1190	595.0	
67930	chr13	114020506	114021963	1457	728.0	
67931	chr13	114023783	114025280	1497	748.0	
67932	chr13	114026038	114026133	95	48.0	
67933	chr13	114029828	114030197	369	184.0	
67934	chr13	114032344	114032565	221	110.0	
67935	chr13	114035557	114036921	1364	682.0	
67936	chr13	114038535	114039458	923	462.0	
67937	chr13	114041357	114043916	2559	1280.0	
67938	chr13	114045305	114045377	72	36.0	
67939	chr13	114047439	114047883	444	222.0	
67940	chr13	114048652	114050223	1571	786.0	
67941	chr13	114051036	114051379	343	172.0	
67942	chr13	114053083	114053517	434	217.0	
67943	chr13	114054299	114055081	782	391.0	
67944	chr13	114055926	114058738	2812	1406.0	
67945	chr13	114059492	114059841	349	174.0	
67946	chr13	114062676	114069512	6836	3418.0	
67947	chr13	114076500	114076751	251	126.0	
67948	chr13	114078019	114079318	1299	650.0	
67949	chr13	114081845	114081852	7	4.0	
67950	chr13	114083281	114083471	190	95.0	
67951	chr13	114087482	114087611	129	64.0	
67952	chr13	114090555	114090780	225	112.0	
67953	chr13	114095938	114096124	186	93.0	
67954	chr13	114099899	114101391	1492	746.0	
67955	chr13	114102270	114103286	1016	508.0	
67956	chr13	114104296	114105508	1212	606.0	
67957	chr13	114107319	114108847	1528	764.0	
67958	chr13	114109559	114112093	2534	1267.0	
67959	chr13	114115123	114115947	824	412.0	
67960	chr13	114117847	114119491	1644	822.0	
67961	chr13	114120713	114121149	436	218.0	
67962	chr13	114122335	114123441	1106	553.0	
67963	chr13	114124738	114125637	899	450.0	
67964	chr13	114126408	114127159	751	376.0	
67965	chr13	114128193	114133217	5024	2512.0	
67966	chr13	114133885	114135746	1861	930.0	
67967	chr13	114139980	114144616	4636	2318.0	
67968	chr13	114146589	114146929	340	170.0	
67969	chr13	114148018	114149222	1204	602.0	
67970	chr13	114150882	114152249	1367	684.0	
67971	chr13	114153026	114153431	405	202.0	
67972	chr13	114154347	114157056	2709	1354.0	
67973	chr13	114161631	114162644	1013	506.0	
67974	chr13	114166582	114166732	150	75.0	
67975	chr13	114167410	114167863	453	226.0	
67976	chr13	114194886	114195232	346	173.0	
67977	chr13	114222281	114223019	738	369.0	
67978	chr13	114225922	114227403	1481	740.0	
67979	chr13	114234400	114235623	1223	612.0	
67980	chr13	114263448	114264314	866	433.0	
67981	chr13	114268265	114269308	1043	522.0	
67982	chr13	114280330	114282820	2490	1245.0	
67983	chr13	114313415	114315850	2435	1218.0	
67984	chr13	114325842	114325913	71	36.0	
67985	chr13	114334365	114334732	367	184.0	
67986	chr13	114339710	114340728	1018	509.0	
67987	chr14	19771865	19772768	903	452.0	
67988	chr14	19974818	19975251	433	216.0	
67989	chr14	20002268	20002794	526	263.0	
67990	chr14	20179188	20180342	1154	577.0	
67991	chr14	20197481	20197839	358	179.0	
67992	chr14	20295207	20295484	277	138.0	
67993	chr14	20305350	20306296	946	473.0	
67994	chr14	20327042	20327884	842	421.0	
67995	chr14	20332564	20333876	1312	656.0	
67996	chr14	20341278	20344291	3013	1506.0	
67997	chr14	20358367	20358927	560	280.0	
67998	chr14	20387477	20388056	579	290.0	
67999	chr14	20412038	20414430	2392	1196.0	
68000	chr14	20415640	20416513	873	436.0	
68001	chr14	20427126	20428378	1252	626.0	
68002	chr14	20429675	20430060	385	192.0	
68003	chr14	20437424	20437818	394	197.0	
68004	chr14	20438763	20439015	252	126.0	
68005	chr14	20440462	20441841	1379	690.0	
68006	chr14	20454160	20456226	2066	1033.0	"protein_binding_site	protein_binding_site	promoter	region	promoter	promoter	region	region	protein_binding_site	region	region	CAAT_signal	protein_binding_site	region	region"
68007	chr14	20456977	20457482	505	252.0	
68008	chr14	20458225	20458271	46	23.0	
68009	chr14	20460304	20462432	2128	1064.0	
68010	chr14	20468729	20473187	4458	2229.0	
68011	chr14	20474521	20475327	806	403.0	
68012	chr14	20475927	20478618	2691	1346.0	
68013	chr14	20479743	20481690	1947	974.0	
68014	chr14	20482636	20483288	652	326.0	
68015	chr14	20487007	20487678	671	336.0	
68016	chr14	20489400	20490006	606	303.0	
68017	chr14	20491654	20491770	116	58.0	
68018	chr14	20493541	20494256	715	358.0	
68019	chr14	20495117	20495655	538	269.0	
68020	chr14	20504158	20504187	29	14.0	
68021	chr14	20530900	20531390	490	245.0	
68022	chr14	20608883	20614609	5726	2863.0	
68023	chr14	20618179	20618567	388	194.0	
68024	chr14	20622772	20623242	470	235.0	
68025	chr14	20623866	20627005	3139	1570.0	
68026	chr14	20629011	20629191	180	90.0	
68027	chr14	20630275	20633797	3522	1761.0	
68028	chr14	20652959	20653741	782	391.0	
68029	chr14	20657502	20658073	571	286.0	
68030	chr14	20662721	20664342	1621	810.0	
68031	chr14	20665407	20665758	351	176.0	
68032	chr14	20667917	20668520	603	302.0	
68033	chr14	20680162	20686383	6221	3110.0	
68034	chr14	20690779	20691676	897	448.0	
68035	chr14	20697615	20698165	550	275.0	
68036	chr14	20714655	20716298	1643	822.0	
68037	chr14	20723798	20723944	146	73.0	
68038	chr14	20726260	20726428	168	84.0	
68039	chr14	20733054	20733352	298	149.0	
68040	chr14	20758255	20758303	48	24.0	
68041	chr14	20780624	20782776	2152	1076.0	
68042	chr14	20783646	20783649	3	2.0	
68043	chr14	20785664	20785746	82	41.0	
68044	chr14	20794607	20795102	495	248.0	
68045	chr14	20796630	20796906	276	138.0	
68046	chr14	20799724	20800759	1035	518.0	
68047	chr14	20812571	20812603	32	16.0	
68048	chr14	20816980	20817381	401	200.0	
68049	chr14	20821643	20822101	458	229.0	
68050	chr14	20846503	20846923	420	210.0	
68051	chr14	20848570	20849061	491	246.0	
68052	chr14	20855512	20856133	621	310.0	
68053	chr14	20857584	20858073	489	244.0	
68054	chr14	20873542	20874256	714	357.0	
68055	chr14	20879446	20879691	245	122.0	
68056	chr14	20881213	20881584	371	186.0	
68057	chr14	20891129	20891859	730	365.0	
68058	chr14	20904603	20905038	435	218.0	
68059	chr14	20918985	20919827	842	421.0	
68060	chr14	20934154	20934530	376	188.0	
68061	chr14	20945140	20945559	419	210.0	
68062	chr14	20955097	20955942	845	422.0	
68063	chr14	20961058	20961680	622	311.0	
68064	chr14	20970611	20972206	1595	798.0	
68065	chr14	20985626	20986016	390	195.0	
68066	chr14	20986874	20987160	286	143.0	
68067	chr14	20988718	20990687	1969	984.0	
68068	chr14	21014441	21015731	1290	645.0	
68069	chr14	21017587	21018253	666	333.0	
68070	chr14	21022952	21026077	3125	1562.0	
68071	chr14	21027016	21027207	191	96.0	
68072	chr14	21032294	21032695	401	200.0	
68073	chr14	21039863	21040543	680	340.0	
68074	chr14	21041793	21041961	168	84.0	
68075	chr14	21066935	21067306	371	186.0	
68076	chr14	21068340	21073141	4801	2400.0	
68077	chr14	21085001	21085886	885	442.0	
68078	chr14	21086876	21089064	2188	1094.0	
68079	chr14	21089671	21090862	1191	596.0	
68080	chr14	21091933	21093322	1389	694.0	
68081	chr14	21095239	21095601	362	181.0	
68082	chr14	21096174	21099281	3107	1554.0	
68083	chr14	21103029	21105108	2079	1040.0	
68084	chr14	21106170	21107459	1289	644.0	
68085	chr14	21136230	21136289	59	30.0	
68086	chr14	21191612	21192720	1108	554.0	
68087	chr14	21202473	21202627	154	77.0	
68088	chr14	21203619	21203780	161	80.0	
68089	chr14	21215845	21216503	658	329.0	
68090	chr14	21229083	21231757	2674	1337.0	
68091	chr14	21233437	21233871	434	217.0	
68092	chr14	21236978	21237875	897	448.0	
68093	chr14	21238861	21239668	807	404.0	
68094	chr14	21240715	21243196	2481	1240.0	
68095	chr14	21243975	21246751	2776	1388.0	
68096	chr14	21247649	21248532	883	442.0	
68097	chr14	21249041	21249671	630	315.0	
68098	chr14	21250836	21259600	8764	4382.0	
68099	chr14	21260132	21262792	2660	1330.0	
68100	chr14	21263343	21270657	7314	3657.0	
68101	chr14	21300838	21301371	533	266.0	
68102	chr14	21307641	21309479	1838	919.0	
68103	chr14	21317129	21317899	770	385.0	
68104	chr14	21319777	21320569	792	396.0	
68105	chr14	21343034	21343553	519	260.0	
68106	chr14	21352346	21352981	635	318.0	
68107	chr14	21383068	21386042	2974	1487.0	
68108	chr14	21436513	21438159	1646	823.0	
68109	chr14	21440843	21441334	491	246.0	
68110	chr14	21454895	21457065	2170	1085.0	
68111	chr14	21476137	21478629	2492	1246.0	
68112	chr14	21498485	21499397	912	456.0	
68113	chr14	21504978	21505425	447	224.0	
68114	chr14	21510417	21512103	1686	843.0	
68115	chr14	21525707	21527436	1729	864.0	
68116	chr14	21557287	21558053	766	383.0	
68117	chr14	21641088	21641504	416	208.0	
68118	chr14	21642201	21642445	244	122.0	
68119	chr14	21703945	21704431	486	243.0	enhancer
68120	chr14	21711375	21712497	1122	561.0	"promoter	sequence_feature"
68121	chr14	21714561	21714574	13	6.0	
68122	chr14	21723419	21723863	444	222.0	promoter
68123	chr14	21729815	21730440	625	312.0	
68124	chr14	21734493	21734886	393	196.0	
68125	chr14	21735908	21736265	357	178.0	sequence_feature
68126	chr14	21748793	21749634	841	420.0	"promoter	sequence_feature	sequence_feature"
68127	chr14	21768122	21768608	486	243.0	"promoter	sequence_feature"
68128	chr14	21797039	21797269	230	115.0	promoter
68129	chr14	21825115	21825613	498	249.0	"promoter	sequence_feature"
68130	chr14	21840744	21841247	503	252.0	"promoter	sequence_feature"
68131	chr14	21846186	21847250	1064	532.0	"promoter	sequence_feature	sequence_feature	recombination_feature"
68132	chr14	21852027	21852690	663	332.0	"promoter	sequence_feature"
68133	chr14	21860055	21860508	453	226.0	
68134	chr14	21864337	21864633	296	148.0	
68135	chr14	21868381	21869063	682	341.0	"promoter	sequence_feature"
68136	chr14	21874205	21875369	1164	582.0	
68137	chr14	21887418	21888009	591	296.0	"promoter	sequence_feature"
68138	chr14	21894016	21894731	715	358.0	"promoter	sequence_feature"
68139	chr14	21902591	21903204	613	306.0	"promoter	sequence_feature"
68140	chr14	21913683	21914288	605	302.0	
68141	chr14	21917774	21918688	914	457.0	"promoter	sequence_feature	sequence_feature"
68142	chr14	21923596	21925020	1424	712.0	"sequence_feature	sequence_feature	recombination_feature	recombination_feature"
68143	chr14	21933693	21933988	295	148.0	
68144	chr14	21940851	21941684	833	416.0	"promoter	sequence_feature	sequence_feature	recombination_feature"
68145	chr14	21965025	21965522	497	248.0	"promoter	sequence_feature"
68146	chr14	21974729	21975205	476	238.0	
68147	chr14	21978151	21979036	885	442.0	"promoter	sequence_feature	sequence_feature"
68148	chr14	21987885	21988291	406	203.0	
68149	chr14	21990115	21990591	476	238.0	"promoter	sequence_feature"
68150	chr14	21997268	21997777	509	254.0	"promoter	sequence_feature"
68151	chr14	22002641	22003814	1173	586.0	"promoter	sequence_feature	sequence_feature	recombination_feature	recombination_feature"
68152	chr14	22007503	22007670	167	84.0	"promoter	sequence_feature"
68153	chr14	22040232	22040779	547	274.0	"promoter	sequence_feature"
68154	chr14	22047065	22047593	528	264.0	
68155	chr14	22052097	22052649	552	276.0	sequence_feature
68156	chr14	22070240	22071545	1305	652.0	"sequence_feature	sequence_feature	recombination_feature	recombination_feature"
68157	chr14	22084355	22084801	446	223.0	
68158	chr14	22095766	22096891	1125	562.0	"sequence_feature	sequence_feature	recombination_feature	recombination_feature"
68159	chr14	22100164	22100637	473	236.0	
68160	chr14	22112015	22112440	425	212.0	"promoter	sequence_feature"
68161	chr14	22113394	22113826	432	216.0	
68162	chr14	22122405	22123468	1063	532.0	
68163	chr14	22132171	22132479	308	154.0	promoter
68164	chr14	22168173	22168480	307	154.0	"promoter	sequence_feature"
68165	chr14	22177854	22178272	418	209.0	"recombination_feature	recombination_feature"
68166	chr14	22200941	22201413	472	236.0	
68167	chr14	22221514	22221937	423	212.0	"promoter	sequence_feature"
68168	chr14	22226261	22227191	930	465.0	"promoter	sequence_feature	sequence_feature"
68169	chr14	22230988	22231451	463	232.0	
68170	chr14	22268892	22269214	322	161.0	
68171	chr14	22282511	22282742	231	116.0	
68172	chr14	22303701	22304019	318	159.0	promoter
68173	chr14	22305828	22305868	40	20.0	
68174	chr14	22311553	22312043	490	245.0	
68175	chr14	22314157	22314609	452	226.0	"promoter	sequence_feature"
68176	chr14	22319756	22320125	369	184.0	promoter
68177	chr14	22337037	22337072	35	18.0	
68178	chr14	22383437	22384166	729	364.0	
68179	chr14	22387355	22387846	491	246.0	
68180	chr14	22391809	22392332	523	262.0	
68181	chr14	22407065	22407473	408	204.0	
68182	chr14	22418702	22419015	313	156.0	
68183	chr14	22420515	22420970	455	228.0	
68184	chr14	22422258	22422641	383	192.0	sequence_feature
68185	chr14	22427458	22428355	897	448.0	
68186	chr14	22428986	22429440	454	227.0	
68187	chr14	22432558	22432894	336	168.0	
68188	chr14	22448262	22449266	1004	502.0	
68189	chr14	22460434	22460908	474	237.0	
68190	chr14	22468881	22469596	715	358.0	"recombination_feature	recombination_feature	recombination_feature"
68191	chr14	22472903	22473399	496	248.0	
68192	chr14	22476069	22476134	65	32.0	
68193	chr14	22484007	22484713	706	353.0	
68194	chr14	22485331	22485603	272	136.0	
68195	chr14	22490685	22490956	271	136.0	
68196	chr14	22491692	22493384	1692	846.0	
68197	chr14	22494621	22494953	332	166.0	
68198	chr14	22496519	22497607	1088	544.0	
68199	chr14	22500981	22501312	331	166.0	
68200	chr14	22504409	22504773	364	182.0	
68201	chr14	22505566	22507886	2320	1160.0	
68202	chr14	22508663	22510463	1800	900.0	
68203	chr14	22512185	22512909	724	362.0	
68204	chr14	22514276	22515755	1479	740.0	
68205	chr14	22517334	22522137	4803	2402.0	
68206	chr14	22522656	22523178	522	261.0	
68207	chr14	22524043	22527649	3606	1803.0	
68208	chr14	22528985	22530435	1450	725.0	
68209	chr14	22531082	22533384	2302	1151.0	
68210	chr14	22535289	22535504	215	108.0	
68211	chr14	22536651	22541381	4730	2365.0	
68212	chr14	22541953	22542053	100	50.0	
68213	chr14	22543788	22559324	15536	7768.0	
68214	chr14	22560407	22562931	2524	1262.0	
68215	chr14	22564109	22564484	375	188.0	
68216	chr14	22565351	22566452	1101	550.0	
68217	chr14	22566957	22567786	829	414.0	
68218	chr14	22568411	22571069	2658	1329.0	
68219	chr14	22582917	22583182	265	132.0	
68220	chr14	22587070	22590301	3231	1616.0	
68221	chr14	22597640	22599286	1646	823.0	
68222	chr14	22646575	22646655	80	40.0	
68223	chr14	22652985	22653441	456	228.0	
68224	chr14	22712767	22713791	1024	512.0	
68225	chr14	22737113	22737379	266	133.0	
68226	chr14	22748234	22749009	775	388.0	
68227	chr14	22766078	22767588	1510	755.0	
68228	chr14	22777438	22777857	419	210.0	
68229	chr14	22783659	22784187	528	264.0	
68230	chr14	22790012	22791001	989	494.0	
68231	chr14	22794574	22794982	408	204.0	
68232	chr14	22798076	22799086	1010	505.0	
68233	chr14	22802559	22802909	350	175.0	
68234	chr14	22810704	22812166	1462	731.0	
68235	chr14	22815170	22816269	1099	550.0	
68236	chr14	22818063	22820059	1996	998.0	
68237	chr14	22822387	22823876	1489	744.0	
68238	chr14	22824883	22824975	92	46.0	
68239	chr14	22829235	22830709	1474	737.0	
68240	chr14	22836449	22837887	1438	719.0	
68241	chr14	22840336	22840787	451	226.0	
68242	chr14	22847789	22848824	1035	518.0	
68243	chr14	22851345	22851794	449	224.0	
68244	chr14	22852718	22854030	1312	656.0	
68245	chr14	22858353	22859258	905	452.0	
68246	chr14	22870689	22873190	2501	1250.0	
68247	chr14	22882779	22883371	592	296.0	
68248	chr14	22886256	22889175	2919	1460.0	
68249	chr14	22900018	22900655	637	318.0	
68250	chr14	22908487	22909173	686	343.0	
68251	chr14	22914725	22915240	515	258.0	
68252	chr14	22915830	22916749	919	460.0	
68253	chr14	22917789	22920829	3040	1520.0	
68254	chr14	22927306	22927369	63	32.0	
68255	chr14	22928376	22931274	2898	1449.0	
68256	chr14	22940887	22941280	393	196.0	
68257	chr14	22951682	22952340	658	329.0	
68258	chr14	22956296	22957743	1447	724.0	
68259	chr14	22973479	22974023	544	272.0	
68260	chr14	22980205	22983750	3545	1772.0	
68261	chr14	22986354	22987189	835	418.0	
68262	chr14	22994673	22995139	466	233.0	
68263	chr14	23006386	23007749	1363	682.0	
68264	chr14	23009624	23010918	1294	647.0	
68265	chr14	23028832	23029176	344	172.0	
68266	chr14	23034068	23035760	1692	846.0	
68267	chr14	23054370	23054743	373	186.0	
68268	chr14	23055873	23059058	3185	1592.0	
68269	chr14	23068412	23069831	1419	710.0	
68270	chr14	23070755	23072263	1508	754.0	
68271	chr14	23076784	23077290	506	253.0	
68272	chr14	23078560	23079208	648	324.0	
68273	chr14	23093999	23096819	2820	1410.0	
68274	chr14	23105980	23106296	316	158.0	
68275	chr14	23109229	23109610	381	190.0	
68276	chr14	23112722	23113118	396	198.0	
68277	chr14	23113625	23114017	392	196.0	
68278	chr14	23114994	23115395	401	200.0	
68279	chr14	23118586	23121736	3150	1575.0	
68280	chr14	23154205	23155340	1135	568.0	
68281	chr14	23160840	23162207	1367	684.0	
68282	chr14	23172854	23173473	619	310.0	
68283	chr14	23180130	23180526	396	198.0	
68284	chr14	23182516	23183925	1409	704.0	
68285	chr14	23186972	23187492	520	260.0	
68286	chr14	23237611	23238291	680	340.0	
68287	chr14	23265077	23265469	392	196.0	
68288	chr14	23285086	23287388	2302	1151.0	
68289	chr14	23294238	23295634	1396	698.0	
68290	chr14	23299638	23303395	3757	1878.0	
68291	chr14	23306372	23307342	970	485.0	
68292	chr14	23320283	23322694	2411	1206.0	
68293	chr14	23327789	23328473	684	342.0	
68294	chr14	23352085	23353286	1201	600.0	
68295	chr14	23379854	23380369	515	258.0	
68296	chr14	23468690	23470271	1581	790.0	
68297	chr14	23478212	23478770	558	279.0	
68298	chr14	23521870	23522180	310	155.0	
68299	chr14	23539533	23540034	501	250.0	
68300	chr14	23550651	23552409	1758	879.0	
68301	chr14	23555476	23557885	2409	1204.0	
68302	chr14	23559384	23560079	695	348.0	
68303	chr14	23562360	23563510	1150	575.0	
68304	chr14	23566746	23570109	3363	1682.0	
68305	chr14	23571923	23573373	1450	725.0	
68306	chr14	23576147	23577858	1711	856.0	
68307	chr14	23588830	23589662	832	416.0	
68308	chr14	23610331	23610990	659	330.0	
68309	chr14	23631709	23632583	874	437.0	
68310	chr14	23660217	23660919	702	351.0	
68311	chr14	23663025	23663687	662	331.0	
68312	chr14	23665900	23666038	138	69.0	
68313	chr14	23727797	23727861	64	32.0	
68314	chr14	23828560	23829063	503	252.0	
68315	chr14	23831797	23831903	106	53.0	
68316	chr14	23910585	23910966	381	190.0	
68317	chr14	23929688	23930220	532	266.0	
68318	chr14	23952982	23954638	1656	828.0	
68319	chr14	23966572	23967243	671	336.0	
68320	chr14	23969604	23970298	694	347.0	
68321	chr14	23988133	23990031	1898	949.0	
68322	chr14	24001745	24001960	215	108.0	
68323	chr14	24006805	24007819	1014	507.0	
68324	chr14	24013710	24014544	834	417.0	
68325	chr14	24032981	24033506	525	262.0	
68326	chr14	24034776	24034846	70	35.0	
68327	chr14	24035720	24037309	1589	794.0	
68328	chr14	24038570	24039162	592	296.0	
68329	chr14	24045269	24045298	29	14.0	
68330	chr14	24048707	24049517	810	405.0	
68331	chr14	24051280	24053847	2567	1284.0	
68332	chr14	24058005	24059040	1035	518.0	
68333	chr14	24075447	24075824	377	188.0	
68334	chr14	24080623	24082109	1486	743.0	
68335	chr14	24090260	24091160	900	450.0	
68336	chr14	24092701	24095985	3284	1642.0	
68337	chr14	24100181	24100548	367	184.0	
68338	chr14	24108376	24109430	1054	527.0	
68339	chr14	24113443	24115988	2545	1272.0	
68340	chr14	24123741	24124137	396	198.0	
68341	chr14	24132095	24132780	685	342.0	
68342	chr14	24135372	24137313	1941	970.0	
68343	chr14	24140372	24142443	2071	1036.0	
68344	chr14	24145564	24148403	2839	1420.0	
68345	chr14	24159744	24164146	4402	2201.0	
68346	chr14	24164717	24168084	3367	1684.0	
68347	chr14	24169358	24169454	96	48.0	
68348	chr14	24170876	24173741	2865	1432.0	
68349	chr14	24174685	24175561	876	438.0	
68350	chr14	24177547	24177569	22	11.0	
68351	chr14	24178366	24185230	6864	3432.0	
68352	chr14	24185915	24186320	405	202.0	
68353	chr14	24187024	24189967	2943	1472.0	
68354	chr14	24194241	24197064	2823	1412.0	
68355	chr14	24199255	24199558	303	152.0	
68356	chr14	24207092	24207650	558	279.0	
68357	chr14	24212386	24216739	4353	2176.0	
68358	chr14	24231395	24233757	2362	1181.0	
68359	chr14	24237120	24237214	94	47.0	
68360	chr14	24240935	24243867	2932	1466.0	
68361	chr14	24246562	24247502	940	470.0	
68362	chr14	24270593	24272407	1814	907.0	
68363	chr14	24273567	24274787	1220	610.0	
68364	chr14	24277559	24278395	836	418.0	
68365	chr14	24279136	24280229	1093	546.0	
68366	chr14	24281627	24282374	747	374.0	
68367	chr14	24289770	24289774	4	2.0	
68368	chr14	24296591	24297976	1385	692.0	
68369	chr14	24298900	24300741	1841	920.0	enhancer
68370	chr14	24307700	24308727	1027	514.0	
68371	chr14	24309943	24315619	5676	2838.0	
68372	chr14	24327256	24328371	1115	558.0	
68373	chr14	24329051	24330479	1428	714.0	
68374	chr14	24331634	24336189	4555	2278.0	
68375	chr14	24339276	24340504	1228	614.0	
68376	chr14	24361372	24361632	260	130.0	
68377	chr14	24365520	24369387	3867	1934.0	
68378	chr14	24395613	24396028	415	208.0	
68379	chr14	24396692	24396998	306	153.0	
68380	chr14	24398746	24399710	964	482.0	
68381	chr14	24412020	24412544	524	262.0	
68382	chr14	24422248	24422602	354	177.0	
68383	chr14	24425243	24425708	465	232.0	
68384	chr14	24426986	24427637	651	326.0	
68385	chr14	24428962	24432536	3574	1787.0	
68386	chr14	24436330	24439180	2850	1425.0	
68387	chr14	24440254	24440683	429	214.0	
68388	chr14	24441729	24443581	1852	926.0	
68389	chr14	24481524	24482188	664	332.0	
68390	chr14	24483635	24484308	673	336.0	
68391	chr14	24576099	24576624	525	262.0	
68392	chr14	24605330	24607993	2663	1332.0	
68393	chr14	24609521	24610562	1041	520.0	
68394	chr14	24612208	24612749	541	270.0	
68395	chr14	24627118	24627874	756	378.0	
68396	chr14	24629540	24630640	1100	550.0	
68397	chr14	24631564	24634925	3361	1680.0	
68398	chr14	24659991	24660635	644	322.0	
68399	chr14	24662705	24663188	483	242.0	
68400	chr14	24665265	24666158	893	446.0	
68401	chr14	24670564	24671099	535	268.0	
68402	chr14	24672932	24675002	2070	1035.0	
68403	chr14	24678292	24681386	3094	1547.0	
68404	chr14	24690424	24690898	474	237.0	
68405	chr14	24692663	24693892	1229	614.0	
68406	chr14	24694589	24695954	1365	682.0	
68407	chr14	24699006	24699477	471	236.0	
68408	chr14	24700501	24700921	420	210.0	
68409	chr14	24705751	24706303	552	276.0	
68410	chr14	24710337	24710848	511	256.0	
68411	chr14	24734892	24735342	450	225.0	
68412	chr14	24875998	24876682	684	342.0	
68413	chr14	24908417	24908881	464	232.0	
68414	chr14	24911459	24912103	644	322.0	
68415	chr14	25049870	25050452	582	291.0	
68416	chr14	25079263	25079512	249	124.0	
68417	chr14	25086857	25087239	382	191.0	
68418	chr14	25103273	25103684	411	206.0	
68419	chr14	25105062	25105086	24	12.0	
68420	chr14	25132595	25133235	640	320.0	
68421	chr14	25150947	25151267	320	160.0	
68422	chr14	25400620	25400980	360	180.0	
68423	chr14	27826131	27826559	428	214.0	
68424	chr14	28057601	28057658	57	28.0	
68425	chr14	30270696	30271045	349	174.0	
68426	chr14	30375271	30375701	430	215.0	
68427	chr14	30521918	30522319	401	200.0	
68428	chr14	30558443	30560153	1710	855.0	
68429	chr14	30577550	30577804	254	127.0	
68430	chr14	30610713	30611462	749	374.0	
68431	chr14	30620092	30623009	2917	1458.0	
68432	chr14	30656132	30656741	609	304.0	
68433	chr14	30848715	30849797	1082	541.0	
68434	chr14	30861191	30861555	364	182.0	
68435	chr14	30874070	30875454	1384	692.0	
68436	chr14	30980009	30980730	721	360.0	
68437	chr14	31024016	31027571	3555	1778.0	
68438	chr14	31068032	31068736	704	352.0	
68439	chr14	31081987	31082425	438	219.0	
68440	chr14	31084492	31084735	243	122.0	
68441	chr14	31090384	31091417	1033	516.0	
68442	chr14	31124044	31124693	649	324.0	
68443	chr14	31127575	31129256	1681	840.0	
68444	chr14	31165945	31166071	126	63.0	
68445	chr14	31199591	31200532	941	470.0	
68446	chr14	31205871	31208986	3115	1558.0	
68447	chr14	31210101	31210621	520	260.0	
68448	chr14	31229509	31230202	693	346.0	
68449	chr14	31270236	31270569	333	166.0	
68450	chr14	31283525	31284008	483	242.0	
68451	chr14	31286820	31286869	49	24.0	
68452	chr14	31355725	31356467	742	371.0	
68453	chr14	31371770	31372007	237	118.0	
68454	chr14	31378085	31378354	269	134.0	
68455	chr14	31409956	31410720	764	382.0	
68456	chr14	31417880	31418039	159	80.0	
68457	chr14	31419631	31421267	1636	818.0	
68458	chr14	31449986	31450425	439	220.0	
68459	chr14	31456674	31458104	1430	715.0	
68460	chr14	31484678	31485209	531	266.0	
68461	chr14	31487639	31488376	737	368.0	
68462	chr14	31489592	31490196	604	302.0	
68463	chr14	31502042	31502169	127	64.0	
68464	chr14	31510292	31510489	197	98.0	
68465	chr14	31544227	31544593	366	183.0	
68466	chr14	31560171	31562068	1897	948.0	
68467	chr14	31770293	31770625	332	166.0	
68468	chr14	31898842	31899262	420	210.0	
68469	chr14	31926072	31926476	404	202.0	
68470	chr14	31937917	31938041	124	62.0	
68471	chr14	31944441	31945535	1094	547.0	
68472	chr14	31947851	31947870	19	10.0	
68473	chr14	32043768	32043783	15	8.0	
68474	chr14	32049633	32050129	496	248.0	
68475	chr14	32073450	32074068	618	309.0	
68476	chr14	32075665	32078884	3219	1610.0	
68477	chr14	32102314	32102856	542	271.0	
68478	chr14	32200410	32204612	4202	2101.0	
68479	chr14	32205981	32206598	617	308.0	
68480	chr14	32251938	32252703	765	382.0	
68481	chr14	32254797	32255298	501	250.0	
68482	chr14	32560385	32560605	220	110.0	
68483	chr14	32576071	32576507	436	218.0	
68484	chr14	32656806	32657559	753	376.0	
68485	chr14	32683733	32684146	413	206.0	
68486	chr14	32939587	32939961	374	187.0	
68487	chr14	33414056	33414228	172	86.0	
68488	chr14	33436261	33436661	400	200.0	
68489	chr14	33792807	33793013	206	103.0	
68490	chr14	33839607	33839980	373	186.0	
68491	chr14	33950140	33951399	1259	630.0	
68492	chr14	33972747	33972783	36	18.0	
68493	chr14	34013221	34014115	894	447.0	
68494	chr14	34018530	34019106	576	288.0	
68495	chr14	34036518	34036822	304	152.0	
68496	chr14	34043632	34044283	651	326.0	
68497	chr14	34059775	34061050	1275	638.0	
68498	chr14	34075088	34075462	374	187.0	
68499	chr14	34077966	34078498	532	266.0	
68500	chr14	34228004	34228391	387	194.0	
68501	chr14	34312493	34312938	445	222.0	
68502	chr14	34322888	34323382	494	247.0	
68503	chr14	34324342	34324746	404	202.0	
68504	chr14	34331607	34332285	678	339.0	
68505	chr14	34362655	34363106	451	226.0	
68506	chr14	34363761	34364075	314	157.0	
68507	chr14	34368141	34369742	1601	800.0	
68508	chr14	34372160	34373366	1206	603.0	
68509	chr14	34400775	34401136	361	180.0	
68510	chr14	34461125	34463415	2290	1145.0	
68511	chr14	34463924	34463929	5	2.0	
68512	chr14	34464998	34465996	998	499.0	
68513	chr14	34496606	34497193	587	294.0	
68514	chr14	34498778	34499162	384	192.0	
68515	chr14	34538959	34540590	1631	816.0	
68516	chr14	34547529	34551893	4364	2182.0	
68517	chr14	34552589	34553314	725	362.0	
68518	chr14	34553948	34555399	1451	726.0	
68519	chr14	34604966	34605841	875	438.0	
68520	chr14	34628656	34630847	2191	1096.0	
68521	chr14	34666282	34666441	159	80.0	
68522	chr14	34672527	34672971	444	222.0	
68523	chr14	34713521	34715548	2027	1014.0	
68524	chr14	34722881	34723397	516	258.0	
68525	chr14	34741789	34742208	419	210.0	
68526	chr14	34781295	34781614	319	160.0	
68527	chr14	34833590	34834529	939	470.0	
68528	chr14	34842889	34843629	740	370.0	
68529	chr14	34856346	34858204	1858	929.0	
68530	chr14	34866096	34866098	2	1.0	
68531	chr14	34867568	34867654	86	43.0	
68532	chr14	34869492	34870416	924	462.0	
68533	chr14	34872339	34875832	3493	1746.0	
68534	chr14	34912221	34912551	330	165.0	
68535	chr14	34930283	34931772	1489	744.0	
68536	chr14	34935316	34936021	705	352.0	
68537	chr14	34980814	34984257	3443	1722.0	
68538	chr14	35020741	35021091	350	175.0	
68539	chr14	35040520	35040873	353	176.0	
68540	chr14	35043078	35043454	376	188.0	
68541	chr14	35045176	35048127	2951	1476.0	
68542	chr14	35048793	35049232	439	220.0	
68543	chr14	35050676	35050842	166	83.0	
68544	chr14	35120734	35123908	3174	1587.0	
68545	chr14	35136222	35136708	486	243.0	
68546	chr14	35140689	35141305	616	308.0	
68547	chr14	35156032	35156433	401	200.0	
68548	chr14	35161192	35161640	448	224.0	
68549	chr14	35196900	35196904	4	2.0	
68550	chr14	35201113	35201474	361	180.0	
68551	chr14	35202360	35202585	225	112.0	
68552	chr14	35203624	35204562	938	469.0	
68553	chr14	35223060	35223544	484	242.0	
68554	chr14	35229473	35229874	401	200.0	
68555	chr14	35254787	35255107	320	160.0	
68556	chr14	35261763	35262134	371	186.0	
68557	chr14	35284537	35288051	3514	1757.0	
68558	chr14	35291498	35294849	3351	1676.0	
68559	chr14	35297123	35297456	333	166.0	
68560	chr14	35298358	35298776	418	209.0	
68561	chr14	35300688	35301734	1046	523.0	
68562	chr14	35331882	35334692	2810	1405.0	
68563	chr14	35336725	35336893	168	84.0	
68564	chr14	35339616	35340538	922	461.0	
68565	chr14	35341340	35342363	1023	512.0	
68566	chr14	35344228	35344796	568	284.0	
68567	chr14	35352112	35352912	800	400.0	
68568	chr14	35365155	35368335	3180	1590.0	
68569	chr14	35369782	35370284	502	251.0	
68570	chr14	35374155	35374864	709	354.0	
68571	chr14	35375443	35376168	725	362.0	
68572	chr14	35384245	35384557	312	156.0	
68573	chr14	35388585	35388796	211	106.0	
68574	chr14	35390522	35407587	17065	8532.0	
68575	chr14	35412967	35413886	919	460.0	
68576	chr14	35415842	35417535	1693	846.0	
68577	chr14	35422139	35423028	889	444.0	
68578	chr14	35438865	35438966	101	50.0	
68579	chr14	35533209	35535832	2623	1312.0	
68580	chr14	35687325	35687731	406	203.0	
68581	chr14	35786219	35786225	6	3.0	
68582	chr14	35800806	35801464	658	329.0	
68583	chr14	35801975	35802329	354	177.0	
68584	chr14	35805577	35805796	219	110.0	
68585	chr14	35808012	35809960	1948	974.0	
68586	chr14	35814297	35814985	688	344.0	
68587	chr14	35818305	35818749	444	222.0	
68588	chr14	35821780	35822314	534	267.0	
68589	chr14	35825411	35827621	2210	1105.0	
68590	chr14	35846184	35846302	118	59.0	
68591	chr14	35856153	35856356	203	102.0	
68592	chr14	35932552	35933197	645	322.0	
68593	chr14	36069531	36069849	318	159.0	
68594	chr14	36293840	36294266	426	213.0	
68595	chr14	36319932	36321349	1417	708.0	
68596	chr14	36339744	36340258	514	257.0	
68597	chr14	36361141	36361606	465	232.0	
68598	chr14	36373928	36374474	546	273.0	
68599	chr14	36661803	36661997	194	97.0	
68600	chr14	37143499	37143800	301	150.0	
68601	chr14	37595017	37595196	179	90.0	
68602	chr14	37595861	37596293	432	216.0	
68603	chr14	37874573	37875109	536	268.0	
68604	chr14	37985845	37986268	423	212.0	
68605	chr14	38056341	38056624	283	142.0	
68606	chr14	38064841	38066176	1335	668.0	
68607	chr14	38073536	38075267	1731	866.0	
68608	chr14	38078000	38079247	1247	624.0	
68609	chr14	38089180	38089556	376	188.0	
68610	chr14	38103812	38104158	346	173.0	
68611	chr14	38721816	38722195	379	190.0	
68612	chr14	38867780	38867833	53	26.0	
68613	chr14	38873912	38874315	403	202.0	
68614	chr14	38989947	38990370	423	212.0	
68615	chr14	39097163	39097458	295	148.0	
68616	chr14	39099987	39100386	399	200.0	
68617	chr14	39100893	39101154	261	130.0	
68618	chr14	39102152	39104072	1920	960.0	
68619	chr14	39107520	39107927	407	204.0	
68620	chr14	39113699	39115506	1807	904.0	
68621	chr14	39169421	39171126	1705	852.0	
68622	chr14	39174142	39176233	2091	1046.0	
68623	chr14	39178517	39178540	23	12.0	
68624	chr14	39181295	39181530	235	118.0	
68625	chr14	39182783	39183704	921	460.0	
68626	chr14	39185057	39185210	153	76.0	
68627	chr14	39228835	39230032	1197	598.0	
68628	chr14	39231416	39232108	692	346.0	
68629	chr14	39232722	39233436	714	357.0	
68630	chr14	39265727	39270432	4705	2352.0	
68631	chr14	39383192	39383588	396	198.0	
68632	chr14	39426396	39427294	898	449.0	
68633	chr14	39428353	39428545	192	96.0	
68634	chr14	39430491	39433783	3292	1646.0	
68635	chr14	39434504	39434765	261	130.0	
68636	chr14	39469321	39469769	448	224.0	
68637	chr14	39472120	39472417	297	148.0	
68638	chr14	39491255	39491370	115	58.0	
68639	chr14	39641503	39641563	60	30.0	
68640	chr14	41718788	41719102	314	157.0	
68641	chr14	41749325	41749905	580	290.0	
68642	chr14	42322835	42323629	794	397.0	
68643	chr14	42428975	42429425	450	225.0	
68644	chr14	42884139	42884486	347	174.0	
68645	chr14	42930033	42930373	340	170.0	
68646	chr14	44846239	44846560	321	160.0	
68647	chr14	44896602	44898256	1654	827.0	
68648	chr14	44911997	44912992	995	498.0	
68649	chr14	44913666	44914017	351	176.0	
68650	chr14	44928788	44929172	384	192.0	
68651	chr14	44960246	44963363	3117	1558.0	
68652	chr14	44989541	44989902	361	180.0	
68653	chr14	45013929	45014299	370	185.0	
68654	chr14	45049092	45049419	327	164.0	
68655	chr14	45083330	45085317	1987	994.0	
68656	chr14	45133740	45136694	2954	1477.0	
68657	chr14	45142085	45142483	398	199.0	
68658	chr14	45177124	45177536	412	206.0	
68659	chr14	45201928	45202249	321	160.0	
68660	chr14	45249756	45251185	1429	714.0	
68661	chr14	45251762	45255252	3490	1745.0	
68662	chr14	45268438	45269000	562	281.0	
68663	chr14	47747106	47747340	234	117.0	
68664	chr14	49019766	49019884	118	59.0	
68665	chr14	49461711	49462217	506	253.0	
68666	chr14	49497726	49498135	409	204.0	
68667	chr14	49581324	49582293	969	484.0	
68668	chr14	49583927	49587557	3630	1815.0	
68669	chr14	49594681	49595008	327	164.0	
68670	chr14	49596381	49600398	4017	2008.0	
68671	chr14	49619008	49622449	3441	1720.0	
68672	chr14	49623625	49624711	1086	543.0	
68673	chr14	49629187	49629241	54	27.0	
68674	chr14	49630699	49630888	189	94.0	
68675	chr14	49631409	49631792	383	192.0	
68676	chr14	49632583	49636325	3742	1871.0	
68677	chr14	49641786	49641916	130	65.0	
68678	chr14	49687370	49688825	1455	728.0	
68679	chr14	49692429	49693996	1567	784.0	
68680	chr14	49766975	49769542	2567	1284.0	
68681	chr14	49830085	49830575	490	245.0	
68682	chr14	49851890	49854469	2579	1290.0	
68683	chr14	49857371	49857756	385	192.0	
68684	chr14	49861247	49866088	4841	2420.0	
68685	chr14	49867456	49869127	1671	836.0	
68686	chr14	49869848	49870500	652	326.0	
68687	chr14	49879527	49880694	1167	584.0	
68688	chr14	49886534	49887018	484	242.0	
68689	chr14	49891853	49896450	4597	2298.0	
68690	chr14	49897065	49897210	145	72.0	
68691	chr14	49898010	49899767	1757	878.0	
68692	chr14	49902732	49903108	376	188.0	
68693	chr14	49905916	49906383	467	234.0	
68694	chr14	49907742	49908149	407	204.0	
68695	chr14	49911526	49912073	547	274.0	
68696	chr14	49920883	49921382	499	250.0	
68697	chr14	49929811	49930701	890	445.0	
68698	chr14	49940815	49941223	408	204.0	
68699	chr14	49945487	49946901	1414	707.0	
68700	chr14	49959950	49960839	889	444.0	
68701	chr14	49965091	49965412	321	160.0	
68702	chr14	49970486	49973325	2839	1420.0	
68703	chr14	49976808	49977941	1133	566.0	
68704	chr14	49982256	49983107	851	426.0	
68705	chr14	49998872	50004346	5474	2737.0	
68706	chr14	50008654	50008844	190	95.0	
68707	chr14	50015754	50016073	319	160.0	
68708	chr14	50021168	50021680	512	256.0	
68709	chr14	50029969	50030556	587	294.0	
68710	chr14	50031585	50032100	515	258.0	
68711	chr14	50037913	50041079	3166	1583.0	
68712	chr14	50043740	50045802	2062	1031.0	
68713	chr14	50047274	50047777	503	252.0	
68714	chr14	50055772	50056752	980	490.0	
68715	chr14	50060199	50063250	3051	1526.0	
68716	chr14	50064794	50065922	1128	564.0	
68717	chr14	50071571	50071589	18	9.0	
68718	chr14	50081497	50084249	2752	1376.0	
68719	chr14	50085349	50086400	1051	526.0	
68720	chr14	50087200	50088115	915	458.0	
68721	chr14	50089316	50089538	222	111.0	
68722	chr14	50091446	50091881	435	218.0	
68723	chr14	50095657	50096782	1125	562.0	
68724	chr14	50104483	50105579	1096	548.0	
68725	chr14	50113371	50113980	609	304.0	
68726	chr14	50115791	50117270	1479	740.0	
68727	chr14	50191531	50191728	197	98.0	
68728	chr14	50225856	50226310	454	227.0	
68729	chr14	50229718	50232621	2903	1452.0	
68730	chr14	50233620	50234185	565	282.0	
68731	chr14	50237479	50237808	329	164.0	
68732	chr14	50260546	50260973	427	214.0	
68733	chr14	50303668	50304217	549	274.0	
68734	chr14	50311329	50313483	2154	1077.0	
68735	chr14	50320585	50321775	1190	595.0	
68736	chr14	50342701	50343193	492	246.0	
68737	chr14	50344163	50344505	342	171.0	
68738	chr14	50351115	50351321	206	103.0	
68739	chr14	50362387	50364412	2025	1012.0	
68740	chr14	50366471	50367285	814	407.0	
68741	chr14	50396100	50397769	1669	834.0	
68742	chr14	50521263	50522430	1167	584.0	
68743	chr14	50524061	50525237	1176	588.0	
68744	chr14	50529428	50533788	4360	2180.0	
68745	chr14	50542796	50543352	556	278.0	
68746	chr14	50559866	50561477	1611	806.0	
68747	chr14	50619595	50619898	303	152.0	
68748	chr14	50666883	50669180	2297	1148.0	
68749	chr14	50670108	50670130	22	11.0	
68750	chr14	50677353	50678061	708	354.0	
68751	chr14	50714501	50714836	335	168.0	
68752	chr14	50726020	50726750	730	365.0	
68753	chr14	50737021	50737250	229	114.0	
68754	chr14	50756168	50756925	757	378.0	
68755	chr14	50773623	50774058	435	218.0	
68756	chr14	50777793	50778312	519	260.0	
68757	chr14	50784768	50786126	1358	679.0	
68758	chr14	50786896	50787466	570	285.0	
68759	chr14	50789535	50790225	690	345.0	
68760	chr14	50791986	50793167	1181	590.0	
68761	chr14	50794551	50794553	2	1.0	
68762	chr14	50797991	50798433	442	221.0	
68763	chr14	50800694	50800949	255	128.0	
68764	chr14	50812164	50813973	1809	904.0	
68765	chr14	50819343	50819599	256	128.0	
68766	chr14	50820709	50824646	3937	1968.0	
68767	chr14	50829034	50832168	3134	1567.0	
68768	chr14	50835135	50835817	682	341.0	
68769	chr14	50859323	50861018	1695	848.0	
68770	chr14	50871887	50872326	439	220.0	
68771	chr14	50875199	50876152	953	476.0	
68772	chr14	50926719	50927385	666	333.0	
68773	chr14	50928043	50928984	941	470.0	
68774	chr14	50932360	50932526	166	83.0	
68775	chr14	50936812	50937777	965	482.0	
68776	chr14	50943296	50945234	1938	969.0	"enhancer	sequence_feature"
68777	chr14	50954796	50956175	1379	690.0	
68778	chr14	50967701	50968350	649	324.0	
68779	chr14	50978156	50978589	433	216.0	
68780	chr14	51093600	51096312	2712	1356.0	
68781	chr14	51139046	51139880	834	417.0	
68782	chr14	51180720	51180790	70	35.0	
68783	chr14	51218573	51218863	290	145.0	
68784	chr14	51239469	51242675	3206	1603.0	
68785	chr14	51283276	51283725	449	224.0	
68786	chr14	51419567	51420142	575	288.0	
68787	chr14	51596387	51596932	545	272.0	
68788	chr14	51650862	51653536	2674	1337.0	
68789	chr14	51776259	51776669	410	205.0	
68790	chr14	51779842	51780576	734	367.0	
68791	chr14	51783814	51784074	260	130.0	
68792	chr14	51789147	51790030	883	442.0	
68793	chr14	51827731	51828651	920	460.0	
68794	chr14	51843795	51845019	1224	612.0	
68795	chr14	51846370	51849623	3253	1626.0	
68796	chr14	51852313	51852695	382	191.0	
68797	chr14	51856863	51857247	384	192.0	
68798	chr14	51859139	51863933	4794	2397.0	
68799	chr14	51864799	51865246	447	224.0	
68800	chr14	51865817	51871073	5256	2628.0	
68801	chr14	51871753	51874262	2509	1254.0	
68802	chr14	51875108	51875458	350	175.0	
68803	chr14	51876871	51877335	464	232.0	
68804	chr14	51877873	51878206	333	166.0	
68805	chr14	51878997	51879790	793	396.0	
68806	chr14	51880832	51881710	878	439.0	
68807	chr14	51883306	51885226	1920	960.0	
68808	chr14	51887044	51887250	206	103.0	
68809	chr14	51888879	51889087	208	104.0	
68810	chr14	51889756	51890339	583	292.0	
68811	chr14	51899067	51899253	186	93.0	
68812	chr14	51901042	51902066	1024	512.0	
68813	chr14	51905419	51906416	997	498.0	
68814	chr14	51912282	51912683	401	200.0	
68815	chr14	51924579	51924769	190	95.0	
68816	chr14	51930095	51930693	598	299.0	
68817	chr14	51978851	51979698	847	424.0	
68818	chr14	51988796	51990621	1825	912.0	
68819	chr14	51996107	51996544	437	218.0	
68820	chr14	52013775	52014464	689	344.0	
68821	chr14	52015638	52015715	77	38.0	
68822	chr14	52043653	52044082	429	214.0	
68823	chr14	52067934	52070124	2190	1095.0	
68824	chr14	52131701	52132102	401	200.0	
68825	chr14	52154980	52155427	447	224.0	
68826	chr14	52175471	52176958	1487	744.0	
68827	chr14	52220986	52221793	807	404.0	
68828	chr14	52247920	52248578	658	329.0	
68829	chr14	52265267	52265668	401	200.0	
68830	chr14	52267184	52269462	2278	1139.0	
68831	chr14	52272225	52272816	591	296.0	
68832	chr14	52279462	52279715	253	126.0	
68833	chr14	52286874	52286984	110	55.0	
68834	chr14	52299651	52300175	524	262.0	
68835	chr14	52303229	52303616	387	194.0	
68836	chr14	52307682	52308376	694	347.0	
68837	chr14	52311199	52312321	1122	561.0	
68838	chr14	52312885	52319229	6344	3172.0	
68839	chr14	52324660	52325804	1144	572.0	
68840	chr14	52327160	52328538	1378	689.0	
68841	chr14	52333416	52333620	204	102.0	
68842	chr14	52335581	52335652	71	36.0	
68843	chr14	52338322	52338748	426	213.0	
68844	chr14	52349774	52350080	306	153.0	
68845	chr14	52351287	52353066	1779	890.0	
68846	chr14	52355068	52355469	401	200.0	
68847	chr14	52363781	52364283	502	251.0	
68848	chr14	52395682	52396154	472	236.0	
68849	chr14	52400777	52401362	585	292.0	
68850	chr14	52402739	52403232	493	246.0	
68851	chr14	52473582	52473992	410	205.0	
68852	chr14	52530895	52531647	752	376.0	
68853	chr14	52532321	52532720	399	200.0	
68854	chr14	52533237	52534152	915	458.0	
68855	chr14	52538642	52538960	318	159.0	
68856	chr14	52551497	52554593	3096	1548.0	
68857	chr14	52678619	52678964	345	172.0	
68858	chr14	52692197	52692711	514	257.0	
68859	chr14	52694440	52697434	2994	1497.0	
68860	chr14	52703174	52703730	556	278.0	
68861	chr14	52706210	52707932	1722	861.0	
68862	chr14	52716080	52716584	504	252.0	
68863	chr14	52729475	52731108	1633	816.0	
68864	chr14	52734482	52734866	384	192.0	
68865	chr14	52741335	52743122	1787	894.0	
68866	chr14	52790673	52792565	1892	946.0	
68867	chr14	52801149	52801699	550	275.0	
68868	chr14	52823614	52823955	341	170.0	
68869	chr14	52869182	52869573	391	196.0	
68870	chr14	52917762	52919250	1488	744.0	
68871	chr14	52924111	52924144	33	16.0	
68872	chr14	52949618	52952400	2782	1391.0	
68873	chr14	52960614	52961538	924	462.0	
68874	chr14	53054903	53055346	443	222.0	
68875	chr14	53060250	53060354	104	52.0	
68876	chr14	53103928	53103960	32	16.0	
68877	chr14	53108060	53110380	2320	1160.0	
68878	chr14	53114065	53114250	185	92.0	
68879	chr14	53117472	53117606	134	67.0	
68880	chr14	53126717	53128789	2072	1036.0	
68881	chr14	53139026	53139389	363	182.0	
68882	chr14	53147265	53147769	504	252.0	
68883	chr14	53148597	53149131	534	267.0	
68884	chr14	53149736	53150380	644	322.0	
68885	chr14	53151035	53154191	3156	1578.0	
68886	chr14	53161661	53162514	853	426.0	
68887	chr14	53180555	53181222	667	334.0	
68888	chr14	53216827	53218257	1430	715.0	
68889	chr14	53306146	53306595	449	224.0	
68890	chr14	53613504	53614029	525	262.0	
68891	chr14	53956697	53956952	255	128.0	"promoter	promoter	protein_binding_site	protein_binding_site	protein_binding_site"
68892	chr14	54048362	54048633	271	136.0	
68893	chr14	54267369	54267407	38	19.0	
68894	chr14	54301325	54301839	514	257.0	
68895	chr14	54348040	54348343	303	152.0	
68896	chr14	54354245	54354265	20	10.0	
68897	chr14	54366719	54367167	448	224.0	
68898	chr14	54396175	54397961	1786	893.0	
68899	chr14	54398752	54399298	546	273.0	
68900	chr14	54420572	54420898	326	163.0	
68901	chr14	54435604	54435850	246	123.0	
68902	chr14	54440486	54442168	1682	841.0	
68903	chr14	54446904	54447852	948	474.0	
68904	chr14	54450254	54451439	1185	592.0	
68905	chr14	54483379	54484085	706	353.0	
68906	chr14	54486611	54487105	494	247.0	
68907	chr14	54487813	54489720	1907	954.0	
68908	chr14	54501651	54501774	123	62.0	
68909	chr14	54502353	54504015	1662	831.0	
68910	chr14	54509114	54510675	1561	780.0	
68911	chr14	54563897	54568565	4668	2334.0	
68912	chr14	54572329	54572615	286	143.0	
68913	chr14	54579675	54579982	307	154.0	
68914	chr14	54597787	54598246	459	230.0	
68915	chr14	54627254	54628545	1291	646.0	
68916	chr14	54629765	54629990	225	112.0	
68917	chr14	54642948	54643371	423	212.0	
68918	chr14	54669706	54670467	761	380.0	
68919	chr14	54691519	54692413	894	447.0	
68920	chr14	54712304	54712681	377	188.0	
68921	chr14	54722789	54723156	367	184.0	
68922	chr14	54730005	54730745	740	370.0	
68923	chr14	54773023	54774627	1604	802.0	
68924	chr14	54776120	54777177	1057	528.0	
68925	chr14	54778973	54779121	148	74.0	
68926	chr14	54782435	54783655	1220	610.0	
68927	chr14	54786466	54787653	1187	594.0	
68928	chr14	54805503	54806390	887	444.0	
68929	chr14	54854217	54854559	342	171.0	
68930	chr14	54857561	54859473	1912	956.0	
68931	chr14	54860320	54860809	489	244.0	
68932	chr14	54863568	54864081	513	256.0	
68933	chr14	54866003	54868335	2332	1166.0	
68934	chr14	54869707	54871275	1568	784.0	
68935	chr14	54876872	54878863	1991	996.0	
68936	chr14	54879558	54880149	591	296.0	
68937	chr14	54881031	54886979	5948	2974.0	
68938	chr14	54888186	54891828	3642	1821.0	
68939	chr14	54892774	54895921	3147	1574.0	
68940	chr14	54896705	54898297	1592	796.0	
68941	chr14	54898897	54903719	4822	2411.0	
68942	chr14	54907945	54909263	1318	659.0	
68943	chr14	54942881	54943347	466	233.0	
68944	chr14	54976527	54976533	6	3.0	
68945	chr14	55000333	55000728	395	198.0	
68946	chr14	55026442	55028206	1764	882.0	
68947	chr14	55050869	55053229	2360	1180.0	
68948	chr14	55055708	55055751	43	22.0	
68949	chr14	55059604	55059728	124	62.0	
68950	chr14	55062770	55063186	416	208.0	
68951	chr14	55070936	55071238	302	151.0	
68952	chr14	55071784	55072839	1055	528.0	
68953	chr14	55074639	55075206	567	284.0	
68954	chr14	55079855	55080403	548	274.0	
68955	chr14	55084606	55085028	422	211.0	
68956	chr14	55089307	55090165	858	429.0	
68957	chr14	55097769	55098916	1147	574.0	
68958	chr14	55102040	55104552	2512	1256.0	
68959	chr14	55107680	55108681	1001	500.0	
68960	chr14	55117614	55118572	958	479.0	
68961	chr14	55120494	55121245	751	376.0	
68962	chr14	55125275	55126374	1099	550.0	
68963	chr14	55127038	55127776	738	369.0	
68964	chr14	55128386	55130361	1975	988.0	
68965	chr14	55131558	55132234	676	338.0	
68966	chr14	55160947	55161418	471	236.0	
68967	chr14	55190853	55192320	1467	734.0	
68968	chr14	55213020	55213570	550	275.0	
68969	chr14	55237998	55238522	524	262.0	
68970	chr14	55245667	55246083	416	208.0	
68971	chr14	55265135	55265691	556	278.0	
68972	chr14	55270716	55273947	3231	1616.0	
68973	chr14	55275866	55276147	281	140.0	
68974	chr14	55277259	55278748	1489	744.0	
68975	chr14	55297887	55298457	570	285.0	
68976	chr14	55301649	55302014	365	182.0	
68977	chr14	55302736	55304428	1692	846.0	
68978	chr14	55326926	55327638	712	356.0	
68979	chr14	55330396	55330741	345	172.0	
68980	chr14	55332361	55334541	2180	1090.0	
68981	chr14	55336169	55338570	2401	1200.0	
68982	chr14	55339902	55340107	205	102.0	
68983	chr14	55349143	55349211	68	34.0	
68984	chr14	55353602	55355304	1702	851.0	
68985	chr14	55373748	55374812	1064	532.0	
68986	chr14	55386061	55386346	285	142.0	
68987	chr14	55411164	55412497	1333	666.0	
68988	chr14	55429860	55430686	826	413.0	
68989	chr14	55434116	55434424	308	154.0	
68990	chr14	55446078	55446562	484	242.0	
68991	chr14	55464041	55464126	85	42.0	
68992	chr14	55579255	55581895	2640	1320.0	
68993	chr14	55582758	55583190	432	216.0	
68994	chr14	55583980	55584570	590	295.0	
68995	chr14	55645107	55645472	365	182.0	
68996	chr14	55707544	55707657	113	56.0	
68997	chr14	55713423	55713959	536	268.0	
68998	chr14	55731920	55732243	323	162.0	
68999	chr14	55790723	55791256	533	266.0	
69000	chr14	55806635	55808141	1506	753.0	
69001	chr14	55814680	55815344	664	332.0	
69002	chr14	55819579	55820022	443	222.0	
69003	chr14	55867395	55867437	42	21.0	
69004	chr14	56002794	56003597	803	402.0	
69005	chr14	56004742	56005209	467	234.0	
69006	chr14	56008150	56008564	414	207.0	
69007	chr14	56059040	56059303	263	132.0	
69008	chr14	56092354	56094453	2099	1050.0	
69009	chr14	56112772	56113235	463	232.0	
69010	chr14	56115898	56120888	4990	2495.0	
69011	chr14	56122249	56122694	445	222.0	
69012	chr14	56127330	56127607	277	138.0	
69013	chr14	56129611	56130404	793	396.0	
69014	chr14	56131761	56132385	624	312.0	
69015	chr14	56137280	56137853	573	286.0	
69016	chr14	56146091	56146284	193	96.0	
69017	chr14	56147721	56149197	1476	738.0	
69018	chr14	56149984	56150402	418	209.0	
69019	chr14	56151021	56151337	316	158.0	
69020	chr14	56160257	56160446	189	94.0	
69021	chr14	56162420	56162893	473	236.0	
69022	chr14	56173592	56173666	74	37.0	
69023	chr14	56195716	56196042	326	163.0	
69024	chr14	56199004	56199615	611	306.0	
69025	chr14	56205839	56206171	332	166.0	
69026	chr14	56216831	56216833	2	1.0	
69027	chr14	56237377	56237812	435	218.0	
69028	chr14	56244089	56244490	401	200.0	
69029	chr14	56333434	56334100	666	333.0	
69030	chr14	56339816	56340537	721	360.0	
69031	chr14	56378490	56378952	462	231.0	
69032	chr14	56422864	56422923	59	30.0	
69033	chr14	56474449	56474835	386	193.0	
69034	chr14	56490428	56490513	85	42.0	
69035	chr14	56491254	56491731	477	238.0	
69036	chr14	56578233	56581458	3225	1612.0	
69037	chr14	57267974	57270142	2168	1084.0	
69038	chr14	57317208	57317624	416	208.0	
69039	chr14	57326491	57326545	54	27.0	
69040	chr14	57388223	57388254	31	16.0	
69041	chr14	57389572	57391986	2414	1207.0	
69042	chr14	58072588	58072984	396	198.0	
69043	chr14	58107956	58108328	372	186.0	
69044	chr14	58151305	58152826	1521	760.0	
69045	chr14	58166333	58166827	494	247.0	
69046	chr14	58171099	58171501	402	201.0	
69047	chr14	58197957	58201201	3244	1622.0	
69048	chr14	58238439	58240931	2492	1246.0	
69049	chr14	58243742	58245779	2037	1018.0	
69050	chr14	58274910	58275011	101	50.0	
69051	chr14	58281065	58282007	942	471.0	
69052	chr14	58296865	58300247	3382	1691.0	
69053	chr14	58309100	58309462	362	181.0	
69054	chr14	58330744	58331692	948	474.0	
69055	chr14	58353477	58353961	484	242.0	
69056	chr14	58354917	58355114	197	98.0	
69057	chr14	58362827	58363195	368	184.0	
69058	chr14	58395287	58396875	1588	794.0	
69059	chr14	58426589	58428666	2077	1038.0	
69060	chr14	58439393	58439883	490	245.0	
69061	chr14	58479980	58480381	401	200.0	
69062	chr14	58501206	58501649	443	222.0	
69063	chr14	58572030	58572404	374	187.0	
69064	chr14	58598423	58598824	401	200.0	
69065	chr14	58634998	58635308	310	155.0	
69066	chr14	58637008	58638962	1954	977.0	
69067	chr14	58739607	58739880	273	136.0	
69068	chr14	58747086	58747742	656	328.0	
69069	chr14	58748250	58749702	1452	726.0	
69070	chr14	58752752	58753348	596	298.0	
69071	chr14	59055470	59055795	325	162.0	
69072	chr14	59127089	59127567	478	239.0	
69073	chr14	59150921	59151472	551	276.0	
69074	chr14	59161422	59162169	747	374.0	
69075	chr14	59175481	59175793	312	156.0	
69076	chr14	59187491	59190793	3302	1651.0	
69077	chr14	59202000	59202453	453	226.0	
69078	chr14	59274967	59275250	283	142.0	
69079	chr14	59321146	59321491	345	172.0	
69080	chr14	59337284	59337742	458	229.0	
69081	chr14	59356862	59356950	88	44.0	
69082	chr14	59361039	59361874	835	418.0	
69083	chr14	59398815	59399256	441	220.0	
69084	chr14	59444200	59444619	419	210.0	
69085	chr14	59463987	59466146	2159	1080.0	
69086	chr14	59482099	59485693	3594	1797.0	
69087	chr14	59489670	59489960	290	145.0	
69088	chr14	59507294	59507755	461	230.0	
69089	chr14	59576119	59577285	1166	583.0	
69090	chr14	59582840	59584024	1184	592.0	
69091	chr14	59585786	59586554	768	384.0	
69092	chr14	59632556	59632701	145	72.0	
69093	chr14	59688417	59688832	415	208.0	
69094	chr14	59699391	59699889	498	249.0	
69095	chr14	59739689	59740112	423	212.0	
69096	chr14	59829507	59829898	391	196.0	
69097	chr14	59849318	59850321	1003	502.0	
69098	chr14	59869791	59871388	1597	798.0	
69099	chr14	59897754	59898150	396	198.0	
69100	chr14	59919127	59920369	1242	621.0	
69101	chr14	59964201	59966144	1943	972.0	
69102	chr14	60051734	60052080	346	173.0	
69103	chr14	60064473	60064932	459	230.0	
69104	chr14	60090995	60094836	3841	1920.0	
69105	chr14	60095385	60095401	16	8.0	
69106	chr14	60106310	60106741	431	216.0	
69107	chr14	60151312	60152757	1445	722.0	
69108	chr14	60153950	60155069	1119	560.0	
69109	chr14	60161329	60162604	1275	638.0	
69110	chr14	60164077	60166546	2469	1234.0	
69111	chr14	60183446	60184779	1333	666.0	
69112	chr14	60195225	60195490	265	132.0	
69113	chr14	60197847	60198058	211	106.0	
69114	chr14	60207138	60207591	453	226.0	
69115	chr14	60220153	60220421	268	134.0	
69116	chr14	60242429	60242830	401	200.0	
69117	chr14	60245476	60245818	342	171.0	
69118	chr14	60247367	60250755	3388	1694.0	
69119	chr14	60266365	60266777	412	206.0	
69120	chr14	60294745	60294826	81	40.0	
69121	chr14	60327318	60328313	995	498.0	
69122	chr14	60330928	60332393	1465	732.0	
69123	chr14	60349879	60350268	389	194.0	
69124	chr14	60625310	60625762	452	226.0	
69125	chr14	60647253	60647699	446	223.0	
69126	chr14	60649228	60649791	563	282.0	
69127	chr14	60652602	60652637	35	18.0	
69128	chr14	60656860	60657949	1089	544.0	
69129	chr14	60721197	60724576	3379	1690.0	
69130	chr14	60734460	60735372	912	456.0	
69131	chr14	60753211	60754323	1112	556.0	
69132	chr14	60845516	60845990	474	237.0	
69133	chr14	60978895	60979068	173	86.0	
69134	chr14	60980138	60982339	2201	1100.0	
69135	chr14	60984132	60984382	250	125.0	
69136	chr14	61025219	61025628	409	204.0	
69137	chr14	61101897	61102879	982	491.0	
69138	chr14	61103414	61104747	1333	666.0	
69139	chr14	61106358	61106601	243	122.0	
69140	chr14	61120634	61121720	1086	543.0	
69141	chr14	61188979	61189340	361	180.0	
69142	chr14	61252692	61253712	1020	510.0	
69143	chr14	61269454	61270224	770	385.0	
69144	chr14	61280066	61281733	1667	834.0	
69145	chr14	61286153	61286598	445	222.0	
69146	chr14	61296912	61297555	643	322.0	
69147	chr14	61318351	61318803	452	226.0	
69148	chr14	61319344	61324499	5155	2578.0	
69149	chr14	61325022	61325438	416	208.0	
69150	chr14	61326201	61339238	13037	6518.0	
69151	chr14	61339770	61339893	123	62.0	
69152	chr14	61340480	61345649	5169	2584.0	
69153	chr14	61346440	61346683	243	122.0	
69154	chr14	61347408	61348949	1541	770.0	
69155	chr14	61350163	61351940	1777	888.0	
69156	chr14	61355743	61356375	632	316.0	
69157	chr14	61358522	61359444	922	461.0	
69158	chr14	61360768	61361453	685	342.0	
69159	chr14	61364536	61365115	579	290.0	
69160	chr14	61366544	61368654	2110	1055.0	
69161	chr14	61369192	61369504	312	156.0	
69162	chr14	61370468	61370623	155	78.0	
69163	chr14	61373121	61373579	458	229.0	
69164	chr14	61375521	61375659	138	69.0	
69165	chr14	61378446	61380314	1868	934.0	
69166	chr14	61380938	61382500	1562	781.0	
69167	chr14	61383861	61383974	113	56.0	
69168	chr14	61384870	61386771	1901	950.0	
69169	chr14	61387351	61391459	4108	2054.0	
69170	chr14	61395058	61395512	454	227.0	
69171	chr14	61396378	61397145	767	384.0	
69172	chr14	61397840	61397978	138	69.0	
69173	chr14	61401092	61401743	651	326.0	
69174	chr14	61403267	61405068	1801	900.0	
69175	chr14	61406567	61407996	1429	714.0	
69176	chr14	61413700	61413874	174	87.0	
69177	chr14	61415810	61417484	1674	837.0	
69178	chr14	61419776	61422322	2546	1273.0	
69179	chr14	61425241	61425258	17	8.0	
69180	chr14	61425922	61426198	276	138.0	
69181	chr14	61432917	61433335	418	209.0	
69182	chr14	61435451	61436414	963	482.0	
69183	chr14	61437377	61440581	3204	1602.0	
69184	chr14	61441160	61441228	68	34.0	
69185	chr14	61442471	61443050	579	290.0	
69186	chr14	61443806	61445428	1622	811.0	
69187	chr14	61446575	61446625	50	25.0	
69188	chr14	61449018	61449534	516	258.0	
69189	chr14	61451599	61455007	3408	1704.0	
69190	chr14	61456567	61457290	723	362.0	
69191	chr14	61460958	61462714	1756	878.0	
69192	chr14	61467323	61467922	599	300.0	
69193	chr14	61469341	61481469	12128	6064.0	
69194	chr14	61483416	61484547	1131	566.0	
69195	chr14	61489578	61493022	3444	1722.0	
69196	chr14	61500033	61500457	424	212.0	
69197	chr14	61502438	61505531	3093	1546.0	
69198	chr14	61507801	61508539	738	369.0	
69199	chr14	61510933	61512411	1478	739.0	
69200	chr14	61514913	61516164	1251	626.0	
69201	chr14	61518823	61518896	73	36.0	
69202	chr14	61524996	61527252	2256	1128.0	
69203	chr14	61527859	61529231	1372	686.0	
69204	chr14	61533608	61533757	149	74.0	
69205	chr14	61549449	61549537	88	44.0	
69206	chr14	61551428	61554471	3043	1522.0	
69207	chr14	61558193	61558626	433	216.0	
69208	chr14	61561904	61563284	1380	690.0	
69209	chr14	61564496	61564981	485	242.0	
69210	chr14	61567743	61571175	3432	1716.0	
69211	chr14	61591895	61592336	441	220.0	
69212	chr14	61594293	61595232	939	470.0	
69213	chr14	61602134	61602727	593	296.0	
69214	chr14	61603666	61604268	602	301.0	
69215	chr14	61636743	61637199	456	228.0	
69216	chr14	61644234	61644504	270	135.0	
69217	chr14	61649312	61649656	344	172.0	
69218	chr14	61660588	61664268	3680	1840.0	
69219	chr14	61667300	61667371	71	36.0	
69220	chr14	61668242	61668761	519	260.0	
69221	chr14	61670363	61671844	1481	740.0	
69222	chr14	61677401	61677908	507	254.0	
69223	chr14	61691072	61691677	605	302.0	
69224	chr14	61694643	61697146	2503	1252.0	
69225	chr14	61697887	61699486	1599	800.0	
69226	chr14	61700349	61700772	423	212.0	
69227	chr14	61701998	61702517	519	260.0	
69228	chr14	61703365	61703867	502	251.0	
69229	chr14	61711040	61711790	750	375.0	
69230	chr14	61718223	61718591	368	184.0	
69231	chr14	61719210	61720642	1432	716.0	
69232	chr14	61727054	61727180	126	63.0	
69233	chr14	61730772	61731396	624	312.0	
69234	chr14	61737753	61738435	682	341.0	
69235	chr14	61749035	61749779	744	372.0	
69236	chr14	61750606	61751699	1093	546.0	
69237	chr14	61752478	61753943	1465	732.0	
69238	chr14	61761584	61763278	1694	847.0	
69239	chr14	61780155	61780395	240	120.0	
69240	chr14	61837373	61838071	698	349.0	
69241	chr14	61860221	61860761	540	270.0	
69242	chr14	61872492	61872870	378	189.0	
69243	chr14	61889477	61890543	1066	533.0	
69244	chr14	61894462	61894874	412	206.0	
69245	chr14	61911642	61911779	137	68.0	
69246	chr14	62077666	62078347	681	340.0	
69247	chr14	62081002	62081446	444	222.0	
69248	chr14	62097921	62098204	283	142.0	
69249	chr14	62116954	62117878	924	462.0	
69250	chr14	62126854	62127283	429	214.0	
69251	chr14	63383753	63384211	458	229.0	
69252	chr14	63388758	63389228	470	235.0	
69253	chr14	63438046	63438763	717	358.0	
69254	chr14	63471247	63471754	507	254.0	
69255	chr14	63473022	63473752	730	365.0	
69256	chr14	63477935	63478497	562	281.0	
69257	chr14	63508164	63508424	260	130.0	
69258	chr14	63510332	63511298	966	483.0	
69259	chr14	63524532	63525265	733	366.0	
69260	chr14	63542090	63544325	2235	1118.0	
69261	chr14	63632844	63633336	492	246.0	
69262	chr14	63640859	63643101	2242	1121.0	
69263	chr14	63650061	63651117	1056	528.0	
69264	chr14	63656197	63657027	830	415.0	
69265	chr14	63663485	63663792	307	154.0	
69266	chr14	63705450	63705915	465	232.0	
69267	chr14	63713040	63713151	111	56.0	
69268	chr14	63717874	63718123	249	124.0	
69269	chr14	63726629	63729127	2498	1249.0	
69270	chr14	63730589	63730646	57	28.0	
69271	chr14	63737670	63738164	494	247.0	
69272	chr14	63745764	63746516	752	376.0	
69273	chr14	63747865	63748211	346	173.0	
69274	chr14	63748851	63749104	253	126.0	
69275	chr14	63759396	63760321	925	462.0	
69276	chr14	63770123	63770811	688	344.0	
69277	chr14	63799684	63799699	15	8.0	
69278	chr14	63840967	63841422	455	228.0	
69279	chr14	63852315	63854562	2247	1124.0	
69280	chr14	63855271	63855406	135	68.0	
69281	chr14	63857172	63858099	927	464.0	
69282	chr14	63860278	63860658	380	190.0	
69283	chr14	63863916	63865705	1789	894.0	
69284	chr14	63868213	63869121	908	454.0	
69285	chr14	63869976	63870373	397	198.0	
69286	chr14	63899897	63900390	493	246.0	
69287	chr14	63901465	63902031	566	283.0	
69288	chr14	63933004	63933410	406	203.0	
69289	chr14	63938279	63939164	885	442.0	
69290	chr14	63940406	63940750	344	172.0	
69291	chr14	63991862	63992251	389	194.0	
69292	chr14	64170196	64170583	387	194.0	
69293	chr14	64195292	64195623	331	166.0	
69294	chr14	64196977	64197419	442	221.0	
69295	chr14	64209416	64209893	477	238.0	
69296	chr14	64232343	64232936	593	296.0	
69297	chr14	64234569	64236821	2252	1126.0	
69298	chr14	64293963	64295373	1410	705.0	
69299	chr14	64303397	64303869	472	236.0	
69300	chr14	64337711	64339583	1872	936.0	
69301	chr14	64344097	64344576	479	240.0	
69302	chr14	64387082	64389941	2859	1430.0	
69303	chr14	64429968	64430416	448	224.0	
69304	chr14	64444280	64444505	225	112.0	
69305	chr14	64445197	64445978	781	390.0	
69306	chr14	64446495	64446555	60	30.0	
69307	chr14	64448124	64448693	569	284.0	
69308	chr14	64464712	64466312	1600	800.0	
69309	chr14	64467184	64467541	357	178.0	
69310	chr14	64478655	64479061	406	203.0	
69311	chr14	64500820	64511899	11079	5540.0	
69312	chr14	64523255	64523306	51	26.0	
69313	chr14	64539346	64542846	3500	1750.0	
69314	chr14	64549579	64550651	1072	536.0	
69315	chr14	64632595	64633585	990	495.0	
69316	chr14	64636617	64637163	546	273.0	
69317	chr14	64653976	64655356	1380	690.0	
69318	chr14	64658778	64659324	546	273.0	
69319	chr14	64671466	64671989	523	262.0	
69320	chr14	64673190	64674367	1177	588.0	
69321	chr14	64676416	64676837	421	210.0	
69322	chr14	64688030	64688598	568	284.0	
69323	chr14	64691289	64691829	540	270.0	
69324	chr14	64696301	64696909	608	304.0	
69325	chr14	64698756	64699683	927	464.0	
69326	chr14	64702670	64706348	3678	1839.0	
69327	chr14	64706946	64709872	2926	1463.0	
69328	chr14	64714175	64714817	642	321.0	
69329	chr14	64716626	64717408	782	391.0	
69330	chr14	64720127	64720840	713	356.0	
69331	chr14	64721458	64721619	161	80.0	
69332	chr14	64722334	64724886	2552	1276.0	
69333	chr14	64726509	64726980	471	236.0	
69334	chr14	64733894	64734303	409	204.0	
69335	chr14	64735087	64735319	232	116.0	
69336	chr14	64745608	64745691	83	42.0	
69337	chr14	64747374	64747407	33	16.0	
69338	chr14	64755358	64757023	1665	832.0	
69339	chr14	64757715	64758622	907	454.0	
69340	chr14	64760096	64760629	533	266.0	
69341	chr14	64762147	64762589	442	221.0	
69342	chr14	64763894	64765272	1378	689.0	
69343	chr14	64812463	64812802	339	170.0	
69344	chr14	64823146	64823841	695	348.0	
69345	chr14	64826741	64827263	522	261.0	
69346	chr14	64879248	64881073	1825	912.0	
69347	chr14	64891753	64892225	472	236.0	
69348	chr14	64905122	64905688	566	283.0	
69349	chr14	64913733	64916245	2512	1256.0	
69350	chr14	64928102	64929401	1299	650.0	
69351	chr14	64935500	64935903	403	202.0	
69352	chr14	64943596	64943669	73	36.0	
69353	chr14	64970005	64970354	349	174.0	
69354	chr14	64971177	64973043	1866	933.0	
69355	chr14	64976712	64977058	346	173.0	
69356	chr14	64983455	64984327	872	436.0	
69357	chr14	64986183	64987767	1584	792.0	
69358	chr14	64990098	64990756	658	329.0	
69359	chr14	64993218	64993922	704	352.0	
69360	chr14	65019943	65020395	452	226.0	
69361	chr14	65042475	65043312	837	418.0	
69362	chr14	65044194	65045109	915	458.0	
69363	chr14	65045860	65045911	51	26.0	
69364	chr14	65047866	65048224	358	179.0	
69365	chr14	65054433	65055278	845	422.0	
69366	chr14	65070477	65070903	426	213.0	
69367	chr14	65074295	65076070	1775	888.0	
69368	chr14	65079038	65079580	542	271.0	
69369	chr14	65080982	65081866	884	442.0	
69370	chr14	65098154	65099097	943	472.0	
69371	chr14	65100696	65103778	3082	1541.0	
69372	chr14	65156451	65157494	1043	522.0	
69373	chr14	65164055	65164554	499	250.0	
69374	chr14	65167026	65167609	583	292.0	
69375	chr14	65168727	65169153	426	213.0	
69376	chr14	65170663	65171481	818	409.0	
69377	chr14	65179902	65180166	264	132.0	
69378	chr14	65205018	65207229	2211	1106.0	
69379	chr14	65207996	65208996	1000	500.0	
69380	chr14	65209952	65210707	755	378.0	
69381	chr14	65211384	65211754	370	185.0	
69382	chr14	65222315	65222815	500	250.0	
69383	chr14	65228400	65228926	526	263.0	
69384	chr14	65229506	65230481	975	488.0	
69385	chr14	65243956	65244357	401	200.0	
69386	chr14	65251286	65251556	270	135.0	
69387	chr14	65281852	65283320	1468	734.0	
69388	chr14	65286750	65288335	1585	792.0	
69389	chr14	65291972	65291981	9	4.0	
69390	chr14	65302097	65302382	285	142.0	
69391	chr14	65302900	65303093	193	96.0	
69392	chr14	65318646	65319067	421	210.0	
69393	chr14	65321498	65321656	158	79.0	
69394	chr14	65332354	65332910	556	278.0	
69395	chr14	65346921	65347280	359	180.0	
69396	chr14	65353260	65353387	127	64.0	
69397	chr14	65359455	65359849	394	197.0	
69398	chr14	65411192	65414143	2951	1476.0	
69399	chr14	65414976	65415377	401	200.0	
69400	chr14	65461749	65462045	296	148.0	
69401	chr14	65478540	65478951	411	206.0	
69402	chr14	65637729	65638217	488	244.0	
69403	chr14	65791363	65791969	606	303.0	
69404	chr14	65824478	65825145	667	334.0	
69405	chr14	65846413	65847945	1532	766.0	
69406	chr14	65850059	65850948	889	444.0	
69407	chr14	65861225	65861323	98	49.0	
69408	chr14	65879340	65879632	292	146.0	
69409	chr14	65927747	65928568	821	410.0	
69410	chr14	65937454	65937471	17	8.0	
69411	chr14	65959224	65959738	514	257.0	
69412	chr14	65960963	65961438	475	238.0	
69413	chr14	66038608	66038919	311	156.0	
69414	chr14	66070649	66071154	505	252.0	
69415	chr14	66359439	66359840	401	200.0	
69416	chr14	66495433	66495927	494	247.0	
69417	chr14	66507034	66509718	2684	1342.0	
69418	chr14	66610289	66610549	260	130.0	
69419	chr14	67067691	67067744	53	26.0	
69420	chr14	67166383	67166726	343	172.0	
69421	chr14	67240125	67242394	2269	1134.0	
69422	chr14	67358987	67361131	2144	1072.0	
69423	chr14	67411756	67412568	812	406.0	
69424	chr14	67414151	67414540	389	194.0	
69425	chr14	67416910	67417115	205	102.0	
69426	chr14	67420142	67420310	168	84.0	
69427	chr14	67423445	67423829	384	192.0	
69428	chr14	67427024	67427728	704	352.0	
69429	chr14	67467558	67468135	577	288.0	
69430	chr14	67487728	67489307	1579	790.0	
69431	chr14	67493017	67493430	413	206.0	
69432	chr14	67503140	67503196	56	28.0	
69433	chr14	67512938	67515923	2985	1492.0	
69434	chr14	67516628	67517102	474	237.0	
69435	chr14	67526527	67527194	667	334.0	
69436	chr14	67532691	67533793	1102	551.0	
69437	chr14	67571234	67571876	642	321.0	
69438	chr14	67575756	67576060	304	152.0	
69439	chr14	67583958	67584477	519	260.0	
69440	chr14	67599383	67601029	1646	823.0	
69441	chr14	67602937	67603380	443	222.0	
69442	chr14	67618379	67621202	2823	1412.0	
69443	chr14	67622589	67623621	1032	516.0	
69444	chr14	67626106	67626409	303	152.0	
69445	chr14	67629049	67629369	320	160.0	
69446	chr14	67666641	67667607	966	483.0	
69447	chr14	67668477	67669230	753	376.0	
69448	chr14	67673812	67675530	1718	859.0	
69449	chr14	67680157	67681427	1270	635.0	
69450	chr14	67694562	67696409	1847	924.0	
69451	chr14	67700452	67701103	651	326.0	
69452	chr14	67703995	67705079	1084	542.0	
69453	chr14	67739225	67739488	263	132.0	
69454	chr14	67766138	67766979	841	420.0	
69455	chr14	67815653	67817422	1769	884.0	
69456	chr14	67818023	67818498	475	238.0	
69457	chr14	67819218	67821164	1946	973.0	
69458	chr14	67836323	67837483	1160	580.0	
69459	chr14	67852893	67854345	1452	726.0	
69460	chr14	67875162	67875633	471	236.0	
69461	chr14	67881210	67881586	376	188.0	
69462	chr14	67882891	67883459	568	284.0	
69463	chr14	67933958	67934431	473	236.0	
69464	chr14	67943810	67944297	487	244.0	
69465	chr14	67962006	67962785	779	390.0	
69466	chr14	67964355	67964708	353	176.0	
69467	chr14	68208722	68209222	500	250.0	
69468	chr14	68210373	68211664	1291	646.0	
69469	chr14	68215522	68216027	505	252.0	
69470	chr14	68247844	68249185	1341	670.0	
69471	chr14	68261130	68261388	258	129.0	
69472	chr14	68267865	68269544	1679	840.0	
69473	chr14	68271708	68272520	812	406.0	
69474	chr14	68275453	68276021	568	284.0	
69475	chr14	68279926	68280327	401	200.0	
69476	chr14	68282693	68284363	1670	835.0	
69477	chr14	68284964	68286414	1450	725.0	
69478	chr14	68293236	68293821	585	292.0	
69479	chr14	68309093	68310061	968	484.0	
69480	chr14	68313001	68313267	266	133.0	
69481	chr14	68325479	68325663	184	92.0	
69482	chr14	68333328	68333572	244	122.0	
69483	chr14	68342301	68342312	11	6.0	
69484	chr14	68359954	68360364	410	205.0	
69485	chr14	68363470	68364253	783	392.0	
69486	chr14	68367630	68368031	401	200.0	
69487	chr14	68368868	68369621	753	376.0	
69488	chr14	68373775	68374608	833	416.0	
69489	chr14	68377188	68378021	833	416.0	enhancer
69490	chr14	68379694	68380090	396	198.0	
69491	chr14	68383266	68383748	482	241.0	
69492	chr14	68384303	68385259	956	478.0	
69493	chr14	68392391	68393265	874	437.0	
69494	chr14	68397127	68398053	926	463.0	
69495	chr14	68401855	68402104	249	124.0	
69496	chr14	68404201	68404297	96	48.0	
69497	chr14	68408904	68409640	736	368.0	
69498	chr14	68423656	68424110	454	227.0	
69499	chr14	68459769	68460197	428	214.0	
69500	chr14	68466436	68466829	393	196.0	
69501	chr14	68468683	68469084	401	200.0	
69502	chr14	68471444	68471939	495	248.0	
69503	chr14	68476248	68477107	859	430.0	
69504	chr14	68483704	68484440	736	368.0	
69505	chr14	68495309	68495795	486	243.0	
69506	chr14	68506545	68508222	1677	838.0	
69507	chr14	68513744	68514328	584	292.0	
69508	chr14	68526729	68527127	398	199.0	
69509	chr14	68569009	68569262	253	126.0	
69510	chr14	68575516	68576454	938	469.0	
69511	chr14	68577614	68578767	1153	576.0	
69512	chr14	68580245	68580747	502	251.0	
69513	chr14	68594201	68594713	512	256.0	
69514	chr14	68598456	68599649	1193	596.0	
69515	chr14	68607574	68609024	1450	725.0	
69516	chr14	68628147	68629192	1045	522.0	
69517	chr14	68637593	68637741	148	74.0	
69518	chr14	68663192	68663969	777	388.0	
69519	chr14	68682265	68683652	1387	694.0	
69520	chr14	68685020	68686476	1456	728.0	
69521	chr14	68689178	68689627	449	224.0	
69522	chr14	68693159	68693645	486	243.0	
69523	chr14	68695209	68695768	559	280.0	
69524	chr14	68703041	68703530	489	244.0	
69525	chr14	68711516	68712435	919	460.0	
69526	chr14	68714846	68715644	798	399.0	
69527	chr14	68718342	68718813	471	236.0	
69528	chr14	68719604	68720201	597	298.0	
69529	chr14	68729837	68729883	46	23.0	
69530	chr14	68732906	68734974	2068	1034.0	
69531	chr14	68741631	68742572	941	470.0	
69532	chr14	68757457	68758339	882	441.0	
69533	chr14	68771646	68772136	490	245.0	
69534	chr14	68772964	68773196	232	116.0	
69535	chr14	68779426	68783287	3861	1930.0	
69536	chr14	68783978	68797619	13641	6820.0	
69537	chr14	68800520	68800745	225	112.0	
69538	chr14	68806416	68807547	1131	566.0	
69539	chr14	68813342	68817421	4079	2040.0	
69540	chr14	68819366	68822796	3430	1715.0	
69541	chr14	68824600	68825291	691	346.0	
69542	chr14	68841268	68841838	570	285.0	
69543	chr14	68843678	68844556	878	439.0	
69544	chr14	68854384	68854864	480	240.0	
69545	chr14	68863175	68863680	505	252.0	
69546	chr14	68874771	68875221	450	225.0	
69547	chr14	68898721	68900060	1339	670.0	
69548	chr14	68911521	68912348	827	414.0	
69549	chr14	68918843	68918970	127	64.0	
69550	chr14	68924205	68924828	623	312.0	
69551	chr14	68928058	68928823	765	382.0	
69552	chr14	68929617	68930392	775	388.0	
69553	chr14	68932435	68933226	791	396.0	
69554	chr14	68937525	68938297	772	386.0	
69555	chr14	68942283	68942731	448	224.0	
69556	chr14	68945841	68945852	11	6.0	
69557	chr14	68947622	68948247	625	312.0	
69558	chr14	68950059	68951903	1844	922.0	
69559	chr14	68957601	68958240	639	320.0	
69560	chr14	68967920	68968656	736	368.0	
69561	chr14	68969971	68970925	954	477.0	
69562	chr14	68976534	68980537	4003	2002.0	
69563	chr14	69002065	69002416	351	176.0	
69564	chr14	69013846	69014620	774	387.0	
69565	chr14	69040279	69040809	530	265.0	
69566	chr14	69042612	69044218	1606	803.0	
69567	chr14	69045887	69046284	397	198.0	
69568	chr14	69052214	69052693	479	240.0	
69569	chr14	69059821	69060707	886	443.0	
69570	chr14	69090190	69090584	394	197.0	
69571	chr14	69101221	69101903	682	341.0	
69572	chr14	69107359	69107832	473	236.0	
69573	chr14	69117386	69117627	241	120.0	
69574	chr14	69129146	69130020	874	437.0	
69575	chr14	69133362	69133432	70	35.0	
69576	chr14	69151162	69155197	4035	2018.0	
69577	chr14	69183724	69184130	406	203.0	
69578	chr14	69191098	69192261	1163	582.0	
69579	chr14	69242550	69243003	453	226.0	
69580	chr14	69261149	69261494	345	172.0	
69581	chr14	69317136	69318609	1473	736.0	
69582	chr14	69351234	69351704	470	235.0	
69583	chr14	69354318	69355042	724	362.0	
69584	chr14	69376320	69376907	587	294.0	
69585	chr14	69397233	69399409	2176	1088.0	
69586	chr14	69428541	69428957	416	208.0	
69587	chr14	69439629	69440270	641	320.0	
69588	chr14	69459991	69460604	613	306.0	
69589	chr14	69468978	69469277	299	150.0	
69590	chr14	69481910	69482163	253	126.0	
69591	chr14	69536892	69537468	576	288.0	
69592	chr14	69539908	69540500	592	296.0	
69593	chr14	69543406	69544197	791	396.0	
69594	chr14	69548055	69548447	392	196.0	
69595	chr14	69572260	69572297	37	18.0	
69596	chr14	69574232	69575117	885	442.0	
69597	chr14	69584910	69585414	504	252.0	
69598	chr14	69603349	69604183	834	417.0	
69599	chr14	69610218	69616555	6337	3168.0	
69600	chr14	69617714	69621293	3579	1790.0	
69601	chr14	69624191	69624226	35	18.0	
69602	chr14	69624944	69626307	1363	682.0	
69603	chr14	69631681	69633085	1404	702.0	
69604	chr14	69635198	69638999	3801	1900.0	
69605	chr14	69639554	69639943	389	194.0	
69606	chr14	69642310	69642752	442	221.0	
69607	chr14	69643451	69645295	1844	922.0	
69608	chr14	69648650	69649280	630	315.0	
69609	chr14	69650725	69651114	389	194.0	
69610	chr14	69651682	69653766	2084	1042.0	
69611	chr14	69656210	69656316	106	53.0	
69612	chr14	69658755	69659052	297	148.0	
69613	chr14	69667152	69668355	1203	602.0	
69614	chr14	69669583	69669645	62	31.0	
69615	chr14	69672448	69674334	1886	943.0	
69616	chr14	69682115	69683036	921	460.0	
69617	chr14	69684034	69685202	1168	584.0	
69618	chr14	69692981	69697376	4395	2198.0	
69619	chr14	69700640	69700879	239	120.0	
69620	chr14	69702743	69703900	1157	578.0	
69621	chr14	69708144	69709136	992	496.0	
69622	chr14	69710225	69710922	697	348.0	
69623	chr14	69711884	69713205	1321	660.0	
69624	chr14	69715910	69717251	1341	670.0	
69625	chr14	69717930	69718329	399	200.0	
69626	chr14	69719226	69720149	923	462.0	
69627	chr14	69725348	69727751	2403	1202.0	
69628	chr14	69728957	69729343	386	193.0	
69629	chr14	69753996	69754047	51	26.0	
69630	chr14	69763972	69764676	704	352.0	
69631	chr14	69766187	69788130	21943	10972.0	
69632	chr14	69789165	69789398	233	116.0	
69633	chr14	69793621	69793841	220	110.0	
69634	chr14	69797184	69797537	353	176.0	
69635	chr14	69818626	69819156	530	265.0	
69636	chr14	70018638	70019423	785	392.0	
69637	chr14	70027798	70028202	404	202.0	
69638	chr14	70254660	70256014	1354	677.0	
69639	chr14	70358981	70360348	1367	684.0	
69640	chr14	70416604	70417305	701	350.0	
69641	chr14	70600063	70601376	1313	656.0	
69642	chr14	70622051	70622562	511	256.0	
69643	chr14	70640516	70644090	3574	1787.0	
69644	chr14	70646765	70646806	41	20.0	
69645	chr14	70653827	70656245	2418	1209.0	
69646	chr14	70658787	70659923	1136	568.0	
69647	chr14	70660971	70662050	1079	540.0	
69648	chr14	70665395	70665876	481	240.0	
69649	chr14	70669005	70669547	542	271.0	
69650	chr14	70692089	70692664	575	288.0	
69651	chr14	70698029	70698746	717	358.0	
69652	chr14	70701451	70701873	422	211.0	
69653	chr14	70713933	70714476	543	272.0	
69654	chr14	70780497	70781146	649	324.0	
69655	chr14	70803247	70804167	920	460.0	
69656	chr14	70807874	70810551	2677	1338.0	
69657	chr14	70817326	70818339	1013	506.0	
69658	chr14	70821479	70823198	1719	860.0	
69659	chr14	70824820	70824963	143	72.0	
69660	chr14	70844195	70844553	358	179.0	
69661	chr14	70871819	70872811	992	496.0	
69662	chr14	70873536	70874016	480	240.0	
69663	chr14	70881679	70883665	1986	993.0	
69664	chr14	70884759	70884760	1	0.0	
69665	chr14	70886194	70889058	2864	1432.0	
69666	chr14	70893099	70893421	322	161.0	
69667	chr14	70906668	70910658	3990	1995.0	
69668	chr14	70916971	70918127	1156	578.0	
69669	chr14	70919587	70920393	806	403.0	
69670	chr14	70926189	70926901	712	356.0	
69671	chr14	70934364	70935473	1109	554.0	
69672	chr14	70941250	70942263	1013	506.0	
69673	chr14	70955805	70956321	516	258.0	
69674	chr14	70971917	70973013	1096	548.0	
69675	chr14	70980986	70982556	1570	785.0	
69676	chr14	70988550	70988836	286	143.0	
69677	chr14	70999050	70999862	812	406.0	
69678	chr14	71050184	71050539	355	178.0	
69679	chr14	71103841	71104302	461	230.0	
69680	chr14	71130539	71131215	676	338.0	
69681	chr14	71138760	71139485	725	362.0	
69682	chr14	71141138	71141543	405	202.0	
69683	chr14	71142115	71143835	1720	860.0	
69684	chr14	71168086	71169396	1310	655.0	
69685	chr14	71231694	71232097	403	202.0	
69686	chr14	71254183	71254261	78	39.0	
69687	chr14	71267082	71268025	943	472.0	
69688	chr14	71289570	71289967	397	198.0	
69689	chr14	71290952	71291532	580	290.0	
69690	chr14	71319538	71323343	3805	1902.0	
69691	chr14	71324577	71326437	1860	930.0	
69692	chr14	71328056	71328566	510	255.0	
69693	chr14	71339642	71339942	300	150.0	
69694	chr14	71340885	71341729	844	422.0	
69695	chr14	71346575	71347219	644	322.0	
69696	chr14	71355893	71356445	552	276.0	
69697	chr14	71358168	71359013	845	422.0	
69698	chr14	71361324	71361792	468	234.0	
69699	chr14	71362947	71363896	949	474.0	
69700	chr14	71371988	71372919	931	466.0	
69701	chr14	71392435	71392771	336	168.0	
69702	chr14	71395236	71395589	353	176.0	
69703	chr14	71398637	71399759	1122	561.0	
69704	chr14	71400666	71401235	569	284.0	
69705	chr14	71403598	71404138	540	270.0	
69706	chr14	71404896	71405270	374	187.0	
69707	chr14	71425189	71425251	62	31.0	
69708	chr14	71478481	71479210	729	364.0	
69709	chr14	71542171	71542616	445	222.0	
69710	chr14	71554350	71556557	2207	1104.0	
69711	chr14	71566311	71566667	356	178.0	
69712	chr14	71583259	71583766	507	254.0	
69713	chr14	71591988	71592301	313	156.0	
69714	chr14	71597639	71598388	749	374.0	
69715	chr14	71625432	71625451	19	10.0	
69716	chr14	71698119	71698223	104	52.0	
69717	chr14	71711172	71711384	212	106.0	
69718	chr14	71752978	71753495	517	258.0	
69719	chr14	71943518	71943578	60	30.0	
69720	chr14	72420753	72421147	394	197.0	
69721	chr14	72439785	72440118	333	166.0	
69722	chr14	72443953	72444332	379	190.0	
69723	chr14	72451126	72452097	971	486.0	
69724	chr14	72476545	72477356	811	406.0	
69725	chr14	72514259	72514353	94	47.0	
69726	chr14	72516610	72517668	1058	529.0	
69727	chr14	72518403	72519721	1318	659.0	
69728	chr14	72525764	72526394	630	315.0	
69729	chr14	72528485	72528700	215	108.0	
69730	chr14	72532750	72533044	294	147.0	
69731	chr14	72535374	72535944	570	285.0	
69732	chr14	72543092	72543791	699	350.0	
69733	chr14	72590553	72591007	454	227.0	
69734	chr14	72594167	72594954	787	394.0	
69735	chr14	72699693	72700138	445	222.0	
69736	chr14	72713968	72714614	646	323.0	
69737	chr14	72715234	72715982	748	374.0	
69738	chr14	72717145	72717578	433	216.0	
69739	chr14	72810106	72810685	579	290.0	
69740	chr14	72891828	72895361	3533	1766.0	
69741	chr14	72904686	72905578	892	446.0	
69742	chr14	72925478	72927864	2386	1193.0	
69743	chr14	72945673	72945707	34	17.0	
69744	chr14	72948401	72948922	521	260.0	
69745	chr14	73026372	73027915	1543	772.0	
69746	chr14	73043125	73043511	386	193.0	
69747	chr14	73057657	73059753	2096	1048.0	
69748	chr14	73135749	73137883	2134	1067.0	
69749	chr14	73141207	73141252	45	22.0	
69750	chr14	73143286	73143324	38	19.0	
69751	chr14	73173114	73173515	401	200.0	
69752	chr14	73176683	73177066	383	192.0	
69753	chr14	73180226	73180751	525	262.0	
69754	chr14	73228412	73228740	328	164.0	
69755	chr14	73231865	73232484	619	310.0	
69756	chr14	73236920	73238228	1308	654.0	
69757	chr14	73239006	73239932	926	463.0	
69758	chr14	73240687	73241278	591	296.0	
69759	chr14	73242345	73243003	658	329.0	
69760	chr14	73245534	73246456	922	461.0	
69761	chr14	73261962	73262083	121	60.0	
69762	chr14	73266787	73267080	293	146.0	
69763	chr14	73269714	73270729	1015	508.0	
69764	chr14	73295137	73295592	455	228.0	
69765	chr14	73310979	73311974	995	498.0	
69766	chr14	73325627	73326067	440	220.0	
69767	chr14	73369649	73369826	177	88.0	
69768	chr14	73401426	73401711	285	142.0	
69769	chr14	73414820	73415392	572	286.0	
69770	chr14	73424394	73425097	703	352.0	
69771	chr14	73452250	73453006	756	378.0	
69772	chr14	73456887	73459435	2548	1274.0	
69773	chr14	73462171	73462579	408	204.0	
69774	chr14	73463219	73464018	799	400.0	
69775	chr14	73464919	73466342	1423	712.0	
69776	chr14	73467239	73467951	712	356.0	
69777	chr14	73471826	73472655	829	414.0	
69778	chr14	73477538	73478107	569	284.0	
69779	chr14	73490436	73492214	1778	889.0	
69780	chr14	73503725	73504057	332	166.0	
69781	chr14	73508367	73509074	707	354.0	
69782	chr14	73539008	73539439	431	216.0	
69783	chr14	73568230	73571437	3207	1604.0	
69784	chr14	73591543	73592760	1217	608.0	
69785	chr14	73612135	73613411	1276	638.0	
69786	chr14	73633073	73634616	1543	772.0	
69787	chr14	73641023	73641360	337	168.0	
69788	chr14	73644345	73645633	1288	644.0	
69789	chr14	73711803	73715035	3232	1616.0	
69790	chr14	73715989	73716224	235	118.0	
69791	chr14	73717877	73718261	384	192.0	
69792	chr14	73719942	73720328	386	193.0	
69793	chr14	73723714	73724756	1042	521.0	
69794	chr14	73727232	73727292	60	30.0	
69795	chr14	73728248	73729998	1750	875.0	
69796	chr14	73731180	73731301	121	60.0	
69797	chr14	73739568	73747204	7636	3818.0	
69798	chr14	73749237	73763512	14275	7138.0	
69799	chr14	73764503	73765713	1210	605.0	
69800	chr14	73769247	73772767	3520	1760.0	
69801	chr14	73773931	73775151	1220	610.0	
69802	chr14	73777385	73778873	1488	744.0	
69803	chr14	73782999	73789251	6252	3126.0	
69804	chr14	73794626	73795258	632	316.0	
69805	chr14	73810774	73811280	506	253.0	
69806	chr14	73825479	73826028	549	274.0	
69807	chr14	73829804	73830541	737	368.0	
69808	chr14	73836660	73836909	249	124.0	
69809	chr14	73851246	73853159	1913	956.0	
69810	chr14	73859570	73860136	566	283.0	
69811	chr14	73861522	73861923	401	200.0	
69812	chr14	73868178	73868602	424	212.0	
69813	chr14	73885910	73889572	3662	1831.0	
69814	chr14	73942722	73943718	996	498.0	
69815	chr14	73949439	73952351	2912	1456.0	
69816	chr14	74017905	74020051	2146	1073.0	
69817	chr14	74032928	74033045	117	58.0	
69818	chr14	74038198	74038652	454	227.0	
69819	chr14	74083826	74086164	2338	1169.0	
69820	chr14	74089654	74090028	374	187.0	
69821	chr14	74111573	74111999	426	213.0	
69822	chr14	74175990	74176531	541	270.0	
69823	chr14	74217571	74218256	685	342.0	
69824	chr14	74240348	74241517	1169	584.0	
69825	chr14	74251371	74252159	788	394.0	
69826	chr14	74256955	74258630	1675	838.0	
69827	chr14	74290455	74290831	376	188.0	
69828	chr14	74294309	74294392	83	42.0	
69829	chr14	74299025	74299415	390	195.0	
69830	chr14	74301759	74303597	1838	919.0	
69831	chr14	74362253	74362820	567	284.0	
69832	chr14	74401058	74403195	2137	1068.0	
69833	chr14	74425760	74426478	718	359.0	
69834	chr14	74472709	74472993	284	142.0	
69835	chr14	74488542	74489357	815	408.0	
69836	chr14	74491847	74494698	2851	1426.0	
69837	chr14	74495305	74495752	447	224.0	
69838	chr14	74502176	74502328	152	76.0	
69839	chr14	74506316	74506632	316	158.0	
69840	chr14	74514336	74515252	916	458.0	
69841	chr14	74533523	74533988	465	232.0	
69842	chr14	74571790	74572562	772	386.0	
69843	chr14	74573916	74575161	1245	622.0	
69844	chr14	74592752	74593467	715	358.0	
69845	chr14	74608628	74609839	1211	606.0	
69846	chr14	74611314	74613193	1879	940.0	
69847	chr14	74614707	74615169	462	231.0	
69848	chr14	74616249	74621091	4842	2421.0	
69849	chr14	74626994	74627518	524	262.0	
69850	chr14	74638233	74638236	3	2.0	
69851	chr14	74647777	74648155	378	189.0	
69852	chr14	74684356	74685143	787	394.0	
69853	chr14	74698373	74698982	609	304.0	
69854	chr14	74712432	74713787	1355	678.0	
69855	chr14	74762540	74764699	2159	1080.0	
69856	chr14	74765627	74766182	555	278.0	
69857	chr14	74784676	74785015	339	170.0	
69858	chr14	74792663	74793064	401	200.0	
69859	chr14	74793756	74793977	221	110.0	
69860	chr14	74804199	74804621	422	211.0	
69861	chr14	74835701	74836039	338	169.0	
69862	chr14	74838042	74839214	1172	586.0	
69863	chr14	74840671	74842174	1503	752.0	
69864	chr14	74860657	74861397	740	370.0	
69865	chr14	74863283	74863708	425	212.0	
69866	chr14	74867559	74868214	655	328.0	
69867	chr14	74875775	74876758	983	492.0	
69868	chr14	74878324	74878743	419	210.0	
69869	chr14	74881009	74883145	2136	1068.0	
69870	chr14	74888036	74888604	568	284.0	
69871	chr14	74893540	74894366	826	413.0	
69872	chr14	74905120	74907583	2463	1232.0	
69873	chr14	74914009	74914334	325	162.0	
69874	chr14	74922697	74923717	1020	510.0	
69875	chr14	74939813	74942465	2652	1326.0	
69876	chr14	74945222	74947139	1917	958.0	
69877	chr14	74954895	74956035	1140	570.0	
69878	chr14	74962009	74962967	958	479.0	
69879	chr14	74973255	74973633	378	189.0	
69880	chr14	74989594	74989990	396	198.0	
69881	chr14	75002044	75004200	2156	1078.0	
69882	chr14	75025082	75025483	401	200.0	
69883	chr14	75049547	75050273	726	363.0	
69884	chr14	75050811	75051910	1099	550.0	
69885	chr14	75063090	75064587	1497	748.0	
69886	chr14	75068832	75070009	1177	588.0	
69887	chr14	75088515	75089184	669	334.0	
69888	chr14	75120603	75121399	796	398.0	
69889	chr14	75123923	75124517	594	297.0	
69890	chr14	75126033	75127910	1877	938.0	
69891	chr14	75132145	75132972	827	414.0	
69892	chr14	75138320	75138989	669	334.0	
69893	chr14	75141038	75142429	1391	696.0	
69894	chr14	75144774	75145721	947	474.0	
69895	chr14	75147313	75147970	657	328.0	
69896	chr14	75156933	75157264	331	166.0	
69897	chr14	75169976	75171196	1220	610.0	
69898	chr14	75174121	75174412	291	146.0	
69899	chr14	75175642	75177439	1797	898.0	
69900	chr14	75180443	75180871	428	214.0	
69901	chr14	75182589	75183200	611	306.0	
69902	chr14	75184336	75184843	507	254.0	
69903	chr14	75188148	75189353	1205	602.0	
69904	chr14	75196411	75196992	581	290.0	
69905	chr14	75205508	75206033	525	262.0	
69906	chr14	75213220	75213329	109	54.0	
69907	chr14	75215421	75215496	75	38.0	
69908	chr14	75220038	75220677	639	320.0	
69909	chr14	75221890	75222783	893	446.0	
69910	chr14	75223691	75224188	497	248.0	
69911	chr14	75228001	75228828	827	414.0	
69912	chr14	75229748	75230940	1192	596.0	
69913	chr14	75232415	75233269	854	427.0	
69914	chr14	75234135	75235552	1417	708.0	
69915	chr14	75237360	75237841	481	240.0	enhancer
69916	chr14	75239081	75239446	365	182.0	
69917	chr14	75246834	75248264	1430	715.0	
69918	chr14	75249018	75250405	1387	694.0	
69919	chr14	75252318	75252328	10	5.0	
69920	chr14	75256726	75262626	5900	2950.0	enhancer
69921	chr14	75268748	75269666	918	459.0	
69922	chr14	75272080	75292554	20474	10237.0	
69923	chr14	75293160	75299651	6491	3246.0	
69924	chr14	75301428	75303976	2548	1274.0	
69925	chr14	75307216	75308400	1184	592.0	
69926	chr14	75310688	75311017	329	164.0	
69927	chr14	75312300	75313759	1459	730.0	
69928	chr14	75320187	75320446	259	130.0	
69929	chr14	75333000	75335868	2868	1434.0	
69930	chr14	75339066	75339448	382	191.0	
69931	chr14	75340815	75342119	1304	652.0	
69932	chr14	75343109	75343427	318	159.0	
69933	chr14	75369939	75370902	963	482.0	
69934	chr14	75383179	75384163	984	492.0	
69935	chr14	75399303	75400634	1331	666.0	
69936	chr14	75403008	75403043	35	18.0	
69937	chr14	75406777	75407408	631	316.0	
69938	chr14	75418889	75419798	909	454.0	
69939	chr14	75426541	75429243	2702	1351.0	
69940	chr14	75435493	75435942	449	224.0	
69941	chr14	75446552	75446782	230	115.0	
69942	chr14	75453657	75454366	709	354.0	
69943	chr14	75459078	75459434	356	178.0	
69944	chr14	75487292	75488087	795	398.0	
69945	chr14	75488721	75489370	649	324.0	
69946	chr14	75497208	75497621	413	206.0	
69947	chr14	75513877	75516263	2386	1193.0	
69948	chr14	75518679	75519148	469	234.0	
69949	chr14	75521449	75525216	3767	1884.0	
69950	chr14	75533379	75533745	366	183.0	
69951	chr14	75539137	75540768	1631	816.0	
69952	chr14	75541390	75543901	2511	1256.0	
69953	chr14	75549242	75549644	402	201.0	
69954	chr14	75559864	75560320	456	228.0	
69955	chr14	75560895	75561542	647	324.0	
69956	chr14	75566256	75566818	562	281.0	
69957	chr14	75570783	75571245	462	231.0	
69958	chr14	75577437	75579320	1883	942.0	
69959	chr14	75597106	75597591	485	242.0	
69960	chr14	75605188	75605703	515	258.0	
69961	chr14	75609940	75610953	1013	506.0	
69962	chr14	75614026	75615932	1906	953.0	
69963	chr14	75623919	75624200	281	140.0	
69964	chr14	75653901	75654763	862	431.0	
69965	chr14	75659938	75661945	2007	1004.0	
69966	chr14	75709178	75709660	482	241.0	
69967	chr14	75720209	75720413	204	102.0	
69968	chr14	75831371	75831952	581	290.0	
69969	chr14	75905469	75905479	10	5.0	
69970	chr14	75906639	75907100	461	230.0	
69971	chr14	75978140	75979607	1467	734.0	
69972	chr14	75981305	75983287	1982	991.0	
69973	chr14	75985252	75986621	1369	684.0	
69974	chr14	76050844	76051157	313	156.0	
69975	chr14	76151002	76152957	1955	978.0	
69976	chr14	76190937	76191797	860	430.0	
69977	chr14	76352754	76353122	368	184.0	
69978	chr14	76387193	76387530	337	168.0	
69979	chr14	76710077	76710530	453	226.0	
69980	chr14	76720207	76721485	1278	639.0	
69981	chr14	76726970	76727018	48	24.0	
69982	chr14	76730041	76730553	512	256.0	
69983	chr14	76742878	76743601	723	362.0	
69984	chr14	76761194	76763743	2549	1274.0	
69985	chr14	76767742	76769212	1470	735.0	
69986	chr14	76771659	76771899	240	120.0	
69987	chr14	76772518	76774233	1715	858.0	
69988	chr14	76776459	76777083	624	312.0	
69989	chr14	76782739	76783324	585	292.0	
69990	chr14	76784549	76785300	751	376.0	
69991	chr14	76810854	76813597	2743	1372.0	
69992	chr14	76828922	76829366	444	222.0	
69993	chr14	76832529	76833115	586	293.0	
69994	chr14	76844097	76844759	662	331.0	
69995	chr14	76846319	76846788	469	234.0	
69996	chr14	76863437	76864611	1174	587.0	
69997	chr14	76866484	76866874	390	195.0	
69998	chr14	76867375	76868317	942	471.0	
69999	chr14	76872701	76873408	707	354.0	
70000	chr14	76875922	76876453	531	266.0	
70001	chr14	76894299	76894617	318	159.0	
70002	chr14	76904472	76905409	937	468.0	
70003	chr14	76908655	76909471	816	408.0	
70004	chr14	76913016	76914166	1150	575.0	
70005	chr14	76917094	76919251	2157	1078.0	enhancer
70006	chr14	76919787	76920890	1103	552.0	enhancer
70007	chr14	76924452	76924983	531	266.0	
70008	chr14	76926049	76927502	1453	726.0	
70009	chr14	76929561	76930873	1312	656.0	
70010	chr14	76946877	76948052	1175	588.0	
70011	chr14	76950806	76951150	344	172.0	
70012	chr14	76953268	76954308	1040	520.0	
70013	chr14	76955457	76959784	4327	2164.0	
70014	chr14	76960454	76962800	2346	1173.0	
70015	chr14	76964734	76965019	285	142.0	
70016	chr14	76977356	76978774	1418	709.0	
70017	chr14	76979594	76979785	191	96.0	
70018	chr14	76997926	76998298	372	186.0	
70019	chr14	77000317	77001314	997	498.0	
70020	chr14	77023103	77025568	2465	1232.0	
70021	chr14	77026160	77029822	3662	1831.0	
70022	chr14	77031784	77034654	2870	1435.0	
70023	chr14	77036562	77036793	231	116.0	
70024	chr14	77037820	77038693	873	436.0	
70025	chr14	77039353	77041514	2161	1080.0	enhancer
70026	chr14	77042170	77042581	411	206.0	enhancer
70027	chr14	77043175	77044354	1179	590.0	enhancer
70028	chr14	77052891	77053820	929	464.0	
70029	chr14	77059586	77059910	324	162.0	
70030	chr14	77068022	77068659	637	318.0	
70031	chr14	77070402	77071261	859	430.0	
70032	chr14	77086277	77086713	436	218.0	
70033	chr14	77094587	77095142	555	278.0	
70034	chr14	77097153	77099839	2686	1343.0	
70035	chr14	77119816	77121928	2112	1056.0	
70036	chr14	77123707	77125719	2012	1006.0	
70037	chr14	77133705	77134160	455	228.0	
70038	chr14	77139555	77140035	480	240.0	
70039	chr14	77152241	77152570	329	164.0	
70040	chr14	77181318	77182564	1246	623.0	
70041	chr14	77208679	77209065	386	193.0	
70042	chr14	77221192	77221631	439	220.0	
70043	chr14	77243822	77244226	404	202.0	
70044	chr14	77301012	77301472	460	230.0	
70045	chr14	77303632	77304099	467	234.0	
70046	chr14	77309153	77309490	337	168.0	
70047	chr14	77315677	77316526	849	424.0	
70048	chr14	77319785	77322789	3004	1502.0	
70049	chr14	77347697	77348184	487	244.0	
70050	chr14	77369392	77369653	261	130.0	
70051	chr14	77372232	77372630	398	199.0	
70052	chr14	77375175	77377956	2781	1390.0	
70053	chr14	77378652	77379234	582	291.0	
70054	chr14	77407074	77407573	499	250.0	
70055	chr14	77456764	77459561	2797	1398.0	
70056	chr14	77498408	77499445	1037	518.0	
70057	chr14	77542009	77542024	15	8.0	
70058	chr14	77542594	77542945	351	176.0	
70059	chr14	77551290	77551728	438	219.0	
70060	chr14	77565234	77566200	966	483.0	
70061	chr14	77580807	77581701	894	447.0	
70062	chr14	77588469	77589954	1485	742.0	
70063	chr14	77590910	77591823	913	456.0	
70064	chr14	77593270	77594074	804	402.0	
70065	chr14	77598506	77599231	725	362.0	
70066	chr14	77603810	77604343	533	266.0	
70067	chr14	77607700	77608419	719	360.0	
70068	chr14	77614947	77617692	2745	1372.0	
70069	chr14	77618601	77618831	230	115.0	
70070	chr14	77640835	77642534	1699	850.0	
70071	chr14	77653438	77653885	447	224.0	
70072	chr14	77654924	77655394	470	235.0	
70073	chr14	77657146	77657784	638	319.0	
70074	chr14	77659587	77660438	851	426.0	
70075	chr14	77667288	77667729	441	220.0	
70076	chr14	77668472	77668841	369	184.0	
70077	chr14	77707172	77708719	1547	774.0	
70078	chr14	77738547	77738983	436	218.0	
70079	chr14	77760026	77762062	2036	1018.0	
70080	chr14	77799558	77800978	1420	710.0	
70081	chr14	77813597	77814122	525	262.0	
70082	chr14	77817309	77817747	438	219.0	
70083	chr14	77862174	77862576	402	201.0	
70084	chr14	77965848	77966314	466	233.0	
70085	chr14	78005266	78005719	453	226.0	
70086	chr14	78022052	78022406	354	177.0	
70087	chr14	78202209	78202377	168	84.0	
70088	chr14	78448501	78448828	327	164.0	
70089	chr14	78450966	78451673	707	354.0	
70090	chr14	78566527	78566955	428	214.0	
70091	chr14	78598060	78598402	342	171.0	
70092	chr14	78969225	78969502	277	138.0	
70093	chr14	79028172	79028802	630	315.0	
70094	chr14	79036359	79036675	316	158.0	
70095	chr14	79064172	79064642	470	235.0	
70096	chr14	80930516	80932122	1606	803.0	
70097	chr14	80940135	80942659	2524	1262.0	
70098	chr14	80954616	80956051	1435	718.0	
70099	chr14	80956904	80957242	338	169.0	
70100	chr14	80959263	80960232	969	484.0	
70101	chr14	80978403	80978745	342	171.0	
70102	chr14	80987378	80987890	512	256.0	
70103	chr14	80996217	80996904	687	344.0	
70104	chr14	81018178	81018769	591	296.0	
70105	chr14	81028508	81028763	255	128.0	
70106	chr14	81033767	81034325	558	279.0	
70107	chr14	81062831	81063204	373	186.0	
70108	chr14	81122489	81122682	193	96.0	
70109	chr14	81127716	81128178	462	231.0	
70110	chr14	81162838	81163370	532	266.0	
70111	chr14	81164099	81164575	476	238.0	
70112	chr14	81169563	81171212	1649	824.0	
70113	chr14	81176199	81176957	758	379.0	
70114	chr14	81192697	81192861	164	82.0	
70115	chr14	81200081	81200510	429	214.0	
70116	chr14	81208483	81209737	1254	627.0	
70117	chr14	81211788	81212267	479	240.0	
70118	chr14	81218969	81222026	3057	1528.0	"sequence_feature	enhancer"
70119	chr14	81256586	81257008	422	211.0	
70120	chr14	81269343	81269818	475	238.0	
70121	chr14	81296462	81296936	474	237.0	
70122	chr14	81303216	81304041	825	412.0	
70123	chr14	81311869	81312151	282	141.0	
70124	chr14	81400169	81402246	2077	1038.0	
70125	chr14	81415855	81417177	1322	661.0	
70126	chr14	81422522	81422824	302	151.0	
70127	chr14	81423351	81423862	511	256.0	
70128	chr14	81427332	81427741	409	204.0	
70129	chr14	81435382	81437025	1643	822.0	
70130	chr14	81453088	81453618	530	265.0	
70131	chr14	81464239	81465363	1124	562.0	
70132	chr14	81473996	81475331	1335	668.0	
70133	chr14	81480724	81481149	425	212.0	
70134	chr14	81485274	81485766	492	246.0	
70135	chr14	81519233	81520139	906	453.0	
70136	chr14	81533049	81534594	1545	772.0	
70137	chr14	81535349	81535999	650	325.0	
70138	chr14	81767611	81767777	166	83.0	
70139	chr14	81772304	81772780	476	238.0	
70140	chr14	83208641	83208773	132	66.0	
70141	chr14	83254933	83255569	636	318.0	
70142	chr14	83260777	83261109	332	166.0	
70143	chr14	84036758	84037352	594	297.0	
70144	chr14	84129023	84129415	392	196.0	
70145	chr14	85293621	85294073	452	226.0	
70146	chr14	85296381	85297114	733	366.0	
70147	chr14	85414193	85414486	293	146.0	
70148	chr14	85416737	85417087	350	175.0	
70149	chr14	85443035	85443278	243	122.0	
70150	chr14	85444670	85444847	177	88.0	
70151	chr14	85453666	85453970	304	152.0	
70152	chr14	85531651	85532283	632	316.0	
70153	chr14	85586926	85587515	589	294.0	
70154	chr14	85599766	85600673	907	454.0	
70155	chr14	85607463	85608243	780	390.0	
70156	chr14	85619982	85620051	69	34.0	
70157	chr14	85620959	85621355	396	198.0	
70158	chr14	85701783	85702205	422	211.0	
70159	chr14	85932655	85933110	455	228.0	
70160	chr14	85933693	85935454	1761	880.0	
70161	chr14	85943129	85943780	651	326.0	
70162	chr14	85948081	85948626	545	272.0	
70163	chr14	86028270	86028325	55	28.0	
70164	chr14	86038366	86038784	418	209.0	
70165	chr14	86243133	86243548	415	208.0	
70166	chr14	86333545	86333819	274	137.0	
70167	chr14	86501627	86502028	401	200.0	
70168	chr14	86712257	86712566	309	154.0	
70169	chr14	87944914	87945439	525	262.0	
70170	chr14	87952261	87953153	892	446.0	
70171	chr14	87959890	87960803	913	456.0	
70172	chr14	87990674	87991133	459	230.0	
70173	chr14	87992002	87993927	1925	962.0	
70174	chr14	87994681	87996182	1501	750.0	
70175	chr14	87999185	87999761	576	288.0	
70176	chr14	88002339	88003775	1436	718.0	
70177	chr14	88004852	88007113	2261	1130.0	
70178	chr14	88008213	88008930	717	358.0	
70179	chr14	88009441	88009651	210	105.0	
70180	chr14	88013479	88014261	782	391.0	
70181	chr14	88017582	88018011	429	214.0	
70182	chr14	88023582	88024197	615	308.0	
70183	chr14	88026794	88027488	694	347.0	
70184	chr14	88029956	88030571	615	308.0	
70185	chr14	88044572	88046354	1782	891.0	
70186	chr14	88049222	88049648	426	213.0	
70187	chr14	88075496	88076049	553	276.0	
70188	chr14	88089445	88089864	419	210.0	
70189	chr14	88129603	88130525	922	461.0	
70190	chr14	88137358	88137745	387	194.0	
70191	chr14	88168319	88169160	841	420.0	
70192	chr14	88179857	88180027	170	85.0	
70193	chr14	88189284	88189759	475	238.0	
70194	chr14	88297316	88297709	393	196.0	
70195	chr14	88299845	88300616	771	386.0	
70196	chr14	88384809	88386324	1515	758.0	
70197	chr14	88492135	88492809	674	337.0	
70198	chr14	88535203	88535684	481	240.0	
70199	chr14	88551277	88552197	920	460.0	
70200	chr14	88554206	88555605	1399	700.0	
70201	chr14	88557083	88558110	1027	514.0	
70202	chr14	88559881	88560160	279	140.0	
70203	chr14	88562368	88563891	1523	762.0	
70204	chr14	88667434	88667944	510	255.0	
70205	chr14	88668454	88668855	401	200.0	
70206	chr14	88791586	88793637	2051	1026.0	
70207	chr14	88823923	88825232	1309	654.0	
70208	chr14	88879030	88879452	422	211.0	
70209	chr14	89000470	89001048	578	289.0	
70210	chr14	89004119	89004746	627	314.0	
70211	chr14	89025232	89026209	977	488.0	
70212	chr14	89026872	89028222	1350	675.0	
70213	chr14	89040264	89041458	1194	597.0	
70214	chr14	89067217	89067868	651	326.0	
70215	chr14	89137505	89137906	401	200.0	
70216	chr14	89164371	89165984	1613	806.0	
70217	chr14	89177357	89178054	697	348.0	
70218	chr14	89198877	89199419	542	271.0	
70219	chr14	89201681	89201995	314	157.0	
70220	chr14	89214321	89214448	127	64.0	
70221	chr14	89221003	89221572	569	284.0	
70222	chr14	89241277	89241620	343	172.0	
70223	chr14	89246461	89246495	34	17.0	
70224	chr14	89276326	89276825	499	250.0	
70225	chr14	89283312	89283796	484	242.0	
70226	chr14	89303349	89306523	3174	1587.0	
70227	chr14	89308594	89308860	266	133.0	
70228	chr14	89349552	89349601	49	24.0	
70229	chr14	89351407	89351770	363	182.0	
70230	chr14	89353467	89353781	314	157.0	
70231	chr14	89357579	89358362	783	392.0	
70232	chr14	89359724	89360089	365	182.0	
70233	chr14	89363017	89363121	104	52.0	
70234	chr14	89364609	89366606	1997	998.0	
70235	chr14	89378151	89378552	401	200.0	
70236	chr14	89383682	89384529	847	424.0	
70237	chr14	89386100	89386643	543	272.0	
70238	chr14	89397810	89398132	322	161.0	
70239	chr14	89399789	89399975	186	93.0	
70240	chr14	89406987	89407304	317	158.0	
70241	chr14	89415583	89419454	3871	1936.0	
70242	chr14	89420023	89420338	315	158.0	
70243	chr14	89425983	89426373	390	195.0	
70244	chr14	89429482	89431498	2016	1008.0	
70245	chr14	89436279	89436702	423	212.0	
70246	chr14	89443946	89444501	555	278.0	
70247	chr14	89445219	89446047	828	414.0	
70248	chr14	89447177	89448085	908	454.0	
70249	chr14	89457779	89458404	625	312.0	
70250	chr14	89458929	89459528	599	300.0	
70251	chr14	89462396	89462872	476	238.0	
70252	chr14	89466335	89467377	1042	521.0	
70253	chr14	89472042	89472525	483	242.0	
70254	chr14	89479658	89480409	751	376.0	
70255	chr14	89484167	89485703	1536	768.0	
70256	chr14	89486472	89487393	921	460.0	
70257	chr14	89493994	89494471	477	238.0	
70258	chr14	89503505	89505316	1811	906.0	
70259	chr14	89507616	89508010	394	197.0	
70260	chr14	89510070	89511112	1042	521.0	
70261	chr14	89544626	89545011	385	192.0	
70262	chr14	89564294	89565267	973	486.0	
70263	chr14	89567010	89567371	361	180.0	
70264	chr14	89578064	89578552	488	244.0	
70265	chr14	89589338	89590270	932	466.0	
70266	chr14	89613554	89614765	1211	606.0	
70267	chr14	89616456	89621783	5327	2664.0	
70268	chr14	89626036	89627003	967	484.0	
70269	chr14	89638975	89639080	105	52.0	
70270	chr14	89641435	89642149	714	357.0	
70271	chr14	89669081	89669714	633	316.0	
70272	chr14	89680875	89682172	1297	648.0	
70273	chr14	89701084	89702541	1457	728.0	
70274	chr14	89719170	89722284	3114	1557.0	
70275	chr14	89723871	89725321	1450	725.0	
70276	chr14	89730539	89731196	657	328.0	
70277	chr14	89767589	89768234	645	322.0	
70278	chr14	89773210	89774481	1271	636.0	
70279	chr14	89912483	89913385	902	451.0	
70280	chr14	89915192	89915685	493	246.0	
70281	chr14	89939387	89940061	674	337.0	
70282	chr14	89954160	89957132	2972	1486.0	
70283	chr14	89959901	89960533	632	316.0	
70284	chr14	89973191	89973657	466	233.0	
70285	chr14	90060145	90063308	3163	1582.0	
70286	chr14	90087242	90088024	782	391.0	
70287	chr14	90235084	90235814	730	365.0	
70288	chr14	90256232	90257320	1088	544.0	
70289	chr14	90272492	90272793	301	150.0	
70290	chr14	90289283	90289662	379	190.0	
70291	chr14	90294293	90295345	1052	526.0	
70292	chr14	90296011	90296751	740	370.0	
70293	chr14	90299385	90299960	575	288.0	
70294	chr14	90300562	90301155	593	296.0	
70295	chr14	90301870	90301887	17	8.0	
70296	chr14	90331331	90332698	1367	684.0	
70297	chr14	90368922	90369375	453	226.0	
70298	chr14	90381970	90385306	3336	1668.0	
70299	chr14	90396269	90402748	6479	3240.0	
70300	chr14	90404115	90404263	148	74.0	
70301	chr14	90405062	90410508	5446	2723.0	
70302	chr14	90416778	90417192	414	207.0	
70303	chr14	90418802	90418998	196	98.0	
70304	chr14	90421329	90421726	397	198.0	
70305	chr14	90428616	90428979	363	182.0	
70306	chr14	90452337	90452433	96	48.0	
70307	chr14	90483568	90483947	379	190.0	
70308	chr14	90495305	90495630	325	162.0	
70309	chr14	90500998	90501154	156	78.0	
70310	chr14	90518881	90519258	377	188.0	
70311	chr14	90608452	90609264	812	406.0	
70312	chr14	90610339	90610733	394	197.0	
70313	chr14	90624147	90624634	487	244.0	
70314	chr14	90629826	90631736	1910	955.0	
70315	chr14	90639708	90640074	366	183.0	
70316	chr14	90644916	90645363	447	224.0	
70317	chr14	90647439	90647892	453	226.0	
70318	chr14	90658417	90659528	1111	556.0	
70319	chr14	90660920	90661565	645	322.0	
70320	chr14	90669778	90670125	347	174.0	
70321	chr14	90673846	90674461	615	308.0	
70322	chr14	90697483	90698027	544	272.0	
70323	chr14	90701463	90701542	79	40.0	
70324	chr14	90722404	90723042	638	319.0	
70325	chr14	90732062	90733133	1071	536.0	
70326	chr14	90757158	90759767	2609	1304.0	
70327	chr14	90760688	90761108	420	210.0	
70328	chr14	90785477	90785975	498	249.0	
70329	chr14	90787892	90788510	618	309.0	
70330	chr14	90796301	90796844	543	272.0	
70331	chr14	90815785	90817083	1298	649.0	
70332	chr14	90820749	90821448	699	350.0	
70333	chr14	90827660	90829505	1845	922.0	
70334	chr14	90836258	90836774	516	258.0	
70335	chr14	90842810	90843143	333	166.0	
70336	chr14	90902964	90903622	658	329.0	
70337	chr14	90969635	90969713	78	39.0	
70338	chr14	91008915	91010205	1290	645.0	
70339	chr14	91022095	91023261	1166	583.0	
70340	chr14	91038435	91038849	414	207.0	
70341	chr14	91047132	91048670	1538	769.0	
70342	chr14	91059530	91061968	2438	1219.0	
70343	chr14	91062727	91063819	1092	546.0	
70344	chr14	91066873	91068156	1283	642.0	
70345	chr14	91078173	91078909	736	368.0	
70346	chr14	91108918	91110063	1145	572.0	
70347	chr14	91113530	91117204	3674	1837.0	
70348	chr14	91124740	91125545	805	402.0	
70349	chr14	91127472	91127735	263	132.0	
70350	chr14	91138394	91138952	558	279.0	
70351	chr14	91142140	91143215	1075	538.0	
70352	chr14	91155036	91155512	476	238.0	
70353	chr14	91172883	91173726	843	422.0	
70354	chr14	91177051	91178096	1045	522.0	
70355	chr14	91194164	91194950	786	393.0	
70356	chr14	91226307	91230801	4494	2247.0	
70357	chr14	91231392	91233079	1687	844.0	
70358	chr14	91241131	91246983	5852	2926.0	
70359	chr14	91247561	91248473	912	456.0	
70360	chr14	91249658	91255493	5835	2918.0	
70361	chr14	91256049	91256349	300	150.0	
70362	chr14	91257493	91257892	399	200.0	
70363	chr14	91260784	91261954	1170	585.0	
70364	chr14	91263630	91265641	2011	1006.0	
70365	chr14	91267458	91268215	757	378.0	
70366	chr14	91269070	91269938	868	434.0	
70367	chr14	91270856	91270867	11	6.0	
70368	chr14	91271771	91272205	434	217.0	
70369	chr14	91274225	91274506	281	140.0	
70370	chr14	91275178	91275180	2	1.0	
70371	chr14	91283214	91283664	450	225.0	
70372	chr14	91286362	91287481	1119	560.0	
70373	chr14	91288333	91288525	192	96.0	
70374	chr14	91289182	91289255	73	36.0	
70375	chr14	91290578	91290813	235	118.0	
70376	chr14	91291455	91293692	2237	1118.0	
70377	chr14	91295865	91296177	312	156.0	
70378	chr14	91299562	91300228	666	333.0	
70379	chr14	91301827	91301841	14	7.0	
70380	chr14	91303005	91303930	925	462.0	
70381	chr14	91309909	91311902	1993	996.0	
70382	chr14	91312902	91313621	719	360.0	
70383	chr14	91315403	91319573	4170	2085.0	
70384	chr14	91320300	91320417	117	58.0	
70385	chr14	91321234	91321275	41	20.0	
70386	chr14	91323244	91325800	2556	1278.0	
70387	chr14	91327058	91329193	2135	1068.0	
70388	chr14	91329905	91332751	2846	1423.0	
70389	chr14	91339974	91340392	418	209.0	
70390	chr14	91344088	91344573	485	242.0	
70391	chr14	91347036	91347271	235	118.0	
70392	chr14	91348465	91352235	3770	1885.0	
70393	chr14	91354218	91356969	2751	1376.0	
70394	chr14	91358932	91359081	149	74.0	
70395	chr14	91360743	91361892	1149	574.0	
70396	chr14	91363694	91366035	2341	1170.0	
70397	chr14	91366639	91368187	1548	774.0	
70398	chr14	91368732	91370495	1763	882.0	
70399	chr14	91371370	91375792	4422	2211.0	
70400	chr14	91376745	91379694	2949	1474.0	
70401	chr14	91380623	91381099	476	238.0	
70402	chr14	91385142	91385663	521	260.0	
70403	chr14	91387252	91389082	1830	915.0	
70404	chr14	91390110	91391948	1838	919.0	
70405	chr14	91392555	91394406	1851	926.0	
70406	chr14	91395554	91400815	5261	2630.0	
70407	chr14	91402025	91406600	4575	2288.0	
70408	chr14	91408063	91411805	3742	1871.0	
70409	chr14	91412977	91419736	6759	3380.0	
70410	chr14	91425668	91425945	277	138.0	
70411	chr14	91427004	91427820	816	408.0	
70412	chr14	91494447	91497212	2765	1382.0	
70413	chr14	91505957	91506169	212	106.0	
70414	chr14	91508794	91511446	2652	1326.0	
70415	chr14	91516974	91517321	347	174.0	
70416	chr14	91520926	91521982	1056	528.0	
70417	chr14	91573808	91574691	883	442.0	
70418	chr14	91606954	91607224	270	135.0	
70419	chr14	91667128	91667449	321	160.0	
70420	chr14	91714796	91715197	401	200.0	
70421	chr14	91774147	91774480	333	166.0	
70422	chr14	91817843	91818331	488	244.0	
70423	chr14	91835390	91837313	1923	962.0	
70424	chr14	91839699	91840155	456	228.0	
70425	chr14	91858527	91858918	391	196.0	
70426	chr14	91861046	91861551	505	252.0	
70427	chr14	91864373	91864455	82	41.0	
70428	chr14	91866106	91868333	2227	1114.0	
70429	chr14	91869594	91870857	1263	632.0	
70430	chr14	91871814	91874416	2602	1301.0	
70431	chr14	91880895	91881576	681	340.0	
70432	chr14	91890167	91890800	633	316.0	
70433	chr14	91892887	91894091	1204	602.0	
70434	chr14	91911298	91912073	775	388.0	
70435	chr14	91947319	91947993	674	337.0	
70436	chr14	91968276	91968779	503	252.0	
70437	chr14	91980146	91980580	434	217.0	
70438	chr14	91996823	91997277	454	227.0	
70439	chr14	92005009	92005377	368	184.0	
70440	chr14	92026853	92026863	10	5.0	
70441	chr14	92039025	92041246	2221	1110.0	
70442	chr14	92105452	92107393	1941	970.0	
70443	chr14	92108412	92108852	440	220.0	
70444	chr14	92109694	92109704	10	5.0	
70445	chr14	92120931	92123150	2219	1110.0	
70446	chr14	92135301	92135647	346	173.0	
70447	chr14	92160591	92161034	443	222.0	
70448	chr14	92215479	92216100	621	310.0	
70449	chr14	92241781	92241797	16	8.0	
70450	chr14	92246005	92246302	297	148.0	
70451	chr14	92247196	92249142	1946	973.0	
70452	chr14	92254771	92255151	380	190.0	
70453	chr14	92258384	92258919	535	268.0	
70454	chr14	92259843	92260573	730	365.0	
70455	chr14	92263668	92264656	988	494.0	
70456	chr14	92322852	92323956	1104	552.0	
70457	chr14	92324527	92324668	141	70.0	
70458	chr14	92327057	92327138	81	40.0	
70459	chr14	92352643	92352964	321	160.0	
70460	chr14	92382480	92382837	357	178.0	
70461	chr14	92386539	92387918	1379	690.0	
70462	chr14	92391797	92393081	1284	642.0	
70463	chr14	92397105	92398199	1094	547.0	
70464	chr14	92400287	92401453	1166	583.0	
70465	chr14	92407289	92407911	622	311.0	
70466	chr14	92409080	92409345	265	132.0	
70467	chr14	92411125	92411257	132	66.0	
70468	chr14	92414482	92415068	586	293.0	
70469	chr14	92417677	92418319	642	321.0	
70470	chr14	92450515	92450741	226	113.0	
70471	chr14	92456575	92457112	537	268.0	
70472	chr14	92460717	92461997	1280	640.0	
70473	chr14	92463138	92463544	406	203.0	
70474	chr14	92465676	92466536	860	430.0	
70475	chr14	92472551	92474019	1468	734.0	
70476	chr14	92475450	92476269	819	410.0	
70477	chr14	92487509	92489315	1806	903.0	
70478	chr14	92490196	92490602	406	203.0	
70479	chr14	92492026	92493400	1374	687.0	
70480	chr14	92494881	92495671	790	395.0	
70481	chr14	92496577	92496869	292	146.0	
70482	chr14	92503764	92504266	502	251.0	
70483	chr14	92506973	92507894	921	460.0	
70484	chr14	92512940	92517716	4776	2388.0	
70485	chr14	92518748	92520527	1779	890.0	
70486	chr14	92524572	92525482	910	455.0	
70487	chr14	92526917	92527959	1042	521.0	
70488	chr14	92529945	92530223	278	139.0	
70489	chr14	92530918	92533019	2101	1050.0	
70490	chr14	92534805	92535830	1025	512.0	
70491	chr14	92539679	92541116	1437	718.0	
70492	chr14	92547350	92548925	1575	788.0	
70493	chr14	92549499	92550276	777	388.0	
70494	chr14	92551191	92551928	737	368.0	
70495	chr14	92555593	92556048	455	228.0	
70496	chr14	92563323	92563858	535	268.0	
70497	chr14	92564379	92565067	688	344.0	
70498	chr14	92568400	92570179	1779	890.0	
70499	chr14	92577036	92577947	911	456.0	
70500	chr14	92582180	92583525	1345	672.0	
70501	chr14	92584450	92587728	3278	1639.0	
70502	chr14	92599824	92600839	1015	508.0	
70503	chr14	92601353	92601579	226	113.0	
70504	chr14	92603229	92603996	767	384.0	
70505	chr14	92609211	92610063	852	426.0	
70506	chr14	92612851	92613505	654	327.0	
70507	chr14	92614015	92614615	600	300.0	
70508	chr14	92615124	92616641	1517	758.0	
70509	chr14	92632953	92634085	1132	566.0	
70510	chr14	92645716	92646834	1118	559.0	
70511	chr14	92647652	92648501	849	424.0	
70512	chr14	92649431	92658254	8823	4412.0	
70513	chr14	92659344	92660514	1170	585.0	
70514	chr14	92664915	92666355	1440	720.0	
70515	chr14	92669849	92670580	731	366.0	
70516	chr14	92675388	92677715	2327	1164.0	
70517	chr14	92680609	92681826	1217	608.0	
70518	chr14	92685844	92687651	1807	904.0	
70519	chr14	92688823	92688855	32	16.0	
70520	chr14	92690229	92690883	654	327.0	
70521	chr14	92691820	92695050	3230	1615.0	
70522	chr14	92696248	92696804	556	278.0	
70523	chr14	92702331	92703055	724	362.0	
70524	chr14	92704047	92705151	1104	552.0	
70525	chr14	92714629	92715180	551	276.0	
70526	chr14	92717592	92718097	505	252.0	
70527	chr14	92724156	92725151	995	498.0	
70528	chr14	92725924	92727590	1666	833.0	
70529	chr14	92728708	92729211	503	252.0	
70530	chr14	92729870	92730384	514	257.0	
70531	chr14	92737309	92737753	444	222.0	
70532	chr14	92747431	92749124	1693	846.0	
70533	chr14	92750016	92751363	1347	674.0	
70534	chr14	92753143	92753778	635	318.0	
70535	chr14	92759310	92759579	269	134.0	
70536	chr14	92765736	92766114	378	189.0	
70537	chr14	92768130	92768735	605	302.0	
70538	chr14	92775230	92775787	557	278.0	
70539	chr14	92779126	92779477	351	176.0	
70540	chr14	92780412	92780813	401	200.0	
70541	chr14	92783730	92784266	536	268.0	
70542	chr14	92785652	92786224	572	286.0	
70543	chr14	92793212	92795105	1893	946.0	
70544	chr14	92846311	92847538	1227	614.0	
70545	chr14	92923245	92923928	683	342.0	
70546	chr14	92951648	92952522	874	437.0	
70547	chr14	92973331	92973556	225	112.0	
70548	chr14	92979509	92979771	262	131.0	
70549	chr14	93007146	93007698	552	276.0	
70550	chr14	93013341	93013781	440	220.0	
70551	chr14	93023108	93023453	345	172.0	
70552	chr14	93032253	93035011	2758	1379.0	
70553	chr14	93036093	93036860	767	384.0	
70554	chr14	93038876	93040877	2001	1000.0	
70555	chr14	93044487	93045464	977	488.0	
70556	chr14	93054056	93054265	209	104.0	
70557	chr14	93056490	93056847	357	178.0	
70558	chr14	93060144	93060413	269	134.0	
70559	chr14	93065750	93066755	1005	502.0	
70560	chr14	93072866	93075004	2138	1069.0	
70561	chr14	93082055	93082551	496	248.0	
70562	chr14	93083660	93083729	69	34.0	
70563	chr14	93085476	93085877	401	200.0	
70564	chr14	93086643	93086707	64	32.0	
70565	chr14	93103256	93104422	1166	583.0	
70566	chr14	93105107	93105954	847	424.0	
70567	chr14	93107860	93108565	705	352.0	
70568	chr14	93111598	93112042	444	222.0	
70569	chr14	93112562	93116826	4264	2132.0	
70570	chr14	93120412	93120927	515	258.0	
70571	chr14	93127150	93127771	621	310.0	
70572	chr14	93128805	93129008	203	102.0	
70573	chr14	93132410	93134201	1791	896.0	
70574	chr14	93136489	93136880	391	196.0	
70575	chr14	93139011	93139672	661	330.0	
70576	chr14	93150144	93152078	1934	967.0	
70577	chr14	93153193	93153410	217	108.0	
70578	chr14	93160257	93160611	354	177.0	
70579	chr14	93177825	93178677	852	426.0	
70580	chr14	93182927	93187002	4075	2038.0	
70581	chr14	93205649	93208295	2646	1323.0	
70582	chr14	93219074	93219551	477	238.0	
70583	chr14	93305958	93306365	407	204.0	
70584	chr14	93317812	93318330	518	259.0	
70585	chr14	93331016	93333915	2899	1450.0	
70586	chr14	93343178	93343657	479	240.0	
70587	chr14	93369481	93370140	659	330.0	
70588	chr14	93375701	93376204	503	252.0	
70589	chr14	93395265	93395576	311	156.0	
70590	chr14	93527118	93527889	771	386.0	
70591	chr14	93533790	93534452	662	331.0	
70592	chr14	93550363	93550492	129	64.0	
70593	chr14	93892919	93893340	421	210.0	
70594	chr14	93906707	93907108	401	200.0	
70595	chr14	93936252	93936638	386	193.0	
70596	chr14	93939062	93940615	1553	776.0	
70597	chr14	93953349	93958329	4980	2490.0	
70598	chr14	93958890	93960496	1606	803.0	
70599	chr14	93961568	93964058	2490	1245.0	
70600	chr14	93967257	93968291	1034	517.0	
70601	chr14	93969046	93969447	401	200.0	
70602	chr14	93970249	93971771	1522	761.0	
70603	chr14	93974740	93975088	348	174.0	
70604	chr14	93976089	93976955	866	433.0	
70605	chr14	93977746	93979006	1260	630.0	
70606	chr14	93985081	93985299	218	109.0	
70607	chr14	93989796	93990336	540	270.0	
70608	chr14	94001518	94002245	727	364.0	
70609	chr14	94005286	94005671	385	192.0	
70610	chr14	94011741	94012482	741	370.0	
70611	chr14	94025795	94027952	2157	1078.0	
70612	chr14	94029074	94029787	713	356.0	
70613	chr14	94036293	94037161	868	434.0	
70614	chr14	94038111	94047623	9512	4756.0	
70615	chr14	94050455	94050750	295	148.0	
70616	chr14	94051834	94052195	361	180.0	
70617	chr14	94052802	94052924	122	61.0	
70618	chr14	94054277	94055472	1195	598.0	
70619	chr14	94056388	94057372	984	492.0	
70620	chr14	94064419	94066736	2317	1158.0	
70621	chr14	94077240	94082008	4768	2384.0	
70622	chr14	94098428	94098794	366	183.0	
70623	chr14	94115155	94115303	148	74.0	
70624	chr14	94128796	94130541	1745	872.0	
70625	chr14	94132206	94132716	510	255.0	
70626	chr14	94136432	94137338	906	453.0	
70627	chr14	94144689	94145178	489	244.0	
70628	chr14	94153964	94154276	312	156.0	
70629	chr14	94158189	94158943	754	377.0	
70630	chr14	94161988	94162468	480	240.0	
70631	chr14	94170155	94170496	341	170.0	
70632	chr14	94173270	94175876	2606	1303.0	
70633	chr14	94180552	94181436	884	442.0	
70634	chr14	94342006	94342603	597	298.0	
70635	chr14	94346435	94346865	430	215.0	
70636	chr14	94355539	94355872	333	166.0	
70637	chr14	94367306	94367824	518	259.0	
70638	chr14	94384786	94385479	693	346.0	
70639	chr14	94387353	94387869	516	258.0	
70640	chr14	94390283	94393088	2805	1402.0	
70641	chr14	94394299	94395214	915	458.0	
70642	chr14	94412988	94413321	333	166.0	
70643	chr14	94423447	94423905	458	229.0	
70644	chr14	94433944	94434230	286	143.0	
70645	chr14	94473719	94474030	311	156.0	
70646	chr14	94486206	94486652	446	223.0	
70647	chr14	94549631	94549754	123	62.0	
70648	chr14	94689466	94689861	395	198.0	
70649	chr14	94768400	94769203	803	402.0	
70650	chr14	94769751	94770378	627	314.0	
70651	chr14	94945491	94946933	1442	721.0	
70652	chr14	95098999	95099352	353	176.0	
70653	chr14	95137361	95137478	117	58.0	
70654	chr14	95140308	95140844	536	268.0	
70655	chr14	95143832	95144233	401	200.0	
70656	chr14	95146292	95146770	478	239.0	
70657	chr14	95156286	95158923	2637	1318.0	
70658	chr14	95163427	95163443	16	8.0	
70659	chr14	95173539	95173957	418	209.0	
70660	chr14	95185290	95186456	1166	583.0	
70661	chr14	95196259	95196665	406	203.0	
70662	chr14	95233665	95233993	328	164.0	
70663	chr14	95255448	95255939	491	246.0	
70664	chr14	95265342	95266103	761	380.0	
70665	chr14	95291132	95292183	1051	526.0	
70666	chr14	95311608	95312286	678	339.0	
70667	chr14	95313625	95315074	1449	724.0	
70668	chr14	95318653	95320431	1778	889.0	
70669	chr14	95322669	95323166	497	248.0	
70670	chr14	95327036	95328307	1271	636.0	
70671	chr14	95361413	95361833	420	210.0	
70672	chr14	95396199	95396619	420	210.0	
70673	chr14	95426953	95427620	667	334.0	
70674	chr14	95431213	95431614	401	200.0	
70675	chr14	95442291	95443302	1011	506.0	
70676	chr14	95456858	95457437	579	290.0	
70677	chr14	95462553	95464932	2379	1190.0	
70678	chr14	95479973	95481023	1050	525.0	
70679	chr14	95486937	95487344	407	204.0	
70680	chr14	95494258	95497108	2850	1425.0	
70681	chr14	95502356	95502883	527	264.0	
70682	chr14	95507030	95508292	1262	631.0	
70683	chr14	95513398	95513675	277	138.0	
70684	chr14	95514731	95520839	6108	3054.0	
70685	chr14	95522503	95525009	2506	1253.0	
70686	chr14	95526997	95527858	861	430.0	
70687	chr14	95533360	95536136	2776	1388.0	
70688	chr14	95560828	95561401	573	286.0	
70689	chr14	95577051	95577476	425	212.0	
70690	chr14	95662678	95663072	394	197.0	
70691	chr14	95683987	95684117	130	65.0	
70692	chr14	95695893	95696322	429	214.0	
70693	chr14	95697960	95698035	75	38.0	
70694	chr14	95713996	95714383	387	194.0	
70695	chr14	95725790	95726312	522	261.0	
70696	chr14	96039008	96039971	963	482.0	
70697	chr14	96100542	96100977	435	218.0	
70698	chr14	96126188	96126942	754	377.0	
70699	chr14	96198771	96198838	67	34.0	
70700	chr14	96204638	96204991	353	176.0	
70701	chr14	96248926	96249507	581	290.0	
70702	chr14	96275540	96275861	321	160.0	
70703	chr14	96297047	96297374	327	164.0	
70704	chr14	96361728	96364552	2824	1412.0	
70705	chr14	96390963	96392970	2007	1004.0	
70706	chr14	96423917	96424837	920	460.0	
70707	chr14	96427118	96427623	505	252.0	
70708	chr14	96495774	96496220	446	223.0	
70709	chr14	96497651	96497858	207	104.0	
70710	chr14	96501159	96503578	2419	1210.0	
70711	chr14	96509792	96509873	81	40.0	
70712	chr14	96517596	96518001	405	202.0	
70713	chr14	96567325	96567632	307	154.0	
70714	chr14	96584319	96584350	31	16.0	
70715	chr14	96592376	96593178	802	401.0	
70716	chr14	96741123	96741900	777	388.0	
70717	chr14	96762528	96763171	643	322.0	
70718	chr14	96783730	96784846	1116	558.0	
70719	chr14	96790784	96791108	324	162.0	
70720	chr14	96793004	96793416	412	206.0	
70721	chr14	96795371	96795755	384	192.0	
70722	chr14	96796764	96798520	1756	878.0	
70723	chr14	96806769	96807382	613	306.0	
70724	chr14	96812341	96812597	256	128.0	
70725	chr14	96816263	96816743	480	240.0	
70726	chr14	96852833	96853224	391	196.0	
70727	chr14	96905777	96906755	978	489.0	
70728	chr14	96949588	96949959	371	186.0	
70729	chr14	96962214	96962989	775	388.0	
70730	chr14	97033174	97033362	188	94.0	
70731	chr14	97077208	97077767	559	280.0	
70732	chr14	97120418	97121174	756	378.0	
70733	chr14	97176996	97177428	432	216.0	
70734	chr14	97185190	97185575	385	192.0	
70735	chr14	97218533	97219863	1330	665.0	
70736	chr14	97291244	97291292	48	24.0	
70737	chr14	97299672	97300007	335	168.0	
70738	chr14	97336212	97336572	360	180.0	
70739	chr14	97378841	97379797	956	478.0	
70740	chr14	97393137	97393820	683	342.0	
70741	chr14	97408902	97409555	653	326.0	
70742	chr14	97432634	97433056	422	211.0	
70743	chr14	97456774	97457460	686	343.0	
70744	chr14	97458200	97459774	1574	787.0	
70745	chr14	97477459	97477760	301	150.0	
70746	chr14	97490463	97490978	515	258.0	
70747	chr14	97544574	97545018	444	222.0	
70748	chr14	97592362	97593017	655	328.0	
70749	chr14	97602161	97603727	1566	783.0	
70750	chr14	97620000	97621423	1423	712.0	
70751	chr14	97634813	97635284	471	236.0	
70752	chr14	97697631	97698245	614	307.0	
70753	chr14	97702765	97703727	962	481.0	
70754	chr14	97705882	97708130	2248	1124.0	
70755	chr14	97709478	97710073	595	298.0	
70756	chr14	97719890	97720398	508	254.0	
70757	chr14	97723995	97725054	1059	530.0	
70758	chr14	97777645	97777717	72	36.0	
70759	chr14	97846159	97846560	401	200.0	
70760	chr14	97974629	97979150	4521	2260.0	
70761	chr14	97993767	97994775	1008	504.0	
70762	chr14	98018640	98019064	424	212.0	
70763	chr14	98103727	98104128	401	200.0	
70764	chr14	98135820	98136807	987	494.0	
70765	chr14	98137685	98139332	1647	824.0	
70766	chr14	98140921	98141530	609	304.0	
70767	chr14	98142614	98142948	334	167.0	
70768	chr14	98167338	98168578	1240	620.0	
70769	chr14	98171823	98171964	141	70.0	
70770	chr14	98173015	98175877	2862	1431.0	
70771	chr14	98182542	98182971	429	214.0	
70772	chr14	98185223	98185438	215	108.0	
70773	chr14	98187339	98187625	286	143.0	
70774	chr14	98188781	98190440	1659	830.0	
70775	chr14	98192815	98193028	213	106.0	
70776	chr14	98195612	98196040	428	214.0	
70777	chr14	98198147	98198921	774	387.0	
70778	chr14	98209951	98210847	896	448.0	
70779	chr14	98223372	98224425	1053	526.0	
70780	chr14	98227167	98227824	657	328.0	
70781	chr14	98229621	98230108	487	244.0	
70782	chr14	98444022	98444583	561	280.0	
70783	chr14	98704322	98704974	652	326.0	
70784	chr14	98912678	98913066	388	194.0	
70785	chr14	98926181	98926502	321	160.0	
70786	chr14	98931654	98933003	1349	674.0	
70787	chr14	98949289	98949788	499	250.0	
70788	chr14	98953496	98954433	937	468.0	
70789	chr14	98956624	98958034	1410	705.0	
70790	chr14	98984182	98985364	1182	591.0	
70791	chr14	99021857	99021973	116	58.0	
70792	chr14	99034991	99039028	4037	2018.0	
70793	chr14	99055569	99056391	822	411.0	
70794	chr14	99075931	99076361	430	215.0	
70795	chr14	99077135	99077422	287	144.0	
70796	chr14	99137519	99138548	1029	514.0	
70797	chr14	99174105	99174330	225	112.0	
70798	chr14	99176022	99177500	1478	739.0	
70799	chr14	99178115	99180507	2392	1196.0	
70800	chr14	99181128	99219332	38204	19102.0	
70801	chr14	99221391	99222609	1218	609.0	
70802	chr14	99223475	99226664	3189	1594.0	
70803	chr14	99227485	99254658	27173	13586.0	
70804	chr14	99255269	99275702	20433	10216.0	
70805	chr14	99280849	99281217	368	184.0	
70806	chr14	99286595	99287966	1371	686.0	
70807	chr14	99319902	99321360	1458	729.0	
70808	chr14	99387921	99388241	320	160.0	
70809	chr14	99389173	99389640	467	234.0	
70810	chr14	99393076	99393415	339	170.0	
70811	chr14	99396198	99396548	350	175.0	
70812	chr14	99415535	99416132	597	298.0	
70813	chr14	99430457	99430895	438	219.0	
70814	chr14	99436460	99436933	473	236.0	
70815	chr14	99476810	99477276	466	233.0	
70816	chr14	99479539	99482499	2960	1480.0	
70817	chr14	99512916	99515300	2384	1192.0	
70818	chr14	99516088	99519014	2926	1463.0	
70819	chr14	99525103	99525807	704	352.0	
70820	chr14	99594808	99595643	835	418.0	
70821	chr14	99603384	99606104	2720	1360.0	
70822	chr14	99609545	99609616	71	36.0	
70823	chr14	99628759	99629370	611	306.0	
70824	chr14	99672487	99673018	531	266.0	
70825	chr14	99676707	99677097	390	195.0	
70826	chr14	99682446	99684995	2549	1274.0	
70827	chr14	99687060	99688225	1165	582.0	
70828	chr14	99729893	99730388	495	248.0	
70829	chr14	99792642	99794008	1366	683.0	
70830	chr14	99885252	99885742	490	245.0	
70831	chr14	99945975	99947339	1364	682.0	
70832	chr14	99970774	99972990	2216	1108.0	
70833	chr14	99982363	99983071	708	354.0	
70834	chr14	99995607	99996282	675	338.0	
70835	chr14	100015394	100015687	293	146.0	
70836	chr14	100025195	100025560	365	182.0	
70837	chr14	100048747	100049284	537	268.0	
70838	chr14	100056850	100057493	643	322.0	
70839	chr14	100058679	100059210	531	266.0	
70840	chr14	100060732	100061228	496	248.0	
70841	chr14	100062486	100070827	8341	4170.0	
70842	chr14	100071557	100077566	6009	3004.0	
70843	chr14	100078234	100079990	1756	878.0	
70844	chr14	100081242	100082902	1660	830.0	
70845	chr14	100083716	100084003	287	144.0	
70846	chr14	100099497	100099601	104	52.0	
70847	chr14	100104895	100109246	4351	2176.0	
70848	chr14	100110867	100111151	284	142.0	
70849	chr14	100118807	100118808	1	0.0	
70850	chr14	100136022	100136063	41	20.0	
70851	chr14	100137971	100138882	911	456.0	
70852	chr14	100140469	100140932	463	232.0	
70853	chr14	100142149	100151254	9105	4552.0	
70854	chr14	100153626	100153808	182	91.0	
70855	chr14	100154992	100155439	447	224.0	
70856	chr14	100157510	100158173	663	332.0	
70857	chr14	100158877	100160305	1428	714.0	
70858	chr14	100162739	100163016	277	138.0	
70859	chr14	100165211	100167831	2620	1310.0	
70860	chr14	100168610	100168672	62	31.0	
70861	chr14	100192324	100194036	1712	856.0	
70862	chr14	100212845	100215251	2406	1203.0	
70863	chr14	100221071	100223088	2017	1008.0	
70864	chr14	100223956	100224865	909	454.0	
70865	chr14	100234522	100235017	495	248.0	
70866	chr14	100235900	100242649	6749	3374.0	
70867	chr14	100246224	100247640	1416	708.0	
70868	chr14	100251327	100251775	448	224.0	
70869	chr14	100256475	100256879	404	202.0	
70870	chr14	100260930	100260938	8	4.0	
70871	chr14	100261650	100262041	391	196.0	
70872	chr14	100271402	100271530	128	64.0	
70873	chr14	100278578	100279169	591	296.0	
70874	chr14	100284622	100286376	1754	877.0	
70875	chr14	100296096	100297793	1697	848.0	
70876	chr14	100303106	100303517	411	206.0	
70877	chr14	100304622	100307950	3328	1664.0	
70878	chr14	100312029	100313146	1117	558.0	
70879	chr14	100317857	100318850	993	496.0	
70880	chr14	100330421	100331476	1055	528.0	
70881	chr14	100332235	100333184	949	474.0	
70882	chr14	100340073	100340175	102	51.0	
70883	chr14	100341087	100342159	1072	536.0	
70884	chr14	100350261	100351470	1209	604.0	
70885	chr14	100373563	100374193	630	315.0	
70886	chr14	100374817	100378469	3652	1826.0	
70887	chr14	100383577	100384307	730	365.0	
70888	chr14	100393747	100394455	708	354.0	
70889	chr14	100406396	100407290	894	447.0	
70890	chr14	100408137	100408952	815	408.0	
70891	chr14	100424774	100425442	668	334.0	
70892	chr14	100434065	100435265	1200	600.0	
70893	chr14	100440176	100440550	374	187.0	
70894	chr14	100486517	100486644	127	64.0	
70895	chr14	100524893	100525154	261	130.0	
70896	chr14	100533217	100533557	340	170.0	
70897	chr14	100545861	100548753	2892	1446.0	
70898	chr14	100553791	100554693	902	451.0	
70899	chr14	100557589	100558318	729	364.0	
70900	chr14	100566820	100569153	2333	1166.0	
70901	chr14	100586368	100587522	1154	577.0	
70902	chr14	100600037	100600333	296	148.0	
70903	chr14	100616882	100618991	2109	1054.0	
70904	chr14	100622066	100622716	650	325.0	
70905	chr14	100639992	100641172	1180	590.0	
70906	chr14	100645153	100646276	1123	562.0	
70907	chr14	100653326	100653765	439	220.0	
70908	chr14	100654699	100655210	511	256.0	
70909	chr14	100662896	100663694	798	399.0	
70910	chr14	100677448	100678018	570	285.0	
70911	chr14	100680691	100681005	314	157.0	
70912	chr14	100683701	100683944	243	122.0	
70913	chr14	100711572	100711979	407	204.0	
70914	chr14	100849373	100849780	407	204.0	
70915	chr14	100851084	100851572	488	244.0	
70916	chr14	101005338	101006028	690	345.0	
70917	chr14	101120247	101121701	1454	727.0	
70918	chr14	101235244	101235574	330	165.0	
70919	chr14	101361073	101361261	188	94.0	
70920	chr14	101442347	101442954	607	304.0	
70921	chr14	101534963	101535992	1029	514.0	
70922	chr14	101596034	101596764	730	365.0	
70923	chr14	101628337	101629022	685	342.0	
70924	chr14	101704195	101704554	359	180.0	
70925	chr14	101705537	101708328	2791	1396.0	
70926	chr14	101710376	101712081	1705	852.0	
70927	chr14	101712757	101714276	1519	760.0	
70928	chr14	101715201	101715762	561	280.0	
70929	chr14	101717332	101717813	481	240.0	
70930	chr14	101721232	101723548	2316	1158.0	
70931	chr14	101725367	101727187	1820	910.0	
70932	chr14	101728109	101728364	255	128.0	
70933	chr14	101730487	101732496	2009	1004.0	
70934	chr14	101737693	101738442	749	374.0	
70935	chr14	101759764	101762746	2982	1491.0	
70936	chr14	101770859	101771554	695	348.0	
70937	chr14	101774350	101774740	390	195.0	
70938	chr14	101776437	101776673	236	118.0	
70939	chr14	101780751	101782136	1385	692.0	
70940	chr14	101791812	101792877	1065	532.0	
70941	chr14	101808131	101808532	401	200.0	
70942	chr14	101809223	101816494	7271	3636.0	
70943	chr14	101817193	101822178	4985	2492.0	
70944	chr14	101822767	101827449	4682	2341.0	
70945	chr14	101835190	101835485	295	148.0	
70946	chr14	101838832	101840010	1178	589.0	
70947	chr14	101840602	101841419	817	408.0	
70948	chr14	101842996	101844731	1735	868.0	
70949	chr14	101849131	101849583	452	226.0	
70950	chr14	101851446	101852417	971	486.0	
70951	chr14	101853560	101854852	1292	646.0	
70952	chr14	101858968	101859810	842	421.0	
70953	chr14	101873995	101874337	342	171.0	
70954	chr14	101875685	101879423	3738	1869.0	
70955	chr14	101916838	101917760	922	461.0	
70956	chr14	101927842	101928287	445	222.0	
70957	chr14	101944992	101945563	571	286.0	
70958	chr14	101947382	101949524	2142	1071.0	
70959	chr14	101950821	101951017	196	98.0	
70960	chr14	101960131	101961726	1595	798.0	
70961	chr14	101963800	101966329	2529	1264.0	
70962	chr14	101969414	101969853	439	220.0	
70963	chr14	101972232	101973579	1347	674.0	
70964	chr14	101980622	101981165	543	272.0	
70965	chr14	101992547	101993188	641	320.0	
70966	chr14	102020165	102020744	579	290.0	
70967	chr14	102046450	102046764	314	157.0	
70968	chr14	102057380	102058202	822	411.0	
70969	chr14	102062964	102063830	866	433.0	
70970	chr14	102065470	102067642	2172	1086.0	
70971	chr14	102069015	102089262	20247	10124.0	
70972	chr14	102089786	102090407	621	310.0	
70973	chr14	102096152	102097213	1061	530.0	
70974	chr14	102102967	102103472	505	252.0	
70975	chr14	102106210	102106815	605	302.0	
70976	chr14	102138886	102141017	2131	1066.0	
70977	chr14	102200771	102201374	603	302.0	
70978	chr14	102220082	102220286	204	102.0	
70979	chr14	102235230	102235741	511	256.0	
70980	chr14	102304362	102305865	1503	752.0	
70981	chr14	102313673	102315076	1403	702.0	
70982	chr14	102316300	102320824	4524	2262.0	
70983	chr14	102322964	102323484	520	260.0	
70984	chr14	102351645	102352000	355	178.0	
70985	chr14	102361846	102364081	2235	1118.0	
70986	chr14	102367707	102368106	399	200.0	
70987	chr14	102369989	102371015	1026	513.0	
70988	chr14	102389196	102389704	508	254.0	
70989	chr14	102394929	102395113	184	92.0	
70990	chr14	102437781	102438491	710	355.0	
70991	chr14	102479919	102480094	175	88.0	
70992	chr14	102499766	102501145	1379	690.0	
70993	chr14	102508032	102511221	3189	1594.0	
70994	chr14	102516355	102517863	1508	754.0	
70995	chr14	102523923	102526413	2490	1245.0	
70996	chr14	102527494	102528090	596	298.0	
70997	chr14	102530569	102531376	807	404.0	
70998	chr14	102544460	102545361	901	450.0	
70999	chr14	102554735	102556156	1421	710.0	
71000	chr14	102560661	102561128	467	234.0	
71001	chr14	102565143	102566067	924	462.0	
71002	chr14	102568016	102568602	586	293.0	
71003	chr14	102573457	102574145	688	344.0	
71004	chr14	102590137	102595591	5454	2727.0	
71005	chr14	102599556	102600097	541	270.0	
71006	chr14	102605570	102606958	1388	694.0	
71007	chr14	102607802	102608875	1073	536.0	
71008	chr14	102611201	102612898	1697	848.0	
71009	chr14	102615232	102615575	343	172.0	
71010	chr14	102616448	102617538	1090	545.0	
71011	chr14	102618855	102619390	535	268.0	
71012	chr14	102620266	102620732	466	233.0	
71013	chr14	102622114	102622967	853	426.0	
71014	chr14	102624669	102626682	2013	1006.0	
71015	chr14	102628244	102630244	2000	1000.0	
71016	chr14	102640937	102641693	756	378.0	
71017	chr14	102644449	102644976	527	264.0	
71018	chr14	102645760	102646688	928	464.0	
71019	chr14	102688297	102688771	474	237.0	
71020	chr14	102694455	102694977	522	261.0	
71021	chr14	102764396	102764441	45	22.0	
71022	chr14	102768147	102768957	810	405.0	
71023	chr14	102774362	102780313	5951	2976.0	
71024	chr14	102781219	102781423	204	102.0	
71025	chr14	102782280	102782411	131	66.0	
71026	chr14	102784760	102785131	371	186.0	
71027	chr14	102786563	102787334	771	386.0	
71028	chr14	102789432	102789587	155	78.0	
71029	chr14	102794023	102794286	263	132.0	
71030	chr14	102794963	102795838	875	438.0	
71031	chr14	102802975	102803215	240	120.0	
71032	chr14	102805223	102808148	2925	1462.0	
71033	chr14	102819101	102820169	1068	534.0	
71034	chr14	102821549	102821641	92	46.0	
71035	chr14	102840750	102841487	737	368.0	
71036	chr14	102849826	102849850	24	12.0	
71037	chr14	102853604	102854135	531	266.0	
71038	chr14	102869166	102869327	161	80.0	
71039	chr14	102872105	102872467	362	181.0	
71040	chr14	102898925	102899137	212	106.0	
71041	chr14	102900969	102902136	1167	584.0	
71042	chr14	102914543	102914750	207	104.0	
71043	chr14	102915655	102915716	61	30.0	
71044	chr14	102916676	102918481	1805	902.0	
71045	chr14	102922338	102923680	1342	671.0	
71046	chr14	102926276	102926292	16	8.0	
71047	chr14	102927340	102930506	3166	1583.0	
71048	chr14	102946679	102946854	175	88.0	
71049	chr14	102948841	102949788	947	474.0	
71050	chr14	103002220	103002323	103	52.0	
71051	chr14	103045464	103045875	411	206.0	
71052	chr14	103052464	103052862	398	199.0	
71053	chr14	103056485	103058399	1914	957.0	
71054	chr14	103074385	103076341	1956	978.0	
71055	chr14	103078032	103078905	873	436.0	
71056	chr14	103090004	103090123	119	60.0	
71057	chr14	103090755	103092281	1526	763.0	
71058	chr14	103094388	103094945	557	278.0	
71059	chr14	103103498	103106143	2645	1322.0	
71060	chr14	103108635	103109365	730	365.0	
71061	chr14	103111339	103112495	1156	578.0	
71062	chr14	103113208	103113271	63	32.0	
71063	chr14	103114888	103115512	624	312.0	
71064	chr14	103117923	103119684	1761	880.0	
71065	chr14	103120921	103124776	3855	1928.0	
71066	chr14	103125965	103126902	937	468.0	
71067	chr14	103128582	103134348	5766	2883.0	
71068	chr14	103135506	103141761	6255	3128.0	
71069	chr14	103142649	103143664	1015	508.0	
71070	chr14	103145810	103146577	767	384.0	
71071	chr14	103155072	103155380	308	154.0	
71072	chr14	103260450	103261008	558	279.0	
71073	chr14	103292714	103293250	536	268.0	
71074	chr14	103304758	103304964	206	103.0	
71075	chr14	103329764	103330316	552	276.0	
71076	chr14	103332190	103350449	18259	9130.0	
71077	chr14	103354710	103355217	507	254.0	
71078	chr14	103355757	103356626	869	434.0	
71079	chr14	103361701	103362309	608	304.0	
71080	chr14	103372638	103372936	298	149.0	
71081	chr14	103380669	103381217	548	274.0	
71082	chr14	103382274	103383011	737	368.0	
71083	chr14	103384362	103387327	2965	1482.0	
71084	chr14	103390714	103391564	850	425.0	
71085	chr14	103393771	103394673	902	451.0	
71086	chr14	103395299	103395625	326	163.0	
71087	chr14	103399838	103400078	240	120.0	
71088	chr14	103401427	103401989	562	281.0	
71089	chr14	103404174	103404175	1	0.0	
71090	chr14	103417598	103418912	1314	657.0	
71091	chr14	103427337	103428044	707	354.0	
71092	chr14	103428771	103429157	386	193.0	
71093	chr14	103443094	103443824	730	365.0	
71094	chr14	103480501	103481081	580	290.0	
71095	chr14	103499715	103500860	1145	572.0	
71096	chr14	103505165	103505426	261	130.0	
71097	chr14	103517736	103523458	5722	2861.0	
71098	chr14	103526523	103530108	3585	1792.0	
71099	chr14	103530636	103530755	119	60.0	
71100	chr14	103533217	103533435	218	109.0	
71101	chr14	103546503	103547549	1046	523.0	
71102	chr14	103561379	103563582	2203	1102.0	
71103	chr14	103571888	103572458	570	285.0	
71104	chr14	103603071	103603478	407	204.0	
71105	chr14	103606840	103608443	1603	802.0	
71106	chr14	103624021	103626583	2562	1281.0	
71107	chr14	103627880	103630253	2373	1186.0	
71108	chr14	103635635	103635987	352	176.0	
71109	chr14	103656117	103656773	656	328.0	
71110	chr14	103679179	103679823	644	322.0	
71111	chr14	103691629	103692040	411	206.0	
71112	chr14	103698961	103699195	234	117.0	
71113	chr14	103701638	103702134	496	248.0	
71114	chr14	103702726	103702976	250	125.0	
71115	chr14	103714248	103716869	2621	1310.0	
71116	chr14	103748400	103748902	502	251.0	
71117	chr14	103808364	103808828	464	232.0	
71118	chr14	103819506	103819868	362	181.0	
71119	chr14	103846484	103849710	3226	1613.0	
71120	chr14	103871488	103872985	1497	748.0	
71121	chr14	103879780	103880774	994	497.0	
71122	chr14	103900962	103901508	546	273.0	
71123	chr14	103906134	103906176	42	21.0	
71124	chr14	103908562	103909012	450	225.0	
71125	chr14	103910018	103910780	762	381.0	
71126	chr14	103920848	103922115	1267	634.0	
71127	chr14	103925367	103925663	296	148.0	
71128	chr14	103930034	103930329	295	148.0	
71129	chr14	103931197	103931959	762	381.0	
71130	chr14	103933150	103934006	856	428.0	
71131	chr14	103949442	103950374	932	466.0	
71132	chr14	104077832	104078591	759	380.0	
71133	chr14	104085092	104085863	771	386.0	
71134	chr14	104093593	104095072	1479	740.0	
71135	chr14	104137404	104138761	1357	678.0	
71136	chr14	104388961	104390377	1416	708.0	
71137	chr14	104391539	104392272	733	366.0	
71138	chr14	104393615	104394920	1305	652.0	
71139	chr14	104399633	104400293	660	330.0	
71140	chr14	104436254	104436382	128	64.0	
71141	chr14	104563945	104564418	473	236.0	
71142	chr14	104639911	104640407	496	248.0	
71143	chr14	104642010	104642401	391	196.0	
71144	chr14	104647549	104648127	578	289.0	
71145	chr14	104649980	104650874	894	447.0	
71146	chr14	104656862	104658798	1936	968.0	
71147	chr14	104660044	104661110	1066	533.0	
71148	chr14	104665438	104666214	776	388.0	
71149	chr14	104676691	104678751	2060	1030.0	
71150	chr14	104680504	104681637	1133	566.0	
71151	chr14	104685201	104685526	325	162.0	
71152	chr14	104686757	104692065	5308	2654.0	
71153	chr14	104693332	104693870	538	269.0	
71154	chr14	104694749	104696185	1436	718.0	
71155	chr14	104708381	104709226	845	422.0	
71156	chr14	104723125	104725465	2340	1170.0	
71157	chr14	104736171	104736646	475	238.0	
71158	chr14	104750757	104751220	463	232.0	
71159	chr14	104751927	104755017	3090	1545.0	
71160	chr14	104768225	104769316	1091	546.0	
71161	chr14	104770362	104772606	2244	1122.0	
71162	chr14	104773798	104773998	200	100.0	
71163	chr14	104775507	104776805	1298	649.0	
71164	chr14	104778340	104779405	1065	532.0	
71165	chr14	104781552	104781666	114	57.0	
71166	chr14	104786004	104788193	2189	1094.0	
71167	chr14	104793943	104801721	7778	3889.0	
71168	chr14	104806477	104806821	344	172.0	
71169	chr14	104815050	104816971	1921	960.0	
71170	chr14	104825483	104828211	2728	1364.0	
71171	chr14	104864184	104866256	2072	1036.0	
71172	chr14	104870775	104871129	354	177.0	
71173	chr14	104876198	104876924	726	363.0	
71174	chr14	104896612	104897078	466	233.0	
71175	chr14	104922593	104922947	354	177.0	
71176	chr14	104924550	104925286	736	368.0	
71177	chr14	104926291	104927116	825	412.0	
71178	chr14	104932815	104934553	1738	869.0	
71179	chr14	104967544	104967783	239	120.0	
71180	chr14	104975627	104979120	3493	1746.0	
71181	chr14	104979940	104980716	776	388.0	
71182	chr14	104982497	104982795	298	149.0	
71183	chr14	104983811	104983986	175	88.0	
71184	chr14	104984998	104987584	2586	1293.0	
71185	chr14	105012167	105012611	444	222.0	
71186	chr14	105014312	105014943	631	316.0	
71187	chr14	105019773	105022235	2462	1231.0	
71188	chr14	105024699	105027481	2782	1391.0	
71189	chr14	105033381	105034806	1425	712.0	
71190	chr14	105043445	105044057	612	306.0	
71191	chr14	105045274	105048512	3238	1619.0	
71192	chr14	105051954	105052035	81	40.0	
71193	chr14	105053814	105054210	396	198.0	
71194	chr14	105055946	105056802	856	428.0	
71195	chr14	105057619	105068229	10610	5305.0	
71196	chr14	105068777	105071191	2414	1207.0	
71197	chr14	105075209	105076078	869	434.0	
71198	chr14	105076681	105077595	914	457.0	
71199	chr14	105086460	105089098	2638	1319.0	
71200	chr14	105090011	105094560	4549	2274.0	
71201	chr14	105162426	105162798	372	186.0	
71202	chr14	105167246	105169602	2356	1178.0	
71203	chr14	105171878	105172015	137	68.0	
71204	chr14	105174055	105175110	1055	528.0	
71205	chr14	105180461	105183027	2566	1283.0	
71206	chr14	105187942	105188319	377	188.0	
71207	chr14	105193007	105194824	1817	908.0	
71208	chr14	105195466	105197732	2266	1133.0	
71209	chr14	105198545	105199488	943	472.0	
71210	chr14	105201304	105203764	2460	1230.0	
71211	chr14	105204354	105206015	1661	830.0	
71212	chr14	105207108	105207901	793	396.0	
71213	chr14	105247832	105249578	1746	873.0	
71214	chr14	105251921	105252011	90	45.0	
71215	chr14	105281797	105282216	419	210.0	
71216	chr14	105283907	105284260	353	176.0	
71217	chr14	105290325	105294783	4458	2229.0	
71218	chr14	105299719	105302885	3166	1583.0	
71219	chr14	105305276	105305732	456	228.0	
71220	chr14	105313427	105316484	3057	1528.0	
71221	chr14	105317533	105318049	516	258.0	
71222	chr14	105351927	105352990	1063	532.0	
71223	chr14	105363725	105364767	1042	521.0	
71224	chr14	105370555	105371459	904	452.0	
71225	chr14	105375473	105376253	780	390.0	
71226	chr14	105386038	105386041	3	2.0	
71227	chr14	105388349	105390685	2336	1168.0	
71228	chr14	105393738	105394899	1161	580.0	
71229	chr14	105396874	105399677	2803	1402.0	
71230	chr14	105404658	105405096	438	219.0	
71231	chr14	105409255	105409793	538	269.0	
71232	chr14	105410918	105412257	1339	670.0	
71233	chr14	105414495	105415550	1055	528.0	
71234	chr14	105418745	105422400	3655	1828.0	
71235	chr14	105422927	105422944	17	8.0	
71236	chr14	105448370	105449220	850	425.0	
71237	chr14	105471183	105471728	545	272.0	
71238	chr14	105473360	105509084	35724	17862.0	
71239	chr14	105511611	105512130	519	260.0	
71240	chr14	105525717	105530737	5020	2510.0	
71241	chr14	105532039	105533193	1154	577.0	
71242	chr14	105537614	105538535	921	460.0	
71243	chr14	105557229	105557569	340	170.0	
71244	chr14	105558942	105558960	18	9.0	
71245	chr14	105586171	105586440	269	134.0	
71246	chr14	105617034	105617676	642	321.0	
71247	chr14	105648380	105648457	77	38.0	
71248	chr14	105706338	105706744	406	203.0	
71249	chr14	105710471	105712285	1814	907.0	
71250	chr14	105801202	105801551	349	174.0	
71251	chr14	105817797	105818634	837	418.0	enhancer
71252	chr14	105857139	105860483	3344	1672.0	
71253	chr14	105861919	105862462	543	272.0	enhancer
71254	chr14	105940104	105940459	355	178.0	
71255	chr14	105941046	105941179	133	66.0	
71256	chr14	105944729	105946280	1551	776.0	
71257	chr14	105968972	105969431	459	230.0	
71258	chr14	105974843	105975373	530	265.0	
71259	chr14	105981237	105982222	985	492.0	
71260	chr14	105986278	105987083	805	402.0	
71261	chr14	106004828	106006614	1786	893.0	
71262	chr14	106013683	106014410	727	364.0	
71263	chr14	106039482	106039601	119	60.0	
71264	chr14	106045135	106045766	631	316.0	
71265	chr14	106061725	106062523	798	399.0	
71266	chr14	106116132	106117006	874	437.0	
71267	chr14	106129305	106129652	347	174.0	
71268	chr14	106153325	106153985	660	330.0	
71269	chr14	106170056	106170831	775	388.0	
71270	chr14	106174085	106175004	919	460.0	
71271	chr14	106177156	106177827	671	336.0	
71272	chr14	106184567	106186284	1717	858.0	
71273	chr14	106196419	106196815	396	198.0	
71274	chr14	106200775	106200890	115	58.0	
71275	chr14	106209678	106210093	415	208.0	
71276	chr14	106224126	106224587	461	230.0	
71277	chr14	106228474	106229175	701	350.0	
71278	chr14	106234583	106235223	640	320.0	
71279	chr14	106257488	106257913	425	212.0	
71280	chr14	106268212	106268929	717	358.0	
71281	chr14	106276270	106277906	1636	818.0	
71282	chr14	106308701	106309445	744	372.0	
71283	chr14	106318692	106319174	482	241.0	
71284	chr14	106335039	106335182	143	72.0	
71285	chr14	106348885	106349642	757	378.0	
71286	chr14	106372993	106374320	1327	664.0	
71287	chr14	106378184	106378618	434	217.0	
71288	chr14	106395350	106397158	1808	904.0	
71289	chr14	106398800	106399530	730	365.0	
71290	chr14	106410264	106410638	374	187.0	
71291	chr14	106417300	106418198	898	449.0	
71292	chr14	106421354	106422052	698	349.0	
71293	chr14	106436335	106436479	144	72.0	
71294	chr14	106442846	106443309	463	232.0	
71295	chr14	106459892	106460393	501	250.0	
71296	chr14	106468843	106469275	432	216.0	
71297	chr14	106477206	106478055	849	424.0	
71298	chr14	106480192	106480630	438	219.0	
71299	chr14	106482209	106482787	578	289.0	
71300	chr14	106491904	106492231	327	164.0	
71301	chr14	106494196	106494804	608	304.0	
71302	chr14	106506564	106508640	2076	1038.0	
71303	chr14	106510685	106511838	1153	576.0	
71304	chr14	106517912	106518816	904	452.0	
71305	chr14	106530416	106531267	851	426.0	
71306	chr14	106537480	106537991	511	256.0	
71307	chr14	106539531	106540351	820	410.0	
71308	chr14	106556658	106557118	460	230.0	
71309	chr14	106564029	106564471	442	221.0	
71310	chr14	106586060	106586553	493	246.0	
71311	chr14	106592379	106592773	394	197.0	
71312	chr14	106605699	106606293	594	297.0	
71313	chr14	106618366	106618974	608	304.0	
71314	chr14	106622145	106622640	495	248.0	
71315	chr14	106626892	106627591	699	350.0	
71316	chr14	106638741	106639272	531	266.0	
71317	chr14	106657374	106657890	516	258.0	
71318	chr14	106661506	106662091	585	292.0	
71319	chr14	106663005	106664131	1126	563.0	
71320	chr14	106674723	106675114	391	196.0	
71321	chr14	106691459	106692533	1074	537.0	
71322	chr14	106694420	106695427	1007	504.0	
71323	chr14	106698523	106699382	859	430.0	
71324	chr14	106706530	106706657	127	64.0	
71325	chr14	106714404	106715319	915	458.0	
71326	chr14	106766765	106767325	560	280.0	
71327	chr14	106774807	106775348	541	270.0	
71328	chr14	106790375	106790895	520	260.0	
71329	chr14	106830510	106831811	1301	650.0	
71330	chr14	106840315	106840629	314	157.0	
71331	chr14	106842665	106846104	3439	1720.0	
71332	chr14	106848301	106849063	762	381.0	
71333	chr14	106850963	106851812	849	424.0	
71334	chr14	106872310	106873602	1292	646.0	
71335	chr14	106875482	106875931	449	224.0	
71336	chr14	106879128	106879643	515	258.0	
71337	chr15	20193046	20193882	836	418.0	
71338	chr15	20227252	20227858	606	303.0	
71339	chr15	20249616	20249886	270	135.0	
71340	chr15	20281112	20281303	191	96.0	
71341	chr15	20340406	20342273	1867	934.0	
71342	chr15	20344947	20345159	212	106.0	
71343	chr15	20346647	20347752	1105	552.0	
71344	chr15	20348823	20354728	5905	2952.0	
71345	chr15	20355938	20358450	2512	1256.0	
71346	chr15	20361208	20361500	292	146.0	
71347	chr15	20642769	20642899	130	65.0	
71348	chr15	20645715	20646980	1265	632.0	
71349	chr15	20672473	20672480	7	4.0	
71350	chr15	20978051	20978436	385	192.0	
71351	chr15	21110584	21110589	5	2.0	
71352	chr15	21260798	21261298	500	250.0	
71353	chr15	21262860	21263461	601	300.0	
71354	chr15	21265613	21266176	563	282.0	
71355	chr15	21267264	21267630	366	183.0	
71356	chr15	21268330	21268936	606	303.0	
71357	chr15	21271497	21272550	1053	526.0	
71358	chr15	21281786	21282324	538	269.0	
71359	chr15	21283151	21285609	2458	1229.0	
71360	chr15	21297799	21297975	176	88.0	
71361	chr15	21324790	21325538	748	374.0	
71362	chr15	21352876	21353268	392	196.0	
71363	chr15	21397684	21397858	174	87.0	
71364	chr15	22068791	22069674	883	442.0	
71365	chr15	22081271	22081811	540	270.0	
71366	chr15	22096147	22096675	528	264.0	
71367	chr15	22098613	22100006	1393	696.0	
71368	chr15	22134880	22135653	773	386.0	
71369	chr15	22141154	22141391	237	118.0	
71370	chr15	22147282	22148860	1578	789.0	
71371	chr15	22154987	22156074	1087	544.0	
71372	chr15	22158230	22158977	747	374.0	
71373	chr15	22159902	22162565	2663	1332.0	
71374	chr15	22163328	22164164	836	418.0	
71375	chr15	22167487	22168143	656	328.0	
71376	chr15	22172324	22174765	2441	1220.0	
71377	chr15	22177816	22180008	2192	1096.0	
71378	chr15	22184646	22185102	456	228.0	
71379	chr15	22194658	22195609	951	476.0	
71380	chr15	22202940	22203706	766	383.0	
71381	chr15	22207401	22207580	179	90.0	
71382	chr15	22217211	22217979	768	384.0	
71383	chr15	22220144	22222030	1886	943.0	
71384	chr15	22222875	22223702	827	414.0	
71385	chr15	22226157	22226750	593	296.0	
71386	chr15	22250550	22250807	257	128.0	
71387	chr15	22253635	22255093	1458	729.0	
71388	chr15	22257301	22258087	786	393.0	
71389	chr15	22259985	22260515	530	265.0	
71390	chr15	22262250	22263211	961	480.0	
71391	chr15	22263847	22266116	2269	1134.0	
71392	chr15	22283102	22283530	428	214.0	
71393	chr15	23038783	23040372	1589	794.0	
71394	chr15	23035891	23036458	567	284.0	
71395	chr15	22978925	22980949	2024	1012.0	
71396	chr15	22974685	22975435	750	375.0	
71397	chr15	22956796	22957251	455	228.0	
71398	chr15	22936827	22937168	341	170.0	
71399	chr15	22842795	22843511	716	358.0	
71400	chr15	22837433	22840533	3100	1550.0	
71401	chr15	22811674	22812010	336	168.0	
71402	chr15	22796555	22797448	893	446.0	
71403	chr15	22785730	22787778	2048	1024.0	
71404	chr15	22775922	22776442	520	260.0	
71405	chr15	22757256	22758367	1111	556.0	
71406	chr15	22664248	22666049	1801	900.0	
71407	chr15	22494358	22495140	782	391.0	
71408	chr15	22390519	22391155	636	318.0	
71409	chr15	23565418	23566543	1125	562.0	
71410	chr15	24772738	24773684	946	473.0	
71411	chr15	24878305	24878449	144	72.0	
71412	chr15	24954619	24957142	2523	1262.0	
71413	chr15	24960255	24960399	144	72.0	
71414	chr15	25372378	25372722	344	172.0	
71415	chr15	25395879	25396378	499	250.0	
71416	chr15	25403732	25404214	482	241.0	
71417	chr15	25410585	25411110	525	262.0	
71418	chr15	25437692	25439931	2239	1120.0	
71419	chr15	25693926	25694275	349	174.0	
71420	chr15	25710088	25710666	578	289.0	
71421	chr15	25738234	25738562	328	164.0	
71422	chr15	25739792	25740250	458	229.0	
71423	chr15	25741124	25741531	407	204.0	
71424	chr15	25761859	25762509	650	325.0	
71425	chr15	25778507	25779115	608	304.0	
71426	chr15	25783511	25784234	723	362.0	
71427	chr15	25788290	25788360	70	35.0	
71428	chr15	25793226	25794008	782	391.0	
71429	chr15	25795053	25796141	1088	544.0	
71430	chr15	25798824	25799168	344	172.0	
71431	chr15	25800331	25800755	424	212.0	
71432	chr15	25810670	25812293	1623	812.0	
71433	chr15	25845380	25847491	2111	1056.0	
71434	chr15	25848947	25851415	2468	1234.0	
71435	chr15	25852693	25853506	813	406.0	
71436	chr15	25858935	25863966	5031	2516.0	
71437	chr15	25933623	25934422	799	400.0	
71438	chr15	25939041	25939471	430	215.0	
71439	chr15	26080099	26083219	3120	1560.0	
71440	chr15	26628992	26629549	557	278.0	
71441	chr15	28086038	28086550	512	256.0	
71442	chr15	28094254	28097596	3342	1671.0	
71443	chr15	28098445	28099723	1278	639.0	
71444	chr15	28106225	28108200	1975	988.0	
71445	chr15	28110108	28110524	416	208.0	
71446	chr15	28123456	28123838	382	191.0	
71447	chr15	28126063	28126409	346	173.0	
71448	chr15	28128023	28128379	356	178.0	
71449	chr15	28321653	28322045	392	196.0	
71450	chr15	28589031	28589993	962	481.0	
71451	chr15	28737452	28739285	1833	916.0	
71452	chr15	28789625	28789751	126	63.0	
71453	chr15	28831771	28832745	974	487.0	
71454	chr15	28873722	28874141	419	210.0	
71455	chr15	28876321	28876647	326	163.0	
71456	chr15	28885236	28887184	1948	974.0	
71457	chr15	28890527	28891492	965	482.0	
71458	chr15	28919184	28920111	927	464.0	
71459	chr15	28935297	28935728	431	216.0	
71460	chr15	28938057	28938571	514	257.0	
71461	chr15	28942039	28942437	398	199.0	
71462	chr15	28948364	28949195	831	416.0	
71463	chr15	28954837	28955512	675	338.0	
71464	chr15	28974083	28974548	465	232.0	
71465	chr15	28975610	28976135	525	262.0	
71466	chr15	28984974	28985145	171	86.0	
71467	chr15	28986079	28986579	500	250.0	
71468	chr15	28994099	28994807	708	354.0	
71469	chr15	29003878	29004218	340	170.0	
71470	chr15	29031560	29032255	695	348.0	
71471	chr15	29038244	29038590	346	173.0	
71472	chr15	29050900	29051325	425	212.0	
71473	chr15	29089569	29090978	1409	704.0	
71474	chr15	29102178	29102617	439	220.0	
71475	chr15	29103342	29104219	877	438.0	
71476	chr15	29114965	29115366	401	200.0	
71477	chr15	29139794	29140185	391	196.0	
71478	chr15	29262768	29262990	222	111.0	
71479	chr15	29268634	29270990	2356	1178.0	
71480	chr15	29309282	29309489	207	104.0	
71481	chr15	29329395	29329542	147	74.0	
71482	chr15	29825186	29825695	509	254.0	
71483	chr15	30173030	30173730	700	350.0	
71484	chr15	30195950	30196384	434	217.0	
71485	chr15	30471076	30471408	332	166.0	
71486	chr15	30566920	30567346	426	213.0	recombination_feature
71487	chr15	30621381	30621553	172	86.0	recombination_feature
71488	chr15	30624145	30624775	630	315.0	recombination_feature
71489	chr15	30625288	30627013	1725	862.0	"recombination_feature	enhancer"
71490	chr15	30649896	30650869	973	486.0	
71491	chr15	30661089	30661450	361	180.0	
71492	chr15	30755058	30755129	71	36.0	
71493	chr15	30843122	30843455	333	166.0	
71494	chr15	30859314	30859631	317	158.0	
71495	chr15	30903308	30904372	1064	532.0	
71496	chr15	30979410	30979885	475	238.0	
71497	chr15	30984785	30985423	638	319.0	
71498	chr15	30990021	30992589	2568	1284.0	
71499	chr15	31004083	31004901	818	409.0	
71500	chr15	31013775	31014278	503	252.0	
71501	chr15	31031643	31032006	363	182.0	
71502	chr15	31049102	31050779	1677	838.0	
71503	chr15	31051562	31052104	542	271.0	
71504	chr15	31080412	31081357	945	472.0	
71505	chr15	31099913	31100135	222	111.0	
71506	chr15	31129040	31129713	673	336.0	
71507	chr15	31135645	31135825	180	90.0	
71508	chr15	31167497	31168340	843	422.0	
71509	chr15	31179789	31180008	219	110.0	
71510	chr15	31197361	31197874	513	256.0	
71511	chr15	31200442	31201239	797	398.0	
71512	chr15	31203034	31203402	368	184.0	
71513	chr15	31207174	31207711	537	268.0	
71514	chr15	31212186	31212743	557	278.0	
71515	chr15	31214529	31217638	3109	1554.0	
71516	chr15	31222235	31223189	954	477.0	
71517	chr15	31224061	31225137	1076	538.0	
71518	chr15	31227915	31228413	498	249.0	
71519	chr15	31229138	31229653	515	258.0	
71520	chr15	31230728	31231288	560	280.0	
71521	chr15	31235625	31235637	12	6.0	
71522	chr15	31241636	31242435	799	400.0	
71523	chr15	31255636	31257045	1409	704.0	
71524	chr15	31258348	31258656	308	154.0	
71525	chr15	31262756	31267389	4633	2316.0	
71526	chr15	31267961	31268660	699	350.0	
71527	chr15	31270745	31271172	427	214.0	
71528	chr15	31272843	31273362	519	260.0	
71529	chr15	31293745	31293853	108	54.0	
71530	chr15	31303081	31303760	679	340.0	enhancer
71531	chr15	31308269	31308654	385	192.0	
71532	chr15	31320041	31320504	463	232.0	
71533	chr15	31323742	31333393	9651	4826.0	
71534	chr15	31334115	31334176	61	30.0	
71535	chr15	31334813	31363418	28605	14302.0	
71536	chr15	31364164	31368431	4267	2134.0	
71537	chr15	31369529	31370200	671	336.0	
71538	chr15	31371469	31371818	349	174.0	
71539	chr15	31372854	31372971	117	58.0	
71540	chr15	31375992	31376006	14	7.0	
71541	chr15	31377313	31377333	20	10.0	
71542	chr15	31378442	31379184	742	371.0	
71543	chr15	31381981	31382681	700	350.0	
71544	chr15	31385706	31388498	2792	1396.0	
71545	chr15	31389477	31390000	523	262.0	
71546	chr15	31391053	31394041	2988	1494.0	
71547	chr15	31397085	31397752	667	334.0	
71548	chr15	31398771	31399115	344	172.0	
71549	chr15	31405238	31405932	694	347.0	
71550	chr15	31412910	31413235	325	162.0	
71551	chr15	31427403	31427905	502	251.0	
71552	chr15	31433532	31436914	3382	1691.0	
71553	chr15	31437741	31438065	324	162.0	
71554	chr15	31439287	31439771	484	242.0	
71555	chr15	31440563	31441600	1037	518.0	
71556	chr15	31443417	31444465	1048	524.0	
71557	chr15	31447889	31448721	832	416.0	
71558	chr15	31455540	31455885	345	172.0	
71559	chr15	31459006	31459510	504	252.0	
71560	chr15	31467948	31468267	319	160.0	
71561	chr15	31472625	31474796	2171	1086.0	
71562	chr15	31482880	31484492	1612	806.0	
71563	chr15	31488119	31490450	2331	1166.0	
71564	chr15	31511678	31512141	463	232.0	
71565	chr15	31867631	31868274	643	322.0	
71566	chr15	31869811	31871555	1744	872.0	
71567	chr15	31977781	31978224	443	222.0	
71568	chr15	32030250	32030561	311	156.0	
71569	chr15	32613854	32613886	32	16.0	recombination_feature
71570	chr15	32614682	32616388	1706	853.0	recombination_feature
71571	chr15	32651166	32651683	517	258.0	
71572	chr15	32657421	32657758	337	168.0	
71573	chr15	32662570	32663052	482	241.0	
71574	chr15	32675351	32675949	598	299.0	
71575	chr15	32684172	32684517	345	172.0	
71576	chr15	32834198	32834559	361	180.0	
71577	chr15	32850014	32850427	413	206.0	
71578	chr15	32861673	32862188	515	258.0	
71579	chr15	32866519	32867727	1208	604.0	
71580	chr15	32908086	32909366	1280	640.0	
71581	chr15	33067859	33068939	1080	540.0	
71582	chr15	33086500	33086898	398	199.0	
71583	chr15	33100377	33100659	282	141.0	
71584	chr15	33126149	33126911	762	381.0	
71585	chr15	33132747	33133148	401	200.0	
71586	chr15	33148348	33148751	403	202.0	
71587	chr15	33150551	33151563	1012	506.0	
71588	chr15	33152387	33153188	801	400.0	
71589	chr15	33154195	33155391	1196	598.0	
71590	chr15	33157882	33158815	933	466.0	
71591	chr15	33188556	33189212	656	328.0	
71592	chr15	33194169	33195554	1385	692.0	
71593	chr15	33201504	33202326	822	411.0	
71594	chr15	33209816	33210140	324	162.0	
71595	chr15	33216296	33216680	384	192.0	
71596	chr15	33226423	33227057	634	317.0	
71597	chr15	33700685	33701111	426	213.0	
71598	chr15	33721991	33722423	432	216.0	
71599	chr15	33757467	33758225	758	379.0	
71600	chr15	34018111	34018933	822	411.0	
71601	chr15	34037886	34040162	2276	1138.0	
71602	chr15	34061678	34062428	750	375.0	
71603	chr15	34100633	34102614	1981	990.0	
71604	chr15	34110063	34110420	357	178.0	
71605	chr15	34209323	34210788	1465	732.0	
71606	chr15	34224065	34225810	1745	872.0	
71607	chr15	34241324	34241785	461	230.0	
71608	chr15	34318213	34319296	1083	542.0	
71609	chr15	34327955	34328244	289	144.0	
71610	chr15	34331752	34332287	535	268.0	
71611	chr15	34333687	34338560	4873	2436.0	
71612	chr15	34341376	34341777	401	200.0	
71613	chr15	34342278	34343685	1407	704.0	
71614	chr15	34365115	34368781	3666	1833.0	
71615	chr15	34436174	34438274	2100	1050.0	
71616	chr15	34513838	34515586	1748	874.0	
71617	chr15	34524114	34524150	36	18.0	
71618	chr15	34582298	34584630	2332	1166.0	
71619	chr15	34587922	34588728	806	403.0	
71620	chr15	34920207	34920646	439	220.0	
71621	chr15	34968998	34970475	1477	738.0	
71622	chr15	34984902	34985383	481	240.0	
71623	chr15	34986753	34986792	39	20.0	
71624	chr15	34987536	34989228	1692	846.0	
71625	chr15	35020120	35020706	586	293.0	
71626	chr15	35023739	35024288	549	274.0	
71627	chr15	35043364	35043757	393	196.0	
71628	chr15	35058879	35058987	108	54.0	
71629	chr15	35071147	35071538	391	196.0	
71630	chr15	35078498	35078878	380	190.0	
71631	chr15	35519753	35519892	139	70.0	
71632	chr15	35545210	35546943	1733	866.0	
71633	chr15	35630613	35630663	50	25.0	
71634	chr15	36578634	36580271	1637	818.0	
71635	chr15	37098778	37099378	600	300.0	
71636	chr15	37100192	37101934	1742	871.0	
71637	chr15	37995702	37996154	452	226.0	
71638	chr15	38002888	38003321	433	216.0	
71639	chr15	38006107	38006330	223	112.0	
71640	chr15	38017664	38018186	522	261.0	
71641	chr15	38042624	38043190	566	283.0	
71642	chr15	38050563	38051015	452	226.0	
71643	chr15	38065903	38066359	456	228.0	
71644	chr15	38068851	38070178	1327	664.0	
71645	chr15	38072105	38073351	1246	623.0	
71646	chr15	38084195	38086631	2436	1218.0	
71647	chr15	38119893	38120297	404	202.0	
71648	chr15	38128431	38128652	221	110.0	
71649	chr15	38129507	38131563	2056	1028.0	
71650	chr15	38134189	38134745	556	278.0	
71651	chr15	38251073	38254966	3893	1946.0	
71652	chr15	38307253	38307654	401	200.0	
71653	chr15	38354335	38354696	361	180.0	
71654	chr15	38389919	38390341	422	211.0	
71655	chr15	38437926	38438262	336	168.0	
71656	chr15	38440183	38441077	894	447.0	
71657	chr15	38453848	38455182	1334	667.0	
71658	chr15	38461077	38461478	401	200.0	
71659	chr15	38474076	38474801	725	362.0	
71660	chr15	38482562	38482844	282	141.0	
71661	chr15	38486978	38487374	396	198.0	
71662	chr15	38494537	38494602	65	32.0	
71663	chr15	38534829	38535057	228	114.0	
71664	chr15	38538050	38539108	1058	529.0	
71665	chr15	38554239	38554952	713	356.0	
71666	chr15	38557066	38558424	1358	679.0	
71667	chr15	38560383	38561220	837	418.0	
71668	chr15	38561747	38565630	3883	1942.0	
71669	chr15	38566709	38566937	228	114.0	
71670	chr15	38576715	38577672	957	478.0	
71671	chr15	38578543	38579037	494	247.0	
71672	chr15	38587110	38587614	504	252.0	
71673	chr15	38609172	38609528	356	178.0	
71674	chr15	38610653	38611611	958	479.0	
71675	chr15	38626634	38626777	143	72.0	
71676	chr15	38642958	38642973	15	8.0	
71677	chr15	38650532	38653824	3292	1646.0	
71678	chr15	38660678	38661175	497	248.0	
71679	chr15	38662455	38662793	338	169.0	
71680	chr15	38665633	38665966	333	166.0	
71681	chr15	38670048	38673365	3317	1658.0	
71682	chr15	38674356	38674757	401	200.0	
71683	chr15	38683023	38684845	1822	911.0	
71684	chr15	38685598	38686713	1115	558.0	
71685	chr15	38688253	38689284	1031	516.0	
71686	chr15	38690085	38691204	1119	560.0	
71687	chr15	38695771	38697080	1309	654.0	
71688	chr15	38698185	38698720	535	268.0	
71689	chr15	38699410	38700123	713	356.0	
71690	chr15	38707797	38708263	466	233.0	
71691	chr15	38817646	38818216	570	285.0	
71692	chr15	38860321	38860606	285	142.0	
71693	chr15	39125965	39126068	103	52.0	
71694	chr15	39263025	39263448	423	212.0	
71695	chr15	39312946	39313799	853	426.0	
71696	chr15	39326326	39327795	1469	734.0	
71697	chr15	39334695	39335676	981	490.0	
71698	chr15	39354243	39354259	16	8.0	
71699	chr15	39375800	39377081	1281	640.0	
71700	chr15	39381420	39382025	605	302.0	
71701	chr15	39387965	39388662	697	348.0	
71702	chr15	39391145	39391716	571	286.0	
71703	chr15	39396866	39397591	725	362.0	
71704	chr15	39411423	39412131	708	354.0	
71705	chr15	39413515	39414519	1004	502.0	
71706	chr15	39415761	39415814	53	26.0	
71707	chr15	39426631	39428160	1529	764.0	
71708	chr15	39433282	39433826	544	272.0	
71709	chr15	39453561	39454680	1119	560.0	
71710	chr15	39468226	39469289	1063	532.0	enhancer
71711	chr15	39472553	39472889	336	168.0	
71712	chr15	39579889	39582024	2135	1068.0	
71713	chr15	39583418	39583813	395	198.0	
71714	chr15	39593944	39594428	484	242.0	
71715	chr15	39623176	39626207	3031	1516.0	
71716	chr15	39629071	39630333	1262	631.0	
71717	chr15	39631429	39631540	111	56.0	
71718	chr15	39641468	39642006	538	269.0	
71719	chr15	39685998	39686426	428	214.0	
71720	chr15	39756858	39757159	301	150.0	
71721	chr15	39774487	39775145	658	329.0	
71722	chr15	39781605	39784198	2593	1296.0	
71723	chr15	39786397	39786887	490	245.0	
71724	chr15	39799413	39799978	565	282.0	
71725	chr15	39877780	39878024	244	122.0	
71726	chr15	39919470	39921463	1993	996.0	
71727	chr15	39933369	39934914	1545	772.0	
71728	chr15	39939636	39939916	280	140.0	
71729	chr15	40021815	40022325	510	255.0	
71730	chr15	40037885	40040701	2816	1408.0	
71731	chr15	40044618	40045920	1302	651.0	
71732	chr15	40046846	40049046	2200	1100.0	
71733	chr15	40049897	40052070	2173	1086.0	
71734	chr15	40052612	40052935	323	162.0	
71735	chr15	40054174	40056147	1973	986.0	
71736	chr15	40064300	40064941	641	320.0	
71737	chr15	40075325	40075788	463	232.0	
71738	chr15	40081419	40083029	1610	805.0	
71739	chr15	40088682	40088954	272	136.0	
71740	chr15	40092977	40093741	764	382.0	enhancer
71741	chr15	40097824	40099354	1530	765.0	
71742	chr15	40100133	40101637	1504	752.0	
71743	chr15	40104386	40109700	5314	2657.0	
71744	chr15	40115562	40116285	723	362.0	
71745	chr15	40122166	40122656	490	245.0	
71746	chr15	40128982	40129658	676	338.0	
71747	chr15	40160329	40161635	1306	653.0	
71748	chr15	40183830	40184231	401	200.0	
71749	chr15	40217081	40217643	562	281.0	
71750	chr15	40232859	40232891	32	16.0	
71751	chr15	40234949	40235859	910	455.0	
71752	chr15	40238664	40239539	875	438.0	
71753	chr15	40252398	40253442	1044	522.0	
71754	chr15	40256398	40257110	712	356.0	
71755	chr15	40266950	40267180	230	115.0	
71756	chr15	40274292	40275364	1072	536.0	
71757	chr15	40277378	40277949	571	286.0	
71758	chr15	40279152	40279852	700	350.0	
71759	chr15	40281841	40283637	1796	898.0	
71760	chr15	40285674	40285954	280	140.0	
71761	chr15	40306184	40310494	4310	2155.0	
71762	chr15	40313473	40314199	726	363.0	
71763	chr15	40320786	40321681	895	448.0	
71764	chr15	40322240	40326067	3827	1914.0	
71765	chr15	40330312	40330950	638	319.0	
71766	chr15	40332176	40332761	585	292.0	
71767	chr15	40333617	40335477	1860	930.0	
71768	chr15	40336678	40338632	1954	977.0	
71769	chr15	40340424	40341409	985	492.0	
71770	chr15	40344323	40345175	852	426.0	
71771	chr15	40357521	40359248	1727	864.0	
71772	chr15	40367315	40369198	1883	942.0	
71773	chr15	40369871	40370033	162	81.0	
71774	chr15	40372981	40373228	247	124.0	
71775	chr15	40379854	40380192	338	169.0	
71776	chr15	40382328	40383663	1335	668.0	
71777	chr15	40388750	40389471	721	360.0	
71778	chr15	40396347	40396639	292	146.0	
71779	chr15	40398203	40399075	872	436.0	
71780	chr15	40403581	40404082	501	250.0	
71781	chr15	40405157	40406519	1362	681.0	
71782	chr15	40407256	40407770	514	257.0	
71783	chr15	40420897	40422577	1680	840.0	
71784	chr15	40435356	40443347	7991	3996.0	
71785	chr15	40450202	40450278	76	38.0	
71786	chr15	40451387	40452926	1539	770.0	
71787	chr15	40453658	40455280	1622	811.0	
71788	chr15	40466440	40466644	204	102.0	
71789	chr15	40468871	40472393	3522	1761.0	
71790	chr15	40493401	40493892	491	246.0	
71791	chr15	40506929	40507685	756	378.0	
71792	chr15	40510889	40512245	1356	678.0	
71793	chr15	40519690	40520221	531	266.0	
71794	chr15	40543800	40544384	584	292.0	
71795	chr15	40550333	40551095	762	381.0	
71796	chr15	40564211	40565783	1572	786.0	
71797	chr15	40567078	40567539	461	230.0	
71798	chr15	40568600	40570308	1708	854.0	
71799	chr15	40582733	40583723	990	495.0	
71800	chr15	40589345	40590907	1562	781.0	
71801	chr15	40593115	40595070	1955	978.0	
71802	chr15	40678834	40679658	824	412.0	
71803	chr15	40693916	40696190	2274	1137.0	
71804	chr15	40702056	40702447	391	196.0	
71805	chr15	40743359	40744869	1510	755.0	
71806	chr15	40745741	40747363	1622	811.0	
71807	chr15	40753669	40755911	2242	1121.0	
71808	chr15	40763057	40766231	3174	1587.0	
71809	chr15	40768567	40770598	2031	1016.0	
71810	chr15	40776640	40777337	697	348.0	
71811	chr15	40782401	40783124	723	362.0	
71812	chr15	40787193	40787976	783	392.0	
71813	chr15	40796551	40796907	356	178.0	
71814	chr15	40806488	40808242	1754	877.0	
71815	chr15	40843735	40845748	2013	1006.0	
71816	chr15	40846932	40847997	1065	532.0	
71817	chr15	40857086	40858255	1169	584.0	
71818	chr15	40859010	40859729	719	360.0	
71819	chr15	40860463	40860820	357	178.0	
71820	chr15	40873479	40874600	1121	560.0	
71821	chr15	40878892	40878979	87	44.0	
71822	chr15	40884610	40885078	468	234.0	
71823	chr15	40891749	40895466	3717	1858.0	
71824	chr15	40902302	40908233	5931	2966.0	
71825	chr15	40909581	40910507	926	463.0	
71826	chr15	40925734	40931030	5296	2648.0	
71827	chr15	40932232	40932295	63	32.0	
71828	chr15	40933593	40933623	30	15.0	
71829	chr15	40937092	40937322	230	115.0	
71830	chr15	40938001	40938742	741	370.0	
71831	chr15	40939623	40942895	3272	1636.0	
71832	chr15	40952617	40954202	1585	792.0	
71833	chr15	40956282	40956313	31	16.0	
71834	chr15	41013606	41014194	588	294.0	
71835	chr15	41017136	41017537	401	200.0	
71836	chr15	41022429	41022919	490	245.0	
71837	chr15	41115033	41117309	2276	1138.0	
71838	chr15	41150760	41151140	380	190.0	
71839	chr15	41169715	41170224	509	254.0	
71840	chr15	41184746	41185299	553	276.0	
71841	chr15	41190220	41190614	394	197.0	
71842	chr15	41215555	41216179	624	312.0	
71843	chr15	41230310	41232153	1843	922.0	
71844	chr15	41258865	41259627	762	381.0	
71845	chr15	41263980	41264320	340	170.0	
71846	chr15	41283081	41285447	2366	1183.0	
71847	chr15	41286895	41287825	930	465.0	
71848	chr15	41290927	41292127	1200	600.0	
71849	chr15	41331531	41334349	2818	1409.0	
71850	chr15	41336525	41336779	254	127.0	
71851	chr15	41337779	41338038	259	130.0	
71852	chr15	41374877	41375457	580	290.0	
71853	chr15	41401905	41403278	1373	686.0	
71854	chr15	41407372	41407726	354	177.0	
71855	chr15	41409602	41410438	836	418.0	
71856	chr15	41416178	41418213	2035	1018.0	
71857	chr15	41424251	41424661	410	205.0	
71858	chr15	41429206	41429888	682	341.0	
71859	chr15	41465767	41466244	477	238.0	
71860	chr15	41482973	41483959	986	493.0	
71861	chr15	41487749	41488203	454	227.0	
71862	chr15	41490433	41490556	123	62.0	
71863	chr15	41492830	41496196	3366	1683.0	
71864	chr15	41501196	41503629	2433	1216.0	
71865	chr15	41511550	41514398	2848	1424.0	
71866	chr15	41515154	41515795	641	320.0	
71867	chr15	41543657	41545082	1425	712.0	
71868	chr15	41556510	41560291	3781	1890.0	
71869	chr15	41585216	41586159	943	472.0	
71870	chr15	41603729	41604539	810	405.0	
71871	chr15	41620809	41622355	1546	773.0	
71872	chr15	41634127	41634640	513	256.0	
71873	chr15	41645362	41645622	260	130.0	
71874	chr15	41647257	41647641	384	192.0	
71875	chr15	41659633	41662498	2865	1432.0	
71876	chr15	41689842	41690248	406	203.0	
71877	chr15	41695759	41696476	717	358.0	
71878	chr15	41772612	41775483	2871	1436.0	
71879	chr15	41810995	41812017	1022	511.0	
71880	chr15	41826236	41828942	2706	1353.0	
71881	chr15	41831127	41831725	598	299.0	
71882	chr15	41851819	41852156	337	168.0	
71883	chr15	41860039	41860521	482	241.0	
71884	chr15	41870456	41871126	670	335.0	
71885	chr15	41881716	41882524	808	404.0	
71886	chr15	41883252	41883529	277	138.0	
71887	chr15	41888616	41889009	393	196.0	
71888	chr15	41892560	41893263	703	352.0	
71889	chr15	41894183	41895822	1639	820.0	
71890	chr15	41904246	41905332	1086	543.0	
71891	chr15	41915266	41915778	512	256.0	
71892	chr15	41916486	41916925	439	220.0	
71893	chr15	41917839	41918069	230	115.0	
71894	chr15	41923660	41923885	225	112.0	
71895	chr15	41926540	41927872	1332	666.0	
71896	chr15	41929112	41929654	542	271.0	
71897	chr15	41930195	41930998	803	402.0	
71898	chr15	41934388	41938068	3680	1840.0	
71899	chr15	41940257	41940868	611	306.0	
71900	chr15	41966723	41973482	6759	3380.0	
71901	chr15	41989313	41990036	723	362.0	
71902	chr15	42035341	42035788	447	224.0	
71903	chr15	42056824	42057977	1153	576.0	
71904	chr15	42059655	42060372	717	358.0	
71905	chr15	42066470	42066844	374	187.0	
71906	chr15	42084302	42084938	636	318.0	
71907	chr15	42100285	42100879	594	297.0	
71908	chr15	42108848	42109143	295	148.0	
71909	chr15	42121022	42121469	447	224.0	
71910	chr15	42133892	42134315	423	212.0	
71911	chr15	42137715	42138067	352	176.0	
71912	chr15	42158292	42158756	464	232.0	
71913	chr15	42168497	42168499	2	1.0	
71914	chr15	42171107	42171506	399	200.0	
71915	chr15	42182851	42183432	581	290.0	
71916	chr15	42184167	42184708	541	270.0	
71917	chr15	42194603	42194737	134	67.0	
71918	chr15	42207604	42208937	1333	666.0	
71919	chr15	42272388	42275475	3087	1544.0	
71920	chr15	42279102	42279875	773	386.0	
71921	chr15	42366168	42366256	88	44.0	
71922	chr15	42366918	42367488	570	285.0	
71923	chr15	42385748	42385793	45	22.0	
71924	chr15	42402163	42402588	425	212.0	
71925	chr15	42471425	42472027	602	301.0	
71926	chr15	42474738	42475087	349	174.0	
71927	chr15	42490145	42491835	1690	845.0	
71928	chr15	42493598	42494132	534	267.0	
71929	chr15	42494842	42497075	2233	1116.0	
71930	chr15	42502827	42503331	504	252.0	
71931	chr15	42503855	42504168	313	156.0	
71932	chr15	42510830	42511575	745	372.0	
71933	chr15	42544749	42545282	533	266.0	
71934	chr15	42547922	42550303	2381	1190.0	
71935	chr15	42574637	42576529	1892	946.0	
71936	chr15	42580956	42582094	1138	569.0	
71937	chr15	42605206	42605574	368	184.0	
71938	chr15	42607964	42609192	1228	614.0	
71939	chr15	42650406	42650856	450	225.0	
71940	chr15	42704341	42704899	558	279.0	
71941	chr15	42736044	42737921	1877	938.0	
71942	chr15	42915869	42916318	449	224.0	
71943	chr15	42919336	42922058	2722	1361.0	
71944	chr15	42926597	42927154	557	278.0	
71945	chr15	43105214	43106845	1631	816.0	
71946	chr15	43107771	43108149	378	189.0	
71947	chr15	43118282	43118688	406	203.0	
71948	chr15	43122302	43123760	1458	729.0	
71949	chr15	43126272	43126812	540	270.0	
71950	chr15	43128944	43129007	63	32.0	
71951	chr15	43132896	43134751	1855	928.0	
71952	chr15	43143647	43143984	337	168.0	
71953	chr15	43144633	43144750	117	58.0	
71954	chr15	43151636	43152137	501	250.0	
71955	chr15	43184467	43186456	1989	994.0	
71956	chr15	43187336	43187967	631	316.0	
71957	chr15	43204247	43204655	408	204.0	
71958	chr15	43225396	43225863	467	234.0	
71959	chr15	43239720	43239972	252	126.0	
71960	chr15	43249582	43250124	542	271.0	
71961	chr15	43253300	43254248	948	474.0	
71962	chr15	43270610	43271120	510	255.0	
71963	chr15	43285486	43286144	658	329.0	
71964	chr15	43329270	43331259	1989	994.0	
71965	chr15	43370108	43371965	1857	928.0	
71966	chr15	43376042	43376507	465	232.0	
71967	chr15	43440665	43441472	807	404.0	
71968	chr15	43483306	43483693	387	194.0	
71969	chr15	43492328	43493952	1624	812.0	
71970	chr15	43510020	43512006	1986	993.0	
71971	chr15	43514258	43514935	677	338.0	
71972	chr15	43517602	43519015	1413	706.0	
71973	chr15	43520238	43520353	115	58.0	
71974	chr15	43743874	43744277	403	202.0	
71975	chr15	43745503	43747556	2053	1026.0	
71976	chr15	43748107	43750832	2725	1362.0	
71977	chr15	43754781	43754880	99	50.0	
71978	chr15	43768792	43770226	1434	717.0	
71979	chr15	43771909	43772173	264	132.0	
71980	chr15	43774032	43778204	4172	2086.0	
71981	chr15	43779162	43779290	128	64.0	
71982	chr15	43789076	43789930	854	427.0	
71983	chr15	43790642	43790687	45	22.0	
71984	chr15	43791351	43793977	2626	1313.0	
71985	chr15	43794837	43795347	510	255.0	
71986	chr15	43796706	43797472	766	383.0	
71987	chr15	43798364	43801329	2965	1482.0	
71988	chr15	43808893	43809754	861	430.0	
71989	chr15	43824114	43825264	1150	575.0	
71990	chr15	43826368	43828510	2142	1071.0	
71991	chr15	43903772	43904143	371	186.0	
71992	chr15	44194213	44195936	1723	862.0	
71993	chr15	44219652	44220116	464	232.0	
71994	chr15	44287019	44289731	2712	1356.0	
71995	chr15	44295697	44296139	442	221.0	
71996	chr15	44296692	44297571	879	440.0	
71997	chr15	44300448	44300985	537	268.0	
71998	chr15	44308454	44308719	265	132.0	
71999	chr15	44319433	44319817	384	192.0	
72000	chr15	44395096	44395366	270	135.0	
72001	chr15	44425871	44428758	2887	1444.0	
72002	chr15	44430132	44430251	119	60.0	
72003	chr15	44501741	44502202	461	230.0	
72004	chr15	44533080	44533081	1	0.0	
72005	chr15	44535853	44538456	2603	1302.0	
72006	chr15	44544762	44544956	194	97.0	
72007	chr15	44545691	44546833	1142	571.0	
72008	chr15	44550230	44550776	546	273.0	
72009	chr15	44555040	44555325	285	142.0	
72010	chr15	44560936	44561161	225	112.0	
72011	chr15	44570170	44570326	156	78.0	
72012	chr15	44578208	44579323	1115	558.0	
72013	chr15	44584102	44584607	505	252.0	
72014	chr15	44592927	44593491	564	282.0	
72015	chr15	44633079	44633456	377	188.0	
72016	chr15	44654903	44655242	339	170.0	
72017	chr15	44659263	44659354	91	46.0	
72018	chr15	44662251	44665043	2792	1396.0	
72019	chr15	44666140	44667487	1347	674.0	
72020	chr15	44668885	44669339	454	227.0	
72021	chr15	44670676	44671072	396	198.0	
72022	chr15	44674864	44678088	3224	1612.0	
72023	chr15	44682384	44683907	1523	762.0	
72024	chr15	44690224	44690642	418	209.0	
72025	chr15	44698666	44698970	304	152.0	
72026	chr15	44709894	44732508	22614	11307.0	
72027	chr15	44734827	44736846	2019	1010.0	
72028	chr15	44738121	44738828	707	354.0	
72029	chr15	44739514	44739529	15	8.0	
72030	chr15	44783866	44785152	1286	643.0	
72031	chr15	44788772	44789191	419	210.0	
72032	chr15	44813253	44813654	401	200.0	
72033	chr15	44853284	44853957	673	336.0	
72034	chr15	45022395	45024129	1734	867.0	
72035	chr15	45036955	45037507	552	276.0	
72036	chr15	45045320	45045824	504	252.0	
72037	chr15	45048360	45049415	1055	528.0	
72038	chr15	45061253	45061658	405	202.0	
72039	chr15	45112529	45112862	333	166.0	
72040	chr15	45116539	45118585	2046	1023.0	
72041	chr15	45126475	45126958	483	242.0	
72042	chr15	45129130	45130153	1023	512.0	
72043	chr15	45134889	45135657	768	384.0	
72044	chr15	45162621	45163664	1043	522.0	
72045	chr15	45166340	45170124	3784	1892.0	
72046	chr15	45179086	45180624	1538	769.0	
72047	chr15	45182193	45182196	3	2.0	
72048	chr15	45185277	45188959	3682	1841.0	
72049	chr15	45197494	45201979	4485	2242.0	
72050	chr15	45203120	45203570	450	225.0	
72051	chr15	45204875	45205599	724	362.0	
72052	chr15	45276867	45277263	396	198.0	
72053	chr15	45278760	45280042	1282	641.0	
72054	chr15	45307131	45307547	416	208.0	
72055	chr15	45338425	45338609	184	92.0	
72056	chr15	45377907	45379087	1180	590.0	
72057	chr15	45391764	45392793	1029	514.0	
72058	chr15	45394030	45394158	128	64.0	
72059	chr15	45399391	45400207	816	408.0	
72060	chr15	45401562	45403942	2380	1190.0	
72061	chr15	45429992	45430932	940	470.0	
72062	chr15	45445071	45445984	913	456.0	
72063	chr15	45447830	45448929	1099	550.0	
72064	chr15	45454371	45459380	5009	2504.0	
72065	chr15	45461262	45462164	902	451.0	
72066	chr15	45521529	45523453	1924	962.0	
72067	chr15	45555977	45556674	697	348.0	
72068	chr15	45572592	45573099	507	254.0	
72069	chr15	45574038	45574392	354	177.0	
72070	chr15	45583397	45584290	893	446.0	
72071	chr15	45585831	45588532	2701	1350.0	
72072	chr15	45603788	45604992	1204	602.0	
72073	chr15	45606951	45607202	251	126.0	
72074	chr15	45611335	45611697	362	181.0	
72075	chr15	45614153	45614737	584	292.0	
72076	chr15	45618871	45619205	334	167.0	
72077	chr15	45631344	45632241	897	448.0	
72078	chr15	45634194	45636026	1832	916.0	
72079	chr15	45637097	45638872	1775	888.0	
72080	chr15	45641233	45641909	676	338.0	
72081	chr15	45645185	45645853	668	334.0	
72082	chr15	45650024	45650885	861	430.0	
72083	chr15	45653552	45654735	1183	592.0	
72084	chr15	45704031	45706265	2234	1117.0	
72085	chr15	45714486	45714911	425	212.0	
72086	chr15	46312164	46312511	347	174.0	
72087	chr15	47196023	47196173	150	75.0	
72088	chr15	47460840	47461145	305	152.0	
72089	chr15	47471565	47471779	214	107.0	
72090	chr15	47504551	47505291	740	370.0	
72091	chr15	47523550	47524107	557	278.0	
72092	chr15	47961638	47962241	603	302.0	
72093	chr15	47987882	47988295	413	206.0	
72094	chr15	47997223	47997262	39	20.0	
72095	chr15	48001592	48002151	559	280.0	
72096	chr15	48002722	48003123	401	200.0	
72097	chr15	48177183	48178753	1570	785.0	
72098	chr15	48285720	48286185	465	232.0	
72099	chr15	48330658	48332913	2255	1128.0	
72100	chr15	48337123	48337261	138	69.0	
72101	chr15	48352445	48352852	407	204.0	
72102	chr15	48794533	48795281	748	374.0	
72103	chr15	48801058	48801504	446	223.0	
72104	chr15	48809984	48812070	2086	1043.0	
72105	chr15	48861798	48862968	1170	585.0	
72106	chr15	48877561	48878914	1353	676.0	
72107	chr15	48962906	48964619	1713	856.0	
72108	chr15	48966552	48967024	472	236.0	
72109	chr15	48975434	48976400	966	483.0	
72110	chr15	48992567	48992851	284	142.0	
72111	chr15	49036832	49037271	439	220.0	
72112	chr15	49045594	49047190	1596	798.0	
72113	chr15	49063318	49064273	955	478.0	
72114	chr15	49145995	49146426	431	216.0	
72115	chr15	49154773	49156617	1844	922.0	
72116	chr15	49169518	49170908	1390	695.0	
72117	chr15	49190603	49190978	375	188.0	
72118	chr15	49216367	49216705	338	169.0	
72119	chr15	49232611	49232750	139	70.0	
72120	chr15	49235353	49236035	682	341.0	
72121	chr15	49421881	49422354	473	236.0	
72122	chr15	49438992	49439390	398	199.0	
72123	chr15	49462423	49462790	367	184.0	
72124	chr15	49492964	49493116	152	76.0	
72125	chr15	49620088	49621978	1890	945.0	
72126	chr15	49706719	49707447	728	364.0	
72127	chr15	49709693	49709952	259	130.0	
72128	chr15	49713448	49713487	39	20.0	
72129	chr15	49715192	49715594	402	201.0	
72130	chr15	49718265	49718985	720	360.0	
72131	chr15	49989603	49989940	337	168.0	
72132	chr15	50003301	50004203	902	451.0	
72133	chr15	50050946	50052285	1339	670.0	
72134	chr15	50055281	50056223	942	471.0	
72135	chr15	50057262	50057645	383	192.0	
72136	chr15	50059818	50060297	479	240.0	
72137	chr15	50064200	50065050	850	425.0	
72138	chr15	50066073	50066710	637	318.0	
72139	chr15	50067286	50067657	371	186.0	
72140	chr15	50095918	50096388	470	235.0	
72141	chr15	50107485	50108299	814	407.0	
72142	chr15	50110410	50110466	56	28.0	
72143	chr15	50112836	50114856	2020	1010.0	
72144	chr15	50116444	50116845	401	200.0	
72145	chr15	50119181	50119529	348	174.0	
72146	chr15	50128232	50128749	517	258.0	
72147	chr15	50134346	50135386	1040	520.0	
72148	chr15	50144447	50144553	106	53.0	
72149	chr15	50145337	50145829	492	246.0	
72150	chr15	50163676	50164094	418	209.0	
72151	chr15	50166384	50166616	232	116.0	
72152	chr15	50181929	50183075	1146	573.0	
72153	chr15	50247510	50248707	1197	598.0	
72154	chr15	50257842	50258286	444	222.0	
72155	chr15	50260258	50261208	950	475.0	
72156	chr15	50262026	50263124	1098	549.0	
72157	chr15	50277382	50277722	340	170.0	
72158	chr15	50315998	50316450	452	226.0	
72159	chr15	50340337	50340873	536	268.0	
72160	chr15	50341584	50342036	452	226.0	
72161	chr15	50347761	50348134	373	186.0	
72162	chr15	50350085	50356087	6002	3001.0	
72163	chr15	50358795	50359258	463	232.0	
72164	chr15	50390470	50390983	513	256.0	
72165	chr15	50423684	50425175	1491	746.0	
72166	chr15	50444534	50445113	579	290.0	
72167	chr15	50448404	50448872	468	234.0	
72168	chr15	50484868	50485140	272	136.0	
72169	chr15	50573750	50574268	518	259.0	
72170	chr15	50675479	50676111	632	316.0	
72171	chr15	50677098	50677232	134	67.0	
72172	chr15	50678246	50678366	120	60.0	
72173	chr15	50685602	50687744	2142	1071.0	
72174	chr15	50751214	50751866	652	326.0	
72175	chr15	50762464	50762967	503	252.0	
72176	chr15	50764223	50766432	2209	1104.0	
72177	chr15	50767309	50767702	393	196.0	
72178	chr15	50774486	50774827	341	170.0	
72179	chr15	50873891	50874427	536	268.0	
72180	chr15	50876502	50877479	977	488.0	
72181	chr15	50879001	50879397	396	198.0	
72182	chr15	50883872	50884450	578	289.0	
72183	chr15	50885139	50886473	1334	667.0	
72184	chr15	50906767	50909602	2835	1418.0	
72185	chr15	50910534	50910935	401	200.0	
72186	chr15	50911527	50912060	533	266.0	
72187	chr15	51003975	51004655	680	340.0	
72188	chr15	51076150	51078017	1867	934.0	
72189	chr15	51094176	51094818	642	321.0	
72190	chr15	51097582	51097873	291	146.0	
72191	chr15	51121083	51121519	436	218.0	
72192	chr15	51127074	51127133	59	30.0	
72193	chr15	51162799	51163579	780	390.0	
72194	chr15	51185406	51186579	1173	586.0	
72195	chr15	51189602	51190220	618	309.0	
72196	chr15	51192408	51193148	740	370.0	
72197	chr15	51202989	51203214	225	112.0	
72198	chr15	51223964	51224075	111	56.0	
72199	chr15	51227971	51228849	878	439.0	
72200	chr15	51244649	51244869	220	110.0	
72201	chr15	51262437	51262822	385	192.0	
72202	chr15	51267344	51268104	760	380.0	
72203	chr15	51281365	51281781	416	208.0	
72204	chr15	51282982	51283443	461	230.0	
72205	chr15	51322480	51323340	860	430.0	
72206	chr15	51332102	51332577	475	238.0	
72207	chr15	51334112	51334470	358	179.0	
72208	chr15	51335343	51335838	495	248.0	
72209	chr15	51341760	51341992	232	116.0	
72210	chr15	51381125	51381654	529	264.0	
72211	chr15	51401789	51402246	457	228.0	
72212	chr15	51442575	51443579	1004	502.0	
72213	chr15	51558410	51558781	371	186.0	
72214	chr15	51576693	51578133	1440	720.0	
72215	chr15	51585799	51586540	741	370.0	
72216	chr15	51588935	51589389	454	227.0	
72217	chr15	51590146	51590582	436	218.0	
72218	chr15	51600321	51600421	100	50.0	
72219	chr15	51619152	51624030	4878	2439.0	
72220	chr15	51625277	51625589	312	156.0	
72221	chr15	51629270	51630237	967	484.0	
72222	chr15	51634531	51635002	471	236.0	
72223	chr15	51647173	51647702	529	264.0	
72224	chr15	51649807	51650356	549	274.0	
72225	chr15	51658942	51659013	71	36.0	
72226	chr15	51672092	51672582	490	245.0	
72227	chr15	51681210	51681813	603	302.0	
72228	chr15	51692091	51692492	401	200.0	
72229	chr15	51726506	51726675	169	84.0	
72230	chr15	51727549	51727862	313	156.0	
72231	chr15	51731106	51733044	1938	969.0	
72232	chr15	51735141	51738570	3429	1714.0	
72233	chr15	51740053	51740072	19	10.0	
72234	chr15	51750930	51753364	2434	1217.0	
72235	chr15	51755737	51756956	1219	610.0	
72236	chr15	51759789	51760054	265	132.0	
72237	chr15	51767971	51768450	479	240.0	
72238	chr15	51776106	51777417	1311	656.0	
72239	chr15	51828985	51830866	1881	940.0	
72240	chr15	51837674	51838286	612	306.0	
72241	chr15	51841374	51842038	664	332.0	
72242	chr15	51843181	51843784	603	302.0	
72243	chr15	51846303	51847199	896	448.0	
72244	chr15	51861651	51862392	741	370.0	
72245	chr15	51888587	51888939	352	176.0	
72246	chr15	51905871	51906245	374	187.0	
72247	chr15	51935764	51935795	31	16.0	
72248	chr15	51969990	51970349	359	180.0	
72249	chr15	51970877	51972470	1593	796.0	
72250	chr15	51981556	51982715	1159	580.0	
72251	chr15	52006440	52007063	623	312.0	
72252	chr15	52008205	52009318	1113	556.0	
72253	chr15	52012978	52013928	950	475.0	
72254	chr15	52014561	52014951	390	195.0	
72255	chr15	52018471	52021721	3250	1625.0	
72256	chr15	52040162	52040459	297	148.0	
72257	chr15	52045454	52046492	1038	519.0	
72258	chr15	52052321	52052801	480	240.0	
72259	chr15	52058274	52058327	53	26.0	
72260	chr15	52078796	52079314	518	259.0	
72261	chr15	52082467	52083112	645	322.0	
72262	chr15	52100365	52101294	929	464.0	
72263	chr15	52101955	52102389	434	217.0	
72264	chr15	52112047	52112800	753	376.0	
72265	chr15	52135516	52136060	544	272.0	
72266	chr15	52137629	52138207	578	289.0	
72267	chr15	52139540	52140293	753	376.0	
72268	chr15	52163548	52163907	359	180.0	
72269	chr15	52164720	52165030	310	155.0	
72270	chr15	52171462	52171518	56	28.0	
72271	chr15	52178587	52181196	2609	1304.0	
72272	chr15	52182165	52182505	340	170.0	
72273	chr15	52183521	52183979	458	229.0	
72274	chr15	52208218	52208770	552	276.0	
72275	chr15	52220882	52222418	1536	768.0	
72276	chr15	52227145	52227880	735	368.0	
72277	chr15	52228916	52229461	545	272.0	
72278	chr15	52232257	52232736	479	240.0	
72279	chr15	52233288	52233864	576	288.0	
72280	chr15	52234539	52235610	1071	536.0	
72281	chr15	52241549	52241838	289	144.0	
72282	chr15	52243963	52244238	275	138.0	
72283	chr15	52246961	52247520	559	280.0	
72284	chr15	52252967	52253052	85	42.0	
72285	chr15	52254403	52254709	306	153.0	
72286	chr15	52256075	52256874	799	400.0	
72287	chr15	52261415	52262327	912	456.0	
72288	chr15	52295341	52295810	469	234.0	
72289	chr15	52331333	52332087	754	377.0	
72290	chr15	52351419	52352094	675	338.0	
72291	chr15	52370059	52370530	471	236.0	
72292	chr15	52437920	52438541	621	310.0	
72293	chr15	52440793	52441459	666	333.0	
72294	chr15	52445589	52445764	175	88.0	
72295	chr15	52463637	52465007	1370	685.0	
72296	chr15	52465871	52466874	1003	502.0	
72297	chr15	52481588	52482599	1011	506.0	
72298	chr15	52487652	52487901	249	124.0	
72299	chr15	52496247	52497183	936	468.0	
72300	chr15	52503743	52504397	654	327.0	
72301	chr15	52505225	52505654	429	214.0	
72302	chr15	52512938	52513197	259	130.0	
72303	chr15	52518708	52519502	794	397.0	
72304	chr15	52527777	52530118	2341	1170.0	
72305	chr15	52546061	52546439	378	189.0	
72306	chr15	52551721	52552672	951	476.0	
72307	chr15	52558173	52558624	451	226.0	
72308	chr15	52565191	52565926	735	368.0	
72309	chr15	52567833	52569855	2022	1011.0	
72310	chr15	52651747	52652408	661	330.0	
72311	chr15	52658885	52659334	449	224.0	
72312	chr15	52677505	52680093	2588	1294.0	
72313	chr15	52682690	52684118	1428	714.0	
72314	chr15	52709726	52710340	614	307.0	
72315	chr15	52730062	52730725	663	332.0	
72316	chr15	52735241	52735939	698	349.0	
72317	chr15	52779992	52781245	1253	626.0	
72318	chr15	52783422	52784351	929	464.0	
72319	chr15	52789787	52791336	1549	774.0	
72320	chr15	52803802	52803978	176	88.0	
72321	chr15	52804675	52804866	191	96.0	
72322	chr15	52805390	52806224	834	417.0	
72323	chr15	54519549	54519914	365	182.0	
72324	chr15	54803066	54803836	770	385.0	
72325	chr15	54884291	54884919	628	314.0	
72326	chr15	55077138	55077400	262	131.0	
72327	chr15	55108891	55109256	365	182.0	
72328	chr15	55168320	55168776	456	228.0	
72329	chr15	55194222	55195140	918	459.0	
72330	chr15	55195937	55197807	1870	935.0	
72331	chr15	55217357	55218397	1040	520.0	
72332	chr15	55220867	55223252	2385	1192.0	
72333	chr15	55224745	55225391	646	323.0	
72334	chr15	55230264	55230599	335	168.0	
72335	chr15	55240102	55240520	418	209.0	
72336	chr15	55245112	55245271	159	80.0	
72337	chr15	55247308	55248313	1005	502.0	
72338	chr15	55250235	55251389	1154	577.0	
72339	chr15	55253469	55253938	469	234.0	
72340	chr15	55254897	55256493	1596	798.0	
72341	chr15	55257281	55258530	1249	624.0	
72342	chr15	55266870	55268660	1790	895.0	
72343	chr15	55276590	55278225	1635	818.0	
72344	chr15	55279451	55280908	1457	728.0	
72345	chr15	55281525	55283673	2148	1074.0	
72346	chr15	55284536	55284898	362	181.0	
72347	chr15	55285671	55287319	1648	824.0	
72348	chr15	55288289	55291109	2820	1410.0	
72349	chr15	55318315	55320460	2145	1072.0	
72350	chr15	55322458	55324096	1638	819.0	
72351	chr15	55327380	55327844	464	232.0	
72352	chr15	55335049	55335350	301	150.0	
72353	chr15	55394643	55395113	470	235.0	
72354	chr15	55402729	55404026	1297	648.0	
72355	chr15	55405997	55406359	362	181.0	
72356	chr15	55407400	55409107	1707	854.0	
72357	chr15	55420478	55420879	401	200.0	
72358	chr15	55429837	55429986	149	74.0	
72359	chr15	55435161	55435647	486	243.0	
72360	chr15	55439640	55440120	480	240.0	
72361	chr15	55494897	55495395	498	249.0	
72362	chr15	55497928	55498847	919	460.0	
72363	chr15	55526441	55526926	485	242.0	
72364	chr15	55535504	55535798	294	147.0	
72365	chr15	55587711	55588710	999	500.0	
72366	chr15	55648350	55648751	401	200.0	
72367	chr15	55685226	55685758	532	266.0	
72368	chr15	55742350	55742903	553	276.0	
72369	chr15	55774392	55774714	322	161.0	
72370	chr15	55846088	55846530	442	221.0	"region	enhancer"
72371	chr15	55942260	55942822	562	281.0	
72372	chr15	55992897	55994371	1474	737.0	
72373	chr15	56037928	56038369	441	220.0	
72374	chr15	56042861	56044149	1288	644.0	
72375	chr15	56052713	56053171	458	229.0	
72376	chr15	56174573	56175048	475	238.0	
72377	chr15	56207061	56207446	385	192.0	
72378	chr15	56241695	56242066	371	186.0	
72379	chr15	56242703	56246816	4113	2056.0	
72380	chr15	56364959	56365836	877	438.0	
72381	chr15	56464674	56465641	967	484.0	
72382	chr15	56468265	56468945	680	340.0	
72383	chr15	56491114	56491509	395	198.0	
72384	chr15	56496569	56496960	391	196.0	
72385	chr15	56537766	56538329	563	282.0	
72386	chr15	56608193	56608452	259	130.0	
72387	chr15	56732132	56734019	1887	944.0	
72388	chr15	56740548	56740550	2	1.0	
72389	chr15	56757948	56758249	301	150.0	
72390	chr15	56759523	56759962	439	220.0	
72391	chr15	56820325	56820731	406	203.0	
72392	chr15	56821668	56822126	458	229.0	
72393	chr15	56877315	56878156	841	420.0	
72394	chr15	56885508	56888179	2671	1336.0	
72395	chr15	56917491	56920585	3094	1547.0	
72396	chr15	56984999	56985635	636	318.0	
72397	chr15	56992654	56993374	720	360.0	
72398	chr15	57100006	57100657	651	326.0	
72399	chr15	57122403	57122487	84	42.0	
72400	chr15	57146442	57146801	359	180.0	
72401	chr15	57153256	57153562	306	153.0	
72402	chr15	57213854	57214241	387	194.0	
72403	chr15	57219437	57219497	60	30.0	
72404	chr15	57281485	57281530	45	22.0	
72405	chr15	57284261	57285002	741	370.0	
72406	chr15	57299735	57300447	712	356.0	
72407	chr15	57306290	57307219	929	464.0	
72408	chr15	57320695	57321143	448	224.0	
72409	chr15	57324234	57324635	401	200.0	
72410	chr15	57340685	57341078	393	196.0	
72411	chr15	57364692	57364923	231	116.0	
72412	chr15	57527413	57527877	464	232.0	
72413	chr15	57559770	57560253	483	242.0	
72414	chr15	57560905	57562494	1589	794.0	
72415	chr15	57563321	57563804	483	242.0	
72416	chr15	57565232	57565832	600	300.0	
72417	chr15	57586933	57587528	595	298.0	
72418	chr15	57591440	57592263	823	412.0	
72419	chr15	57607675	57607981	306	153.0	
72420	chr15	57703433	57703849	416	208.0	
72421	chr15	57705954	57707721	1767	884.0	
72422	chr15	57732497	57732917	420	210.0	
72423	chr15	57747173	57747507	334	167.0	
72424	chr15	57861102	57861205	103	52.0	
72425	chr15	57866164	57866511	347	174.0	
72426	chr15	57868218	57868505	287	144.0	
72427	chr15	58043224	58043590	366	183.0	
72428	chr15	58065143	58066747	1604	802.0	
72429	chr15	58070833	58071201	368	184.0	
72430	chr15	58115711	58115992	281	140.0	
72431	chr15	58137922	58138602	680	340.0	
72432	chr15	58139654	58140547	893	446.0	
72433	chr15	58146360	58147732	1372	686.0	
72434	chr15	58182538	58182919	381	190.0	
72435	chr15	58209007	58209736	729	364.0	
72436	chr15	58221590	58222023	433	216.0	
72437	chr15	58227671	58228127	456	228.0	
72438	chr15	58232299	58232695	396	198.0	
72439	chr15	58243355	58243514	159	80.0	
72440	chr15	58247574	58248962	1388	694.0	
72441	chr15	58249900	58250296	396	198.0	
72442	chr15	58269907	58270429	522	261.0	
72443	chr15	58313363	58313741	378	189.0	
72444	chr15	58314449	58314911	462	231.0	
72445	chr15	58329774	58330244	470	235.0	
72446	chr15	58330772	58333247	2475	1238.0	
72447	chr15	58357917	58358613	696	348.0	
72448	chr15	58361403	58361880	477	238.0	
72449	chr15	58363203	58363315	112	56.0	
72450	chr15	58369357	58369885	528	264.0	
72451	chr15	58381688	58382087	399	200.0	
72452	chr15	58410116	58410803	687	344.0	
72453	chr15	58438899	58439308	409	204.0	
72454	chr15	58457491	58458460	969	484.0	
72455	chr15	58459082	58460046	964	482.0	
72456	chr15	58472904	58474220	1316	658.0	
72457	chr15	58475026	58475286	260	130.0	
72458	chr15	58484477	58485659	1182	591.0	
72459	chr15	58489512	58489735	223	112.0	
72460	chr15	58506601	58507205	604	302.0	
72461	chr15	58515704	58516239	535	268.0	
72462	chr15	58517283	58518999	1716	858.0	
72463	chr15	58520502	58522127	1625	812.0	
72464	chr15	58524142	58524732	590	295.0	
72465	chr15	58526134	58527183	1049	524.0	
72466	chr15	58545238	58545755	517	258.0	
72467	chr15	58568139	58568592	453	226.0	
72468	chr15	58582201	58582526	325	162.0	
72469	chr15	58598370	58598499	129	64.0	
72470	chr15	58608004	58608717	713	356.0	
72471	chr15	58614617	58615451	834	417.0	
72472	chr15	58627085	58629120	2035	1018.0	
72473	chr15	58650152	58650553	401	200.0	
72474	chr15	58690733	58690995	262	131.0	
72475	chr15	58703637	58703949	312	156.0	
72476	chr15	58724387	58724985	598	299.0	
72477	chr15	58726732	58727357	625	312.0	
72478	chr15	58731669	58732137	468	234.0	
72479	chr15	58737894	58738536	642	321.0	
72480	chr15	58746196	58746413	217	108.0	
72481	chr15	58748062	58750672	2610	1305.0	
72482	chr15	58760938	58761312	374	187.0	
72483	chr15	58768758	58768863	105	52.0	
72484	chr15	58770243	58772464	2221	1110.0	
72485	chr15	58864851	58865469	618	309.0	
72486	chr15	58866138	58866671	533	266.0	
72487	chr15	58931982	58934637	2655	1328.0	
72488	chr15	58957127	58957977	850	425.0	
72489	chr15	58975471	58976025	554	277.0	
72490	chr15	58979199	58982463	3264	1632.0	
72491	chr15	58986989	58988767	1778	889.0	
72492	chr15	58999753	58999974	221	110.0	
72493	chr15	59001999	59003123	1124	562.0	
72494	chr15	59104446	59105871	1425	712.0	
72495	chr15	59138099	59138606	507	254.0	
72496	chr15	59169317	59169803	486	243.0	
72497	chr15	59174797	59175280	483	242.0	
72498	chr15	59176879	59177901	1022	511.0	
72499	chr15	59185582	59186322	740	370.0	
72500	chr15	59237222	59237469	247	124.0	
72501	chr15	59247348	59247794	446	223.0	
72502	chr15	59251276	59251643	367	184.0	
72503	chr15	59296026	59296432	406	203.0	
72504	chr15	59298116	59298789	673	336.0	
72505	chr15	59299866	59301096	1230	615.0	
72506	chr15	59305445	59305789	344	172.0	
72507	chr15	59312198	59312592	394	197.0	
72508	chr15	59327819	59328342	523	262.0	
72509	chr15	59350035	59350492	457	228.0	
72510	chr15	59353996	59354213	217	108.0	
72511	chr15	59364233	59364667	434	217.0	
72512	chr15	59367226	59367517	291	146.0	
72513	chr15	59369557	59369664	107	54.0	
72514	chr15	59371654	59373261	1607	804.0	
72515	chr15	59384510	59384942	432	216.0	
72516	chr15	59388627	59389042	415	208.0	
72517	chr15	59393180	59393282	102	51.0	
72518	chr15	59398435	59400179	1744	872.0	
72519	chr15	59401433	59401834	401	200.0	
72520	chr15	59406454	59406842	388	194.0	
72521	chr15	59410115	59410786	671	336.0	
72522	chr15	59411443	59411717	274	137.0	
72523	chr15	59412544	59413976	1432	716.0	
72524	chr15	59419246	59419543	297	148.0	
72525	chr15	59429934	59430518	584	292.0	
72526	chr15	59437378	59438684	1306	653.0	
72527	chr15	59482596	59483121	525	262.0	
72528	chr15	59492787	59493515	728	364.0	
72529	chr15	59501523	59501894	371	186.0	
72530	chr15	59516604	59517255	651	326.0	
72531	chr15	59521422	59521830	408	204.0	
72532	chr15	59522812	59523533	721	360.0	
72533	chr15	59524095	59524816	721	360.0	
72534	chr15	59528800	59529365	565	282.0	
72535	chr15	59531241	59531743	502	251.0	
72536	chr15	59532664	59533198	534	267.0	
72537	chr15	59543808	59544299	491	246.0	
72538	chr15	59550484	59550815	331	166.0	
72539	chr15	59614951	59615415	464	232.0	
72540	chr15	59622344	59622564	220	110.0	
72541	chr15	59656749	59658233	1484	742.0	
72542	chr15	59685719	59686958	1239	620.0	
72543	chr15	59687521	59690390	2869	1434.0	
72544	chr15	59690944	59691641	697	348.0	
72545	chr15	59724890	59725327	437	218.0	
72546	chr15	59751709	59752356	647	324.0	
72547	chr15	59791847	59792720	873	436.0	
72548	chr15	59798591	59798934	343	172.0	
72549	chr15	59803319	59804369	1050	525.0	
72550	chr15	59814392	59814793	401	200.0	
72551	chr15	59917482	59917941	459	230.0	
72552	chr15	59976309	59977044	735	368.0	
72553	chr15	59996829	59997631	802	401.0	
72554	chr15	60003727	60006972	3245	1622.0	
72555	chr15	60127102	60128371	1269	634.0	
72556	chr15	60179806	60180198	392	196.0	
72557	chr15	60255386	60255758	372	186.0	
72558	chr15	60326825	60327230	405	202.0	
72559	chr15	60329044	60329175	131	66.0	
72560	chr15	60359621	60360089	468	234.0	
72561	chr15	60389070	60390074	1004	502.0	
72562	chr15	60391009	60391690	681	340.0	
72563	chr15	60392550	60394980	2430	1215.0	
72564	chr15	60395656	60395925	269	134.0	
72565	chr15	60396577	60399783	3206	1603.0	
72566	chr15	60407453	60409117	1664	832.0	
72567	chr15	60458687	60459134	447	224.0	
72568	chr15	60469863	60470320	457	228.0	
72569	chr15	60477796	60480512	2716	1358.0	
72570	chr15	60485431	60485719	288	144.0	
72571	chr15	60507520	60508746	1226	613.0	
72572	chr15	60511489	60511966	477	238.0	
72573	chr15	60520348	60521392	1044	522.0	
72574	chr15	60526197	60526804	607	304.0	
72575	chr15	60528284	60529034	750	375.0	
72576	chr15	60539055	60541105	2050	1025.0	
72577	chr15	60541690	60544227	2537	1268.0	
72578	chr15	60546680	60548695	2015	1008.0	
72579	chr15	60549537	60550369	832	416.0	
72580	chr15	60551094	60552959	1865	932.0	
72581	chr15	60554844	60555383	539	270.0	
72582	chr15	60556825	60557680	855	428.0	
72583	chr15	60562283	60562519	236	118.0	
72584	chr15	60563271	60564352	1081	540.0	
72585	chr15	60568035	60571580	3545	1772.0	
72586	chr15	60572825	60576253	3428	1714.0	
72587	chr15	60580077	60587021	6944	3472.0	
72588	chr15	60588886	60593459	4573	2286.0	
72589	chr15	60634924	60636200	1276	638.0	
72590	chr15	60649416	60650646	1230	615.0	
72591	chr15	60660540	60660902	362	181.0	
72592	chr15	60667225	60667786	561	280.0	
72593	chr15	60695674	60696130	456	228.0	
72594	chr15	60697863	60698060	197	98.0	
72595	chr15	60704023	60705053	1030	515.0	
72596	chr15	60720421	60721421	1000	500.0	
72597	chr15	60740647	60741085	438	219.0	
72598	chr15	60787733	60788529	796	398.0	
72599	chr15	60795504	60796304	800	400.0	
72600	chr15	60799866	60800667	801	400.0	
72601	chr15	60809358	60809786	428	214.0	
72602	chr15	60839898	60841734	1836	918.0	
72603	chr15	60843971	60845492	1521	760.0	
72604	chr15	60860204	60860690	486	243.0	
72605	chr15	60863485	60863790	305	152.0	
72606	chr15	60899199	60899783	584	292.0	
72607	chr15	60905589	60905960	371	186.0	
72608	chr15	60916091	60917367	1276	638.0	
72609	chr15	60932447	60932996	549	274.0	
72610	chr15	61833846	61834537	691	346.0	
72611	chr15	61835400	61835913	513	256.0	
72612	chr15	61841509	61841775	266	133.0	
72613	chr15	61856297	61858178	1881	940.0	
72614	chr15	61871921	61872261	340	170.0	
72615	chr15	62046050	62046466	416	208.0	
72616	chr15	62047263	62047723	460	230.0	
72617	chr15	62052722	62053033	311	156.0	
72618	chr15	62059134	62061643	2509	1254.0	
72619	chr15	62066508	62069166	2658	1329.0	
72620	chr15	62071646	62072134	488	244.0	
72621	chr15	62119177	62119853	676	338.0	
72622	chr15	62122138	62122737	599	300.0	
72623	chr15	62124194	62124445	251	126.0	
72624	chr15	62125043	62125124	81	40.0	
72625	chr15	62164512	62165217	705	352.0	
72626	chr15	62224153	62224303	150	75.0	
72627	chr15	62344834	62345351	517	258.0	
72628	chr15	62389966	62392777	2811	1406.0	
72629	chr15	62649892	62650108	216	108.0	
72630	chr15	62653096	62653559	463	232.0	
72631	chr15	62657601	62657860	259	130.0	
72632	chr15	62658393	62659006	613	306.0	
72633	chr15	62742420	62742759	339	170.0	
72634	chr15	62779276	62779416	140	70.0	
72635	chr15	62782001	62782352	351	176.0	
72636	chr15	62847917	62848271	354	177.0	
72637	chr15	62857468	62857863	395	198.0	
72638	chr15	62931645	62931986	341	170.0	
72639	chr15	63029916	63030737	821	410.0	
72640	chr15	63042223	63044044	1821	910.0	
72641	chr15	63047502	63049513	2011	1006.0	
72642	chr15	63093489	63094022	533	266.0	enhancer
72643	chr15	63103697	63103737	40	20.0	
72644	chr15	63104761	63105810	1049	524.0	
72645	chr15	63121220	63122998	1778	889.0	
72646	chr15	63134627	63134645	18	9.0	
72647	chr15	63135461	63136366	905	452.0	
72648	chr15	63156417	63158495	2078	1039.0	
72649	chr15	63166208	63166663	455	228.0	
72650	chr15	63184352	63184439	87	44.0	
72651	chr15	63188526	63196574	8048	4024.0	
72652	chr15	63203593	63204255	662	331.0	
72653	chr15	63210050	63211224	1174	587.0	
72654	chr15	63211861	63214641	2780	1390.0	
72655	chr15	63221353	63221737	384	192.0	
72656	chr15	63226384	63227214	830	415.0	
72657	chr15	63231722	63232841	1119	560.0	
72658	chr15	63233755	63234866	1111	556.0	
72659	chr15	63238876	63239256	380	190.0	
72660	chr15	63244989	63245636	647	324.0	
72661	chr15	63246517	63247804	1287	644.0	
72662	chr15	63274191	63274855	664	332.0	
72663	chr15	63276683	63278627	1944	972.0	
72664	chr15	63283058	63283582	524	262.0	
72665	chr15	63288724	63289192	468	234.0	
72666	chr15	63294502	63294629	127	64.0	
72667	chr15	63362906	63363308	402	201.0	
72668	chr15	63381541	63382227	686	343.0	
72669	chr15	63402794	63403255	461	230.0	
72670	chr15	63436693	63437383	690	345.0	
72671	chr15	63440931	63440939	8	4.0	
72672	chr15	63446057	63446731	674	337.0	
72673	chr15	63448212	63449309	1097	548.0	
72674	chr15	63456194	63456751	557	278.0	
72675	chr15	63466468	63467327	859	430.0	
72676	chr15	63473301	63475325	2024	1012.0	
72677	chr15	63479293	63481574	2281	1140.0	
72678	chr15	63483368	63484186	818	409.0	
72679	chr15	63486587	63488376	1789	894.0	
72680	chr15	63489978	63491920	1942	971.0	
72681	chr15	63494526	63499464	4938	2469.0	
72682	chr15	63500235	63507188	6953	3476.0	
72683	chr15	63508030	63508623	593	296.0	
72684	chr15	63509860	63510868	1008	504.0	
72685	chr15	63512141	63512179	38	19.0	
72686	chr15	63514389	63515098	709	354.0	
72687	chr15	63517172	63518030	858	429.0	
72688	chr15	63528138	63528141	3	2.0	
72689	chr15	63530930	63532014	1084	542.0	
72690	chr15	63544179	63544858	679	340.0	
72691	chr15	63593711	63596535	2824	1412.0	
72692	chr15	63597363	63597648	285	142.0	
72693	chr15	63598782	63603009	4227	2114.0	
72694	chr15	63603557	63603843	286	143.0	
72695	chr15	63605617	63606650	1033	516.0	
72696	chr15	63610021	63611172	1151	576.0	
72697	chr15	63668230	63669455	1225	612.0	
72698	chr15	63672897	63673112	215	108.0	
72699	chr15	63699418	63699567	149	74.0	
72700	chr15	63707920	63708599	679	340.0	
72701	chr15	63752028	63752566	538	269.0	
72702	chr15	63763473	63763831	358	179.0	
72703	chr15	63800251	63800573	322	161.0	
72704	chr15	63805920	63806720	800	400.0	
72705	chr15	63807357	63807438	81	40.0	
72706	chr15	63809432	63809882	450	225.0	
72707	chr15	63814304	63814767	463	232.0	
72708	chr15	63815671	63816093	422	211.0	
72709	chr15	63821687	63821713	26	13.0	
72710	chr15	63826500	63827553	1053	526.0	
72711	chr15	63830255	63830824	569	284.0	
72712	chr15	63832858	63834851	1993	996.0	
72713	chr15	63841747	63842630	883	442.0	
72714	chr15	63858816	63859159	343	172.0	
72715	chr15	63859931	63860946	1015	508.0	
72716	chr15	63870031	63870395	364	182.0	
72717	chr15	63881522	63881941	419	210.0	
72718	chr15	63887461	63888061	600	300.0	
72719	chr15	63890924	63891737	813	406.0	
72720	chr15	63892324	63893581	1257	628.0	
72721	chr15	63896393	63897261	868	434.0	
72722	chr15	63899193	63899704	511	256.0	
72723	chr15	63905718	63906585	867	434.0	
72724	chr15	63939553	63940030	477	238.0	
72725	chr15	63944998	63945877	879	440.0	
72726	chr15	63970651	63971727	1076	538.0	
72727	chr15	63986503	63987500	997	498.0	
72728	chr15	63990407	63991061	654	327.0	
72729	chr15	64001118	64001776	658	329.0	
72730	chr15	64009326	64011435	2109	1054.0	
72731	chr15	64026670	64026796	126	63.0	
72732	chr15	64044283	64045236	953	476.0	
72733	chr15	64045808	64047185	1377	688.0	
72734	chr15	64048538	64049504	966	483.0	
72735	chr15	64067274	64068146	872	436.0	
72736	chr15	64069402	64069905	503	252.0	
72737	chr15	64071463	64071663	200	100.0	
72738	chr15	64089268	64090984	1716	858.0	
72739	chr15	64091999	64094701	2702	1351.0	
72740	chr15	64095277	64097318	2041	1020.0	
72741	chr15	64100877	64101460	583	292.0	
72742	chr15	64105260	64105747	487	244.0	
72743	chr15	64110923	64111676	753	376.0	
72744	chr15	64112828	64113442	614	307.0	
72745	chr15	64137203	64137681	478	239.0	
72746	chr15	64144676	64145269	593	296.0	
72747	chr15	64149703	64150570	867	434.0	
72748	chr15	64151188	64154539	3351	1676.0	
72749	chr15	64156456	64156619	163	82.0	
72750	chr15	64162304	64164432	2128	1064.0	
72751	chr15	64180078	64180712	634	317.0	
72752	chr15	64209793	64209898	105	52.0	
72753	chr15	64246838	64247024	186	93.0	
72754	chr15	64247901	64248365	464	232.0	
72755	chr15	64274618	64274676	58	29.0	
72756	chr15	64283998	64284556	558	279.0	
72757	chr15	64334581	64334982	401	200.0	
72758	chr15	64355194	64356929	1735	868.0	
72759	chr15	64367847	64368237	390	195.0	
72760	chr15	64380748	64382119	1371	686.0	
72761	chr15	64387253	64388415	1162	581.0	
72762	chr15	64427033	64427328	295	148.0	
72763	chr15	64430001	64430898	897	448.0	
72764	chr15	64447986	64448289	303	152.0	
72765	chr15	64455757	64457112	1355	678.0	
72766	chr15	64459633	64462248	2615	1308.0	
72767	chr15	64502356	64504054	1698	849.0	
72768	chr15	64507216	64507880	664	332.0	
72769	chr15	64514349	64514833	484	242.0	
72770	chr15	64571825	64572331	506	253.0	
72771	chr15	64596642	64597810	1168	584.0	
72772	chr15	64620080	64620451	371	186.0	
72773	chr15	64622237	64623752	1515	758.0	
72774	chr15	64624336	64624662	326	163.0	
72775	chr15	64633994	64635782	1788	894.0	
72776	chr15	64639324	64641080	1756	878.0	
72777	chr15	64651389	64652099	710	355.0	
72778	chr15	64653784	64654170	386	193.0	
72779	chr15	64681427	64681829	402	201.0	
72780	chr15	64686089	64686697	608	304.0	
72781	chr15	64691822	64693726	1904	952.0	
72782	chr15	64694992	64695997	1005	502.0	
72783	chr15	64701517	64704065	2548	1274.0	
72784	chr15	64717943	64718596	653	326.0	
72785	chr15	64727933	64728808	875	438.0	
72786	chr15	64731025	64731838	813	406.0	
72787	chr15	64754934	64755283	349	174.0	
72788	chr15	64767205	64767560	355	178.0	
72789	chr15	64774979	64776306	1327	664.0	
72790	chr15	64802032	64802442	410	205.0	
72791	chr15	64809807	64810360	553	276.0	
72792	chr15	64814981	64815295	314	157.0	
72793	chr15	64823356	64826425	3069	1534.0	
72794	chr15	64835343	64836495	1152	576.0	
72795	chr15	64837332	64838135	803	402.0	
72796	chr15	64839820	64839941	121	60.0	
72797	chr15	64840674	64848272	7598	3799.0	
72798	chr15	64851034	64852038	1004	502.0	
72799	chr15	64855245	64858656	3411	1706.0	
72800	chr15	64861525	64861563	38	19.0	
72801	chr15	64862083	64862665	582	291.0	
72802	chr15	64864135	64868024	3889	1944.0	
72803	chr15	64870175	64871342	1167	584.0	
72804	chr15	64872632	64873795	1163	582.0	
72805	chr15	64875573	64875803	230	115.0	
72806	chr15	64877179	64878082	903	452.0	
72807	chr15	64881882	64884698	2816	1408.0	
72808	chr15	64891265	64898009	6744	3372.0	
72809	chr15	64901775	64902431	656	328.0	
72810	chr15	64905213	64906115	902	451.0	
72811	chr15	64911405	64912154	749	374.0	
72812	chr15	64984269	64986002	1733	866.0	
72813	chr15	64988750	64990644	1894	947.0	
72814	chr15	65009068	65009160	92	46.0	
72815	chr15	65028250	65029946	1696	848.0	
72816	chr15	65032886	65034135	1249	624.0	
72817	chr15	65049097	65050190	1093	546.0	
72818	chr15	65054184	65054726	542	271.0	
72819	chr15	65077829	65078458	629	314.0	
72820	chr15	65101215	65101931	716	358.0	
72821	chr15	65132622	65134484	1862	931.0	
72822	chr15	65184048	65186259	2211	1106.0	
72823	chr15	65189112	65189340	228	114.0	
72824	chr15	65212051	65212454	403	202.0	
72825	chr15	65270908	65271339	431	216.0	
72826	chr15	65275087	65275488	401	200.0	
72827	chr15	65285865	65287939	2074	1037.0	
72828	chr15	65295389	65298743	3354	1677.0	
72829	chr15	65299891	65301178	1287	644.0	
72830	chr15	65303616	65306303	2687	1344.0	
72831	chr15	65318714	65319491	777	388.0	
72832	chr15	65376871	65377894	1023	512.0	
72833	chr15	65384565	65386076	1511	756.0	
72834	chr15	65400747	65401668	921	460.0	
72835	chr15	65422322	65422604	282	141.0	
72836	chr15	65512591	65513544	953	476.0	
72837	chr15	65516677	65518275	1598	799.0	
72838	chr15	65529825	65531277	1452	726.0	
72839	chr15	65583697	65584141	444	222.0	
72840	chr15	65610182	65612385	2203	1102.0	
72841	chr15	65630828	65631882	1054	527.0	
72842	chr15	65638316	65639262	946	473.0	
72843	chr15	65705613	65706233	620	310.0	
72844	chr15	65761195	65761996	801	400.0	
72845	chr15	65763143	65763718	575	288.0	
72846	chr15	65765345	65765818	473	236.0	
72847	chr15	65766479	65767108	629	314.0	
72848	chr15	65767861	65768906	1045	522.0	
72849	chr15	65772736	65774222	1486	743.0	
72850	chr15	65775364	65776081	717	358.0	
72851	chr15	65776775	65779888	3113	1556.0	
72852	chr15	65781709	65782491	782	391.0	
72853	chr15	65784101	65784175	74	37.0	
72854	chr15	65787300	65793723	6423	3212.0	
72855	chr15	65796851	65796930	79	40.0	
72856	chr15	65804434	65805547	1113	556.0	
72857	chr15	65807502	65808180	678	339.0	
72858	chr15	65818347	65820079	1732	866.0	
72859	chr15	65822931	65823237	306	153.0	
72860	chr15	65824098	65824562	464	232.0	
72861	chr15	65827116	65827533	417	208.0	
72862	chr15	65828324	65829629	1305	652.0	
72863	chr15	65832517	65833763	1246	623.0	
72864	chr15	65837580	65838320	740	370.0	
72865	chr15	65839490	65839622	132	66.0	
72866	chr15	65841263	65841766	503	252.0	
72867	chr15	65856603	65858190	1587	794.0	
72868	chr15	65862548	65863269	721	360.0	
72869	chr15	65868675	65871400	2725	1362.0	
72870	chr15	65881941	65882412	471	236.0	
72871	chr15	65884544	65884999	455	228.0	
72872	chr15	65887466	65888030	564	282.0	
72873	chr15	65902172	65902947	775	388.0	
72874	chr15	65917061	65917550	489	244.0	
72875	chr15	65981898	65982710	812	406.0	
72876	chr15	66115549	66116204	655	328.0	
72877	chr15	66191496	66191873	377	188.0	
72878	chr15	66251785	66254082	2297	1148.0	
72879	chr15	66287431	66287865	434	217.0	
72880	chr15	66292996	66294963	1967	984.0	
72881	chr15	66355717	66357419	1702	851.0	
72882	chr15	66362040	66362578	538	269.0	
72883	chr15	66369654	66370673	1019	510.0	
72884	chr15	66381442	66381449	7	4.0	
72885	chr15	66385869	66388345	2476	1238.0	
72886	chr15	66389297	66391299	2002	1001.0	
72887	chr15	66393687	66394016	329	164.0	
72888	chr15	66394579	66395311	732	366.0	
72889	chr15	66401539	66402070	531	266.0	
72890	chr15	66402838	66403236	398	199.0	
72891	chr15	66404211	66404957	746	373.0	
72892	chr15	66408276	66409475	1199	600.0	
72893	chr15	66411153	66411658	505	252.0	
72894	chr15	66429049	66429818	769	384.0	
72895	chr15	66433706	66434036	330	165.0	
72896	chr15	66454105	66454614	509	254.0	
72897	chr15	66465325	66465732	407	204.0	
72898	chr15	66471824	66472940	1116	558.0	
72899	chr15	66483118	66483648	530	265.0	
72900	chr15	66493996	66494880	884	442.0	
72901	chr15	66496894	66499434	2540	1270.0	
72902	chr15	66502868	66506092	3224	1612.0	
72903	chr15	66566857	66567430	573	286.0	
72904	chr15	66578324	66578633	309	154.0	
72905	chr15	66603545	66604002	457	228.0	
72906	chr15	66614826	66615553	727	364.0	
72907	chr15	66617274	66618076	802	401.0	
72908	chr15	66619099	66619549	450	225.0	
72909	chr15	66650486	66650835	349	174.0	
72910	chr15	66654711	66655284	573	286.0	
72911	chr15	66673535	66673946	411	206.0	
72912	chr15	66692926	66693258	332	166.0	
72913	chr15	66698315	66698778	463	232.0	
72914	chr15	66700409	66704534	4125	2062.0	
72915	chr15	66716356	66716413	57	28.0	
72916	chr15	66765709	66766139	430	215.0	
72917	chr15	66774356	66774707	351	176.0	
72918	chr15	66803096	66803495	399	200.0	
72919	chr15	66832503	66833727	1224	612.0	
72920	chr15	66835456	66835943	487	244.0	
72921	chr15	66840666	66841077	411	206.0	
72922	chr15	66842067	66843337	1270	635.0	
72923	chr15	66851038	66851761	723	362.0	
72924	chr15	66853381	66853701	320	160.0	
72925	chr15	66862751	66863359	608	304.0	
72926	chr15	66865787	66867163	1376	688.0	
72927	chr15	66901397	66901686	289	144.0	
72928	chr15	66903551	66904275	724	362.0	
72929	chr15	66908092	66908848	756	378.0	
72930	chr15	66911946	66912522	576	288.0	
72931	chr15	66921206	66921710	504	252.0	
72932	chr15	66923455	66923760	305	152.0	
72933	chr15	66941734	66942160	426	213.0	
72934	chr15	66946475	66947156	681	340.0	
72935	chr15	66951954	66952321	367	184.0	
72936	chr15	66963719	66964206	487	244.0	
72937	chr15	67006029	67006504	475	238.0	
72938	chr15	67017244	67017745	501	250.0	
72939	chr15	67019912	67020290	378	189.0	
72940	chr15	67023939	67024940	1001	500.0	
72941	chr15	67025776	67026929	1153	576.0	
72942	chr15	67027789	67028350	561	280.0	
72943	chr15	67032944	67034275	1331	666.0	
72944	chr15	67037155	67037381	226	113.0	
72945	chr15	67041600	67041995	395	198.0	
72946	chr15	67042517	67042866	349	174.0	
72947	chr15	67048595	67049256	661	330.0	
72948	chr15	67049765	67050395	630	315.0	
72949	chr15	67056078	67056856	778	389.0	
72950	chr15	67062061	67069559	7498	3749.0	
72951	chr15	67072522	67072782	260	130.0	
72952	chr15	67074186	67075156	970	485.0	
72953	chr15	67076298	67076943	645	322.0	
72954	chr15	67077700	67078197	497	248.0	
72955	chr15	67080638	67084365	3727	1864.0	
72956	chr15	67085033	67087348	2315	1158.0	
72957	chr15	67089221	67090051	830	415.0	
72958	chr15	67090552	67094146	3594	1797.0	
72959	chr15	67096026	67096287	261	130.0	
72960	chr15	67096900	67097220	320	160.0	
72961	chr15	67097810	67099338	1528	764.0	
72962	chr15	67100593	67104885	4292	2146.0	
72963	chr15	67105520	67105887	367	184.0	
72964	chr15	67106476	67111376	4900	2450.0	
72965	chr15	67114690	67116009	1319	660.0	
72966	chr15	67116543	67117778	1235	618.0	
72967	chr15	67120017	67122424	2407	1204.0	
72968	chr15	67127817	67128332	515	258.0	
72969	chr15	67133757	67135811	2054	1027.0	
72970	chr15	67136958	67137715	757	378.0	
72971	chr15	67140024	67140770	746	373.0	
72972	chr15	67144510	67145243	733	366.0	
72973	chr15	67146358	67147561	1203	602.0	
72974	chr15	67148156	67148946	790	395.0	
72975	chr15	67149637	67151036	1399	700.0	
72976	chr15	67161374	67162169	795	398.0	
72977	chr15	67174901	67177424	2523	1262.0	
72978	chr15	67177947	67177954	7	4.0	
72979	chr15	67181466	67181650	184	92.0	
72980	chr15	67185661	67186555	894	447.0	
72981	chr15	67197093	67197526	433	216.0	
72982	chr15	67198298	67198718	420	210.0	
72983	chr15	67222293	67222371	78	39.0	
72984	chr15	67240245	67241722	1477	738.0	
72985	chr15	67253527	67255435	1908	954.0	
72986	chr15	67303759	67304123	364	182.0	
72987	chr15	67396243	67396483	240	120.0	
72988	chr15	67433488	67433889	401	200.0	
72989	chr15	67456696	67457370	674	337.0	
72990	chr15	67505927	67506413	486	243.0	
72991	chr15	67520038	67522658	2620	1310.0	
72992	chr15	67539288	67539987	699	350.0	
72993	chr15	67541271	67543988	2717	1358.0	
72994	chr15	67545099	67545133	34	17.0	
72995	chr15	67720544	67720854	310	155.0	
72996	chr15	67744790	67745149	359	180.0	
72997	chr15	67745986	67746501	515	258.0	
72998	chr15	67753968	67754057	89	44.0	
72999	chr15	67758599	67759053	454	227.0	
73000	chr15	67762863	67763215	352	176.0	
73001	chr15	67766927	67767363	436	218.0	
73002	chr15	67779761	67780151	390	195.0	
73003	chr15	67783193	67783807	614	307.0	
73004	chr15	67784312	67784940	628	314.0	
73005	chr15	67820822	67821344	522	261.0	
73006	chr15	67823076	67823811	735	368.0	
73007	chr15	67825092	67826077	985	492.0	
73008	chr15	67826683	67827535	852	426.0	
73009	chr15	67828249	67828908	659	330.0	
73010	chr15	67830477	67830490	13	6.0	
73011	chr15	67831977	67836902	4925	2462.0	
73012	chr15	67838753	67841734	2981	1490.0	
73013	chr15	67850883	67851781	898	449.0	
73014	chr15	67863125	67864061	936	468.0	
73015	chr15	67879339	67879908	569	284.0	
73016	chr15	67880557	67881169	612	306.0	
73017	chr15	67882310	67882842	532	266.0	
73018	chr15	67884394	67885227	833	416.0	
73019	chr15	67968094	67968566	472	236.0	
73020	chr15	68009018	68009744	726	363.0	
73021	chr15	68031314	68031803	489	244.0	
73022	chr15	68032656	68033039	383	192.0	
73023	chr15	68041848	68042249	401	200.0	
73024	chr15	68053584	68055879	2295	1148.0	
73025	chr15	68114377	68114737	360	180.0	
73026	chr15	68175677	68175857	180	90.0	
73027	chr15	68184806	68185510	704	352.0	
73028	chr15	68192860	68193261	401	200.0	
73029	chr15	68194973	68195464	491	246.0	
73030	chr15	68198437	68198551	114	57.0	
73031	chr15	68205063	68206630	1567	784.0	
73032	chr15	68207537	68207802	265	132.0	
73033	chr15	68208357	68208920	563	282.0	
73034	chr15	68209427	68211244	1817	908.0	
73035	chr15	68214799	68215266	467	234.0	
73036	chr15	68228345	68230754	2409	1204.0	
73037	chr15	68232452	68233645	1193	596.0	
73038	chr15	68248992	68249510	518	259.0	
73039	chr15	68252848	68253356	508	254.0	
73040	chr15	68256682	68257573	891	446.0	
73041	chr15	68276735	68279459	2724	1362.0	
73042	chr15	68282041	68282229	188	94.0	
73043	chr15	68285440	68285571	131	66.0	
73044	chr15	68298771	68299540	769	384.0	
73045	chr15	68301486	68301704	218	109.0	
73046	chr15	68306138	68307083	945	472.0	
73047	chr15	68341863	68342452	589	294.0	
73048	chr15	68352329	68352830	501	250.0	
73049	chr15	68383380	68383825	445	222.0	
73050	chr15	68390500	68390830	330	165.0	
73051	chr15	68550469	68550870	401	200.0	
73052	chr15	68554027	68554344	317	158.0	
73053	chr15	68559298	68560193	895	448.0	
73054	chr15	68577329	68579170	1841	920.0	
73055	chr15	68618548	68618632	84	42.0	
73056	chr15	68631429	68632056	627	314.0	
73057	chr15	68651109	68651464	355	178.0	
73058	chr15	68673889	68675514	1625	812.0	
73059	chr15	68725773	68726181	408	204.0	
73060	chr15	68730454	68730778	324	162.0	
73061	chr15	68742267	68742368	101	50.0	
73062	chr15	68754472	68755322	850	425.0	
73063	chr15	68781246	68784149	2903	1452.0	
73064	chr15	68791218	68792376	1158	579.0	
73065	chr15	68794610	68796193	1583	792.0	
73066	chr15	68797254	68797585	331	166.0	
73067	chr15	68798300	68798769	469	234.0	
73068	chr15	68815574	68822549	6975	3488.0	
73069	chr15	68828940	68829459	519	260.0	
73070	chr15	68833946	68834763	817	408.0	
73071	chr15	68843754	68844317	563	282.0	
73072	chr15	68875575	68876254	679	340.0	
73073	chr15	68924865	68925298	433	216.0	
73074	chr15	68930201	68930776	575	288.0	
73075	chr15	69031595	69031831	236	118.0	
73076	chr15	69059016	69059543	527	264.0	
73077	chr15	69093136	69093574	438	219.0	
73078	chr15	69126051	69126406	355	178.0	
73079	chr15	69131480	69132300	820	410.0	
73080	chr15	69159786	69162039	2253	1126.0	
73081	chr15	69167198	69167687	489	244.0	
73082	chr15	69185732	69186131	399	200.0	
73083	chr15	69298713	69299109	396	198.0	
73084	chr15	69313470	69313766	296	148.0	
73085	chr15	69394435	69395046	611	306.0	
73086	chr15	69413696	69415216	1520	760.0	
73087	chr15	69436011	69436390	379	190.0	
73088	chr15	69436910	69437623	713	356.0	
73089	chr15	69440068	69440220	152	76.0	
73090	chr15	69443013	69443569	556	278.0	
73091	chr15	69451797	69458951	7154	3577.0	
73092	chr15	69462026	69463629	1603	802.0	
73093	chr15	69465914	69466404	490	245.0	
73094	chr15	69467841	69469866	2025	1012.0	
73095	chr15	69475678	69476358	680	340.0	
73096	chr15	69478192	69478652	460	230.0	
73097	chr15	69499434	69499843	409	204.0	
73098	chr15	69509208	69509437	229	114.0	
73099	chr15	69515521	69516354	833	416.0	
73100	chr15	69523375	69523786	411	206.0	
73101	chr15	69574702	69574753	51	26.0	
73102	chr15	69575773	69576636	863	432.0	
73103	chr15	69578777	69578995	218	109.0	
73104	chr15	69583665	69583752	87	44.0	
73105	chr15	69594240	69594902	662	331.0	
73106	chr15	69595478	69595793	315	158.0	
73107	chr15	69604210	69604335	125	62.0	
73108	chr15	69606154	69606555	401	200.0	
73109	chr15	69607124	69607545	421	210.0	
73110	chr15	69609189	69610816	1627	814.0	
73111	chr15	69626362	69626497	135	68.0	
73112	chr15	69652325	69653274	949	474.0	
73113	chr15	69660815	69661314	499	250.0	
73114	chr15	69666315	69669837	3522	1761.0	
73115	chr15	69677447	69677833	386	193.0	
73116	chr15	69679550	69679999	449	224.0	
73117	chr15	69691557	69692015	458	229.0	
73118	chr15	69698012	69698340	328	164.0	
73119	chr15	69707406	69707597	191	96.0	
73120	chr15	69712988	69715118	2130	1065.0	
73121	chr15	69718411	69722284	3873	1936.0	
73122	chr15	69722961	69723542	581	290.0	
73123	chr15	69725455	69726631	1176	588.0	
73124	chr15	69729108	69729582	474	237.0	
73125	chr15	69744522	69744923	401	200.0	
73126	chr15	69749789	69750220	431	216.0	
73127	chr15	69751681	69751996	315	158.0	
73128	chr15	69755149	69756296	1147	574.0	
73129	chr15	69758471	69761921	3450	1725.0	
73130	chr15	69769575	69769711	136	68.0	
73131	chr15	69782894	69783163	269	134.0	
73132	chr15	69798641	69799063	422	211.0	
73133	chr15	69804651	69805568	917	458.0	
73134	chr15	69807889	69808115	226	113.0	
73135	chr15	69976375	69976730	355	178.0	
73136	chr15	69979690	69980234	544	272.0	
73137	chr15	70014838	70015418	580	290.0	
73138	chr15	70022696	70024119	1423	712.0	
73139	chr15	70035607	70037159	1552	776.0	
73140	chr15	70078586	70078873	287	144.0	
73141	chr15	70085892	70085958	66	33.0	
73142	chr15	70086562	70087342	780	390.0	
73143	chr15	70091786	70092921	1135	568.0	
73144	chr15	70093686	70102127	8441	4220.0	enhancer
73145	chr15	70103854	70104281	427	214.0	
73146	chr15	70113049	70113996	947	474.0	
73147	chr15	70128549	70128744	195	98.0	
73148	chr15	70140442	70143195	2753	1376.0	
73149	chr15	70160373	70160541	168	84.0	
73150	chr15	70196568	70197231	663	332.0	
73151	chr15	70236151	70236544	393	196.0	
73152	chr15	70239979	70240552	573	286.0	
73153	chr15	70242096	70242169	73	36.0	
73154	chr15	70245788	70247308	1520	760.0	
73155	chr15	70257415	70260144	2729	1364.0	
73156	chr15	70263915	70265035	1120	560.0	
73157	chr15	70266054	70268375	2321	1160.0	
73158	chr15	70270022	70270603	581	290.0	
73159	chr15	70271330	70271915	585	292.0	
73160	chr15	70281954	70282387	433	216.0	
73161	chr15	70284357	70284757	400	200.0	
73162	chr15	70300027	70301093	1066	533.0	
73163	chr15	70308039	70308774	735	368.0	
73164	chr15	70319289	70320914	1625	812.0	
73165	chr15	70321553	70322657	1104	552.0	
73166	chr15	70327782	70328590	808	404.0	
73167	chr15	70336462	70336778	316	158.0	
73168	chr15	70339748	70340593	845	422.0	
73169	chr15	70348824	70349514	690	345.0	
73170	chr15	70362966	70363283	317	158.0	
73171	chr15	70386498	70387004	506	253.0	
73172	chr15	70424861	70425359	498	249.0	
73173	chr15	70430132	70430337	205	102.0	
73174	chr15	70435331	70435835	504	252.0	
73175	chr15	70447635	70448657	1022	511.0	
73176	chr15	70452186	70452578	392	196.0	
73177	chr15	70459118	70460709	1591	796.0	
73178	chr15	70462533	70463922	1389	694.0	
73179	chr15	70466859	70467364	505	252.0	
73180	chr15	70474312	70475690	1378	689.0	
73181	chr15	70478398	70480931	2533	1266.0	
73182	chr15	70483529	70483664	135	68.0	
73183	chr15	70486015	70488512	2497	1248.0	
73184	chr15	70491065	70495388	4323	2162.0	
73185	chr15	70503304	70503428	124	62.0	
73186	chr15	70504104	70506101	1997	998.0	
73187	chr15	70507586	70510078	2492	1246.0	
73188	chr15	70512536	70513234	698	349.0	
73189	chr15	70526424	70526936	512	256.0	
73190	chr15	70527948	70529149	1201	600.0	
73191	chr15	70534917	70536230	1313	656.0	
73192	chr15	70556047	70556077	30	15.0	
73193	chr15	70556664	70557274	610	305.0	
73194	chr15	70558807	70560052	1245	622.0	
73195	chr15	70585131	70585601	470	235.0	
73196	chr15	70672100	70672643	543	272.0	
73197	chr15	70722624	70723023	399	200.0	
73198	chr15	70741171	70742190	1019	510.0	
73199	chr15	70748185	70748530	345	172.0	
73200	chr15	70752092	70752528	436	218.0	
73201	chr15	70762383	70764096	1713	856.0	
73202	chr15	70767691	70768638	947	474.0	
73203	chr15	70777486	70778022	536	268.0	
73204	chr15	70806967	70807465	498	249.0	
73205	chr15	70811999	70812459	460	230.0	
73206	chr15	70826655	70826966	311	156.0	
73207	chr15	70853806	70854468	662	331.0	
73208	chr15	70891801	70893208	1407	704.0	
73209	chr15	71115143	71115784	641	320.0	
73210	chr15	71295350	71295756	406	203.0	
73211	chr15	71372797	71373083	286	143.0	
73212	chr15	71730602	71730819	217	108.0	
73213	chr15	71744146	71744203	57	28.0	
73214	chr15	72103204	72103656	452	226.0	
73215	chr15	72116733	72119328	2595	1298.0	
73216	chr15	72141646	72141647	1	0.0	
73217	chr15	72155775	72156510	735	368.0	
73218	chr15	72194958	72195594	636	318.0	
73219	chr15	72197090	72198118	1028	514.0	
73220	chr15	72199478	72201130	1652	826.0	
73221	chr15	72220398	72221067	669	334.0	
73222	chr15	72222373	72222812	439	220.0	
73223	chr15	72226261	72232877	6616	3308.0	
73224	chr15	72236980	72237912	932	466.0	
73225	chr15	72249423	72249842	419	210.0	
73226	chr15	72271716	72273680	1964	982.0	
73227	chr15	72285906	72286364	458	229.0	
73228	chr15	72306024	72307076	1052	526.0	
73229	chr15	72312515	72313077	562	281.0	
73230	chr15	72318166	72320966	2800	1400.0	
73231	chr15	72338708	72340196	1488	744.0	
73232	chr15	72342392	72342719	327	164.0	
73233	chr15	72358870	72359010	140	70.0	
73234	chr15	72365789	72366410	621	310.0	
73235	chr15	72368327	72369395	1068	534.0	
73236	chr15	72369936	72370422	486	243.0	
73237	chr15	72372375	72373046	671	336.0	
73238	chr15	72375167	72376964	1797	898.0	
73239	chr15	72420608	72420945	337	168.0	
73240	chr15	72461610	72462713	1103	552.0	
73241	chr15	72464218	72464885	667	334.0	
73242	chr15	72472884	72476853	3969	1984.0	
73243	chr15	72477730	72483530	5800	2900.0	
73244	chr15	72485030	72490954	5924	2962.0	
73245	chr15	72491790	72492089	299	150.0	
73246	chr15	72492639	72493583	944	472.0	
73247	chr15	72494099	72498781	4682	2341.0	
73248	chr15	72499808	72500263	455	228.0	
73249	chr15	72501663	72506509	4846	2423.0	
73250	chr15	72507064	72510805	3741	1870.0	
73251	chr15	72511428	72511900	472	236.0	
73252	chr15	72514467	72514973	506	253.0	
73253	chr15	72515715	72516219	504	252.0	
73254	chr15	72516777	72518791	2014	1007.0	
73255	chr15	72522925	72523681	756	378.0	
73256	chr15	72529248	72529493	245	122.0	
73257	chr15	72532968	72533433	465	232.0	
73258	chr15	72534484	72534950	466	233.0	
73259	chr15	72599875	72600242	367	184.0	
73260	chr15	72636752	72637155	403	202.0	
73261	chr15	72670488	72671498	1010	505.0	
73262	chr15	72680973	72681296	323	162.0	
73263	chr15	72685503	72686931	1428	714.0	
73264	chr15	72722042	72722505	463	232.0	
73265	chr15	72740127	72740748	621	310.0	
73266	chr15	72751721	72752656	935	468.0	
73267	chr15	72774790	72775440	650	325.0	
73268	chr15	72781620	72786080	4460	2230.0	
73269	chr15	72786656	72787158	502	251.0	
73270	chr15	72796393	72797740	1347	674.0	
73271	chr15	72805444	72805951	507	254.0	
73272	chr15	72809172	72809784	612	306.0	
73273	chr15	72820261	72820617	356	178.0	
73274	chr15	72821360	72821793	433	216.0	
73275	chr15	72838279	72838531	252	126.0	
73276	chr15	72967488	72967811	323	162.0	
73277	chr15	73051211	73053617	2406	1203.0	
73278	chr15	73081333	73081823	490	245.0	
73279	chr15	73127301	73127689	388	194.0	
73280	chr15	73141215	73141724	509	254.0	
73281	chr15	73143057	73143199	142	71.0	
73282	chr15	73225390	73225653	263	132.0	
73283	chr15	73240876	73241284	408	204.0	
73284	chr15	73265524	73265942	418	209.0	
73285	chr15	73273281	73273743	462	231.0	
73286	chr15	73284111	73284454	343	172.0	
73287	chr15	73286895	73287678	783	392.0	
73288	chr15	73295673	73296449	776	388.0	
73289	chr15	73303711	73304124	413	206.0	
73290	chr15	73305879	73306304	425	212.0	
73291	chr15	73318750	73319051	301	150.0	
73292	chr15	73448334	73448484	150	75.0	
73293	chr15	73482097	73482549	452	226.0	
73294	chr15	73518904	73519473	569	284.0	
73295	chr15	73540427	73540512	85	42.0	
73296	chr15	73560507	73560948	441	220.0	
73297	chr15	73564250	73564746	496	248.0	
73298	chr15	73583013	73583319	306	153.0	
73299	chr15	73601485	73602752	1267	634.0	
73300	chr15	73629162	73629620	458	229.0	
73301	chr15	73631147	73631157	10	5.0	
73302	chr15	73631682	73634279	2597	1298.0	
73303	chr15	73635903	73637045	1142	571.0	
73304	chr15	73650709	73651282	573	286.0	
73305	chr15	73677026	73677530	504	252.0	
73306	chr15	73683770	73684720	950	475.0	
73307	chr15	73696751	73697748	997	498.0	
73308	chr15	73700121	73700707	586	293.0	
73309	chr15	73704761	73705219	458	229.0	
73310	chr15	73711515	73711960	445	222.0	
73311	chr15	73873930	73874248	318	159.0	
73312	chr15	73897312	73897818	506	253.0	
73313	chr15	73908185	73908733	548	274.0	
73314	chr15	73911185	73911565	380	190.0	
73315	chr15	73914268	73914513	245	122.0	
73316	chr15	73920230	73921113	883	442.0	
73317	chr15	73923830	73924929	1099	550.0	
73318	chr15	73926307	73928485	2178	1089.0	
73319	chr15	73941936	73942222	286	143.0	
73320	chr15	73950895	73951775	880	440.0	
73321	chr15	73958977	73959688	711	356.0	
73322	chr15	73964538	73966275	1737	868.0	
73323	chr15	73972813	73973626	813	406.0	
73324	chr15	73974324	73974770	446	223.0	
73325	chr15	73975688	73976192	504	252.0	
73326	chr15	73982443	73983030	587	294.0	
73327	chr15	73991447	73992979	1532	766.0	
73328	chr15	73993982	73997633	3651	1826.0	
73329	chr15	74007828	74008208	380	190.0	
73330	chr15	74048088	74049057	969	484.0	
73331	chr15	74051093	74051654	561	280.0	
73332	chr15	74053935	74054514	579	290.0	
73333	chr15	74099843	74100549	706	353.0	
73334	chr15	74122706	74122724	18	9.0	
73335	chr15	74127461	74128003	542	271.0	
73336	chr15	74134447	74134766	319	160.0	
73337	chr15	74136288	74136598	310	155.0	
73338	chr15	74291436	74291853	417	208.0	
73339	chr15	74322507	74322988	481	240.0	
73340	chr15	74365660	74366437	777	388.0	
73341	chr15	74373352	74375822	2470	1235.0	
73342	chr15	74378642	74379390	748	374.0	
73343	chr15	74382081	74385682	3601	1800.0	
73344	chr15	74390515	74391511	996	498.0	
73345	chr15	74396264	74397871	1607	804.0	
73346	chr15	74399799	74404510	4711	2356.0	
73347	chr15	74408323	74408853	530	265.0	
73348	chr15	74415028	74415396	368	184.0	
73349	chr15	74420028	74420694	666	333.0	
73350	chr15	74428263	74429707	1444	722.0	
73351	chr15	74430515	74434732	4217	2108.0	
73352	chr15	74438312	74439197	885	442.0	
73353	chr15	74460246	74461941	1695	848.0	
73354	chr15	74464169	74464675	506	253.0	
73355	chr15	74489570	74490530	960	480.0	
73356	chr15	74511747	74512705	958	479.0	
73357	chr15	74529870	74530426	556	278.0	
73358	chr15	74540189	74542591	2402	1201.0	
73359	chr15	74543496	74544098	602	301.0	
73360	chr15	74545734	74546847	1113	556.0	
73361	chr15	74549910	74550176	266	133.0	
73362	chr15	74570084	74570476	392	196.0	
73363	chr15	74588370	74589081	711	356.0	
73364	chr15	74597800	74599272	1472	736.0	
73365	chr15	74611001	74611143	142	71.0	
73366	chr15	74612184	74612625	441	220.0	
73367	chr15	74613176	74617352	4176	2088.0	
73368	chr15	74618945	74619296	351	176.0	
73369	chr15	74620238	74621704	1466	733.0	
73370	chr15	74627085	74627692	607	304.0	
73371	chr15	74630435	74632409	1974	987.0	
73372	chr15	74634900	74635928	1028	514.0	
73373	chr15	74695334	74696988	1654	827.0	
73374	chr15	74710319	74710609	290	145.0	
73375	chr15	74712552	74712657	105	52.0	
73376	chr15	74716650	74716977	327	164.0	
73377	chr15	74723925	74724400	475	238.0	
73378	chr15	74725355	74726873	1518	759.0	
73379	chr15	74768629	74769462	833	416.0	
73380	chr15	74770792	74771857	1065	532.0	
73381	chr15	74775049	74775456	407	204.0	
73382	chr15	74776618	74778391	1773	886.0	
73383	chr15	74779226	74791074	11848	5924.0	
73384	chr15	74792524	74794090	1566	783.0	
73385	chr15	74794718	74796665	1947	974.0	
73386	chr15	74798357	74801212	2855	1428.0	
73387	chr15	74807345	74807349	4	2.0	
73388	chr15	74818518	74819112	594	297.0	
73389	chr15	74821271	74821827	556	278.0	
73390	chr15	74826204	74827031	827	414.0	
73391	chr15	74835195	74835826	631	316.0	
73392	chr15	74842331	74846064	3733	1866.0	
73393	chr15	74857227	74857471	244	122.0	
73394	chr15	74857978	74858396	418	209.0	
73395	chr15	74863347	74863743	396	198.0	
73396	chr15	74867741	74868817	1076	538.0	
73397	chr15	74869434	74871163	1729	864.0	
73398	chr15	74872162	74874374	2212	1106.0	
73399	chr15	74886087	74886440	353	176.0	
73400	chr15	74889219	74890807	1588	794.0	
73401	chr15	74893216	74894183	967	484.0	
73402	chr15	74901318	74902202	884	442.0	
73403	chr15	74902718	74902910	192	96.0	
73404	chr15	74905772	74907724	1952	976.0	
73405	chr15	74937188	74938851	1663	832.0	
73406	chr15	74950064	74951015	951	476.0	
73407	chr15	74955952	74959626	3674	1837.0	
73408	chr15	74988031	74988424	393	196.0	
73409	chr15	74994976	74996234	1258	629.0	
73410	chr15	75008384	75009496	1112	556.0	
73411	chr15	75022878	75024511	1633	816.0	
73412	chr15	75025105	75025534	429	214.0	
73413	chr15	75029019	75030433	1414	707.0	
73414	chr15	75031827	75032228	401	200.0	
73415	chr15	75034525	75035062	537	268.0	
73416	chr15	75037698	75038062	364	182.0	
73417	chr15	75042523	75044469	1946	973.0	
73418	chr15	75046174	75047950	1776	888.0	
73419	chr15	75061277	75062476	1199	600.0	
73420	chr15	75064855	75065188	333	166.0	
73421	chr15	75066988	75067703	715	358.0	
73422	chr15	75069250	75070229	979	490.0	
73423	chr15	75072936	75073692	756	378.0	
73424	chr15	75077389	75078126	737	368.0	
73425	chr15	75090053	75090794	741	370.0	
73426	chr15	75098747	75098963	216	108.0	
73427	chr15	75104570	75105600	1030	515.0	
73428	chr15	75107714	75109284	1570	785.0	
73429	chr15	75109933	75109990	57	28.0	
73430	chr15	75110940	75111614	674	337.0	
73431	chr15	75112243	75113598	1355	678.0	
73432	chr15	75125022	75125770	748	374.0	
73433	chr15	75130044	75131775	1731	866.0	
73434	chr15	75153010	75154975	1965	982.0	
73435	chr15	75162011	75162452	441	220.0	
73436	chr15	75164706	75165078	372	186.0	
73437	chr15	75175545	75176069	524	262.0	
73438	chr15	75178298	75179592	1294	647.0	
73439	chr15	75184666	75184801	135	68.0	
73440	chr15	75198525	75199134	609	304.0	
73441	chr15	75200531	75205409	4878	2439.0	
73442	chr15	75207465	75207725	260	130.0	
73443	chr15	75210405	75210913	508	254.0	
73444	chr15	75211623	75211670	47	24.0	
73445	chr15	75213538	75216435	2897	1448.0	
73446	chr15	75219364	75219852	488	244.0	
73447	chr15	75274405	75274993	588	294.0	
73448	chr15	75299202	75299584	382	191.0	
73449	chr15	75333627	75334071	444	222.0	
73450	chr15	75335540	75336642	1102	551.0	
73451	chr15	75346744	75348868	2124	1062.0	
73452	chr15	75349496	75351526	2030	1015.0	
73453	chr15	75352412	75352876	464	232.0	
73454	chr15	75353419	75354369	950	475.0	
73455	chr15	75367293	75370120	2827	1414.0	
73456	chr15	75385931	75386283	352	176.0	
73457	chr15	75445725	75446646	921	460.0	
73458	chr15	75448043	75448659	616	308.0	
73459	chr15	75449703	75456864	7161	3580.0	
73460	chr15	75508925	75509317	392	196.0	
73461	chr15	75532425	75532747	322	161.0	
73462	chr15	75551084	75551538	454	227.0	
73463	chr15	75572904	75573305	401	200.0	
73464	chr15	75574847	75575233	386	193.0	
73465	chr15	75577480	75580097	2617	1308.0	
73466	chr15	75597700	75598163	463	232.0	
73467	chr15	75606445	75607863	1418	709.0	
73468	chr15	75620419	75621563	1144	572.0	
73469	chr15	75624504	75626662	2158	1079.0	
73470	chr15	75638288	75641486	3198	1599.0	
73471	chr15	75646656	75648611	1955	978.0	
73472	chr15	75651551	75652041	490	245.0	
73473	chr15	75665542	75665929	387	194.0	
73474	chr15	75666466	75666490	24	12.0	
73475	chr15	75683537	75684233	696	348.0	
73476	chr15	75685977	75686635	658	329.0	
73477	chr15	75695255	75695775	520	260.0	
73478	chr15	75696309	75696525	216	108.0	
73479	chr15	75699287	75701097	1810	905.0	
73480	chr15	75720815	75721510	695	348.0	
73481	chr15	75723480	75724395	915	458.0	
73482	chr15	75726086	75726605	519	260.0	
73483	chr15	75728007	75728895	888	444.0	
73484	chr15	75731588	75733278	1690	845.0	
73485	chr15	75735003	75735481	478	239.0	
73486	chr15	75737837	75739641	1804	902.0	
73487	chr15	75748774	75749327	553	276.0	
73488	chr15	75758042	75759753	1711	856.0	
73489	chr15	75801812	75802681	869	434.0	
73490	chr15	75810008	75810145	137	68.0	
73491	chr15	75817257	75817703	446	223.0	
73492	chr15	75836764	75837561	797	398.0	
73493	chr15	75841610	75841758	148	74.0	
73494	chr15	75842349	75845572	3223	1612.0	
73495	chr15	75903229	75904811	1582	791.0	
73496	chr15	75921814	75922098	284	142.0	
73497	chr15	75923800	75924138	338	169.0	
73498	chr15	76006312	76006830	518	259.0	
73499	chr15	76056834	76057825	991	496.0	
73500	chr15	76059015	76060805	1790	895.0	
73501	chr15	76065266	76065716	450	225.0	
73502	chr15	76139394	76140106	712	356.0	
73503	chr15	76147870	76148327	457	228.0	
73504	chr15	76150436	76151427	991	496.0	
73505	chr15	76163314	76163810	496	248.0	
73506	chr15	76168975	76169466	491	246.0	
73507	chr15	76185659	76186012	353	176.0	
73508	chr15	76190646	76191594	948	474.0	
73509	chr15	76235201	76235616	415	208.0	
73510	chr15	76282498	76282835	337	168.0	
73511	chr15	76286179	76286902	723	362.0	
73512	chr15	76310440	76312128	1688	844.0	
73513	chr15	76330396	76330472	76	38.0	
73514	chr15	76333923	76334270	347	174.0	
73515	chr15	76335124	76343465	8341	4170.0	
73516	chr15	76345659	76347323	1664	832.0	
73517	chr15	76533338	76533928	590	295.0	
73518	chr15	76902663	76906086	3423	1712.0	
73519	chr15	76908026	76908422	396	198.0	
73520	chr15	76930834	76932675	1841	920.0	
73521	chr15	76935605	76935978	373	186.0	
73522	chr15	76973170	76973789	619	310.0	
73523	chr15	76976498	76977002	504	252.0	
73524	chr15	76983584	76984588	1004	502.0	
73525	chr15	76988175	76989272	1097	548.0	
73526	chr15	76990950	76991541	591	296.0	
73527	chr15	76992145	76999235	7090	3545.0	
73528	chr15	76999996	77000369	373	186.0	
73529	chr15	77002511	77004797	2286	1143.0	
73530	chr15	77010865	77011354	489	244.0	
73531	chr15	77012445	77016108	3663	1832.0	
73532	chr15	77019866	77020361	495	248.0	
73533	chr15	77021366	77022942	1576	788.0	
73534	chr15	77023548	77024852	1304	652.0	
73535	chr15	77031275	77031827	552	276.0	
73536	chr15	77034878	77035622	744	372.0	
73537	chr15	77037348	77038427	1079	540.0	
73538	chr15	77040472	77041082	610	305.0	
73539	chr15	77067318	77068390	1072	536.0	
73540	chr15	77069941	77071812	1871	936.0	
73541	chr15	77078587	77079466	879	440.0	
73542	chr15	77083584	77084477	893	446.0	
73543	chr15	77107658	77108025	367	184.0	
73544	chr15	77118795	77119234	439	220.0	
73545	chr15	77160813	77161204	391	196.0	
73546	chr15	77162835	77163303	468	234.0	
73547	chr15	77163982	77164167	185	92.0	
73548	chr15	77179296	77180103	807	404.0	
73549	chr15	77180742	77182211	1469	734.0	
73550	chr15	77185546	77185568	22	11.0	
73551	chr15	77186577	77186873	296	148.0	
73552	chr15	77187591	77188381	790	395.0	
73553	chr15	77406363	77406487	124	62.0	
73554	chr15	77409506	77410289	783	392.0	
73555	chr15	77415490	77416437	947	474.0	
73556	chr15	77419042	77421741	2699	1350.0	
73557	chr15	77493270	77493833	563	282.0	
73558	chr15	77496699	77497260	561	280.0	
73559	chr15	77507393	77507723	330	165.0	
73560	chr15	77537922	77538256	334	167.0	
73561	chr15	77542983	77543975	992	496.0	
73562	chr15	77548239	77548987	748	374.0	
73563	chr15	77633139	77634796	1657	828.0	
73564	chr15	77870406	77870807	401	200.0	
73565	chr15	77900416	77900699	283	142.0	
73566	chr15	77902923	77903188	265	132.0	
73567	chr15	77910307	77911077	770	385.0	
73568	chr15	77944174	77944883	709	354.0	
73569	chr15	77953845	77954439	594	297.0	
73570	chr15	77959106	77959978	872	436.0	
73571	chr15	77966722	77967210	488	244.0	
73572	chr15	77981804	77982045	241	120.0	
73573	chr15	77989690	77991298	1608	804.0	
73574	chr15	77992064	77992563	499	250.0	
73575	chr15	77993274	77994480	1206	603.0	
73576	chr15	77999808	78000577	769	384.0	
73577	chr15	78018852	78019452	600	300.0	
73578	chr15	78032611	78033097	486	243.0	
73579	chr15	78033852	78036219	2367	1184.0	
73580	chr15	78037730	78038214	484	242.0	
73581	chr15	78044212	78044972	760	380.0	
73582	chr15	78046739	78048370	1631	816.0	
73583	chr15	78049296	78052705	3409	1704.0	
73584	chr15	78054888	78057281	2393	1196.0	
73585	chr15	78059082	78059486	404	202.0	
73586	chr15	78061813	78062558	745	372.0	
73587	chr15	78065134	78066339	1205	602.0	
73588	chr15	78067535	78070683	3148	1574.0	
73589	chr15	78071371	78073297	1926	963.0	
73590	chr15	78075658	78078344	2686	1343.0	
73591	chr15	78082215	78083116	901	450.0	
73592	chr15	78083713	78084048	335	168.0	
73593	chr15	78087819	78088649	830	415.0	
73594	chr15	78103580	78104602	1022	511.0	
73595	chr15	78105930	78106295	365	182.0	
73596	chr15	78107867	78109154	1287	644.0	
73597	chr15	78112940	78113999	1059	530.0	
73598	chr15	78126896	78127251	355	178.0	
73599	chr15	78128722	78132248	3526	1763.0	
73600	chr15	78148539	78150308	1769	884.0	
73601	chr15	78167433	78167885	452	226.0	
73602	chr15	78171233	78171860	627	314.0	
73603	chr15	78173104	78173853	749	374.0	
73604	chr15	78177357	78177745	388	194.0	
73605	chr15	78195447	78196102	655	328.0	
73606	chr15	78223694	78224365	671	336.0	
73607	chr15	78240853	78241553	700	350.0	
73608	chr15	78242109	78242444	335	168.0	
73609	chr15	78263253	78266361	3108	1554.0	
73610	chr15	78266907	78267306	399	200.0	
73611	chr15	78298840	78302121	3281	1640.0	
73612	chr15	78308184	78308840	656	328.0	
73613	chr15	78353154	78353552	398	199.0	
73614	chr15	78360932	78361674	742	371.0	
73615	chr15	78375056	78375401	345	172.0	
73616	chr15	78399046	78399662	616	308.0	
73617	chr15	78420267	78420567	300	150.0	
73618	chr15	78422612	78423306	694	347.0	
73619	chr15	78425628	78425841	213	106.0	
73620	chr15	78437117	78439313	2196	1098.0	
73621	chr15	78453392	78453961	569	284.0	
73622	chr15	78454846	78455511	665	332.0	
73623	chr15	78461480	78461890	410	205.0	
73624	chr15	78482387	78482738	351	176.0	
73625	chr15	78506867	78508387	1520	760.0	
73626	chr15	78539661	78541936	2275	1138.0	
73627	chr15	78543453	78543629	176	88.0	
73628	chr15	78564911	78566465	1554	777.0	
73629	chr15	78618346	78618945	599	300.0	
73630	chr15	78641055	78641423	368	184.0	
73631	chr15	78709289	78709830	541	270.0	
73632	chr15	78719802	78720223	421	210.0	
73633	chr15	78726943	78727127	184	92.0	
73634	chr15	78738086	78738544	458	229.0	
73635	chr15	78740400	78740854	454	227.0	
73636	chr15	78750702	78751520	818	409.0	
73637	chr15	78756228	78757836	1608	804.0	
73638	chr15	78761135	78762327	1192	596.0	
73639	chr15	78808486	78808931	445	222.0	
73640	chr15	78810405	78812161	1756	878.0	
73641	chr15	78830737	78831079	342	171.0	
73642	chr15	78859877	78861091	1214	607.0	
73643	chr15	78872035	78878411	6376	3188.0	
73644	chr15	78879810	78879857	47	24.0	
73645	chr15	78884418	78884449	31	16.0	
73646	chr15	78902426	78902673	247	124.0	
73647	chr15	78907715	78907971	256	128.0	
73648	chr15	78909544	78911546	2002	1001.0	
73649	chr15	78915129	78916000	871	436.0	
73650	chr15	78916834	78917485	651	326.0	
73651	chr15	78922996	78923569	573	286.0	
73652	chr15	78926894	78927618	724	362.0	
73653	chr15	78936049	78936236	187	94.0	
73654	chr15	78937040	78937828	788	394.0	
73655	chr15	78938567	78939896	1329	664.0	
73656	chr15	78943879	78946389	2510	1255.0	
73657	chr15	78951504	78951598	94	47.0	
73658	chr15	78976597	78977700	1103	552.0	
73659	chr15	78979505	78980103	598	299.0	
73660	chr15	78988305	78989118	813	406.0	
73661	chr15	79004262	79005183	921	460.0	
73662	chr15	79007070	79007617	547	274.0	
73663	chr15	79009370	79009835	465	232.0	
73664	chr15	79025232	79025557	325	162.0	
73665	chr15	79107089	79107597	508	254.0	
73666	chr15	79184664	79184696	32	16.0	
73667	chr15	79307728	79307839	111	56.0	
73668	chr15	79308903	79309009	106	53.0	
73669	chr15	79310532	79311806	1274	637.0	
73670	chr15	79339997	79340388	391	196.0	
73671	chr15	79348762	79348858	96	48.0	
73672	chr15	79380972	79381534	562	281.0	
73673	chr15	79595990	79596470	480	240.0	
73674	chr15	79779879	79780095	216	108.0	
73675	chr15	79798203	79798633	430	215.0	
73676	chr15	79853452	79853950	498	249.0	
73677	chr15	79872362	79873292	930	465.0	
73678	chr15	79896025	79899251	3226	1613.0	
73679	chr15	79899999	79900567	568	284.0	
73680	chr15	79902072	79902214	142	71.0	
73681	chr15	79904378	79904492	114	57.0	
73682	chr15	79905256	79905621	365	182.0	
73683	chr15	79909579	79910045	466	233.0	
73684	chr15	79922628	79924480	1852	926.0	
73685	chr15	79948157	79948563	406	203.0	
73686	chr15	79952195	79952747	552	276.0	
73687	chr15	79953763	79955107	1344	672.0	
73688	chr15	79960619	79961249	630	315.0	
73689	chr15	79962045	79962743	698	349.0	
73690	chr15	79964521	79964807	286	143.0	
73691	chr15	79965800	79968900	3100	1550.0	
73692	chr15	79970574	79971803	1229	614.0	
73693	chr15	79973134	79974000	866	433.0	
73694	chr15	79977239	79979581	2342	1171.0	
73695	chr15	79981595	79982628	1033	516.0	
73696	chr15	79986908	79987328	420	210.0	
73697	chr15	79989549	79990661	1112	556.0	
73698	chr15	79993274	79993990	716	358.0	
73699	chr15	79994558	79994922	364	182.0	
73700	chr15	80017624	80018280	656	328.0	
73701	chr15	80033503	80033839	336	168.0	
73702	chr15	80054221	80054425	204	102.0	
73703	chr15	80055968	80056417	449	224.0	
73704	chr15	80058655	80061251	2596	1298.0	
73705	chr15	80063476	80063670	194	97.0	
73706	chr15	80070902	80071134	232	116.0	
73707	chr15	80072156	80072992	836	418.0	
73708	chr15	80081280	80081879	599	300.0	
73709	chr15	80090894	80091250	356	178.0	
73710	chr15	80123235	80123369	134	67.0	
73711	chr15	80150981	80153906	2925	1462.0	
73712	chr15	80154997	80156195	1198	599.0	
73713	chr15	80159639	80161313	1674	837.0	
73714	chr15	80173211	80173778	567	284.0	
73715	chr15	80328475	80328859	384	192.0	
73716	chr15	80455546	80456206	660	330.0	
73717	chr15	80461292	80461697	405	202.0	
73718	chr15	80473222	80473674	452	226.0	
73719	chr15	80643529	80643769	240	120.0	
73720	chr15	80674267	80674503	236	118.0	
73721	chr15	80694019	80696842	2823	1412.0	
73722	chr15	80721610	80721807	197	98.0	
73723	chr15	80776376	80777570	1194	597.0	
73724	chr15	80778926	80779408	482	241.0	
73725	chr15	80780623	80780925	302	151.0	
73726	chr15	80789240	80789587	347	174.0	
73727	chr15	80955766	80956194	428	214.0	
73728	chr15	80969980	80970476	496	248.0	
73729	chr15	80977480	80978093	613	306.0	
73730	chr15	80981901	80982569	668	334.0	
73731	chr15	80984714	80985564	850	425.0	
73732	chr15	80988890	80990506	1616	808.0	
73733	chr15	80991441	80992372	931	466.0	
73734	chr15	80996178	80996650	472	236.0	
73735	chr15	80998207	80998842	635	318.0	
73736	chr15	80999432	81002863	3431	1716.0	
73737	chr15	81023081	81025218	2137	1068.0	
73738	chr15	81029816	81030694	878	439.0	
73739	chr15	81098810	81099410	600	300.0	
73740	chr15	81106461	81106887	426	213.0	
73741	chr15	81155582	81155983	401	200.0	
73742	chr15	81184280	81184449	169	84.0	
73743	chr15	81265230	81266996	1766	883.0	
73744	chr15	81269185	81269649	464	232.0	
73745	chr15	81274782	81275668	886	443.0	
73746	chr15	81284368	81284822	454	227.0	
73747	chr15	81286245	81287366	1121	560.0	
73748	chr15	81288696	81288935	239	120.0	
73749	chr15	81291485	81294991	3506	1753.0	
73750	chr15	81295528	81300242	4714	2357.0	
73751	chr15	81301376	81304982	3606	1803.0	
73752	chr15	81311247	81313684	2437	1218.0	
73753	chr15	81315227	81316199	972	486.0	
73754	chr15	81322479	81322999	520	260.0	
73755	chr15	81323576	81325060	1484	742.0	
73756	chr15	81331275	81331356	81	40.0	
73757	chr15	81333835	81334217	382	191.0	
73758	chr15	81336595	81336964	369	184.0	
73759	chr15	81338576	81338660	84	42.0	
73760	chr15	81400623	81401072	449	224.0	
73761	chr15	81410278	81410817	539	270.0	
73762	chr15	81480563	81481059	496	248.0	
73763	chr15	81948772	81949157	385	192.0	
73764	chr15	82018249	82018615	366	183.0	
73765	chr15	82044236	82048014	3778	1889.0	
73766	chr15	82108450	82108921	471	236.0	
73767	chr15	82139793	82140065	272	136.0	
73768	chr15	82186961	82187367	406	203.0	
73769	chr15	82197929	82198416	487	244.0	
73770	chr15	82261799	82263432	1633	816.0	
73771	chr15	82286570	82287473	903	452.0	
73772	chr15	82540192	82540921	729	364.0	
73773	chr15	82647213	82648475	1262	631.0	
73774	chr15	82679811	82681290	1479	740.0	
73775	chr15	82709055	82710405	1350	675.0	
73776	chr15	82749876	82751741	1865	932.0	
73777	chr15	82806055	82806485	430	215.0	
73778	chr15	82808855	82811716	2861	1430.0	
73779	chr15	82832537	82833248	711	356.0	
73780	chr15	82844653	82845493	840	420.0	
73781	chr15	82849505	82850524	1019	510.0	
73782	chr15	82853285	82853352	67	34.0	
73783	chr15	82872167	82872228	61	30.0	
73784	chr15	82944816	82945236	420	210.0	
73785	chr15	82951775	82953000	1225	612.0	
73786	chr15	82961112	82961263	151	76.0	
73787	chr15	82968133	82968376	243	122.0	
73788	chr15	82985503	82986882	1379	690.0	
73789	chr15	83000123	83000864	741	370.0	
73790	chr15	83010660	83012501	1841	920.0	
73791	chr15	83062614	83064008	1394	697.0	
73792	chr15	83065174	83065201	27	14.0	
73793	chr15	83066015	83068110	2095	1048.0	
73794	chr15	83068982	83069814	832	416.0	
73795	chr15	83092014	83092907	893	446.0	
73796	chr15	83099861	83100543	682	341.0	
73797	chr15	83106990	83109779	2789	1394.0	
73798	chr15	83206888	83208514	1626	813.0	
73799	chr15	83248379	83248743	364	182.0	
73800	chr15	83427793	83428261	468	234.0	
73801	chr15	83438667	83439047	380	190.0	
73802	chr15	83446807	83448140	1333	666.0	
73803	chr15	84080244	84080318	74	37.0	
73804	chr15	84099170	84099513	343	172.0	
73805	chr15	84142750	84143462	712	356.0	
73806	chr15	84195542	84195984	442	221.0	
73807	chr15	84246249	84246952	703	352.0	
73808	chr15	84500154	84500559	405	202.0	
73809	chr15	84569801	84571637	1836	918.0	
73810	chr15	84587724	84588628	904	452.0	
73811	chr15	84595566	84596158	592	296.0	
73812	chr15	84598024	84599397	1373	686.0	
73813	chr15	84600145	84601750	1605	802.0	
73814	chr15	84604825	84605775	950	475.0	
73815	chr15	84616260	84616679	419	210.0	
73816	chr15	84630817	84634726	3909	1954.0	
73817	chr15	84635885	84636330	445	222.0	
73818	chr15	84638186	84638391	205	102.0	
73819	chr15	84653574	84655697	2123	1062.0	
73820	chr15	84656654	84659343	2689	1344.0	
73821	chr15	84681825	84682234	409	204.0	
73822	chr15	84684165	84684409	244	122.0	
73823	chr15	84686516	84686790	274	137.0	
73824	chr15	84697309	84697686	377	188.0	
73825	chr15	84703258	84703422	164	82.0	
73826	chr15	84715177	84717375	2198	1099.0	
73827	chr15	84720484	84721823	1339	670.0	
73828	chr15	84724654	84725690	1036	518.0	
73829	chr15	84734115	84737059	2944	1472.0	
73830	chr15	84738406	84738638	232	116.0	
73831	chr15	84747208	84751234	4026	2013.0	
73832	chr15	84761446	84762151	705	352.0	
73833	chr15	84773698	84774099	401	200.0	
73834	chr15	84785524	84785933	409	204.0	
73835	chr15	84814809	84815394	585	292.0	
73836	chr15	84845564	84845925	361	180.0	
73837	chr15	84878460	84878962	502	251.0	
73838	chr15	84915070	84915213	143	72.0	
73839	chr15	84927920	84928648	728	364.0	
73840	chr15	84955294	84955888	594	297.0	
73841	chr15	84979664	84983911	4247	2124.0	
73842	chr15	84987929	84989361	1432	716.0	
73843	chr15	84991375	84991414	39	20.0	
73844	chr15	84992548	84992911	363	182.0	
73845	chr15	85002519	85002905	386	193.0	
73846	chr15	85003625	85004955	1330	665.0	
73847	chr15	85005760	85006140	380	190.0	
73848	chr15	85008773	85009237	464	232.0	
73849	chr15	85030158	85030579	421	210.0	
73850	chr15	85036725	85037145	420	210.0	
73851	chr15	85037705	85037732	27	14.0	
73852	chr15	85044244	85044691	447	224.0	
73853	chr15	85047232	85047568	336	168.0	
73854	chr15	85100570	85100902	332	166.0	
73855	chr15	85168559	85169253	694	347.0	
73856	chr15	85257737	85258092	355	178.0	
73857	chr15	85289660	85290109	449	224.0	
73858	chr15	85296446	85297225	779	390.0	
73859	chr15	85312346	85313430	1084	542.0	
73860	chr15	85316292	85316901	609	304.0	
73861	chr15	85318223	85318645	422	211.0	
73862	chr15	85329367	85331938	2571	1286.0	
73863	chr15	85357883	85358333	450	225.0	
73864	chr15	85379184	85382697	3513	1756.0	
73865	chr15	85383470	85384135	665	332.0	
73866	chr15	85387864	85388363	499	250.0	
73867	chr15	85404110	85404610	500	250.0	
73868	chr15	85407503	85408845	1342	671.0	
73869	chr15	85413184	85414885	1701	850.0	
73870	chr15	85443011	85444181	1170	585.0	
73871	chr15	85457624	85457761	137	68.0	
73872	chr15	85475315	85475745	430	215.0	
73873	chr15	85482903	85483315	412	206.0	
73874	chr15	85485895	85486429	534	267.0	
73875	chr15	85490861	85491285	424	212.0	
73876	chr15	85492340	85492746	406	203.0	
73877	chr15	85494354	85494776	422	211.0	
73878	chr15	85504963	85505491	528	264.0	
73879	chr15	85527964	85528353	389	194.0	
73880	chr15	85533658	85534678	1020	510.0	
73881	chr15	85535524	85536652	1128	564.0	
73882	chr15	85540371	85540833	462	231.0	
73883	chr15	85541753	85542077	324	162.0	
73884	chr15	85542771	85544302	1531	766.0	
73885	chr15	85544941	85546279	1338	669.0	
73886	chr15	85547402	85547785	383	192.0	
73887	chr15	85554811	85555629	818	409.0	
73888	chr15	85570324	85570889	565	282.0	
73889	chr15	85578820	85585377	6557	3278.0	
73890	chr15	85597215	85597821	606	303.0	
73891	chr15	85615642	85616448	806	403.0	
73892	chr15	85618526	85621249	2723	1362.0	
73893	chr15	85623305	85626398	3093	1546.0	
73894	chr15	85628960	85629510	550	275.0	
73895	chr15	85646164	85647296	1132	566.0	
73896	chr15	85649079	85649854	775	388.0	
73897	chr15	85667675	85668797	1122	561.0	
73898	chr15	85687347	85687422	75	38.0	
73899	chr15	85688638	85693749	5111	2556.0	
73900	chr15	85701803	85704941	3138	1569.0	
73901	chr15	85706318	85708674	2356	1178.0	
73902	chr15	85709549	85709573	24	12.0	
73903	chr15	85710395	85710701	306	153.0	
73904	chr15	85723896	85724889	993	496.0	
73905	chr15	85729800	85730863	1063	532.0	
73906	chr15	85742174	85742679	505	252.0	
73907	chr15	85743775	85744020	245	122.0	
73908	chr15	85744809	85745099	290	145.0	
73909	chr15	85748154	85752858	4704	2352.0	
73910	chr15	85753669	85754304	635	318.0	
73911	chr15	85756599	85757108	509	254.0	
73912	chr15	85758433	85758437	4	2.0	
73913	chr15	85760798	85760799	1	0.0	
73914	chr15	85782083	85782760	677	338.0	
73915	chr15	85784822	85786490	1668	834.0	
73916	chr15	85792562	85795547	2985	1492.0	
73917	chr15	85824387	85824787	400	200.0	
73918	chr15	85831560	85832906	1346	673.0	
73919	chr15	85839683	85841031	1348	674.0	
73920	chr15	85854286	85854779	493	246.0	
73921	chr15	85858510	85859201	691	346.0	
73922	chr15	85927942	85928197	255	128.0	
73923	chr15	86611611	86612139	528	264.0	
73924	chr15	86624550	86625045	495	248.0	
73925	chr15	86653412	86654261	849	424.0	
73926	chr15	86743305	86743685	380	190.0	
73927	chr15	87597339	87598107	768	384.0	
73928	chr15	87724306	87724757	451	226.0	
73929	chr15	87737057	87737377	320	160.0	
73930	chr15	87752517	87752873	356	178.0	
73931	chr15	87761673	87762602	929	464.0	
73932	chr15	87881002	87881455	453	226.0	
73933	chr15	87902914	87903579	665	332.0	
73934	chr15	88246729	88247205	476	238.0	
73935	chr15	88450155	88450596	441	220.0	
73936	chr15	88454956	88455472	516	258.0	
73937	chr15	88466797	88468296	1499	750.0	
73938	chr15	88476581	88476918	337	168.0	
73939	chr15	88545953	88547196	1243	622.0	
73940	chr15	88605489	88606068	579	290.0	
73941	chr15	88610796	88611348	552	276.0	
73942	chr15	88614609	88614673	64	32.0	
73943	chr15	88620750	88625330	4580	2290.0	
73944	chr15	88627137	88628063	926	463.0	
73945	chr15	88630028	88630828	800	400.0	
73946	chr15	88632851	88633244	393	196.0	
73947	chr15	88635078	88642265	7187	3594.0	
73948	chr15	88644775	88647064	2289	1144.0	
73949	chr15	88647634	88650685	3051	1526.0	
73950	chr15	88651386	88652859	1473	736.0	
73951	chr15	88654407	88657942	3535	1768.0	
73952	chr15	88658834	88659512	678	339.0	
73953	chr15	88664191	88664856	665	332.0	
73954	chr15	88701625	88701929	304	152.0	
73955	chr15	88708308	88709180	872	436.0	
73956	chr15	88725942	88726044	102	51.0	
73957	chr15	88834300	88834680	380	190.0	
73958	chr15	88878721	88879087	366	183.0	
73959	chr15	88894162	88896028	1866	933.0	
73960	chr15	88896672	88897992	1320	660.0	
73961	chr15	88904167	88905473	1306	653.0	
73962	chr15	88912201	88914027	1826	913.0	
73963	chr15	88918778	88919071	293	146.0	
73964	chr15	89017285	89018149	864	432.0	
73965	chr15	89057399	89058137	738	369.0	
73966	chr15	89068182	89069007	825	412.0	
73967	chr15	89070047	89071014	967	484.0	
73968	chr15	89072252	89072755	503	252.0	
73969	chr15	89087443	89092000	4557	2278.0	
73970	chr15	89093892	89095414	1522	761.0	
73971	chr15	89112282	89112662	380	190.0	
73972	chr15	89117681	89118837	1156	578.0	
73973	chr15	89128750	89130777	2027	1014.0	
73974	chr15	89131645	89132014	369	184.0	
73975	chr15	89132619	89133731	1112	556.0	
73976	chr15	89135658	89137246	1588	794.0	
73977	chr15	89140528	89141032	504	252.0	
73978	chr15	89143444	89144058	614	307.0	
73979	chr15	89166262	89166527	265	132.0	
73980	chr15	89167321	89168256	935	468.0	
73981	chr15	89171462	89171877	415	208.0	
73982	chr15	89177682	89178164	482	241.0	
73983	chr15	89203907	89204187	280	140.0	
73984	chr15	89206751	89207396	645	322.0	
73985	chr15	89243234	89244949	1715	858.0	
73986	chr15	89321864	89321960	96	48.0	
73987	chr15	89326195	89326232	37	18.0	
73988	chr15	89329374	89330271	897	448.0	
73989	chr15	89332346	89332982	636	318.0	
73990	chr15	89333805	89336230	2425	1212.0	
73991	chr15	89346826	89347227	401	200.0	
73992	chr15	89356754	89357058	304	152.0	
73993	chr15	89358283	89360124	1841	920.0	
73994	chr15	89361376	89363586	2210	1105.0	
73995	chr15	89364202	89364737	535	268.0	
73996	chr15	89367363	89368333	970	485.0	
73997	chr15	89368893	89369028	135	68.0	
73998	chr15	89369964	89370383	419	210.0	
73999	chr15	89377850	89379526	1676	838.0	
74000	chr15	89395645	89396546	901	450.0	
74001	chr15	89399229	89400618	1389	694.0	
74002	chr15	89401697	89402527	830	415.0	
74003	chr15	89407182	89407769	587	294.0	
74004	chr15	89408782	89409372	590	295.0	
74005	chr15	89411192	89412210	1018	509.0	
74006	chr15	89416170	89416948	778	389.0	
74007	chr15	89419342	89419779	437	218.0	
74008	chr15	89429082	89429484	402	201.0	
74009	chr15	89430425	89431297	872	436.0	
74010	chr15	89441264	89441891	627	314.0	
74011	chr15	89462578	89462618	40	20.0	
74012	chr15	89472746	89473169	423	212.0	
74013	chr15	89486596	89487041	445	222.0	
74014	chr15	89496372	89496656	284	142.0	
74015	chr15	89556661	89557036	375	188.0	
74016	chr15	89574729	89576621	1892	946.0	
74017	chr15	89647050	89647503	453	226.0	
74018	chr15	89655284	89655692	408	204.0	
74019	chr15	89665461	89666031	570	285.0	
74020	chr15	89690145	89691388	1243	622.0	
74021	chr15	89739947	89740545	598	299.0	
74022	chr15	89746930	89747000	70	35.0	
74023	chr15	89749934	89751723	1789	894.0	
74024	chr15	89760636	89761327	691	346.0	
74025	chr15	89776138	89777077	939	470.0	
74026	chr15	89780803	89782905	2102	1051.0	
74027	chr15	89803810	89804357	547	274.0	
74028	chr15	89812224	89812768	544	272.0	
74029	chr15	89813977	89815454	1477	738.0	
74030	chr15	89820721	89822352	1631	816.0	
74031	chr15	89823343	89823939	596	298.0	
74032	chr15	89825041	89825900	859	430.0	
74033	chr15	89826913	89827093	180	90.0	
74034	chr15	89828566	89828851	285	142.0	
74035	chr15	89836541	89837988	1447	724.0	
74036	chr15	89839359	89840148	789	394.0	
74037	chr15	89848563	89849157	594	297.0	
74038	chr15	89851290	89852065	775	388.0	
74039	chr15	89870070	89870087	17	8.0	
74040	chr15	89874880	89877408	2528	1264.0	
74041	chr15	89884477	89884886	409	204.0	
74042	chr15	89888248	89888590	342	171.0	
74043	chr15	89890899	89891523	624	312.0	
74044	chr15	89892977	89894887	1910	955.0	
74045	chr15	89898569	89899612	1043	522.0	
74046	chr15	89910925	89911785	860	430.0	
74047	chr15	89912406	89913191	785	392.0	
74048	chr15	89936036	89937286	1250	625.0	
74049	chr15	89963179	89963822	643	322.0	
74050	chr15	89967808	89968415	607	304.0	
74051	chr15	89971522	89972427	905	452.0	
74052	chr15	89974370	89975225	855	428.0	
74053	chr15	89975854	89976651	797	398.0	
74054	chr15	89993309	89993810	501	250.0	
74055	chr15	89998637	89998708	71	36.0	
74056	chr15	89999246	90003384	4138	2069.0	
74057	chr15	90004267	90005410	1143	572.0	
74058	chr15	90009454	90010165	711	356.0	
74059	chr15	90013197	90014111	914	457.0	
74060	chr15	90019741	90020587	846	423.0	
74061	chr15	90031198	90031885	687	344.0	
74062	chr15	90033935	90036385	2450	1225.0	
74063	chr15	90037239	90038903	1664	832.0	
74064	chr15	90040072	90040345	273	136.0	
74065	chr15	90047078	90047538	460	230.0	
74066	chr15	90058063	90060350	2287	1144.0	
74067	chr15	90061718	90062791	1073	536.0	
74068	chr15	90063302	90065647	2345	1172.0	
74069	chr15	90070733	90071680	947	474.0	
74070	chr15	90082396	90082592	196	98.0	
74071	chr15	90086716	90088065	1349	674.0	
74072	chr15	90095393	90103283	7890	3945.0	
74073	chr15	90142486	90143723	1237	618.0	
74074	chr15	90157790	90158650	860	430.0	
74075	chr15	90159230	90159499	269	134.0	
74076	chr15	90160183	90160643	460	230.0	
74077	chr15	90161883	90162508	625	312.0	
74078	chr15	90165573	90166105	532	266.0	
74079	chr15	90184071	90185774	1703	852.0	
74080	chr15	90188816	90189557	741	370.0	
74081	chr15	90190636	90193583	2947	1474.0	
74082	chr15	90200417	90202291	1874	937.0	
74083	chr15	90205736	90206300	564	282.0	
74084	chr15	90211292	90211828	536	268.0	
74085	chr15	90213737	90215142	1405	702.0	
74086	chr15	90219327	90220163	836	418.0	
74087	chr15	90221250	90221697	447	224.0	
74088	chr15	90227772	90235030	7258	3629.0	
74089	chr15	90248746	90250020	1274	637.0	
74090	chr15	90264123	90267041	2918	1459.0	
74091	chr15	90286635	90287075	440	220.0	
74092	chr15	90291670	90291983	313	156.0	
74093	chr15	90293221	90293946	725	362.0	
74094	chr15	90300988	90301818	830	415.0	
74095	chr15	90306099	90307107	1008	504.0	
74096	chr15	90310070	90310597	527	264.0	
74097	chr15	90319766	90320619	853	426.0	
74098	chr15	90325602	90326193	591	296.0	
74099	chr15	90336661	90337567	906	453.0	
74100	chr15	90342568	90343023	455	228.0	
74101	chr15	90344344	90345191	847	424.0	
74102	chr15	90345842	90346169	327	164.0	
74103	chr15	90351607	90353030	1423	712.0	
74104	chr15	90361806	90362662	856	428.0	
74105	chr15	90367397	90367983	586	293.0	
74106	chr15	90376485	90377471	986	493.0	
74107	chr15	90387360	90390194	2834	1417.0	
74108	chr15	90390928	90391201	273	136.0	
74109	chr15	90393020	90393186	166	83.0	
74110	chr15	90394580	90394758	178	89.0	
74111	chr15	90400282	90402754	2472	1236.0	
74112	chr15	90407725	90408792	1067	534.0	
74113	chr15	90412294	90414359	2065	1032.0	
74114	chr15	90418658	90420005	1347	674.0	
74115	chr15	90478951	90479320	369	184.0	
74116	chr15	90480895	90481450	555	278.0	
74117	chr15	90482156	90482801	645	322.0	
74118	chr15	90511103	90511475	372	186.0	
74119	chr15	90513064	90513357	293	146.0	
74120	chr15	90522152	90522619	467	234.0	
74121	chr15	90529199	90531172	1973	986.0	
74122	chr15	90539633	90540315	682	341.0	
74123	chr15	90545126	90545360	234	117.0	
74124	chr15	90547577	90547923	346	173.0	
74125	chr15	90550624	90551420	796	398.0	
74126	chr15	90553958	90554464	506	253.0	
74127	chr15	90557432	90558636	1204	602.0	
74128	chr15	90561808	90562490	682	341.0	
74129	chr15	90563507	90564839	1332	666.0	
74130	chr15	90565943	90567145	1202	601.0	
74131	chr15	90568417	90569246	829	414.0	
74132	chr15	90570848	90572287	1439	720.0	
74133	chr15	90574257	90574941	684	342.0	
74134	chr15	90579332	90579622	290	145.0	
74135	chr15	90580286	90580428	142	71.0	
74136	chr15	90581853	90582308	455	228.0	
74137	chr15	90592286	90592674	388	194.0	
74138	chr15	90594083	90596351	2268	1134.0	
74139	chr15	90597415	90598678	1263	632.0	
74140	chr15	90603898	90604311	413	206.0	
74141	chr15	90620309	90620770	461	230.0	
74142	chr15	90646074	90646456	382	191.0	
74143	chr15	90647457	90649097	1640	820.0	
74144	chr15	90650059	90650427	368	184.0	
74145	chr15	90654642	90655135	493	246.0	
74146	chr15	90657709	90658269	560	280.0	
74147	chr15	90660087	90661773	1686	843.0	
74148	chr15	90664863	90666277	1414	707.0	
74149	chr15	90678227	90678972	745	372.0	
74150	chr15	90686041	90686936	895	448.0	
74151	chr15	90693613	90694088	475	238.0	
74152	chr15	90701025	90702262	1237	618.0	
74153	chr15	90711892	90712201	309	154.0	
74154	chr15	90716483	90718083	1600	800.0	
74155	chr15	90725431	90725635	204	102.0	
74156	chr15	90738615	90739462	847	424.0	
74157	chr15	90742104	90742496	392	196.0	
74158	chr15	90749787	90750640	853	426.0	
74159	chr15	90761949	90762600	651	326.0	
74160	chr15	90780924	90781278	354	177.0	
74161	chr15	90786274	90787019	745	372.0	
74162	chr15	90793338	90793717	379	190.0	
74163	chr15	90808379	90809047	668	334.0	
74164	chr15	90812158	90813190	1032	516.0	
74165	chr15	90816220	90816972	752	376.0	
74166	chr15	90818145	90820261	2116	1058.0	
74167	chr15	90824026	90824469	443	222.0	
74168	chr15	90829712	90831310	1598	799.0	
74169	chr15	90836313	90836713	400	200.0	
74170	chr15	90837678	90840373	2695	1348.0	
74171	chr15	90844703	90845813	1110	555.0	
74172	chr15	90850962	90853540	2578	1289.0	
74173	chr15	90854305	90854868	563	282.0	
74174	chr15	90856075	90857354	1279	640.0	
74175	chr15	90858033	90858259	226	113.0	
74176	chr15	90859251	90860000	749	374.0	
74177	chr15	90862959	90863887	928	464.0	
74178	chr15	90869184	90874487	5303	2652.0	
74179	chr15	90877381	90877743	362	181.0	
74180	chr15	90883036	90886482	3446	1723.0	
74181	chr15	90889343	90889915	572	286.0	
74182	chr15	90897001	90897649	648	324.0	
74183	chr15	90901776	90904227	2451	1226.0	
74184	chr15	90913883	90916504	2621	1310.0	
74185	chr15	90928019	90928693	674	337.0	
74186	chr15	90929332	90933149	3817	1908.0	
74187	chr15	90933875	90936078	2203	1102.0	
74188	chr15	90949541	90949945	404	202.0	
74189	chr15	90953891	90957376	3485	1742.0	
74190	chr15	90981661	90982548	887	444.0	
74191	chr15	90988592	90989414	822	411.0	
74192	chr15	90993633	90995504	1871	936.0	
74193	chr15	91021651	91023228	1577	788.0	
74194	chr15	91032891	91033586	695	348.0	
74195	chr15	91047378	91048057	679	340.0	
74196	chr15	91048773	91049188	415	208.0	
74197	chr15	91049709	91050299	590	295.0	
74198	chr15	91055807	91056302	495	248.0	
74199	chr15	91100089	91100565	476	238.0	
74200	chr15	91142163	91142443	280	140.0	
74201	chr15	91243762	91244267	505	252.0	
74202	chr15	91247589	91247948	359	180.0	
74203	chr15	91258366	91258836	470	235.0	
74204	chr15	91263854	91265160	1306	653.0	
74205	chr15	91271491	91272021	530	265.0	
74206	chr15	91289375	91289735	360	180.0	
74207	chr15	91291617	91292129	512	256.0	
74208	chr15	91302709	91303267	558	279.0	
74209	chr15	91308276	91308539	263	132.0	
74210	chr15	91311844	91312451	607	304.0	
74211	chr15	91316105	91316590	485	242.0	
74212	chr15	91319998	91320535	537	268.0	
74213	chr15	91348983	91349615	632	316.0	
74214	chr15	91370050	91370061	11	6.0	
74215	chr15	91407436	91407879	443	222.0	
74216	chr15	91422735	91423391	656	328.0	
74217	chr15	91426459	91426867	408	204.0	
74218	chr15	91453359	91453830	471	236.0	
74219	chr15	91469475	91470594	1119	560.0	
74220	chr15	91472164	91472907	743	372.0	
74221	chr15	91482835	91483111	276	138.0	
74222	chr15	91491079	91491738	659	330.0	
74223	chr15	91515380	91515702	322	161.0	
74224	chr15	91522573	91523073	500	250.0	
74225	chr15	91655842	91656243	401	200.0	
74226	chr15	91660271	91660571	300	150.0	
74227	chr15	91694897	91694911	14	7.0	
74228	chr15	91705989	91707025	1036	518.0	
74229	chr15	91849608	91850729	1121	560.0	
74230	chr15	91852064	91858415	6351	3176.0	
74231	chr15	91860775	91862049	1274	637.0	
74232	chr15	91863145	91863420	275	138.0	
74233	chr15	91864572	91865098	526	263.0	
74234	chr15	91866291	91866685	394	197.0	
74235	chr15	91871151	91872277	1126	563.0	
74236	chr15	91885895	91886306	411	206.0	
74237	chr15	91911864	91912291	427	214.0	
74238	chr15	91921207	91922069	862	431.0	
74239	chr15	91942622	91944071	1449	724.0	
74240	chr15	91946580	91948222	1642	821.0	
74241	chr15	91950382	91951160	778	389.0	
74242	chr15	91954207	91954925	718	359.0	
74243	chr15	91962383	91962748	365	182.0	
74244	chr15	91963836	91963998	162	81.0	
74245	chr15	91992964	91993071	107	54.0	
74246	chr15	92011890	92012059	169	84.0	
74247	chr15	92068081	92068617	536	268.0	
74248	chr15	92069365	92070295	930	465.0	
74249	chr15	92070960	92071603	643	322.0	
74250	chr15	92077261	92078025	764	382.0	
74251	chr15	92082199	92082675	476	238.0	
74252	chr15	92095422	92096278	856	428.0	
74253	chr15	92097498	92097999	501	250.0	
74254	chr15	92158577	92158718	141	70.0	
74255	chr15	92161055	92161368	313	156.0	
74256	chr15	92521559	92521893	334	167.0	
74257	chr15	92655541	92655939	398	199.0	
74258	chr15	92714199	92715237	1038	519.0	
74259	chr15	92728561	92728613	52	26.0	
74260	chr15	92733199	92734437	1238	619.0	
74261	chr15	92763652	92763769	117	58.0	
74262	chr15	92797051	92797785	734	367.0	
74263	chr15	92801860	92802455	595	298.0	
74264	chr15	92803539	92804771	1232	616.0	
74265	chr15	92807577	92811017	3440	1720.0	
74266	chr15	92813246	92814265	1019	510.0	
74267	chr15	92817353	92817946	593	296.0	
74268	chr15	92819656	92821081	1425	712.0	"enhancer	sequence_feature"
74269	chr15	92831277	92833403	2126	1063.0	
74270	chr15	92844745	92845639	894	447.0	
74271	chr15	92848858	92850572	1714	857.0	
74272	chr15	92879808	92880411	603	302.0	
74273	chr15	92881205	92885484	4279	2140.0	
74274	chr15	92886301	92886696	395	198.0	
74275	chr15	92887216	92887655	439	220.0	
74276	chr15	92889153	92890145	992	496.0	
74277	chr15	92890671	92891908	1237	618.0	
74278	chr15	92893747	92895616	1869	934.0	
74279	chr15	92896507	92897157	650	325.0	
74280	chr15	92899532	92901773	2241	1120.0	
74281	chr15	92902607	92916742	14135	7068.0	
74282	chr15	92917334	92918416	1082	541.0	
74283	chr15	92920737	92923513	2776	1388.0	
74284	chr15	92924164	92924705	541	270.0	
74285	chr15	92925609	92926185	576	288.0	
74286	chr15	92930490	92930889	399	200.0	
74287	chr15	92931470	92931532	62	31.0	
74288	chr15	92932681	92934145	1464	732.0	
74289	chr15	92936672	92937097	425	212.0	
74290	chr15	92945056	92945279	223	112.0	
74291	chr15	92958058	92958538	480	240.0	
74292	chr15	92959429	92959632	203	102.0	
74293	chr15	92969294	92969702	408	204.0	
74294	chr15	92989528	92989846	318	159.0	
74295	chr15	93024911	93031278	6367	3184.0	
74296	chr15	93035753	93038106	2353	1176.0	
74297	chr15	93039690	93040950	1260	630.0	
74298	chr15	93047385	93048349	964	482.0	
74299	chr15	93050145	93050625	480	240.0	
74300	chr15	93052488	93052889	401	200.0	
74301	chr15	93072579	93073885	1306	653.0	
74302	chr15	93087748	93089670	1922	961.0	
74303	chr15	93141223	93141897	674	337.0	
74304	chr15	93150999	93151060	61	30.0	
74305	chr15	93152097	93152768	671	336.0	
74306	chr15	93178775	93179629	854	427.0	
74307	chr15	93225475	93226195	720	360.0	
74308	chr15	93235866	93236864	998	499.0	
74309	chr15	93247512	93248269	757	378.0	
74310	chr15	93250143	93250654	511	256.0	
74311	chr15	93252752	93253148	396	198.0	
74312	chr15	93261611	93261982	371	186.0	
74313	chr15	93275905	93276396	491	246.0	
74314	chr15	93861567	93863644	2077	1038.0	
74315	chr15	93865533	93865995	462	231.0	
74316	chr15	93987064	93987474	410	205.0	
74317	chr15	94059223	94059620	397	198.0	
74318	chr15	94119828	94120376	548	274.0	
74319	chr15	94164172	94165131	959	480.0	
74320	chr15	94172702	94173549	847	424.0	
74321	chr15	94174122	94175012	890	445.0	
74322	chr15	94177208	94177487	279	140.0	
74323	chr15	94185586	94185877	291	146.0	
74324	chr15	94203398	94203468	70	35.0	
74325	chr15	94205387	94205732	345	172.0	
74326	chr15	94206309	94207244	935	468.0	
74327	chr15	94229265	94232936	3671	1836.0	
74328	chr15	94233472	94233646	174	87.0	
74329	chr15	94234233	94234798	565	282.0	
74330	chr15	94235582	94236235	653	326.0	
74331	chr15	94238440	94239089	649	324.0	
74332	chr15	94253609	94254198	589	294.0	
74333	chr15	94256556	94256950	394	197.0	
74334	chr15	94258189	94258661	472	236.0	
74335	chr15	94259342	94260297	955	478.0	
74336	chr15	94263376	94264016	640	320.0	
74337	chr15	94272137	94273277	1140	570.0	
74338	chr15	94286762	94286817	55	28.0	
74339	chr15	94287458	94288409	951	476.0	
74340	chr15	94290763	94291098	335	168.0	
74341	chr15	94294178	94294367	189	94.0	
74342	chr15	94295371	94295383	12	6.0	
74343	chr15	94297460	94298042	582	291.0	
74344	chr15	94304974	94305675	701	350.0	
74345	chr15	94306588	94307584	996	498.0	
74346	chr15	94322203	94322557	354	177.0	
74347	chr15	94323071	94323154	83	42.0	
74348	chr15	94323983	94324700	717	358.0	
74349	chr15	94327362	94327733	371	186.0	
74350	chr15	94370419	94371268	849	424.0	
74351	chr15	94387806	94388340	534	267.0	
74352	chr15	94413470	94413597	127	64.0	
74353	chr15	94584708	94585201	493	246.0	
74354	chr15	95259456	95259814	358	179.0	
74355	chr15	95410045	95410052	7	4.0	
74356	chr15	95446740	95447363	623	312.0	
74357	chr15	95621042	95621282	240	120.0	
74358	chr15	95826843	95827126	283	142.0	
74359	chr15	95839141	95839896	755	378.0	
74360	chr15	95864312	95864955	643	322.0	
74361	chr15	95865478	95865879	401	200.0	
74362	chr15	95869921	95870206	285	142.0	
74363	chr15	95875144	95875736	592	296.0	
74364	chr15	95879310	95880031	721	360.0	
74365	chr15	95929318	95929675	357	178.0	
74366	chr15	96042889	96043317	428	214.0	
74367	chr15	96053090	96053902	812	406.0	
74368	chr15	96058318	96058980	662	331.0	
74369	chr15	96327282	96327528	246	123.0	
74370	chr15	96330169	96331274	1105	552.0	
74371	chr15	96356690	96358005	1315	658.0	
74372	chr15	96582504	96582862	358	179.0	
74373	chr15	96585904	96587375	1471	736.0	enhancer
74374	chr15	97501067	97501757	690	345.0	
74375	chr15	97504101	97504542	441	220.0	
74376	chr15	97909286	97909715	429	214.0	
74377	chr15	97959761	97961999	2238	1119.0	
74378	chr15	97966119	97966136	17	8.0	
74379	chr15	97984178	97984657	479	240.0	
74380	chr15	97995870	97996296	426	213.0	
74381	chr15	98076468	98076870	402	201.0	
74382	chr15	98085252	98085360	108	54.0	
74383	chr15	98160130	98160667	537	268.0	
74384	chr15	98169543	98170017	474	237.0	
74385	chr15	98178026	98178331	305	152.0	
74386	chr15	98421561	98422035	474	237.0	
74387	chr15	98428291	98428806	515	258.0	
74388	chr15	98442381	98442768	387	194.0	
74389	chr15	98518984	98519534	550	275.0	
74390	chr15	98547622	98548867	1245	622.0	
74391	chr15	98600181	98600887	706	353.0	
74392	chr15	98612836	98612864	28	14.0	
74393	chr15	98646831	98652349	5518	2759.0	
74394	chr15	98659164	98659682	518	259.0	
74395	chr15	98713727	98713836	109	54.0	
74396	chr15	98734553	98735113	560	280.0	
74397	chr15	98776566	98777309	743	372.0	
74398	chr15	98779347	98780184	837	418.0	
74399	chr15	98788125	98788831	706	353.0	
74400	chr15	98800651	98801325	674	337.0	
74401	chr15	98823052	98823528	476	238.0	
74402	chr15	98845256	98845644	388	194.0	
74403	chr15	98850503	98853785	3282	1641.0	
74404	chr15	98858594	98859081	487	244.0	
74405	chr15	98865204	98866876	1672	836.0	
74406	chr15	98873501	98874493	992	496.0	
74407	chr15	98881558	98882010	452	226.0	
74408	chr15	98899232	98900113	881	440.0	
74409	chr15	98904605	98904822	217	108.0	
74410	chr15	98915174	98915651	477	238.0	
74411	chr15	98952330	98953633	1303	652.0	
74412	chr15	98978095	98978494	399	200.0	
74413	chr15	99008719	99008912	193	96.0	
74414	chr15	99014697	99015635	938	469.0	
74415	chr15	99018044	99018456	412	206.0	
74416	chr15	99058811	99059504	693	346.0	
74417	chr15	99076473	99077142	669	334.0	
74418	chr15	99090311	99090728	417	208.0	
74419	chr15	99100558	99100900	342	171.0	
74420	chr15	99104676	99105969	1293	646.0	
74421	chr15	99124142	99124464	322	161.0	
74422	chr15	99213202	99213603	401	200.0	
74423	chr15	99239835	99240018	183	92.0	
74424	chr15	99248274	99248583	309	154.0	
74425	chr15	99249405	99249604	199	100.0	
74426	chr15	99250613	99252390	1777	888.0	
74427	chr15	99272953	99273418	465	232.0	
74428	chr15	99286424	99286806	382	191.0	
74429	chr15	99343821	99344227	406	203.0	
74430	chr15	99408931	99409525	594	297.0	
74431	chr15	99421037	99421512	475	238.0	
74432	chr15	99424758	99425809	1051	526.0	
74433	chr15	99433320	99433710	390	195.0	
74434	chr15	99438625	99438963	338	169.0	
74435	chr15	99444053	99444607	554	277.0	
74436	chr15	99447515	99447895	380	190.0	
74437	chr15	99450742	99451530	788	394.0	
74438	chr15	99452467	99453808	1341	670.0	
74439	chr15	99454868	99455413	545	272.0	
74440	chr15	99473872	99474691	819	410.0	
74441	chr15	99476356	99477412	1056	528.0	
74442	chr15	99478253	99478579	326	163.0	
74443	chr15	99485431	99487687	2256	1128.0	
74444	chr15	99495771	99496504	733	366.0	
74445	chr15	99500131	99500938	807	404.0	
74446	chr15	99502083	99502578	495	248.0	
74447	chr15	99503999	99505077	1078	539.0	
74448	chr15	99507648	99508210	562	281.0	
74449	chr15	99509402	99511142	1740	870.0	
74450	chr15	99511778	99512580	802	401.0	
74451	chr15	99556053	99556423	370	185.0	
74452	chr15	99562206	99567830	5624	2812.0	
74453	chr15	99614164	99615307	1143	572.0	
74454	chr15	99630991	99631836	845	422.0	
74455	chr15	99658015	99658422	407	204.0	
74456	chr15	99683258	99683347	89	44.0	
74457	chr15	99703134	99704849	1715	858.0	
74458	chr15	99706603	99707879	1276	638.0	
74459	chr15	99720464	99721494	1030	515.0	
74460	chr15	99729947	99730278	331	166.0	
74461	chr15	99732358	99734195	1837	918.0	
74462	chr15	99755672	99756273	601	300.0	
74463	chr15	99770689	99771130	441	220.0	
74464	chr15	99805893	99806433	540	270.0	
74465	chr15	99807024	99807471	447	224.0	
74466	chr15	99911995	99912398	403	202.0	
74467	chr15	99915598	99917596	1998	999.0	
74468	chr15	99925641	99926654	1013	506.0	
74469	chr15	99928242	99929170	928	464.0	
74470	chr15	100201663	100202160	497	248.0	
74471	chr15	100229293	100230019	726	363.0	
74472	chr15	100330059	100331241	1182	591.0	
74473	chr15	100332813	100335669	2856	1428.0	
74474	chr15	100338526	100339604	1078	539.0	
74475	chr15	100340663	100342758	2095	1048.0	
74476	chr15	100349270	100351234	1964	982.0	
74477	chr15	100353431	100353922	491	246.0	
74478	chr15	100383759	100384202	443	222.0	
74479	chr15	100394725	100395204	479	240.0	
74480	chr15	100517146	100517836	690	345.0	
74481	chr15	100520055	100520943	888	444.0	
74482	chr15	100537259	100537838	579	290.0	
74483	chr15	100559286	100559818	532	266.0	
74484	chr15	100560369	100560727	358	179.0	
74485	chr15	100572421	100572779	358	179.0	
74486	chr15	100580607	100580694	87	44.0	
74487	chr15	100595781	100598179	2398	1199.0	
74488	chr15	100600771	100603631	2860	1430.0	
74489	chr15	100612646	100612839	193	96.0	
74490	chr15	100627704	100628238	534	267.0	
74491	chr15	100721651	100722332	681	340.0	
74492	chr15	100833791	100834214	423	212.0	
74493	chr15	100849335	100849962	627	314.0	
74494	chr15	100872872	100873493	621	310.0	
74495	chr15	100879431	100879915	484	242.0	
74496	chr15	100902486	100902903	417	208.0	
74497	chr15	100917878	100920878	3000	1500.0	
74498	chr15	100922141	100922804	663	332.0	
74499	chr15	100934562	100935216	654	327.0	
74500	chr15	100939788	100940181	393	196.0	
74501	chr15	100940690	100941880	1190	595.0	
74502	chr15	100952183	100952330	147	74.0	
74503	chr15	100958713	100959824	1111	556.0	
74504	chr15	101006826	101009063	2237	1118.0	
74505	chr15	101015134	101015626	492	246.0	
74506	chr15	101018087	101018488	401	200.0	
74507	chr15	101035589	101035951	362	181.0	
74508	chr15	101062709	101063153	444	222.0	
74509	chr15	101070583	101071037	454	227.0	
74510	chr15	101088506	101089403	897	448.0	
74511	chr15	101116141	101116399	258	129.0	
74512	chr15	101121511	101122302	791	396.0	
74513	chr15	101123579	101123875	296	148.0	
74514	chr15	101124581	101125547	966	483.0	
74515	chr15	101126655	101128127	1472	736.0	
74516	chr15	101130086	101130364	278	139.0	
74517	chr15	101135496	101136025	529	264.0	
74518	chr15	101137135	101138052	917	458.0	
74519	chr15	101139979	101140617	638	319.0	
74520	chr15	101150108	101150827	719	360.0	
74521	chr15	101152818	101153233	415	208.0	
74522	chr15	101156581	101156910	329	164.0	
74523	chr15	101167561	101168793	1232	616.0	
74524	chr15	101175369	101175883	514	257.0	
74525	chr15	101187942	101188285	343	172.0	
74526	chr15	101193496	101194727	1231	616.0	
74527	chr15	101199657	101200170	513	256.0	
74528	chr15	101201284	101201935	651	326.0	
74529	chr15	101203755	101204142	387	194.0	
74530	chr15	101206037	101206635	598	299.0	
74531	chr15	101207712	101208408	696	348.0	
74532	chr15	101237080	101237689	609	304.0	
74533	chr15	101239464	101240259	795	398.0	
74534	chr15	101242105	101245281	3176	1588.0	
74535	chr15	101246656	101248520	1864	932.0	
74536	chr15	101249927	101252947	3020	1510.0	
74537	chr15	101257887	101258768	881	440.0	
74538	chr15	101269890	101269950	60	30.0	
74539	chr15	101276189	101278206	2017	1008.0	
74540	chr15	101288669	101289485	816	408.0	
74541	chr15	101293311	101296290	2979	1490.0	
74542	chr15	101300257	101300923	666	333.0	
74543	chr15	101320335	101321351	1016	508.0	
74544	chr15	101333579	101335064	1485	742.0	
74545	chr15	101446023	101446756	733	366.0	
74546	chr15	101455148	101456185	1037	518.0	
74547	chr15	101499983	101500421	438	219.0	
74548	chr15	101501788	101502379	591	296.0	
74549	chr15	101625037	101625673	636	318.0	
74550	chr15	101640751	101642736	1985	992.0	
74551	chr15	101646628	101647059	431	216.0	
74552	chr15	101651506	101653303	1797	898.0	
74553	chr15	101654156	101654607	451	226.0	
74554	chr15	101723144	101725248	2104	1052.0	
74555	chr15	101745293	101746841	1548	774.0	
74556	chr16	10000	11312	1312	656.0	
74557	chr16	34662	35723	1061	530.0	
74558	chr16	37528	37938	410	205.0	
74559	chr16	38677	39582	905	452.0	
74560	chr16	52795	54516	1721	860.0	
74561	chr16	57792	57896	104	52.0	
74562	chr16	65399	66444	1045	522.0	
74563	chr16	71834	72957	1123	562.0	
74564	chr16	75954	79323	3369	1684.0	
74565	chr16	84516	85369	853	426.0	
74566	chr16	96618	97706	1088	544.0	locus_control_region
74567	chr16	106781	107473	692	346.0	"locus_control_region	enhancer"
74568	chr16	117665	118274	609	304.0	locus_control_region
74569	chr16	123878	124432	554	277.0	locus_control_region
74570	chr16	137930	139354	1424	712.0	locus_control_region
74571	chr16	154042	154935	893	446.0	
74572	chr16	164838	167133	2295	1148.0	
74573	chr16	175025	175354	329	164.0	
74574	chr16	180061	182175	2114	1057.0	
74575	chr16	228446	229896	1450	725.0	
74576	chr16	233958	236034	2076	1038.0	
74577	chr16	241834	242336	502	251.0	
74578	chr16	252455	253437	982	491.0	
74579	chr16	275148	275549	401	200.0	
74580	chr16	278826	279383	557	278.0	
74581	chr16	280470	280653	183	92.0	
74582	chr16	303664	304097	433	216.0	
74583	chr16	307620	309885	2265	1132.0	
74584	chr16	321981	322608	627	314.0	
74585	chr16	323513	325988	2475	1238.0	
74586	chr16	326562	328172	1610	805.0	
74587	chr16	336159	336728	569	284.0	
74588	chr16	337896	338524	628	314.0	
74589	chr16	339414	340767	1353	676.0	
74590	chr16	351666	355663	3997	1998.0	
74591	chr16	361756	362747	991	496.0	
74592	chr16	363339	363504	165	82.0	
74593	chr16	364730	364905	175	88.0	
74594	chr16	370166	371769	1603	802.0	
74595	chr16	372885	373049	164	82.0	
74596	chr16	380800	384765	3965	1982.0	
74597	chr16	391692	393106	1414	707.0	
74598	chr16	396517	399062	2545	1272.0	
74599	chr16	399930	402626	2696	1348.0	
74600	chr16	424365	427349	2984	1492.0	
74601	chr16	487717	488044	327	164.0	
74602	chr16	495429	495639	210	105.0	
74603	chr16	525238	530823	5585	2792.0	
74604	chr16	535511	535938	427	214.0	
74605	chr16	546444	547720	1276	638.0	
74606	chr16	555089	555454	365	182.0	
74607	chr16	566562	567468	906	453.0	
74608	chr16	569279	571744	2465	1232.0	
74609	chr16	578736	579573	837	418.0	
74610	chr16	584159	584349	190	95.0	
74611	chr16	587949	590896	2947	1474.0	
74612	chr16	592443	593362	919	460.0	
74613	chr16	596191	596661	470	235.0	
74614	chr16	610989	611516	527	264.0	
74615	chr16	629933	630080	147	74.0	
74616	chr16	631068	631555	487	244.0	
74617	chr16	634871	638140	3269	1634.0	
74618	chr16	641176	643394	2218	1109.0	
74619	chr16	647943	650052	2109	1054.0	
74620	chr16	660220	661546	1326	663.0	
74621	chr16	667416	669549	2133	1066.0	
74622	chr16	672314	672344	30	15.0	
74623	chr16	674738	681464	6726	3363.0	
74624	chr16	683418	685105	1687	844.0	
74625	chr16	685988	686411	423	212.0	
74626	chr16	689664	691031	1367	684.0	
74627	chr16	693202	696240	3038	1519.0	
74628	chr16	699286	699703	417	208.0	
74629	chr16	700375	701251	876	438.0	
74630	chr16	705652	707311	1659	830.0	
74631	chr16	711449	712195	746	373.0	
74632	chr16	712777	713266	489	244.0	
74633	chr16	714150	716334	2184	1092.0	
74634	chr16	719646	723109	3463	1732.0	
74635	chr16	723759	729098	5339	2670.0	
74636	chr16	730104	730150	46	23.0	
74637	chr16	733599	734090	491	246.0	
74638	chr16	740346	741731	1385	692.0	
74639	chr16	745746	746026	280	140.0	
74640	chr16	754579	755089	510	255.0	
74641	chr16	757423	757920	497	248.0	
74642	chr16	785201	786206	1005	502.0	
74643	chr16	787637	789316	1679	840.0	
74644	chr16	800573	800809	236	118.0	
74645	chr16	806713	808495	1782	891.0	
74646	chr16	813535	814077	542	271.0	
74647	chr16	819363	819773	410	205.0	
74648	chr16	877421	878063	642	321.0	
74649	chr16	963836	965249	1413	706.0	
74650	chr16	970034	971770	1736	868.0	
74651	chr16	976355	976594	239	120.0	
74652	chr16	978070	978722	652	326.0	
74653	chr16	979784	982661	2877	1438.0	
74654	chr16	996621	998620	1999	1000.0	
74655	chr16	1002758	1003168	410	205.0	
74656	chr16	1003839	1004621	782	391.0	
74657	chr16	1048514	1048791	277	138.0	
74658	chr16	1055131	1055477	346	173.0	
74659	chr16	1057436	1057870	434	217.0	
74660	chr16	1102758	1103451	693	346.0	
74661	chr16	1106268	1106688	420	210.0	
74662	chr16	1151678	1154282	2604	1302.0	
74663	chr16	1188709	1189110	401	200.0	
74664	chr16	1194589	1194986	397	198.0	
74665	chr16	1206791	1207138	347	174.0	
74666	chr16	1208228	1208654	426	213.0	
74667	chr16	1244912	1245318	406	203.0	
74668	chr16	1247321	1247591	270	135.0	
74669	chr16	1259079	1259208	129	64.0	
74670	chr16	1290010	1290362	352	176.0	
74671	chr16	1300626	1301506	880	440.0	
74672	chr16	1303323	1304833	1510	755.0	
74673	chr16	1308266	1312377	4111	2056.0	
74674	chr16	1325971	1326136	165	82.0	
74675	chr16	1330487	1336341	5854	2927.0	
74676	chr16	1338109	1338544	435	218.0	
74677	chr16	1342191	1344831	2640	1320.0	
74678	chr16	1351110	1352588	1478	739.0	
74679	chr16	1363329	1364025	696	348.0	
74680	chr16	1366236	1366264	28	14.0	
74681	chr16	1366778	1366779	1	0.0	
74682	chr16	1370152	1370763	611	306.0	
74683	chr16	1378653	1380609	1956	978.0	
74684	chr16	1407669	1409015	1346	673.0	
74685	chr16	1413337	1415709	2372	1186.0	
74686	chr16	1416955	1417014	59	30.0	
74687	chr16	1420036	1421726	1690	845.0	enhancer
74688	chr16	1428416	1429011	595	298.0	
74689	chr16	1432153	1433168	1015	508.0	
74690	chr16	1444986	1445505	519	260.0	
74691	chr16	1458654	1459458	804	402.0	
74692	chr16	1469522	1471639	2117	1058.0	
74693	chr16	1474282	1475919	1637	818.0	
74694	chr16	1480345	1480984	639	320.0	
74695	chr16	1483266	1483783	517	258.0	
74696	chr16	1492600	1494202	1602	801.0	
74697	chr16	1525788	1527501	1713	856.0	
74698	chr16	1533044	1536191	3147	1574.0	
74699	chr16	1537715	1539173	1458	729.0	
74700	chr16	1542984	1544271	1287	644.0	
74701	chr16	1559428	1559819	391	196.0	
74702	chr16	1609953	1615271	5318	2659.0	
74703	chr16	1646251	1646404	153	76.0	
74704	chr16	1677634	1679183	1549	774.0	
74705	chr16	1705017	1707737	2720	1360.0	
74706	chr16	1708354	1709119	765	382.0	
74707	chr16	1712807	1714474	1667	834.0	
74708	chr16	1717701	1717787	86	43.0	
74709	chr16	1719570	1720266	696	348.0	
74710	chr16	1721710	1722821	1111	556.0	
74711	chr16	1723330	1724000	670	335.0	
74712	chr16	1731474	1731849	375	188.0	
74713	chr16	1757330	1757591	261	130.0	
74714	chr16	1766774	1767480	706	353.0	
74715	chr16	1768836	1774468	5632	2816.0	
74716	chr16	1781436	1783805	2369	1184.0	
74717	chr16	1812618	1813113	495	248.0	
74718	chr16	1825602	1827833	2231	1116.0	
74719	chr16	1855191	1856006	815	408.0	
74720	chr16	1863606	1864218	612	306.0	
74721	chr16	1871968	1872490	522	261.0	
74722	chr16	1920873	1921232	359	180.0	
74723	chr16	1923500	1924097	597	298.0	
74724	chr16	1929120	1930486	1366	683.0	
74725	chr16	1938193	1938962	769	384.0	
74726	chr16	1941595	1944060	2465	1232.0	
74727	chr16	1958740	1966214	7474	3737.0	
74728	chr16	1971094	1973026	1932	966.0	
74729	chr16	1979128	1980476	1348	674.0	
74730	chr16	1983202	1985019	1817	908.0	
74731	chr16	1988763	1994287	5524	2762.0	
74732	chr16	2003693	2004473	780	390.0	
74733	chr16	2005357	2006074	717	358.0	
74734	chr16	2007779	2010703	2924	1462.0	
74735	chr16	2015214	2016867	1653	826.0	
74736	chr16	2019478	2020607	1129	564.0	
74737	chr16	2022601	2024100	1499	750.0	
74738	chr16	2026413	2028353	1940	970.0	
74739	chr16	2032870	2033975	1105	552.0	
74740	chr16	2043931	2044386	455	228.0	
74741	chr16	2046917	2048727	1810	905.0	
74742	chr16	2065199	2065702	503	252.0	
74743	chr16	2081962	2082209	247	124.0	
74744	chr16	2087266	2087421	155	78.0	
74745	chr16	2090183	2091594	1411	706.0	
74746	chr16	2121397	2121797	400	200.0	
74747	chr16	2124863	2126062	1199	600.0	
74748	chr16	2127009	2128967	1958	979.0	
74749	chr16	2135163	2136711	1548	774.0	
74750	chr16	2140293	2141220	927	464.0	
74751	chr16	2143198	2144229	1031	516.0	
74752	chr16	2147427	2150496	3069	1534.0	
74753	chr16	2151557	2151719	162	81.0	
74754	chr16	2152616	2156969	4353	2176.0	
74755	chr16	2178416	2179187	771	386.0	
74756	chr16	2194754	2197143	2389	1194.0	
74757	chr16	2204730	2206503	1773	886.0	
74758	chr16	2212871	2213363	492	246.0	
74759	chr16	2214050	2215878	1828	914.0	
74760	chr16	2222911	2224467	1556	778.0	
74761	chr16	2236199	2237965	1766	883.0	
74762	chr16	2250762	2253536	2774	1387.0	
74763	chr16	2266922	2269536	2614	1307.0	
74764	chr16	2272695	2273194	499	250.0	
74765	chr16	2295151	2295464	313	156.0	
74766	chr16	2296621	2296956	335	168.0	
74767	chr16	2339600	2342228	2628	1314.0	
74768	chr16	2422076	2423682	1606	803.0	
74769	chr16	2428298	2430761	2463	1232.0	
74770	chr16	2440110	2440386	276	138.0	
74771	chr16	2459236	2460753	1517	758.0	
74772	chr16	2467389	2469213	1824	912.0	
74773	chr16	2470757	2471819	1062	531.0	
74774	chr16	2473357	2476071	2714	1357.0	
74775	chr16	2486675	2488769	2094	1047.0	
74776	chr16	2494135	2494591	456	228.0	
74777	chr16	2500778	2501890	1112	556.0	
74778	chr16	2502907	2503365	458	229.0	
74779	chr16	2506872	2508435	1563	782.0	
74780	chr16	2509679	2510486	807	404.0	
74781	chr16	2512515	2521772	9257	4628.0	
74782	chr16	2523708	2524519	811	406.0	
74783	chr16	2526227	2533681	7454	3727.0	
74784	chr16	2535363	2538621	3258	1629.0	
74785	chr16	2539898	2541487	1589	794.0	
74786	chr16	2560221	2561162	941	470.0	
74787	chr16	2603013	2604303	1290	645.0	
74788	chr16	2607557	2608046	489	244.0	
74789	chr16	2660655	2661085	430	215.0	
74790	chr16	2669936	2670497	561	280.0	
74791	chr16	2672784	2675001	2217	1108.0	
74792	chr16	2681966	2683348	1382	691.0	
74793	chr16	2686755	2687861	1106	553.0	
74794	chr16	2693251	2693496	245	122.0	
74795	chr16	2710729	2710753	24	12.0	
74796	chr16	2713626	2713926	300	150.0	
74797	chr16	2715099	2716647	1548	774.0	
74798	chr16	2717575	2717599	24	12.0	
74799	chr16	2719850	2721954	2104	1052.0	
74800	chr16	2751513	2757544	6031	3016.0	
74801	chr16	2759929	2759956	27	14.0	
74802	chr16	2762050	2773206	11156	5578.0	
74803	chr16	2775057	2775553	496	248.0	
74804	chr16	2776320	2778806	2486	1243.0	
74805	chr16	2784801	2786244	1443	722.0	
74806	chr16	2793789	2794963	1174	587.0	
74807	chr16	2795817	2796039	222	111.0	
74808	chr16	2799963	2800158	195	98.0	
74809	chr16	2816985	2817507	522	261.0	
74810	chr16	2823388	2823759	371	186.0	
74811	chr16	2838747	2839338	591	296.0	
74812	chr16	2840991	2844064	3073	1536.0	
74813	chr16	2845026	2845411	385	192.0	
74814	chr16	2846430	2847193	763	382.0	
74815	chr16	2852765	2853073	308	154.0	
74816	chr16	2856206	2856655	449	224.0	
74817	chr16	2857401	2858935	1534	767.0	
74818	chr16	2867706	2869086	1380	690.0	
74819	chr16	2874578	2875493	915	458.0	
74820	chr16	2881839	2883969	2130	1065.0	
74821	chr16	2897129	2897522	393	196.0	
74822	chr16	2903842	2907695	3853	1926.0	
74823	chr16	2911231	2912992	1761	880.0	
74824	chr16	2919390	2920127	737	368.0	
74825	chr16	2926653	2927657	1004	502.0	
74826	chr16	2956029	2956602	573	286.0	
74827	chr16	2961452	2970915	9463	4732.0	
74828	chr16	2979581	2981225	1644	822.0	
74829	chr16	2983389	2984309	920	460.0	
74830	chr16	3003448	3005140	1692	846.0	
74831	chr16	3007028	3008635	1607	804.0	
74832	chr16	3018129	3018560	431	216.0	
74833	chr16	3019857	3024978	5121	2560.0	
74834	chr16	3027784	3030320	2536	1268.0	
74835	chr16	3031383	3032084	701	350.0	
74836	chr16	3032722	3032905	183	92.0	
74837	chr16	3033736	3034179	443	222.0	
74838	chr16	3036067	3037114	1047	524.0	
74839	chr16	3045238	3047613	2375	1188.0	
74840	chr16	3048487	3049036	549	274.0	
74841	chr16	3054780	3055510	730	365.0	
74842	chr16	3057948	3060221	2273	1136.0	
74843	chr16	3062270	3062361	91	46.0	
74844	chr16	3064820	3066676	1856	928.0	
74845	chr16	3067211	3068909	1698	849.0	
74846	chr16	3069956	3070357	401	200.0	
74847	chr16	3072157	3072494	337	168.0	
74848	chr16	3073022	3073166	144	72.0	
74849	chr16	3074132	3076001	1869	934.0	
74850	chr16	3076698	3077517	819	410.0	
74851	chr16	3086628	3087610	982	491.0	
74852	chr16	3094507	3095069	562	281.0	
74853	chr16	3095614	3096795	1181	590.0	
74854	chr16	3099044	3102584	3540	1770.0	
74855	chr16	3105440	3107404	1964	982.0	
74856	chr16	3123365	3125276	1911	956.0	
74857	chr16	3129025	3130239	1214	607.0	
74858	chr16	3131703	3132215	512	256.0	
74859	chr16	3133951	3135836	1885	942.0	
74860	chr16	3149370	3153265	3895	1948.0	
74861	chr16	3154783	3160328	5545	2772.0	
74862	chr16	3165527	3166389	862	431.0	
74863	chr16	3170329	3172513	2184	1092.0	
74864	chr16	3174016	3174546	530	265.0	
74865	chr16	3175160	3175615	455	228.0	
74866	chr16	3182566	3184498	1932	966.0	
74867	chr16	3187629	3189794	2165	1082.0	
74868	chr16	3190828	3191527	699	350.0	
74869	chr16	3214789	3216339	1550	775.0	
74870	chr16	3234484	3236293	1809	904.0	
74871	chr16	3242715	3243177	462	231.0	
74872	chr16	3256201	3257205	1004	502.0	
74873	chr16	3257946	3260306	2360	1180.0	
74874	chr16	3262847	3265344	2497	1248.0	
74875	chr16	3266882	3267352	470	235.0	
74876	chr16	3282162	3284224	2062	1031.0	
74877	chr16	3304840	3306252	1412	706.0	
74878	chr16	3364631	3365647	1016	508.0	
74879	chr16	3400342	3402077	1735	868.0	
74880	chr16	3431514	3432291	777	388.0	
74881	chr16	3442758	3444452	1694	847.0	
74882	chr16	3456182	3460045	3863	1932.0	
74883	chr16	3461038	3461650	612	306.0	
74884	chr16	3467919	3468342	423	212.0	
74885	chr16	3499640	3501672	2032	1016.0	
74886	chr16	3503348	3504097	749	374.0	
74887	chr16	3509360	3510156	796	398.0	
74888	chr16	3527209	3527682	473	236.0	
74889	chr16	3547011	3547390	379	190.0	
74890	chr16	3548394	3548997	603	302.0	
74891	chr16	3575661	3580747	5086	2543.0	
74892	chr16	3585536	3585909	373	186.0	
74893	chr16	3589329	3590018	689	344.0	
74894	chr16	3591038	3591375	337	168.0	
74895	chr16	3610344	3612692	2348	1174.0	
74896	chr16	3618709	3619141	432	216.0	
74897	chr16	3625928	3626854	926	463.0	
74898	chr16	3637250	3637878	628	314.0	
74899	chr16	3654014	3654696	682	341.0	
74900	chr16	3665441	3665959	518	259.0	
74901	chr16	3690312	3691201	889	444.0	
74902	chr16	3716659	3718365	1706	853.0	
74903	chr16	3725307	3725367	60	30.0	
74904	chr16	3731142	3731358	216	108.0	
74905	chr16	3734556	3735038	482	241.0	
74906	chr16	3767633	3767949	316	158.0	
74907	chr16	3780591	3780927	336	168.0	
74908	chr16	3789598	3790186	588	294.0	
74909	chr16	3798226	3799178	952	476.0	
74910	chr16	3818261	3820191	1930	965.0	
74911	chr16	3854205	3855231	1026	513.0	
74912	chr16	3856494	3858045	1551	776.0	
74913	chr16	3860728	3861106	378	189.0	
74914	chr16	3861735	3862510	775	388.0	
74915	chr16	3863614	3864040	426	213.0	
74916	chr16	3871027	3871549	522	261.0	
74917	chr16	3876796	3877126	330	165.0	
74918	chr16	3878571	3881935	3364	1682.0	
74919	chr16	3903168	3903436	268	134.0	
74920	chr16	3938814	3939526	712	356.0	
74921	chr16	3954212	3954706	494	247.0	
74922	chr16	3960594	3961269	675	338.0	
74923	chr16	3962576	3963856	1280	640.0	
74924	chr16	3968693	3968925	232	116.0	
74925	chr16	3982949	3983637	688	344.0	
74926	chr16	4011112	4011908	796	398.0	
74927	chr16	4016541	4017248	707	354.0	
74928	chr16	4019253	4019732	479	240.0	
74929	chr16	4032735	4033204	469	234.0	
74930	chr16	4052732	4054141	1409	704.0	
74931	chr16	4059802	4060564	762	381.0	
74932	chr16	4064794	4065521	727	364.0	
74933	chr16	4081477	4082000	523	262.0	
74934	chr16	4095987	4096082	95	48.0	
74935	chr16	4114928	4117226	2298	1149.0	
74936	chr16	4142116	4142915	799	400.0	
74937	chr16	4161043	4161309	266	133.0	
74938	chr16	4179024	4179464	440	220.0	
74939	chr16	4182887	4184611	1724	862.0	
74940	chr16	4194562	4195152	590	295.0	
74941	chr16	4200159	4200609	450	225.0	
74942	chr16	4245411	4245777	366	183.0	
74943	chr16	4253017	4254577	1560	780.0	
74944	chr16	4261523	4261976	453	226.0	
74945	chr16	4263606	4263996	390	195.0	
74946	chr16	4270915	4274469	3554	1777.0	
74947	chr16	4288149	4288994	845	422.0	
74948	chr16	4290425	4290930	505	252.0	
74949	chr16	4306137	4310352	4215	2108.0	
74950	chr16	4313729	4316935	3206	1603.0	
74951	chr16	4319283	4319876	593	296.0	
74952	chr16	4325390	4325854	464	232.0	
74953	chr16	4327435	4328776	1341	670.0	
74954	chr16	4330207	4330760	553	276.0	
74955	chr16	4345750	4347496	1746	873.0	
74956	chr16	4350499	4352336	1837	918.0	
74957	chr16	4358982	4361068	2086	1043.0	
74958	chr16	4364059	4365437	1378	689.0	
74959	chr16	4369101	4369483	382	191.0	
74960	chr16	4370915	4375467	4552	2276.0	
74961	chr16	4376042	4376654	612	306.0	
74962	chr16	4377872	4378168	296	148.0	
74963	chr16	4378910	4379535	625	312.0	
74964	chr16	4380184	4380858	674	337.0	
74965	chr16	4381754	4383053	1299	650.0	
74966	chr16	4383867	4390143	6276	3138.0	
74967	chr16	4391599	4393852	2253	1126.0	
74968	chr16	4394399	4395074	675	338.0	
74969	chr16	4399080	4400206	1126	563.0	
74970	chr16	4402351	4405969	3618	1809.0	
74971	chr16	4407444	4410530	3086	1543.0	
74972	chr16	4412291	4412624	333	166.0	
74973	chr16	4413271	4417426	4155	2078.0	
74974	chr16	4418740	4419248	508	254.0	
74975	chr16	4420416	4421139	723	362.0	
74976	chr16	4424833	4426652	1819	910.0	
74977	chr16	4459160	4460006	846	423.0	
74978	chr16	4465587	4466862	1275	638.0	
74979	chr16	4472741	4473136	395	198.0	
74980	chr16	4473878	4475094	1216	608.0	
74981	chr16	4475724	4478444	2720	1360.0	
74982	chr16	4487882	4489238	1356	678.0	
74983	chr16	4504298	4507005	2707	1354.0	
74984	chr16	4510922	4511932	1010	505.0	
74985	chr16	4514334	4516541	2207	1104.0	
74986	chr16	4517790	4518333	543	272.0	
74987	chr16	4522735	4523444	709	354.0	
74988	chr16	4526762	4527338	576	288.0	
74989	chr16	4529219	4529966	747	374.0	
74990	chr16	4534337	4536313	1976	988.0	
74991	chr16	4537278	4539416	2138	1069.0	
74992	chr16	4548485	4549379	894	447.0	
74993	chr16	4585353	4585878	525	262.0	
74994	chr16	4611589	4611643	54	27.0	
74995	chr16	4613009	4617284	4275	2138.0	
74996	chr16	4623490	4626251	2761	1380.0	
74997	chr16	4640604	4641337	733	366.0	
74998	chr16	4641960	4642295	335	168.0	
74999	chr16	4647037	4648180	1143	572.0	
75000	chr16	4649100	4649481	381	190.0	
75001	chr16	4650020	4650946	926	463.0	
75002	chr16	4660401	4661124	723	362.0	
75003	chr16	4663431	4665845	2414	1207.0	
75004	chr16	4675925	4677139	1214	607.0	
75005	chr16	4679055	4680831	1776	888.0	
75006	chr16	4681787	4683390	1603	802.0	
75007	chr16	4686737	4686741	4	2.0	
75008	chr16	4688442	4688740	298	149.0	
75009	chr16	4690283	4696655	6372	3186.0	
75010	chr16	4700423	4700757	334	167.0	
75011	chr16	4733636	4735558	1922	961.0	
75012	chr16	4743319	4743720	401	200.0	
75013	chr16	4747944	4748326	382	191.0	
75014	chr16	4766151	4770076	3925	1962.0	
75015	chr16	4771697	4772042	345	172.0	
75016	chr16	4782299	4782883	584	292.0	
75017	chr16	4800183	4804166	3983	1992.0	
75018	chr16	4846259	4848746	2487	1244.0	
75019	chr16	4852177	4852556	379	190.0	
75020	chr16	4862620	4862903	283	142.0	
75021	chr16	4947806	4948234	428	214.0	
75022	chr16	4955952	4956814	862	431.0	
75023	chr16	4957561	4958885	1324	662.0	
75024	chr16	4975997	4976484	487	244.0	
75025	chr16	5032903	5034539	1636	818.0	
75026	chr16	5056318	5056789	471	236.0	
75027	chr16	5071203	5072813	1610	805.0	
75028	chr16	5084748	5085208	460	230.0	
75029	chr16	5092038	5092754	716	358.0	
75030	chr16	5096806	5099163	2357	1178.0	
75031	chr16	5117233	5117753	520	260.0	
75032	chr16	5208160	5208473	313	156.0	
75033	chr16	5239531	5239882	351	176.0	
75034	chr16	6827294	6827674	380	190.0	
75035	chr16	8567378	8568365	987	494.0	
75036	chr16	8571327	8571662	335	168.0	
75037	chr16	8572884	8573181	297	148.0	
75038	chr16	8582083	8582457	374	187.0	
75039	chr16	8594089	8594550	461	230.0	
75040	chr16	8621099	8622616	1517	758.0	
75041	chr16	8632256	8633668	1412	706.0	
75042	chr16	8644041	8645495	1454	727.0	
75043	chr16	8655063	8655562	499	250.0	
75044	chr16	8660908	8661365	457	228.0	
75045	chr16	8673715	8675998	2283	1142.0	
75046	chr16	8725740	8725946	206	103.0	
75047	chr16	8729681	8730331	650	325.0	
75048	chr16	8748916	8749373	457	228.0	
75049	chr16	8791875	8792310	435	218.0	
75050	chr16	8796905	8798791	1886	943.0	
75051	chr16	8817086	8817178	92	46.0	
75052	chr16	8820183	8820515	332	166.0	
75053	chr16	8832696	8833169	473	236.0	
75054	chr16	8850244	8850930	686	343.0	
75055	chr16	8867052	8869977	2925	1462.0	
75056	chr16	8870720	8871592	872	436.0	
75057	chr16	8880027	8880863	836	418.0	
75058	chr16	8884794	8884868	74	37.0	
75059	chr16	8885608	8886605	997	498.0	
75060	chr16	8887551	8887620	69	34.0	
75061	chr16	8890955	8892413	1458	729.0	
75062	chr16	8905173	8905625	452	226.0	
75063	chr16	8908699	8909315	616	308.0	
75064	chr16	8919736	8920060	324	162.0	
75065	chr16	8924272	8924584	312	156.0	
75066	chr16	8931840	8932234	394	197.0	
75067	chr16	8935924	8937072	1148	574.0	
75068	chr16	8941632	8942405	773	386.0	
75069	chr16	8944011	8945546	1535	768.0	
75070	chr16	8946548	8946889	341	170.0	
75071	chr16	8948837	8949922	1085	542.0	
75072	chr16	8951294	8952218	924	462.0	
75073	chr16	8956741	8964719	7978	3989.0	
75074	chr16	8966805	8967511	706	353.0	
75075	chr16	8992028	8992334	306	153.0	
75076	chr16	9008475	9009220	745	372.0	
75077	chr16	9047604	9048284	680	340.0	
75078	chr16	9053025	9053498	473	236.0	
75079	chr16	9061271	9061890	619	310.0	
75080	chr16	9077173	9077943	770	385.0	
75081	chr16	9078711	9079485	774	387.0	
75082	chr16	9081101	9081532	431	216.0	
75083	chr16	9082096	9083021	925	462.0	
75084	chr16	9089933	9094972	5039	2520.0	
75085	chr16	9095622	9101169	5547	2774.0	
75086	chr16	9102271	9104185	1914	957.0	
75087	chr16	9105172	9111370	6198	3099.0	
75088	chr16	9112192	9117813	5621	2810.0	
75089	chr16	9119710	9120509	799	400.0	
75090	chr16	9121919	9128963	7044	3522.0	
75091	chr16	9130166	9130339	173	86.0	
75092	chr16	9132363	9133626	1263	632.0	
75093	chr16	9134575	9136203	1628	814.0	
75094	chr16	9138628	9140341	1713	856.0	
75095	chr16	10181557	10181679	122	61.0	
75096	chr16	10256728	10257263	535	268.0	
75097	chr16	10297005	10297932	927	464.0	
75098	chr16	10314831	10315177	346	173.0	
75099	chr16	10319326	10319329	3	2.0	
75100	chr16	10329370	10330157	787	394.0	
75101	chr16	10333280	10333680	400	200.0	
75102	chr16	10340449	10340503	54	27.0	
75103	chr16	10362273	10362676	403	202.0	
75104	chr16	10385558	10387158	1600	800.0	
75105	chr16	10500973	10501445	472	236.0	
75106	chr16	10509502	10510028	526	263.0	
75107	chr16	10514537	10515037	500	250.0	
75108	chr16	10521640	10522112	472	236.0	
75109	chr16	10552883	10553646	763	382.0	
75110	chr16	10613766	10614186	420	210.0	
75111	chr16	10619260	10619879	619	310.0	
75112	chr16	10625901	10626328	427	214.0	
75113	chr16	10628773	10629702	929	464.0	
75114	chr16	10631939	10632073	134	67.0	
75115	chr16	10635356	10635744	388	194.0	
75116	chr16	10668656	10668723	67	34.0	
75117	chr16	10736925	10739332	2407	1204.0	
75118	chr16	10743299	10744885	1586	793.0	
75119	chr16	10749386	10749784	398	199.0	
75120	chr16	10752826	10753729	903	452.0	
75121	chr16	10765625	10766458	833	416.0	
75122	chr16	10770850	10771392	542	271.0	
75123	chr16	10776278	10776722	444	222.0	
75124	chr16	10792221	10792614	393	196.0	
75125	chr16	10799719	10799918	199	100.0	
75126	chr16	10806577	10807327	750	375.0	
75127	chr16	10812476	10812907	431	216.0	
75128	chr16	10821220	10821702	482	241.0	
75129	chr16	10828727	10829498	771	386.0	
75130	chr16	10832244	10832706	462	231.0	
75131	chr16	10842977	10843593	616	308.0	
75132	chr16	10846613	10847595	982	491.0	
75133	chr16	10862320	10862980	660	330.0	
75134	chr16	10867233	10867463	230	115.0	
75135	chr16	10868294	10869330	1036	518.0	
75136	chr16	10870017	10872097	2080	1040.0	
75137	chr16	10876293	10880995	4702	2351.0	
75138	chr16	10881676	10882036	360	180.0	
75139	chr16	10885242	10885761	519	260.0	
75140	chr16	10886674	10887629	955	478.0	
75141	chr16	10888603	10888979	376	188.0	
75142	chr16	10889989	10890264	275	138.0	
75143	chr16	10891416	10892196	780	390.0	
75144	chr16	10895319	10895713	394	197.0	
75145	chr16	10896444	10897505	1061	530.0	
75146	chr16	10912580	10913128	548	274.0	
75147	chr16	10918323	10919201	878	439.0	
75148	chr16	10930688	10931261	573	286.0	
75149	chr16	10933170	10933475	305	152.0	
75150	chr16	10936543	10943169	6626	3313.0	
75151	chr16	10943959	10945622	1663	832.0	
75152	chr16	10949095	10950048	953	476.0	
75153	chr16	10953683	10954563	880	440.0	
75154	chr16	10957883	10958171	288	144.0	
75155	chr16	10963729	10965899	2170	1085.0	
75156	chr16	10971393	10971887	494	247.0	
75157	chr16	10981752	10982103	351	176.0	
75158	chr16	10987542	10987941	399	200.0	
75159	chr16	10988462	10988857	395	198.0	
75160	chr16	11052151	11053001	850	425.0	
75161	chr16	11066542	11066640	98	49.0	
75162	chr16	11076159	11076687	528	264.0	
75163	chr16	11077968	11078380	412	206.0	
75164	chr16	11088075	11088638	563	282.0	
75165	chr16	11093894	11095270	1376	688.0	
75166	chr16	11104688	11105890	1202	601.0	
75167	chr16	11114522	11115342	820	410.0	
75168	chr16	11135321	11135846	525	262.0	
75169	chr16	11139961	11140377	416	208.0	
75170	chr16	11153060	11153419	359	180.0	
75171	chr16	11179684	11180921	1237	618.0	
75172	chr16	11181752	11182529	777	388.0	
75173	chr16	11201753	11202443	690	345.0	
75174	chr16	11205757	11207129	1372	686.0	
75175	chr16	11208763	11209571	808	404.0	
75176	chr16	11219101	11219645	544	272.0	
75177	chr16	11223949	11226318	2369	1184.0	
75178	chr16	11232590	11235387	2797	1398.0	
75179	chr16	11236757	11237448	691	346.0	
75180	chr16	11240692	11241281	589	294.0	
75181	chr16	11244625	11245004	379	190.0	
75182	chr16	11245935	11246999	1064	532.0	
75183	chr16	11248105	11259486	11381	5690.0	
75184	chr16	11263687	11264568	881	440.0	
75185	chr16	11279148	11279533	385	192.0	
75186	chr16	11283968	11284342	374	187.0	
75187	chr16	11297096	11298339	1243	622.0	
75188	chr16	11306999	11307759	760	380.0	
75189	chr16	11308726	11309236	510	255.0	
75190	chr16	11309785	11313184	3399	1700.0	
75191	chr16	11325587	11326454	867	434.0	
75192	chr16	11327314	11329351	2037	1018.0	
75193	chr16	11344844	11346123	1279	640.0	
75194	chr16	11349534	11350460	926	463.0	
75195	chr16	11354226	11356063	1837	918.0	
75196	chr16	11356606	11357276	670	335.0	
75197	chr16	11361492	11362641	1149	574.0	
75198	chr16	11363238	11363615	377	188.0	
75199	chr16	11370385	11372160	1775	888.0	
75200	chr16	11379379	11379885	506	253.0	
75201	chr16	11386976	11387310	334	167.0	
75202	chr16	11395990	11396836	846	423.0	
75203	chr16	11405511	11405988	477	238.0	
75204	chr16	11407397	11408135	738	369.0	
75205	chr16	11410298	11411159	861	430.0	
75206	chr16	11423468	11423949	481	240.0	
75207	chr16	11428326	11428694	368	184.0	
75208	chr16	11458330	11458836	506	253.0	
75209	chr16	11494563	11494642	79	40.0	
75210	chr16	11495259	11495697	438	219.0	
75211	chr16	11497282	11497927	645	322.0	
75212	chr16	11498808	11499007	199	100.0	
75213	chr16	11506742	11507446	704	352.0	
75214	chr16	11531896	11532802	906	453.0	
75215	chr16	11536002	11536600	598	299.0	
75216	chr16	11539704	11540188	484	242.0	
75217	chr16	11543682	11544076	394	197.0	
75218	chr16	11550866	11551451	585	292.0	
75219	chr16	11556485	11558083	1598	799.0	
75220	chr16	11560177	11565370	5193	2596.0	
75221	chr16	11566524	11566596	72	36.0	
75222	chr16	11568233	11569015	782	391.0	
75223	chr16	11570148	11573819	3671	1836.0	
75224	chr16	11575173	11576005	832	416.0	
75225	chr16	11576535	11577642	1107	554.0	
75226	chr16	11580019	11582605	2586	1293.0	
75227	chr16	11583742	11587919	4177	2088.0	
75228	chr16	11596367	11599068	2701	1350.0	
75229	chr16	11604723	11604896	173	86.0	
75230	chr16	11608892	11609438	546	273.0	
75231	chr16	11611877	11614530	2653	1326.0	
75232	chr16	11618978	11619979	1001	500.0	
75233	chr16	11621459	11622904	1445	722.0	
75234	chr16	11624511	11625556	1045	522.0	
75235	chr16	11628975	11630052	1077	538.0	
75236	chr16	11632272	11632969	697	348.0	
75237	chr16	11636328	11636534	206	103.0	
75238	chr16	11639883	11642790	2907	1454.0	
75239	chr16	11654327	11654881	554	277.0	
75240	chr16	11664753	11666607	1854	927.0	
75241	chr16	11667588	11673586	5998	2999.0	
75242	chr16	11674194	11675277	1083	542.0	
75243	chr16	11677197	11677506	309	154.0	
75244	chr16	11678055	11678799	744	372.0	
75245	chr16	11680200	11680711	511	256.0	
75246	chr16	11681438	11683237	1799	900.0	enhancer
75247	chr16	11689000	11689766	766	383.0	
75248	chr16	11698372	11698695	323	162.0	
75249	chr16	11700199	11701081	882	441.0	
75250	chr16	11714323	11715541	1218	609.0	
75251	chr16	11718173	11718280	107	54.0	
75252	chr16	11727786	11728805	1019	510.0	
75253	chr16	11734853	11734900	47	24.0	
75254	chr16	11737693	11738089	396	198.0	
75255	chr16	11739255	11744725	5470	2735.0	
75256	chr16	11760197	11760369	172	86.0	
75257	chr16	11768777	11769273	496	248.0	
75258	chr16	11782569	11784260	1691	846.0	
75259	chr16	11786185	11786651	466	233.0	
75260	chr16	11792561	11792911	350	175.0	
75261	chr16	11793589	11798923	5334	2667.0	
75262	chr16	11799522	11800788	1266	633.0	
75263	chr16	11809803	11810670	867	434.0	
75264	chr16	11813535	11815549	2014	1007.0	
75265	chr16	11819754	11820211	457	228.0	
75266	chr16	11824247	11824876	629	314.0	
75267	chr16	11834320	11834641	321	160.0	
75268	chr16	11850723	11852479	1756	878.0	
75269	chr16	11880047	11880329	282	141.0	
75270	chr16	11892706	11893185	479	240.0	
75271	chr16	11910902	11911667	765	382.0	
75272	chr16	11913367	11916847	3480	1740.0	
75273	chr16	11949628	11949997	369	184.0	
75274	chr16	11966260	11966577	317	158.0	
75275	chr16	11975807	11977988	2181	1090.0	
75276	chr16	11994401	11995199	798	399.0	
75277	chr16	12010366	12011202	836	418.0	
75278	chr16	12033844	12035538	1694	847.0	
75279	chr16	12041606	12041706	100	50.0	
75280	chr16	12043954	12044411	457	228.0	
75281	chr16	12062358	12063219	861	430.0	
75282	chr16	12067608	12068490	882	441.0	
75283	chr16	12075604	12076269	665	332.0	
75284	chr16	12078930	12080661	1731	866.0	
75285	chr16	12088017	12088479	462	231.0	
75286	chr16	12089351	12090263	912	456.0	
75287	chr16	12095124	12095663	539	270.0	
75288	chr16	12132310	12132707	397	198.0	
75289	chr16	12147733	12148039	306	153.0	
75290	chr16	12284582	12284628	46	23.0	
75291	chr16	12323145	12323364	219	110.0	
75292	chr16	12344607	12344972	365	182.0	
75293	chr16	12348751	12349142	391	196.0	
75294	chr16	12415912	12416966	1054	527.0	
75295	chr16	12455187	12455672	485	242.0	
75296	chr16	12458483	12460136	1653	826.0	
75297	chr16	12500784	12501257	473	236.0	
75298	chr16	12529653	12530675	1022	511.0	
75299	chr16	12532786	12533511	725	362.0	
75300	chr16	12544088	12545425	1337	668.0	
75301	chr16	12547109	12547767	658	329.0	
75302	chr16	12573098	12574156	1058	529.0	
75303	chr16	12646818	12647159	341	170.0	
75304	chr16	12685827	12686257	430	215.0	
75305	chr16	12800659	12802242	1583	792.0	
75306	chr16	12802989	12804434	1445	722.0	
75307	chr16	12813453	12813647	194	97.0	
75308	chr16	12816547	12817329	782	391.0	
75309	chr16	12818178	12819834	1656	828.0	
75310	chr16	12837372	12837745	373	186.0	
75311	chr16	13904867	13905181	314	157.0	
75312	chr16	13906672	13907080	408	204.0	
75313	chr16	13919214	13920806	1592	796.0	
75314	chr16	13923704	13924339	635	318.0	
75315	chr16	13935551	13935774	223	112.0	
75316	chr16	13957248	13958236	988	494.0	
75317	chr16	14003145	14003600	455	228.0	
75318	chr16	14015871	14016305	434	217.0	
75319	chr16	14024662	14024663	1	0.0	
75320	chr16	14070617	14072000	1383	692.0	
75321	chr16	14193296	14193622	326	163.0	
75322	chr16	14198550	14198962	412	206.0	
75323	chr16	14249515	14249919	404	202.0	
75324	chr16	14282571	14283218	647	324.0	
75325	chr16	14284883	14287868	2985	1492.0	
75326	chr16	14289646	14290151	505	252.0	
75327	chr16	14292039	14292527	488	244.0	
75328	chr16	14300735	14303364	2629	1314.0	
75329	chr16	14308977	14309818	841	420.0	
75330	chr16	14310629	14310938	309	154.0	
75331	chr16	14345556	14345883	327	164.0	
75332	chr16	14354369	14355405	1036	518.0	
75333	chr16	14405703	14405996	293	146.0	
75334	chr16	14436409	14437080	671	336.0	
75335	chr16	14529060	14529549	489	244.0	
75336	chr16	14559739	14560083	344	172.0	
75337	chr16	14629191	14630951	1760	880.0	
75338	chr16	14632116	14634631	2515	1258.0	
75339	chr16	14658179	14658293	114	57.0	
75340	chr16	14833368	14833926	558	279.0	
75341	chr16	14974281	14976290	2009	1004.0	
75342	chr16	15007382	15007760	378	189.0	
75343	chr16	15013786	15014940	1154	577.0	
75344	chr16	15021969	15022621	652	326.0	
75345	chr16	15031227	15031628	401	200.0	
75346	chr16	15041600	15042004	404	202.0	
75347	chr16	15052687	15053177	490	245.0	
75348	chr16	15055097	15056816	1719	860.0	
75349	chr16	15072249	15072865	616	308.0	
75350	chr16	15093716	15094969	1253	626.0	
75351	chr16	15153970	15155549	1579	790.0	
75352	chr16	15389895	15390409	514	257.0	
75353	chr16	15395761	15396253	492	246.0	
75354	chr16	15403546	15405289	1743	872.0	
75355	chr16	15427567	15428008	441	220.0	
75356	chr16	15434219	15435155	936	468.0	
75357	chr16	15483942	15483978	36	18.0	
75358	chr16	15492421	15492500	79	40.0	
75359	chr16	15509126	15509671	545	272.0	
75360	chr16	15520689	15521272	583	292.0	
75361	chr16	15522924	15523688	764	382.0	
75362	chr16	15571897	15571977	80	40.0	
75363	chr16	15588946	15589453	507	254.0	
75364	chr16	15590248	15593670	3422	1711.0	
75365	chr16	15595009	15595105	96	48.0	
75366	chr16	15607681	15608316	635	318.0	
75367	chr16	15636393	15636891	498	249.0	
75368	chr16	15638979	15639623	644	322.0	
75369	chr16	15642029	15644205	2176	1088.0	
75370	chr16	15649502	15651567	2065	1032.0	
75371	chr16	15658963	15659722	759	380.0	
75372	chr16	15670124	15670134	10	5.0	
75373	chr16	15672006	15673800	1794	897.0	
75374	chr16	15682025	15682544	519	260.0	
75375	chr16	15704447	15705098	651	326.0	
75376	chr16	15719943	15720306	363	182.0	
75377	chr16	15756550	15756959	409	204.0	
75378	chr16	15765846	15766305	459	230.0	
75379	chr16	15821850	15822213	363	182.0	
75380	chr16	15829572	15829902	330	165.0	
75381	chr16	15887846	15889374	1528	764.0	
75382	chr16	15897835	15898220	385	192.0	
75383	chr16	15907963	15908488	525	262.0	
75384	chr16	15912574	15912750	176	88.0	
75385	chr16	15936723	15937269	546	273.0	
75386	chr16	15941961	15942250	289	144.0	
75387	chr16	15942905	15943632	727	364.0	
75388	chr16	15948667	15951109	2442	1221.0	
75389	chr16	15951904	15952956	1052	526.0	
75390	chr16	15954576	15955273	697	348.0	
75391	chr16	15956105	15956636	531	266.0	
75392	chr16	15958733	15959073	340	170.0	
75393	chr16	15960296	15962230	1934	967.0	
75394	chr16	15970143	15970575	432	216.0	
75395	chr16	15998253	15998914	661	330.0	
75396	chr16	16007072	16008225	1153	576.0	
75397	chr16	16025109	16026145	1036	518.0	
75398	chr16	16033172	16033902	730	365.0	
75399	chr16	16039028	16039355	327	164.0	
75400	chr16	16046030	16046091	61	30.0	
75401	chr16	16062122	16062342	220	110.0	
75402	chr16	16074385	16074914	529	264.0	
75403	chr16	16075478	16076998	1520	760.0	
75404	chr16	16100670	16100912	242	121.0	
75405	chr16	16127386	16128099	713	356.0	
75406	chr16	16143008	16143388	380	190.0	
75407	chr16	16150035	16150083	48	24.0	
75408	chr16	16187357	16187737	380	190.0	
75409	chr16	16194794	16195276	482	241.0	
75410	chr16	16201239	16201655	416	208.0	
75411	chr16	16202365	16202805	440	220.0	
75412	chr16	16207386	16208290	904	452.0	
75413	chr16	16232201	16232807	606	303.0	
75414	chr16	16861704	16861825	121	60.0	
75415	chr16	16984747	16985126	379	190.0	
75416	chr16	16992955	16993589	634	317.0	
75417	chr16	17013276	17014351	1075	538.0	
75418	chr16	17026453	17027230	777	388.0	
75419	chr16	17063136	17063847	711	356.0	
75420	chr16	17070525	17071800	1275	638.0	
75421	chr16	17101755	17101899	144	72.0	
75422	chr16	17154920	17155913	993	496.0	
75423	chr16	17162527	17162875	348	174.0	
75424	chr16	17163887	17164358	471	236.0	
75425	chr16	17171593	17172165	572	286.0	
75426	chr16	17173111	17174008	897	448.0	
75427	chr16	17194143	17194601	458	229.0	
75428	chr16	17211740	17212151	411	206.0	
75429	chr16	17213039	17213360	321	160.0	
75430	chr16	17222764	17223568	804	402.0	
75431	chr16	17224699	17225327	628	314.0	
75432	chr16	17235475	17235535	60	30.0	
75433	chr16	17238256	17239008	752	376.0	
75434	chr16	17258747	17259859	1112	556.0	
75435	chr16	17273089	17273522	433	216.0	
75436	chr16	17278089	17278413	324	162.0	
75437	chr16	17294836	17295221	385	192.0	
75438	chr16	17301418	17303530	2112	1056.0	
75439	chr16	17318198	17318641	443	222.0	
75440	chr16	17319454	17319595	141	70.0	
75441	chr16	17321236	17322372	1136	568.0	
75442	chr16	17340876	17341178	302	151.0	
75443	chr16	17341881	17345452	3571	1786.0	
75444	chr16	17346517	17347540	1023	512.0	
75445	chr16	17348385	17348747	362	181.0	
75446	chr16	17350105	17350631	526	263.0	
75447	chr16	17359657	17361390	1733	866.0	
75448	chr16	17363967	17365343	1376	688.0	
75449	chr16	17366741	17371695	4954	2477.0	
75450	chr16	17375498	17376443	945	472.0	
75451	chr16	17377465	17378473	1008	504.0	
75452	chr16	17380514	17381143	629	314.0	
75453	chr16	17382955	17383436	481	240.0	
75454	chr16	17396637	17397775	1138	569.0	
75455	chr16	17409122	17409526	404	202.0	
75456	chr16	17414394	17414857	463	232.0	
75457	chr16	17415638	17417382	1744	872.0	
75458	chr16	17439535	17440018	483	242.0	
75459	chr16	17448555	17449957	1402	701.0	
75460	chr16	17451562	17452377	815	408.0	
75461	chr16	17461907	17462823	916	458.0	
75462	chr16	17463459	17463643	184	92.0	
75463	chr16	17467667	17468372	705	352.0	
75464	chr16	17468877	17471902	3025	1512.0	
75465	chr16	17473972	17475021	1049	524.0	
75466	chr16	17476616	17477199	583	292.0	
75467	chr16	17529873	17530493	620	310.0	
75468	chr16	17579231	17579735	504	252.0	
75469	chr16	17590901	17592389	1488	744.0	
75470	chr16	18561723	18562415	692	346.0	
75471	chr16	18586792	18587177	385	192.0	
75472	chr16	18759828	18760346	518	259.0	
75473	chr16	18767086	18767640	554	277.0	
75474	chr16	18774717	18774998	281	140.0	
75475	chr16	18782987	18783440	453	226.0	
75476	chr16	18786868	18787927	1059	530.0	
75477	chr16	18788836	18791341	2505	1252.0	
75478	chr16	18793370	18793920	550	275.0	
75479	chr16	18799919	18802524	2605	1302.0	
75480	chr16	18803858	18804481	623	312.0	
75481	chr16	18819687	18819888	201	100.0	
75482	chr16	18877327	18877623	296	148.0	
75483	chr16	18923020	18923516	496	248.0	
75484	chr16	18925173	18927368	2195	1098.0	
75485	chr16	18945883	18946628	745	372.0	
75486	chr16	18969202	18969723	521	260.0	
75487	chr16	19066923	19069184	2261	1130.0	
75488	chr16	19072167	19072698	531	266.0	
75489	chr16	19073261	19073795	534	267.0	
75490	chr16	19086188	19087106	918	459.0	
75491	chr16	19094981	19095495	514	257.0	
75492	chr16	19107642	19108218	576	288.0	
75493	chr16	19113452	19114847	1395	698.0	
75494	chr16	19117071	19118092	1021	510.0	
75495	chr16	19118680	19119543	863	432.0	
75496	chr16	19130752	19131592	840	420.0	
75497	chr16	19136808	19137233	425	212.0	
75498	chr16	19167498	19169085	1587	794.0	
75499	chr16	19175536	19175801	265	132.0	
75500	chr16	19179490	19180342	852	426.0	
75501	chr16	19184108	19184689	581	290.0	
75502	chr16	19190289	19191058	769	384.0	
75503	chr16	19210200	19211425	1225	612.0	
75504	chr16	19294032	19294790	758	379.0	
75505	chr16	19375560	19375983	423	212.0	
75506	chr16	19389396	19389435	39	20.0	
75507	chr16	19451951	19452329	378	189.0	
75508	chr16	19493563	19494116	553	276.0	
75509	chr16	19497284	19497550	266	133.0	
75510	chr16	19502590	19503084	494	247.0	
75511	chr16	19510959	19511274	315	158.0	
75512	chr16	19513505	19514156	651	326.0	
75513	chr16	19520641	19522684	2043	1022.0	
75514	chr16	19523533	19525460	1927	964.0	
75515	chr16	19554723	19556747	2024	1012.0	
75516	chr16	19559087	19559791	704	352.0	
75517	chr16	19576144	19576556	412	206.0	
75518	chr16	19583672	19584116	444	222.0	
75519	chr16	19601355	19601741	386	193.0	
75520	chr16	19640094	19640487	393	196.0	
75521	chr16	19691347	19691687	340	170.0	
75522	chr16	19696108	19697004	896	448.0	
75523	chr16	19717415	19719019	1604	802.0	
75524	chr16	19804754	19805367	613	306.0	
75525	chr16	19809256	19809556	300	150.0	
75526	chr16	19883391	19886907	3516	1758.0	
75527	chr16	19899302	19899712	410	205.0	
75528	chr16	19907372	19908029	657	328.0	
75529	chr16	20383324	20383720	396	198.0	
75530	chr16	20385746	20386166	420	210.0	
75531	chr16	20409779	20410588	809	404.0	
75532	chr16	20674048	20676676	2628	1314.0	
75533	chr16	20680373	20680429	56	28.0	
75534	chr16	20691431	20692085	654	327.0	
75535	chr16	20693864	20694265	401	200.0	
75536	chr16	20740162	20742433	2271	1136.0	
75537	chr16	20744806	20745254	448	224.0	
75538	chr16	20747129	20747597	468	234.0	
75539	chr16	20754421	20754800	379	190.0	
75540	chr16	20763209	20764454	1245	622.0	
75541	chr16	20774665	20775194	529	264.0	
75542	chr16	20781970	20781982	12	6.0	
75543	chr16	20805704	20807520	1816	908.0	
75544	chr16	20819998	20820230	232	116.0	
75545	chr16	20844560	20845068	508	254.0	
75546	chr16	20849565	20850303	738	369.0	
75547	chr16	20874296	20875419	1123	562.0	
75548	chr16	20897306	20898332	1026	513.0	
75549	chr16	20899270	20902083	2813	1406.0	
75550	chr16	20903461	20905278	1817	908.0	
75551	chr16	20910449	20911607	1158	579.0	
75552	chr16	20914226	20914443	217	108.0	
75553	chr16	20916976	20917291	315	158.0	
75554	chr16	20941148	20941721	573	286.0	
75555	chr16	20944909	20945514	605	302.0	
75556	chr16	21083761	21084206	445	222.0	
75557	chr16	21116283	21116619	336	168.0	
75558	chr16	21158115	21160076	1961	980.0	
75559	chr16	21188606	21189117	511	256.0	
75560	chr16	21277914	21278588	674	337.0	
75561	chr16	21283765	21284193	428	214.0	
75562	chr16	21300301	21302097	1796	898.0	
75563	chr16	21356232	21356732	500	250.0	
75564	chr16	21358121	21359035	914	457.0	
75565	chr16	21359870	21360711	841	420.0	
75566	chr16	21363590	21364465	875	438.0	
75567	chr16	21501185	21504067	2882	1441.0	
75568	chr16	21506553	21510888	4335	2168.0	
75569	chr16	21511605	21512906	1301	650.0	
75570	chr16	21513499	21514306	807	404.0	
75571	chr16	21517172	21521140	3968	1984.0	
75572	chr16	21525391	21525717	326	163.0	
75573	chr16	21540639	21542131	1492	746.0	
75574	chr16	21554384	21555461	1077	538.0	
75575	chr16	21583771	21584581	810	405.0	
75576	chr16	21590168	21591181	1013	506.0	
75577	chr16	21597575	21600903	3328	1664.0	
75578	chr16	21603977	21605235	1258	629.0	
75579	chr16	21608666	21609436	770	385.0	
75580	chr16	21611013	21612496	1483	742.0	
75581	chr16	21617604	21618012	408	204.0	
75582	chr16	21619119	21619614	495	248.0	
75583	chr16	21626409	21627329	920	460.0	
75584	chr16	21631467	21632469	1002	501.0	
75585	chr16	21638465	21638974	509	254.0	
75586	chr16	21640475	21641176	701	350.0	
75587	chr16	21644968	21648024	3056	1528.0	
75588	chr16	21649900	21651385	1485	742.0	
75589	chr16	21652396	21653887	1491	746.0	
75590	chr16	21656808	21657829	1021	510.0	
75591	chr16	21658390	21659510	1120	560.0	
75592	chr16	21661203	21661698	495	248.0	
75593	chr16	21663802	21664448	646	323.0	
75594	chr16	21684278	21684546	268	134.0	
75595	chr16	21708302	21708966	664	332.0	
75596	chr16	21756395	21756759	364	182.0	
75597	chr16	21801804	21802248	444	222.0	
75598	chr16	21819856	21821098	1242	621.0	
75599	chr16	21837168	21837605	437	218.0	
75600	chr16	21934801	21935691	890	445.0	
75601	chr16	21950944	21951437	493	246.0	
75602	chr16	21952045	21954305	2260	1130.0	
75603	chr16	22000725	22001578	853	426.0	
75604	chr16	22007054	22009538	2484	1242.0	
75605	chr16	22035165	22035377	212	106.0	
75606	chr16	22077616	22078160	544	272.0	
75607	chr16	22098974	22099383	409	204.0	
75608	chr16	22162075	22162789	714	357.0	
75609	chr16	22184013	22184282	269	134.0	
75610	chr16	22188162	22193244	5082	2541.0	
75611	chr16	22194616	22196557	1941	970.0	
75612	chr16	22199602	22199905	303	152.0	
75613	chr16	22204560	22204975	415	208.0	
75614	chr16	22205549	22207774	2225	1112.0	
75615	chr16	22216511	22216969	458	229.0	
75616	chr16	22217953	22218411	458	229.0	
75617	chr16	22240817	22241433	616	308.0	
75618	chr16	22296307	22299441	3134	1567.0	
75619	chr16	22300212	22300875	663	332.0	
75620	chr16	22318567	22319128	561	280.0	
75621	chr16	22321159	22321959	800	400.0	
75622	chr16	22330549	22330661	112	56.0	
75623	chr16	22353038	22354229	1191	596.0	
75624	chr16	22355605	22355996	391	196.0	
75625	chr16	22357200	22358588	1388	694.0	
75626	chr16	22369265	22369927	662	331.0	
75627	chr16	22371791	22372406	615	308.0	
75628	chr16	22373062	22375597	2535	1268.0	
75629	chr16	22381361	22381838	477	238.0	
75630	chr16	22400910	22401316	406	203.0	
75631	chr16	22417897	22417961	64	32.0	
75632	chr16	22436482	22437998	1516	758.0	
75633	chr16	22572509	22572964	455	228.0	
75634	chr16	22670550	22670917	367	184.0	
75635	chr16	22680671	22681023	352	176.0	
75636	chr16	22782465	22782704	239	120.0	
75637	chr16	22788134	22788451	317	158.0	
75638	chr16	22899010	22899172	162	81.0	
75639	chr16	22948760	22949141	381	190.0	
75640	chr16	23060652	23061095	443	222.0	
75641	chr16	23064669	23065014	345	172.0	
75642	chr16	23148329	23150180	1851	926.0	
75643	chr16	23182266	23183395	1129	564.0	
75644	chr16	23434278	23434739	461	230.0	
75645	chr16	23435356	23435898	542	271.0	
75646	chr16	23452392	23453695	1303	652.0	
75647	chr16	23482561	23484142	1581	790.0	
75648	chr16	23496789	23497375	586	293.0	
75649	chr16	23504004	23507076	3072	1536.0	
75650	chr16	23508273	23511117	2844	1422.0	
75651	chr16	23514690	23515207	517	258.0	
75652	chr16	23516674	23517234	560	280.0	
75653	chr16	23518273	23518935	662	331.0	
75654	chr16	23520429	23521465	1036	518.0	
75655	chr16	23528889	23528978	89	44.0	
75656	chr16	23538592	23539034	442	221.0	
75657	chr16	23556077	23558508	2431	1216.0	
75658	chr16	23570901	23571637	736	368.0	
75659	chr16	23595509	23597405	1896	948.0	
75660	chr16	23640629	23642209	1580	790.0	
75661	chr16	23678286	23679841	1555	778.0	
75662	chr16	23727901	23728014	113	56.0	
75663	chr16	23735194	23735545	351	176.0	
75664	chr16	23788609	23789071	462	231.0	
75665	chr16	23801309	23801850	541	270.0	
75666	chr16	23803450	23804086	636	318.0	
75667	chr16	23806981	23807536	555	278.0	
75668	chr16	23823402	23823793	391	196.0	
75669	chr16	23825930	23827607	1677	838.0	
75670	chr16	23835242	23838228	2986	1493.0	
75671	chr16	23840466	23840636	170	85.0	
75672	chr16	23842228	23842665	437	218.0	
75673	chr16	23847802	23849309	1507	754.0	
75674	chr16	23852755	23853688	933	466.0	
75675	chr16	23854975	23855474	499	250.0	
75676	chr16	23856291	23856532	241	120.0	
75677	chr16	23857543	23860340	2797	1398.0	
75678	chr16	23863162	23864437	1275	638.0	
75679	chr16	23868127	23869474	1347	674.0	
75680	chr16	23877125	23877491	366	183.0	
75681	chr16	23881535	23882119	584	292.0	
75682	chr16	23897346	23897524	178	89.0	
75683	chr16	23901495	23901575	80	40.0	
75684	chr16	23923904	23924595	691	346.0	
75685	chr16	23948674	23951126	2452	1226.0	
75686	chr16	23951986	23952858	872	436.0	
75687	chr16	23959121	23960596	1475	738.0	
75688	chr16	23966661	23967317	656	328.0	
75689	chr16	23968194	23968594	400	200.0	
75690	chr16	23976607	23976686	79	40.0	
75691	chr16	23987412	23987833	421	210.0	
75692	chr16	24005774	24005884	110	55.0	
75693	chr16	24008821	24010910	2089	1044.0	
75694	chr16	24013612	24014899	1287	644.0	
75695	chr16	24034940	24035801	861	430.0	
75696	chr16	24036600	24037111	511	256.0	
75697	chr16	24041770	24042514	744	372.0	
75698	chr16	24049414	24049542	128	64.0	
75699	chr16	24070864	24071300	436	218.0	
75700	chr16	24072737	24073174	437	218.0	
75701	chr16	24151405	24151865	460	230.0	
75702	chr16	24253075	24253517	442	221.0	
75703	chr16	24255809	24256295	486	243.0	
75704	chr16	24273510	24273943	433	216.0	
75705	chr16	24504653	24505207	554	277.0	
75706	chr16	24516901	24517619	718	359.0	
75707	chr16	24525097	24525780	683	342.0	
75708	chr16	24538739	24542783	4044	2022.0	
75709	chr16	24562336	24562371	35	18.0	
75710	chr16	24662954	24663255	301	150.0	
75711	chr16	24728735	24730853	2118	1059.0	
75712	chr16	24748352	24748378	26	13.0	
75713	chr16	24838751	24839105	354	177.0	
75714	chr16	24896525	24896786	261	130.0	
75715	chr16	24921279	24921368	89	44.0	
75716	chr16	24972849	24972933	84	42.0	
75717	chr16	24975386	24975827	441	220.0	
75718	chr16	24986639	24987156	517	258.0	
75719	chr16	24996357	24996694	337	168.0	
75720	chr16	25005996	25007070	1074	537.0	
75721	chr16	25009591	25010343	752	376.0	
75722	chr16	25012668	25013073	405	202.0	
75723	chr16	25013679	25016207	2528	1264.0	
75724	chr16	25018915	25020272	1357	678.0	
75725	chr16	25029626	25029631	5	2.0	
75726	chr16	25030326	25032436	2110	1055.0	
75727	chr16	25048310	25050393	2083	1042.0	
75728	chr16	25051512	25052158	646	323.0	
75729	chr16	25055369	25056230	861	430.0	
75730	chr16	25060608	25061712	1104	552.0	
75731	chr16	25066031	25067819	1788	894.0	
75732	chr16	25093056	25093986	930	465.0	
75733	chr16	25106363	25108431	2068	1034.0	
75734	chr16	25110474	25112422	1948	974.0	
75735	chr16	25123498	25123724	226	113.0	
75736	chr16	25126772	25127258	486	243.0	
75737	chr16	25134457	25134664	207	104.0	
75738	chr16	25225078	25225884	806	403.0	
75739	chr16	25233497	25234304	807	404.0	
75740	chr16	25256832	25259284	2452	1226.0	
75741	chr16	25276642	25277022	380	190.0	
75742	chr16	25838720	25839059	339	170.0	
75743	chr16	26597831	26598750	919	460.0	
75744	chr16	26645177	26645967	790	395.0	
75745	chr16	27109579	27110424	845	422.0	
75746	chr16	27113565	27113849	284	142.0	
75747	chr16	27154780	27155459	679	340.0	
75748	chr16	27169373	27170355	982	491.0	
75749	chr16	27173803	27174685	882	441.0	
75750	chr16	27179017	27180173	1156	578.0	
75751	chr16	27195686	27196727	1041	520.0	
75752	chr16	27199591	27200348	757	378.0	
75753	chr16	27202923	27204720	1797	898.0	
75754	chr16	27229204	27229405	201	100.0	
75755	chr16	27230043	27233351	3308	1654.0	
75756	chr16	27234560	27238865	4305	2152.0	
75757	chr16	27242756	27243632	876	438.0	
75758	chr16	27247116	27247591	475	238.0	
75759	chr16	27254319	27254679	360	180.0	
75760	chr16	27262926	27263340	414	207.0	
75761	chr16	27267310	27269432	2122	1061.0	
75762	chr16	27271480	27271985	505	252.0	
75763	chr16	27273927	27274659	732	366.0	
75764	chr16	27285841	27286889	1048	524.0	
75765	chr16	27287784	27288324	540	270.0	
75766	chr16	27299726	27300362	636	318.0	
75767	chr16	27305010	27305830	820	410.0	
75768	chr16	27313263	27319501	6238	3119.0	
75769	chr16	27321134	27321760	626	313.0	
75770	chr16	27326529	27327715	1186	593.0	
75771	chr16	27331964	27332612	648	324.0	
75772	chr16	27340679	27340978	299	150.0	
75773	chr16	27341534	27341951	417	208.0	
75774	chr16	27346752	27347300	548	274.0	
75775	chr16	27348087	27348170	83	42.0	
75776	chr16	27355487	27356111	624	312.0	
75777	chr16	27363444	27364763	1319	660.0	
75778	chr16	27365468	27366298	830	415.0	
75779	chr16	27366861	27368861	2000	1000.0	
75780	chr16	27372429	27372983	554	277.0	
75781	chr16	27374040	27375513	1473	736.0	
75782	chr16	27377614	27378257	643	322.0	
75783	chr16	27383497	27384366	869	434.0	
75784	chr16	27389375	27389572	197	98.0	
75785	chr16	27398834	27399731	897	448.0	
75786	chr16	27400760	27409084	8324	4162.0	
75787	chr16	27410687	27411093	406	203.0	
75788	chr16	27414867	27415262	395	198.0	
75789	chr16	27426253	27427435	1182	591.0	
75790	chr16	27428537	27428746	209	104.0	
75791	chr16	27431009	27431253	244	122.0	
75792	chr16	27433088	27433119	31	16.0	
75793	chr16	27445485	27451502	6017	3008.0	
75794	chr16	27453103	27453504	401	200.0	
75795	chr16	27455621	27457725	2104	1052.0	
75796	chr16	27459936	27460343	407	204.0	
75797	chr16	27463157	27465742	2585	1292.0	
75798	chr16	27491804	27492766	962	481.0	
75799	chr16	27515873	27516238	365	182.0	
75800	chr16	27549117	27550939	1822	911.0	
75801	chr16	27566378	27566823	445	222.0	
75802	chr16	27729580	27729899	319	160.0	
75803	chr16	27748888	27749300	412	206.0	
75804	chr16	27867499	27868025	526	263.0	
75805	chr16	27972453	27972942	489	244.0	
75806	chr16	28070645	28071146	501	250.0	
75807	chr16	28087531	28087684	153	76.0	
75808	chr16	28088672	28089726	1054	527.0	
75809	chr16	28110003	28110945	942	471.0	
75810	chr16	28136806	28137653	847	424.0	
75811	chr16	28139436	28139978	542	271.0	
75812	chr16	28140558	28142857	2299	1150.0	
75813	chr16	28145832	28146963	1131	566.0	
75814	chr16	28148821	28149827	1006	503.0	
75815	chr16	28157961	28158592	631	316.0	
75816	chr16	28163499	28164694	1195	598.0	
75817	chr16	28165487	28166255	768	384.0	
75818	chr16	28168927	28169659	732	366.0	
75819	chr16	28180605	28182578	1973	986.0	
75820	chr16	28186360	28189889	3529	1764.0	
75821	chr16	28192454	28194988	2534	1267.0	
75822	chr16	28202330	28202853	523	262.0	
75823	chr16	28209910	28212797	2887	1444.0	
75824	chr16	28217891	28218603	712	356.0	
75825	chr16	28276873	28279561	2688	1344.0	
75826	chr16	28291553	28293976	2423	1212.0	
75827	chr16	28294900	28295484	584	292.0	
75828	chr16	28297117	28298342	1225	612.0	
75829	chr16	28304132	28304533	401	200.0	
75830	chr16	28309018	28310930	1912	956.0	
75831	chr16	28311861	28312433	572	286.0	
75832	chr16	28316746	28317690	944	472.0	
75833	chr16	28321661	28322295	634	317.0	
75834	chr16	28326839	28327363	524	262.0	
75835	chr16	28364826	28365217	391	196.0	
75836	chr16	28478583	28478765	182	91.0	
75837	chr16	28490455	28492720	2265	1132.0	
75838	chr16	28493426	28496002	2576	1288.0	
75839	chr16	28505563	28508589	3026	1513.0	
75840	chr16	28524480	28525151	671	336.0	
75841	chr16	28532039	28532562	523	262.0	
75842	chr16	28534157	28535355	1198	599.0	
75843	chr16	28542812	28543577	765	382.0	
75844	chr16	28549227	28549794	567	284.0	
75845	chr16	28553473	28554944	1471	736.0	
75846	chr16	28573322	28573830	508	254.0	
75847	chr16	28609189	28610534	1345	672.0	
75848	chr16	28615861	28616291	430	215.0	
75849	chr16	28616894	28617014	120	60.0	
75850	chr16	28617875	28618292	417	208.0	
75851	chr16	28622838	28623919	1081	540.0	
75852	chr16	28750078	28750479	401	200.0	
75853	chr16	28802399	28802923	524	262.0	
75854	chr16	28803546	28803868	322	161.0	
75855	chr16	28820114	28820396	282	141.0	
75856	chr16	28822072	28825199	3127	1564.0	
75857	chr16	28834840	28835156	316	158.0	
75858	chr16	28839856	28840355	499	250.0	
75859	chr16	28845324	28847460	2136	1068.0	
75860	chr16	28862663	28865688	3025	1512.0	
75861	chr16	28873472	28874146	674	337.0	
75862	chr16	28876867	28877601	734	367.0	
75863	chr16	28879183	28880684	1501	750.0	
75864	chr16	28902709	28903237	528	264.0	
75865	chr16	28923721	28926284	2563	1282.0	
75866	chr16	28930631	28932090	1459	730.0	
75867	chr16	28936024	28937173	1149	574.0	
75868	chr16	28945147	28946330	1183	592.0	
75869	chr16	28947888	28948076	188	94.0	
75870	chr16	28950069	28951961	1892	946.0	
75871	chr16	28973804	28975646	1842	921.0	
75872	chr16	28977641	28978176	535	268.0	
75873	chr16	28981467	28981950	483	242.0	
75874	chr16	28983874	28988527	4653	2326.0	
75875	chr16	28990220	28990842	622	311.0	
75876	chr16	28999676	28999865	189	94.0	
75877	chr16	29007674	29009787	2113	1056.0	
75878	chr16	29012794	29014910	2116	1058.0	
75879	chr16	29029194	29029742	548	274.0	
75880	chr16	29074554	29075575	1021	510.0	
75881	chr16	29081800	29082655	855	428.0	
75882	chr16	29094514	29095153	639	320.0	
75883	chr16	29111723	29112681	958	479.0	
75884	chr16	29113337	29113832	495	248.0	
75885	chr16	29114981	29116182	1201	600.0	
75886	chr16	29118270	29119085	815	408.0	
75887	chr16	29125881	29126811	930	465.0	
75888	chr16	29129424	29129980	556	278.0	
75889	chr16	29148190	29149769	1579	790.0	
75890	chr16	29152330	29152995	665	332.0	
75891	chr16	29154272	29154320	48	24.0	
75892	chr16	29154844	29157819	2975	1488.0	
75893	chr16	29173250	29173776	526	263.0	
75894	chr16	29178057	29178346	289	144.0	
75895	chr16	29181841	29182193	352	176.0	
75896	chr16	29184506	29185443	937	468.0	
75897	chr16	29224733	29225019	286	143.0	
75898	chr16	29227904	29228701	797	398.0	
75899	chr16	29248124	29248973	849	424.0	
75900	chr16	29265208	29265721	513	256.0	
75901	chr16	29266685	29266870	185	92.0	
75902	chr16	29290489	29291984	1495	748.0	
75903	chr16	29299856	29300600	744	372.0	
75904	chr16	29318492	29319162	670	335.0	
75905	chr16	29335407	29335802	395	198.0	
75906	chr16	29337427	29337936	509	254.0	
75907	chr16	29339067	29339869	802	401.0	
75908	chr16	29346825	29347417	592	296.0	
75909	chr16	29382915	29383383	468	234.0	
75910	chr16	29469560	29469946	386	193.0	
75911	chr16	29585057	29585629	572	286.0	
75912	chr16	29591971	29592374	403	202.0	
75913	chr16	29594183	29596111	1928	964.0	
75914	chr16	29599812	29601192	1380	690.0	
75915	chr16	29601997	29603056	1059	530.0	
75916	chr16	29606833	29607540	707	354.0	
75917	chr16	29610607	29614264	3657	1828.0	
75918	chr16	29618224	29619014	790	395.0	
75919	chr16	29626657	29628046	1389	694.0	
75920	chr16	29640734	29642022	1288	644.0	
75921	chr16	29644315	29646145	1830	915.0	
75922	chr16	29649637	29649923	286	143.0	
75923	chr16	29653386	29653960	574	287.0	
75924	chr16	29654803	29655523	720	360.0	
75925	chr16	29661472	29667682	6210	3105.0	
75926	chr16	29674220	29674678	458	229.0	
75927	chr16	29676036	29676580	544	272.0	
75928	chr16	29677267	29677845	578	289.0	
75929	chr16	29679181	29680211	1030	515.0	
75930	chr16	29686942	29687366	424	212.0	
75931	chr16	29691638	29692403	765	382.0	
75932	chr16	29700371	29703021	2650	1325.0	
75933	chr16	29710209	29712021	1812	906.0	
75934	chr16	29721352	29722032	680	340.0	
75935	chr16	29729252	29729612	360	180.0	
75936	chr16	29732108	29732773	665	332.0	
75937	chr16	29736550	29737240	690	345.0	
75938	chr16	29737975	29739225	1250	625.0	
75939	chr16	29740524	29742031	1507	754.0	
75940	chr16	29742868	29747349	4481	2240.0	
75941	chr16	29748743	29749097	354	177.0	
75942	chr16	29754429	29754918	489	244.0	
75943	chr16	29756559	29757117	558	279.0	
75944	chr16	29773508	29773598	90	45.0	
75945	chr16	29784371	29785651	1280	640.0	
75946	chr16	29789854	29792571	2717	1358.0	
75947	chr16	29804249	29812757	8508	4254.0	
75948	chr16	29813457	29813947	490	245.0	
75949	chr16	29814498	29817601	3103	1552.0	
75950	chr16	29819959	29821912	1953	976.0	
75951	chr16	29825121	29825645	524	262.0	
75952	chr16	29826666	29827646	980	490.0	
75953	chr16	29847328	29849781	2453	1226.0	
75954	chr16	29862409	29864136	1727	864.0	
75955	chr16	29876156	29878089	1933	966.0	
75956	chr16	29892151	29892579	428	214.0	
75957	chr16	29899335	29900967	1632	816.0	
75958	chr16	29925258	29927128	1870	935.0	
75959	chr16	29961218	29963302	2084	1042.0	
75960	chr16	29972450	29975143	2693	1346.0	
75961	chr16	29975962	29976363	401	200.0	
75962	chr16	29994766	29997021	2255	1128.0	
75963	chr16	30004750	30005939	1189	594.0	
75964	chr16	30010242	30012128	1886	943.0	
75965	chr16	30020728	30022170	1442	721.0	
75966	chr16	30028670	30028973	303	152.0	
75967	chr16	30030828	30032712	1884	942.0	
75968	chr16	30040216	30040587	371	186.0	
75969	chr16	30052651	30053842	1191	596.0	
75970	chr16	30054955	30055542	587	294.0	
75971	chr16	30063526	30067449	3923	1962.0	
75972	chr16	30068525	30069683	1158	579.0	
75973	chr16	30070597	30070971	374	187.0	
75974	chr16	30074608	30076945	2337	1168.0	
75975	chr16	30077662	30077947	285	142.0	
75976	chr16	30083598	30084256	658	329.0	
75977	chr16	30084811	30085167	356	178.0	
75978	chr16	30086653	30087903	1250	625.0	
75979	chr16	30089661	30090520	859	430.0	
75980	chr16	30091236	30093298	2062	1031.0	
75981	chr16	30094927	30097325	2398	1199.0	
75982	chr16	30112672	30113329	657	328.0	
75983	chr16	30115114	30115635	521	260.0	
75984	chr16	30120299	30120607	308	154.0	
75985	chr16	30121818	30123919	2101	1050.0	
75986	chr16	30130538	30131167	629	314.0	
75987	chr16	30137017	30137643	626	313.0	
75988	chr16	30139583	30140265	682	341.0	
75989	chr16	30142984	30143527	543	272.0	
75990	chr16	30147319	30147461	142	71.0	
75991	chr16	30149420	30150063	643	322.0	
75992	chr16	30165927	30166806	879	440.0	
75993	chr16	30176924	30177376	452	226.0	
75994	chr16	30182331	30188127	5796	2898.0	
75995	chr16	30334276	30336350	2074	1037.0	
75996	chr16	30349632	30351084	1452	726.0	
75997	chr16	30354333	30357136	2803	1402.0	
75998	chr16	30367778	30372452	4674	2337.0	
75999	chr16	30377170	30383439	6269	3134.0	
76000	chr16	30394708	30396295	1587	794.0	
76001	chr16	30397425	30398108	683	342.0	
76002	chr16	30399867	30401144	1277	638.0	
76003	chr16	30406722	30408193	1471	736.0	
76004	chr16	30408760	30410093	1333	666.0	
76005	chr16	30417197	30418875	1678	839.0	
76006	chr16	30428890	30430923	2033	1016.0	
76007	chr16	30434354	30434377	23	12.0	
76008	chr16	30445056	30446549	1493	746.0	
76009	chr16	30449687	30451380	1693	846.0	
76010	chr16	30458515	30459491	976	488.0	
76011	chr16	30461460	30461746	286	143.0	
76012	chr16	30469267	30474445	5178	2589.0	
76013	chr16	30475063	30475537	474	237.0	
76014	chr16	30478816	30479110	294	147.0	
76015	chr16	30482415	30482728	313	156.0	
76016	chr16	30491871	30492309	438	219.0	
76017	chr16	30519504	30519857	353	176.0	
76018	chr16	30520435	30520732	297	148.0	
76019	chr16	30521593	30524533	2940	1470.0	
76020	chr16	30525871	30528306	2435	1218.0	
76021	chr16	30530166	30530433	267	134.0	
76022	chr16	30533790	30536755	2965	1482.0	
76023	chr16	30546117	30546573	456	228.0	
76024	chr16	30551129	30552472	1343	672.0	
76025	chr16	30553401	30553506	105	52.0	
76026	chr16	30556899	30560066	3167	1584.0	
76027	chr16	30561071	30562057	986	493.0	
76028	chr16	30567059	30568852	1793	896.0	
76029	chr16	30570908	30572761	1853	926.0	
76030	chr16	30575409	30575801	392	196.0	
76031	chr16	30584945	30586527	1582	791.0	
76032	chr16	30597932	30598742	810	405.0	
76033	chr16	30601955	30603328	1373	686.0	
76034	chr16	30605099	30605683	584	292.0	
76035	chr16	30609330	30610944	1614	807.0	
76036	chr16	30613700	30614209	509	254.0	
76037	chr16	30615237	30615819	582	291.0	
76038	chr16	30628456	30629368	912	456.0	
76039	chr16	30633658	30635302	1644	822.0	
76040	chr16	30637858	30638392	534	267.0	
76041	chr16	30649583	30652489	2906	1453.0	
76042	chr16	30657194	30661502	4308	2154.0	
76043	chr16	30663792	30663847	55	28.0	
76044	chr16	30668232	30668399	167	84.0	
76045	chr16	30670133	30670509	376	188.0	
76046	chr16	30692545	30694483	1938	969.0	
76047	chr16	30697447	30699881	2434	1217.0	
76048	chr16	30713565	30714236	671	336.0	
76049	chr16	30714989	30716386	1397	698.0	
76050	chr16	30722570	30722640	70	35.0	
76051	chr16	30724329	30725710	1381	690.0	
76052	chr16	30728763	30729252	489	244.0	
76053	chr16	30747420	30749464	2044	1022.0	
76054	chr16	30758698	30762991	4293	2146.0	
76055	chr16	30767560	30768392	832	416.0	
76056	chr16	30774828	30776625	1797	898.0	
76057	chr16	30780582	30780808	226	113.0	
76058	chr16	30786003	30787782	1779	890.0	
76059	chr16	30805060	30806737	1677	838.0	
76060	chr16	30808121	30808660	539	270.0	
76061	chr16	30812796	30815149	2353	1176.0	
76062	chr16	30844420	30845522	1102	551.0	
76063	chr16	30873317	30873761	444	222.0	
76064	chr16	30874352	30877201	2849	1424.0	
76065	chr16	30893068	30897821	4753	2376.0	
76066	chr16	30901370	30904561	3191	1596.0	
76067	chr16	30921331	30925852	4521	2260.0	
76068	chr16	30927759	30928531	772	386.0	
76069	chr16	30935094	30935691	597	298.0	
76070	chr16	30941606	30942702	1096	548.0	
76071	chr16	30948005	30950895	2890	1445.0	
76072	chr16	30953416	30954281	865	432.0	
76073	chr16	30956596	30958949	2353	1176.0	
76074	chr16	30977714	30977751	37	18.0	
76075	chr16	30984673	30985860	1187	594.0	
76076	chr16	30994376	30994880	504	252.0	
76077	chr16	30996632	30997934	1302	651.0	
76078	chr16	31009980	31011052	1072	536.0	
76079	chr16	31031783	31034863	3080	1540.0	
76080	chr16	31036669	31037148	479	240.0	
76081	chr16	31048601	31048901	300	150.0	
76082	chr16	31052136	31052527	391	196.0	
76083	chr16	31063655	31066119	2464	1232.0	
76084	chr16	31072041	31075536	3495	1748.0	
76085	chr16	31081961	31082149	188	94.0	
76086	chr16	31093058	31096325	3267	1634.0	
76087	chr16	31105559	31106319	760	380.0	
76088	chr16	31107948	31109231	1283	642.0	
76089	chr16	31113030	31114224	1194	597.0	
76090	chr16	31116263	31119131	2868	1434.0	
76091	chr16	31128329	31130980	2651	1326.0	
76092	chr16	31134090	31135130	1040	520.0	
76093	chr16	31140656	31143433	2777	1388.0	
76094	chr16	31149404	31150662	1258	629.0	
76095	chr16	31157094	31157576	482	241.0	
76096	chr16	31159602	31160290	688	344.0	
76097	chr16	31176850	31177751	901	450.0	
76098	chr16	31178660	31205524	26864	13432.0	
76099	chr16	31206551	31208874	2323	1162.0	
76100	chr16	31214343	31217315	2972	1486.0	
76101	chr16	31242186	31242702	516	258.0	
76102	chr16	31243823	31244678	855	428.0	
76103	chr16	31253359	31254273	914	457.0	
76104	chr16	31259478	31260926	1448	724.0	
76105	chr16	31263268	31263716	448	224.0	
76106	chr16	31265106	31266220	1114	557.0	
76107	chr16	31301886	31302516	630	315.0	
76108	chr16	31330973	31331796	823	412.0	
76109	chr16	31333629	31334284	655	328.0	
76110	chr16	31344602	31345347	745	372.0	
76111	chr16	31348339	31349061	722	361.0	
76112	chr16	31350077	31350750	673	336.0	
76113	chr16	31351394	31353093	1699	850.0	
76114	chr16	31354154	31355866	1712	856.0	
76115	chr16	31356530	31358393	1863	932.0	
76116	chr16	31360319	31360657	338	169.0	
76117	chr16	31364711	31365726	1015	508.0	
76118	chr16	31367732	31368400	668	334.0	
76119	chr16	31382429	31383008	579	290.0	
76120	chr16	31386248	31387271	1023	512.0	
76121	chr16	31397173	31397434	261	130.0	
76122	chr16	31400046	31400698	652	326.0	
76123	chr16	31414945	31414956	11	6.0	
76124	chr16	31420059	31420398	339	170.0	
76125	chr16	31421542	31422061	519	260.0	
76126	chr16	31427261	31428210	949	474.0	
76127	chr16	31439274	31439373	99	50.0	
76128	chr16	31442474	31443660	1186	593.0	
76129	chr16	31451768	31452113	345	172.0	
76130	chr16	31453534	31454433	899	450.0	
76131	chr16	31455445	31457059	1614	807.0	
76132	chr16	31457682	31461313	3631	1816.0	
76133	chr16	31467111	31467672	561	280.0	
76134	chr16	31471752	31473317	1565	782.0	
76135	chr16	31475929	31478186	2257	1128.0	
76136	chr16	31487032	31488841	1809	904.0	
76137	chr16	31507467	31509102	1635	818.0	
76138	chr16	31695440	31696441	1001	500.0	
76139	chr16	31700185	31701810	1625	812.0	
76140	chr16	31706844	31706866	22	11.0	
76141	chr16	31708326	31708803	477	238.0	
76142	chr16	31711530	31711720	190	95.0	
76143	chr16	31712381	31715677	3296	1648.0	
76144	chr16	31859319	31859830	511	256.0	
76145	chr16	31861456	31861838	382	191.0	
76146	chr16	31868493	31870380	1887	944.0	
76147	chr16	31873103	31878322	5219	2610.0	
76148	chr16	31880083	31881001	918	459.0	
76149	chr16	31956236	31956633	397	198.0	
76150	chr16	32066301	32066371	70	35.0	
76151	chr16	32084962	32085882	920	460.0	
76152	chr16	32115701	32116533	832	416.0	
76153	chr16	32187664	32188431	767	384.0	
76154	chr16	32253510	32254662	1152	576.0	
76155	chr16	33337943	33337992	49	24.0	
76156	chr16	33339655	33340061	406	203.0	
76157	chr16	33491323	33492049	726	363.0	
76158	chr16	33655838	33656202	364	182.0	
76159	chr16	33707007	33707675	668	334.0	
76160	chr16	34062429	34064820	2391	1196.0	
76161	chr16	34065544	34066231	687	344.0	
76162	chr16	34071626	34071779	153	76.0	
76163	chr16	34085248	34085402	154	77.0	
76164	chr16	34098969	34099333	364	182.0	
76165	chr16	34140994	34141384	390	195.0	
76166	chr16	34142060	34142072	12	6.0	
76167	chr16	34163057	34164021	964	482.0	
76168	chr16	34165665	34165818	153	76.0	
76169	chr16	34167431	34167559	128	64.0	
76170	chr16	34168404	34174550	6146	3073.0	
76171	chr16	34180217	34182261	2044	1022.0	
76172	chr16	34185655	34185919	264	132.0	
76173	chr16	34206927	34206976	49	24.0	
76174	chr16	35207664	35207784	120	60.0	
76175	chr16	46387867	46388262	395	198.0	
76176	chr16	46382795	46383718	923	462.0	
76177	chr16	46385584	46386155	571	286.0	
76178	chr16	46391660	46395758	4098	2049.0	
76179	chr16	46401399	46401824	425	212.0	
76180	chr16	46554320	46554784	464	232.0	
76181	chr16	46612192	46612586	394	197.0	
76182	chr16	46620266	46622046	1780	890.0	
76183	chr16	46658655	46659498	843	422.0	
76184	chr16	46673300	46673848	548	274.0	
76185	chr16	46687924	46690873	2949	1474.0	
76186	chr16	46709683	46709955	272	136.0	
76187	chr16	46711094	46711764	670	335.0	
76188	chr16	46712467	46713374	907	454.0	
76189	chr16	46743148	46743885	737	368.0	
76190	chr16	46787821	46788307	486	243.0	
76191	chr16	46789277	46790652	1375	688.0	
76192	chr16	46829582	46832120	2538	1269.0	
76193	chr16	46836516	46837552	1036	518.0	
76194	chr16	46843901	46844443	542	271.0	
76195	chr16	46853874	46854536	662	331.0	
76196	chr16	46857607	46857899	292	146.0	
76197	chr16	46859764	46860392	628	314.0	
76198	chr16	46878300	46878778	478	239.0	
76199	chr16	46883436	46885277	1841	920.0	
76200	chr16	46899399	46899845	446	223.0	
76201	chr16	46908817	46909298	481	240.0	
76202	chr16	46916252	46917325	1073	536.0	
76203	chr16	46918801	46919444	643	322.0	
76204	chr16	46929653	46930349	696	348.0	
76205	chr16	46932716	46933112	396	198.0	
76206	chr16	46943041	46943430	389	194.0	
76207	chr16	46947743	46948303	560	280.0	
76208	chr16	46961258	46962234	976	488.0	
76209	chr16	46972200	46975072	2872	1436.0	
76210	chr16	47016411	47017300	889	444.0	
76211	chr16	47018083	47018970	887	444.0	
76212	chr16	47037249	47038635	1386	693.0	
76213	chr16	47045064	47045841	777	388.0	
76214	chr16	47136414	47136432	18	9.0	
76215	chr16	47141587	47144913	3326	1663.0	
76216	chr16	47392122	47392544	422	211.0	
76217	chr16	47460091	47462465	2374	1187.0	
76218	chr16	47492539	47494121	1582	791.0	
76219	chr16	47523316	47523805	489	244.0	
76220	chr16	47565304	47566215	911	456.0	
76221	chr16	47568296	47568812	516	258.0	
76222	chr16	47574328	47575128	800	400.0	
76223	chr16	47592313	47592564	251	126.0	
76224	chr16	47643578	47644104	526	263.0	
76225	chr16	47699105	47699516	411	206.0	
76226	chr16	47779554	47780110	556	278.0	
76227	chr16	48055029	48055430	401	200.0	
76228	chr16	48117457	48117934	477	238.0	
76229	chr16	48156645	48157174	529	264.0	
76230	chr16	48164806	48165560	754	377.0	
76231	chr16	48188322	48188989	667	334.0	
76232	chr16	48201711	48202031	320	160.0	
76233	chr16	48231864	48232185	321	160.0	
76234	chr16	48243957	48245283	1326	663.0	
76235	chr16	48285028	48285371	343	172.0	
76236	chr16	48317561	48319232	1671	836.0	
76237	chr16	48331059	48331077	18	9.0	
76238	chr16	48347201	48347587	386	193.0	
76239	chr16	48353283	48354535	1252	626.0	
76240	chr16	48361909	48361923	14	7.0	
76241	chr16	48365352	48367176	1824	912.0	
76242	chr16	48373518	48374071	553	276.0	
76243	chr16	48378538	48379591	1053	526.0	
76244	chr16	48381713	48381882	169	84.0	
76245	chr16	48383635	48386324	2689	1344.0	
76246	chr16	48388642	48388769	127	64.0	
76247	chr16	48391053	48391368	315	158.0	
76248	chr16	48431940	48432603	663	332.0	
76249	chr16	48433796	48435308	1512	756.0	
76250	chr16	48458040	48458848	808	404.0	
76251	chr16	48492244	48492411	167	84.0	
76252	chr16	48524820	48525284	464	232.0	
76253	chr16	48526571	48526589	18	9.0	
76254	chr16	48536111	48537675	1564	782.0	
76255	chr16	48539165	48539391	226	113.0	
76256	chr16	48541803	48542562	759	380.0	
76257	chr16	48552655	48553132	477	238.0	
76258	chr16	48556766	48557512	746	373.0	
76259	chr16	48558174	48559007	833	416.0	
76260	chr16	48562051	48562374	323	162.0	
76261	chr16	48576926	48577459	533	266.0	
76262	chr16	48596260	48596709	449	224.0	
76263	chr16	48597843	48598430	587	294.0	
76264	chr16	48602229	48604353	2124	1062.0	
76265	chr16	48605609	48606140	531	266.0	
76266	chr16	48607091	48607551	460	230.0	
76267	chr16	48608158	48614060	5902	2951.0	
76268	chr16	48619671	48619956	285	142.0	
76269	chr16	48621054	48621948	894	447.0	
76270	chr16	48622917	48624249	1332	666.0	
76271	chr16	48630116	48631046	930	465.0	
76272	chr16	49281734	49282569	835	418.0	
76273	chr16	49399833	49399847	14	7.0	
76274	chr16	49407913	49408349	436	218.0	
76275	chr16	49441228	49441951	723	362.0	
76276	chr16	49462342	49464295	1953	976.0	
76277	chr16	49464850	49465098	248	124.0	
76278	chr16	49484346	49484807	461	230.0	
76279	chr16	49492145	49492608	463	232.0	
76280	chr16	49528115	49528795	680	340.0	
76281	chr16	49575207	49575862	655	328.0	
76282	chr16	49592892	49593308	416	208.0	
76283	chr16	49754796	49755114	318	159.0	
76284	chr16	49854901	49856113	1212	606.0	
76285	chr16	49856678	49859353	2675	1338.0	
76286	chr16	49876686	49876982	296	148.0	
76287	chr16	50024541	50026199	1658	829.0	
76288	chr16	50037751	50038249	498	249.0	
76289	chr16	50038914	50039679	765	382.0	
76290	chr16	50065334	50068083	2749	1374.0	
76291	chr16	50093426	50094459	1033	516.0	
76292	chr16	50102497	50102727	230	115.0	
76293	chr16	50121862	50122057	195	98.0	
76294	chr16	50151995	50156115	4120	2060.0	
76295	chr16	50156754	50156765	11	6.0	
76296	chr16	50158893	50159281	388	194.0	
76297	chr16	50160420	50161945	1525	762.0	
76298	chr16	50194510	50194629	119	60.0	
76299	chr16	50195223	50195667	444	222.0	
76300	chr16	50196666	50197391	725	362.0	
76301	chr16	50199064	50199066	2	1.0	
76302	chr16	50201757	50202234	477	238.0	
76303	chr16	50209546	50210982	1436	718.0	
76304	chr16	50213677	50214393	716	358.0	
76305	chr16	50242995	50243410	415	208.0	
76306	chr16	50245275	50247203	1928	964.0	
76307	chr16	50259514	50259586	72	36.0	
76308	chr16	50261875	50262055	180	90.0	
76309	chr16	50265091	50268594	3503	1752.0	
76310	chr16	50269323	50270029	706	353.0	
76311	chr16	50270788	50279983	9195	4598.0	
76312	chr16	50281379	50285096	3717	1858.0	
76313	chr16	50309744	50309991	247	124.0	
76314	chr16	50312263	50312449	186	93.0	
76315	chr16	50313189	50314331	1142	571.0	
76316	chr16	50323693	50323983	290	145.0	
76317	chr16	50326819	50327770	951	476.0	
76318	chr16	50329710	50329763	53	26.0	
76319	chr16	50335129	50335838	709	354.0	
76320	chr16	50338792	50339369	577	288.0	
76321	chr16	50354864	50355307	443	222.0	
76322	chr16	50366107	50366539	432	216.0	
76323	chr16	50368060	50370122	2062	1031.0	
76324	chr16	50382213	50382432	219	110.0	
76325	chr16	50509812	50509857	45	22.0	
76326	chr16	50545730	50546341	611	306.0	
76327	chr16	50547172	50550597	3425	1712.0	
76328	chr16	50553358	50553522	164	82.0	
76329	chr16	50558084	50558089	5	2.0	
76330	chr16	50584109	50584420	311	156.0	
76331	chr16	50588695	50589788	1093	546.0	
76332	chr16	50602430	50603001	571	286.0	
76333	chr16	50611455	50612056	601	300.0	
76334	chr16	50626932	50627929	997	498.0	
76335	chr16	50644741	50645140	399	200.0	
76336	chr16	50664369	50667780	3411	1706.0	
76337	chr16	50671619	50672234	615	308.0	
76338	chr16	50677394	50677862	468	234.0	
76339	chr16	50678415	50679800	1385	692.0	
76340	chr16	50680433	50682138	1705	852.0	
76341	chr16	50683531	50686340	2809	1404.0	
76342	chr16	50688760	50689395	635	318.0	
76343	chr16	50692862	50694521	1659	830.0	
76344	chr16	50695271	50698892	3621	1810.0	
76345	chr16	50699526	50700472	946	473.0	
76346	chr16	50708559	50709835	1276	638.0	
76347	chr16	50712587	50713344	757	378.0	
76348	chr16	50714388	50715113	725	362.0	
76349	chr16	50720028	50720412	384	192.0	
76350	chr16	50721935	50722583	648	324.0	
76351	chr16	50724424	50724696	272	136.0	
76352	chr16	50735735	50736145	410	205.0	
76353	chr16	50740623	50744200	3577	1788.0	
76354	chr16	50744933	50746385	1452	726.0	
76355	chr16	50747065	50748184	1119	560.0	
76356	chr16	50781114	50781537	423	212.0	
76357	chr16	50805881	50807141	1260	630.0	
76358	chr16	50841090	50841503	413	206.0	
76359	chr16	52727437	52728271	834	417.0	
76360	chr16	52741668	52741980	312	156.0	
76361	chr16	53052503	53053083	580	290.0	
76362	chr16	53054294	53056131	1837	918.0	
76363	chr16	53061488	53062336	848	424.0	
76364	chr16	53068263	53068951	688	344.0	
76365	chr16	53090493	53092324	1831	916.0	
76366	chr16	53093816	53094603	787	394.0	
76367	chr16	53098457	53100293	1836	918.0	
76368	chr16	53128853	53129241	388	194.0	
76369	chr16	53129778	53132232	2454	1227.0	
76370	chr16	53159659	53160300	641	320.0	
76371	chr16	53207708	53208800	1092	546.0	
76372	chr16	53216780	53217244	464	232.0	
76373	chr16	53219509	53221005	1496	748.0	
76374	chr16	53225077	53225278	201	100.0	
76375	chr16	53369855	53371188	1333	666.0	
76376	chr16	53372841	53374042	1201	600.0	
76377	chr16	53374859	53375192	333	166.0	
76378	chr16	53433832	53436075	2243	1122.0	
76379	chr16	53445521	53445991	470	235.0	
76380	chr16	53449858	53450341	483	242.0	
76381	chr16	53453856	53454433	577	288.0	
76382	chr16	53456045	53458326	2281	1140.0	
76383	chr16	53481989	53483000	1011	506.0	
76384	chr16	53501261	53505010	3749	1874.0	
76385	chr16	53510013	53511928	1915	958.0	
76386	chr16	53513160	53513441	281	140.0	
76387	chr16	53518151	53519782	1631	816.0	
76388	chr16	53534774	53535321	547	274.0	
76389	chr16	53537551	53538126	575	288.0	
76390	chr16	53545327	53545859	532	266.0	
76391	chr16	53549872	53550535	663	332.0	
76392	chr16	53703304	53704860	1556	778.0	
76393	chr16	53744685	53744748	63	32.0	
76394	chr16	53773405	53773499	94	47.0	
76395	chr16	53776083	53776553	470	235.0	
76396	chr16	53822981	53823654	673	336.0	
76397	chr16	53865129	53865978	849	424.0	
76398	chr16	53872521	53872546	25	12.0	
76399	chr16	53892076	53892427	351	176.0	
76400	chr16	53911522	53912892	1370	685.0	
76401	chr16	53913494	53914042	548	274.0	
76402	chr16	53945905	53946280	375	188.0	
76403	chr16	53952233	53952829	596	298.0	enhancer
76404	chr16	54193600	54194013	413	206.0	
76405	chr16	54266352	54266994	642	321.0	
76406	chr16	54927927	54931639	3712	1856.0	
76407	chr16	54936954	54937556	602	301.0	
76408	chr16	55333827	55333868	41	20.0	
76409	chr16	55437301	55438162	861	430.0	
76410	chr16	55439141	55439763	622	311.0	
76411	chr16	55444324	55445509	1185	592.0	
76412	chr16	55464969	55465699	730	365.0	
76413	chr16	55494981	55495422	441	220.0	
76414	chr16	55500457	55500959	502	251.0	
76415	chr16	55508225	55510615	2390	1195.0	
76416	chr16	55538896	55539428	532	266.0	
76417	chr16	55567376	55567748	372	186.0	
76418	chr16	55568876	55569372	496	248.0	
76419	chr16	55577851	55578307	456	228.0	
76420	chr16	55622250	55622713	463	232.0	
76421	chr16	55701666	55702102	436	218.0	
76422	chr16	55712223	55712710	487	244.0	
76423	chr16	55752691	55754498	1807	904.0	
76424	chr16	55756881	55757394	513	256.0	
76425	chr16	55782582	55782880	298	149.0	
76426	chr16	55787995	55788368	373	186.0	
76427	chr16	55832932	55834506	1574	787.0	
76428	chr16	55835618	55836699	1081	540.0	
76429	chr16	55839023	55839636	613	306.0	
76430	chr16	55842778	55843210	432	216.0	
76431	chr16	55944255	55944668	413	206.0	
76432	chr16	56041749	56042142	393	196.0	
76433	chr16	56048429	56049230	801	400.0	
76434	chr16	56119380	56119392	12	6.0	
76435	chr16	56121099	56121484	385	192.0	
76436	chr16	56190156	56192494	2338	1169.0	
76437	chr16	56193210	56193310	100	50.0	
76438	chr16	56194033	56194911	878	439.0	
76439	chr16	56198897	56199752	855	428.0	
76440	chr16	56201947	56203550	1603	802.0	
76441	chr16	56211733	56212034	301	150.0	
76442	chr16	56226861	56227423	562	281.0	
76443	chr16	56261946	56262952	1006	503.0	
76444	chr16	56278986	56279665	679	340.0	
76445	chr16	56282492	56282868	376	188.0	
76446	chr16	56286799	56287130	331	166.0	
76447	chr16	56299288	56299680	392	196.0	
76448	chr16	56318008	56318768	760	380.0	
76449	chr16	56356298	56358263	1965	982.0	
76450	chr16	56415871	56416232	361	180.0	
76451	chr16	56423543	56426237	2694	1347.0	
76452	chr16	56450348	56452615	2267	1134.0	
76453	chr16	56513842	56514360	518	259.0	
76454	chr16	56519109	56520882	1773	886.0	
76455	chr16	56576785	56577576	791	396.0	
76456	chr16	56589176	56589830	654	327.0	
76457	chr16	56591682	56592041	359	180.0	
76458	chr16	56600362	56600855	493	246.0	
76459	chr16	56603573	56603989	416	208.0	
76460	chr16	56607055	56610982	3927	1964.0	
76461	chr16	56617032	56617738	706	353.0	
76462	chr16	56625019	56626255	1236	618.0	
76463	chr16	56630139	56630540	401	200.0	
76464	chr16	56631944	56632812	868	434.0	
76465	chr16	56634997	56636631	1634	817.0	
76466	chr16	56638013	56638777	764	382.0	
76467	chr16	56642976	56644057	1081	540.0	
76468	chr16	56657026	56658720	1694	847.0	
76469	chr16	56662488	56663520	1032	516.0	
76470	chr16	56667899	56668486	587	294.0	
76471	chr16	56673926	56674337	411	206.0	
76472	chr16	56675598	56676384	786	393.0	
76473	chr16	56681676	56683407	1731	866.0	
76474	chr16	56701684	56702683	999	500.0	
76475	chr16	56708441	56709357	916	458.0	
76476	chr16	56729077	56730964	1887	944.0	
76477	chr16	56732787	56733233	446	223.0	
76478	chr16	56735567	56736118	551	276.0	
76479	chr16	56793592	56793852	260	130.0	
76480	chr16	56847498	56848289	791	396.0	
76481	chr16	56858227	56858816	589	294.0	
76482	chr16	56860125	56861518	1393	696.0	
76483	chr16	56862262	56863362	1100	550.0	
76484	chr16	56867021	56867718	697	348.0	
76485	chr16	56869472	56870333	861	430.0	
76486	chr16	56871074	56871637	563	282.0	
76487	chr16	56888743	56889264	521	260.0	
76488	chr16	56898828	56899303	475	238.0	
76489	chr16	56910420	56912449	2029	1014.0	
76490	chr16	56913109	56913474	365	182.0	
76491	chr16	56916574	56918320	1746	873.0	
76492	chr16	56924428	56924970	542	271.0	
76493	chr16	56930634	56936698	6064	3032.0	
76494	chr16	56938048	56952146	14098	7049.0	
76495	chr16	56964261	56966478	2217	1108.0	
76496	chr16	56971074	56971658	584	292.0	
76497	chr16	56974582	56975503	921	460.0	
76498	chr16	56977938	56978223	285	142.0	
76499	chr16	56979919	56980257	338	169.0	
76500	chr16	56985504	56986302	798	399.0	
76501	chr16	56987307	56992443	5136	2568.0	
76502	chr16	56993392	56993531	139	70.0	
76503	chr16	56994133	56996198	2065	1032.0	
76504	chr16	56998840	57001749	2909	1454.0	
76505	chr16	57003371	57003897	526	263.0	
76506	chr16	57005653	57006051	398	199.0	
76507	chr16	57009633	57010043	410	205.0	
76508	chr16	57011143	57011201	58	29.0	
76509	chr16	57013879	57015389	1510	755.0	
76510	chr16	57016265	57016537	272	136.0	
76511	chr16	57022374	57022821	447	224.0	
76512	chr16	57023433	57024294	861	430.0	
76513	chr16	57024854	57025316	462	231.0	
76514	chr16	57025930	57026652	722	361.0	
76515	chr16	57029634	57030207	573	286.0	
76516	chr16	57036340	57037746	1406	703.0	
76517	chr16	57038351	57043662	5311	2656.0	
76518	chr16	57045202	57046305	1103	552.0	
76519	chr16	57047122	57047885	763	382.0	
76520	chr16	57050182	57050963	781	390.0	
76521	chr16	57055904	57055909	5	2.0	
76522	chr16	57057946	57058239	293	146.0	
76523	chr16	57059214	57059590	376	188.0	
76524	chr16	57060145	57063293	3148	1574.0	
76525	chr16	57065304	57067988	2684	1342.0	
76526	chr16	57069752	57072240	2488	1244.0	
76527	chr16	57074457	57074825	368	184.0	
76528	chr16	57077847	57078053	206	103.0	
76529	chr16	57078983	57079063	80	40.0	
76530	chr16	57081517	57081847	330	165.0	
76531	chr16	57082371	57082455	84	42.0	
76532	chr16	57083070	57085437	2367	1184.0	
76533	chr16	57090042	57090886	844	422.0	
76534	chr16	57091436	57093587	2151	1076.0	
76535	chr16	57124015	57124192	177	88.0	
76536	chr16	57126620	57126625	5	2.0	
76537	chr16	57128569	57129560	991	496.0	
76538	chr16	57130313	57131574	1261	630.0	
76539	chr16	57133229	57135750	2521	1260.0	
76540	chr16	57139936	57140339	403	202.0	
76541	chr16	57141614	57142334	720	360.0	
76542	chr16	57166891	57168441	1550	775.0	
76543	chr16	57185055	57187968	2913	1456.0	
76544	chr16	57235747	57236110	363	182.0	
76545	chr16	57240782	57241423	641	320.0	
76546	chr16	57244263	57245987	1724	862.0	
76547	chr16	57260403	57260800	397	198.0	
76548	chr16	57266438	57267331	893	446.0	
76549	chr16	57276500	57278056	1556	778.0	
76550	chr16	57283998	57285298	1300	650.0	
76551	chr16	57297727	57298465	738	369.0	
76552	chr16	57299100	57301372	2272	1136.0	
76553	chr16	57304100	57304539	439	220.0	
76554	chr16	57324709	57325274	565	282.0	
76555	chr16	57339598	57341498	1900	950.0	
76556	chr16	57343192	57343543	351	176.0	
76557	chr16	57349054	57349824	770	385.0	
76558	chr16	57357595	57358872	1277	638.0	
76559	chr16	57381126	57381249	123	62.0	
76560	chr16	57383838	57384707	869	434.0	
76561	chr16	57406915	57407259	344	172.0	
76562	chr16	57413329	57413885	556	278.0	
76563	chr16	57416138	57417747	1609	804.0	
76564	chr16	57418696	57419523	827	414.0	
76565	chr16	57433982	57434287	305	152.0	
76566	chr16	57446423	57448144	1721	860.0	
76567	chr16	57462163	57463410	1247	624.0	
76568	chr16	57472924	57473177	253	126.0	
76569	chr16	57475427	57476779	1352	676.0	
76570	chr16	57478662	57479325	663	332.0	
76571	chr16	57485588	57486985	1397	698.0	
76572	chr16	57519543	57520383	840	420.0	
76573	chr16	57522949	57523401	452	226.0	
76574	chr16	57526477	57526745	268	134.0	
76575	chr16	57529407	57531672	2265	1132.0	
76576	chr16	57532431	57539573	7142	3571.0	
76577	chr16	57542024	57545025	3001	1500.0	
76578	chr16	57575970	57579125	3155	1578.0	
76579	chr16	57588812	57589879	1067	534.0	
76580	chr16	57590690	57593567	2877	1438.0	
76581	chr16	57599828	57600763	935	468.0	
76582	chr16	57601350	57602654	1304	652.0	
76583	chr16	57609316	57610468	1152	576.0	
76584	chr16	57617762	57617924	162	81.0	
76585	chr16	57628159	57629922	1763	882.0	
76586	chr16	57639210	57639664	454	227.0	
76587	chr16	57646290	57649675	3385	1692.0	
76588	chr16	57651813	57652397	584	292.0	
76589	chr16	57656299	57656742	443	222.0	
76590	chr16	57667019	57668687	1668	834.0	
76591	chr16	57669362	57669945	583	292.0	
76592	chr16	57675630	57676097	467	234.0	
76593	chr16	57684397	57684490	93	46.0	
76594	chr16	57687386	57687780	394	197.0	
76595	chr16	57689438	57691370	1932	966.0	
76596	chr16	57694514	57695490	976	488.0	
76597	chr16	57720203	57720668	465	232.0	
76598	chr16	57732126	57732163	37	18.0	
76599	chr16	57734677	57737283	2606	1303.0	
76600	chr16	57756765	57757838	1073	536.0	
76601	chr16	57758502	57758870	368	184.0	
76602	chr16	57764632	57765279	647	324.0	
76603	chr16	57795304	57795812	508	254.0	
76604	chr16	57799477	57803214	3737	1868.0	
76605	chr16	57807866	57808776	910	455.0	
76606	chr16	57809860	57811189	1329	664.0	
76607	chr16	57814959	57816867	1908	954.0	
76608	chr16	57863628	57863688	60	30.0	
76609	chr16	57889345	57890855	1510	755.0	
76610	chr16	57892489	57894537	2048	1024.0	
76611	chr16	57899638	57900325	687	344.0	
76612	chr16	57906332	57906845	513	256.0	
76613	chr16	57984287	57986343	2056	1028.0	
76614	chr16	57994705	57995291	586	293.0	
76615	chr16	57998185	58002155	3970	1985.0	
76616	chr16	58005046	58005681	635	318.0	
76617	chr16	58020380	58021089	709	354.0	
76618	chr16	58024581	58027255	2674	1337.0	
76619	chr16	58046404	58046728	324	162.0	
76620	chr16	58097152	58097646	494	247.0	
76621	chr16	58121813	58122297	484	242.0	
76622	chr16	58124364	58124717	353	176.0	
76623	chr16	58125928	58130168	4240	2120.0	
76624	chr16	58177024	58177382	358	179.0	
76625	chr16	58196926	58198794	1868	934.0	
76626	chr16	58236102	58236979	877	438.0	
76627	chr16	58243476	58243807	331	166.0	
76628	chr16	58249376	58250609	1233	616.0	
76629	chr16	58336587	58337095	508	254.0	
76630	chr16	58384670	58384971	301	150.0	
76631	chr16	58391828	58393457	1629	814.0	
76632	chr16	58421132	58421479	347	174.0	
76633	chr16	58425826	58426643	817	408.0	
76634	chr16	58463444	58463631	187	94.0	
76635	chr16	58487633	58488176	543	272.0	
76636	chr16	58494972	58495618	646	323.0	
76637	chr16	58499939	58500237	298	149.0	
76638	chr16	58500878	58502028	1150	575.0	
76639	chr16	58507225	58507478	253	126.0	
76640	chr16	58511634	58512660	1026	513.0	
76641	chr16	58514682	58516870	2188	1094.0	
76642	chr16	58627161	58631163	4002	2001.0	
76643	chr16	58661086	58661696	610	305.0	
76644	chr16	58683945	58685205	1260	630.0	
76645	chr16	58699212	58699356	144	72.0	
76646	chr16	58733264	58734809	1545	772.0	
76647	chr16	58755793	58756841	1048	524.0	
76648	chr16	58814273	58814667	394	197.0	
76649	chr16	58860055	58860189	134	67.0	
76650	chr16	58882094	58882801	707	354.0	
76651	chr16	58935235	58935403	168	84.0	
76652	chr16	58970791	58971241	450	225.0	
76653	chr16	59039386	59039660	274	137.0	
76654	chr16	59058394	59058428	34	17.0	
76655	chr16	59067183	59067642	459	230.0	
76656	chr16	59259039	59260419	1380	690.0	
76657	chr16	59900250	59900284	34	17.0	
76658	chr16	60077809	60078357	548	274.0	
76659	chr16	60107225	60107948	723	362.0	
76660	chr16	60188785	60189192	407	204.0	
76661	chr16	61887868	61888282	414	207.0	
76662	chr16	65725086	65725617	531	266.0	
76663	chr16	65734892	65735258	366	183.0	
76664	chr16	65739387	65740086	699	350.0	
76665	chr16	66150681	66151129	448	224.0	
76666	chr16	66166565	66166904	339	170.0	
76667	chr16	66205549	66206522	973	486.0	
76668	chr16	66207122	66208292	1170	585.0	
76669	chr16	66220868	66220994	126	63.0	
76670	chr16	66229709	66229777	68	34.0	
76671	chr16	66270329	66270882	553	276.0	
76672	chr16	66274410	66274781	371	186.0	
76673	chr16	66315179	66315659	480	240.0	
76674	chr16	66357472	66357837	365	182.0	
76675	chr16	66368995	66369479	484	242.0	
76676	chr16	66376869	66377254	385	192.0	
76677	chr16	66406215	66407299	1084	542.0	
76678	chr16	66408233	66408964	731	366.0	
76679	chr16	66426953	66427422	469	234.0	
76680	chr16	66428076	66428179	103	52.0	
76681	chr16	66474667	66475271	604	302.0	
76682	chr16	66476327	66476682	355	178.0	
76683	chr16	66478522	66479479	957	478.0	
76684	chr16	66481090	66481272	182	91.0	
76685	chr16	66483457	66484191	734	367.0	
76686	chr16	66485337	66485558	221	110.0	
76687	chr16	66486925	66487647	722	361.0	
76688	chr16	66490738	66491083	345	172.0	
76689	chr16	66512185	66513504	1319	660.0	
76690	chr16	66515745	66518192	2447	1224.0	
76691	chr16	66520242	66523026	2784	1392.0	
76692	chr16	66523605	66526344	2739	1370.0	
76693	chr16	66526906	66526907	1	0.0	
76694	chr16	66539640	66540024	384	192.0	
76695	chr16	66544031	66544424	393	196.0	
76696	chr16	66547780	66553735	5955	2978.0	
76697	chr16	66561584	66562850	1266	633.0	
76698	chr16	66578931	66579583	652	326.0	
76699	chr16	66585532	66586307	775	388.0	
76700	chr16	66589152	66590826	1674	837.0	
76701	chr16	66594632	66595181	549	274.0	
76702	chr16	66603014	66607001	3987	1994.0	
76703	chr16	66607939	66609005	1066	533.0	
76704	chr16	66616572	66616816	244	122.0	
76705	chr16	66650831	66652385	1554	777.0	
76706	chr16	66652974	66653400	426	213.0	
76707	chr16	66654003	66654380	377	188.0	
76708	chr16	66660679	66661151	472	236.0	
76709	chr16	66695223	66697707	2484	1242.0	
76710	chr16	66700915	66701338	423	212.0	
76711	chr16	66703423	66703802	379	190.0	
76712	chr16	66717009	66717438	429	214.0	
76713	chr16	66728074	66728813	739	370.0	
76714	chr16	66739701	66740951	1250	625.0	
76715	chr16	66741460	66741871	411	206.0	
76716	chr16	66746569	66747256	687	344.0	
76717	chr16	66750742	66752348	1606	803.0	
76718	chr16	66830274	66831763	1489	744.0	
76719	chr16	66844888	66845054	166	83.0	
76720	chr16	66853367	66853600	233	116.0	
76721	chr16	66867582	66868414	832	416.0	
76722	chr16	66872612	66875311	2699	1350.0	
76723	chr16	66878076	66878498	422	211.0	
76724	chr16	66879641	66881392	1751	876.0	
76725	chr16	66895009	66895765	756	378.0	
76726	chr16	66905849	66906246	397	198.0	
76727	chr16	66909808	66910119	311	156.0	
76728	chr16	66921811	66921888	77	38.0	
76729	chr16	66924646	66929148	4502	2251.0	
76730	chr16	66933540	66935534	1994	997.0	
76731	chr16	66937134	66937533	399	200.0	
76732	chr16	66946914	66949217	2303	1152.0	
76733	chr16	66953855	66954534	679	340.0	
76734	chr16	66959237	66960274	1037	518.0	
76735	chr16	66960948	66961446	498	249.0	
76736	chr16	66974825	66975270	445	222.0	
76737	chr16	66977248	66978284	1036	518.0	
76738	chr16	66984804	66985212	408	204.0	
76739	chr16	67000065	67001594	1529	764.0	
76740	chr16	67013333	67014930	1597	798.0	
76741	chr16	67017634	67018503	869	434.0	
76742	chr16	67028221	67030595	2374	1187.0	
76743	chr16	67052504	67054399	1895	948.0	
76744	chr16	67104971	67105698	727	364.0	
76745	chr16	67109202	67111110	1908	954.0	
76746	chr16	67115570	67116055	485	242.0	
76747	chr16	67116597	67117377	780	390.0	
76748	chr16	67149903	67152061	2158	1079.0	
76749	chr16	67154958	67156919	1961	980.0	
76750	chr16	67157890	67161536	3646	1823.0	
76751	chr16	67162425	67166029	3604	1802.0	
76752	chr16	67169462	67171467	2005	1002.0	
76753	chr16	67173045	67175016	1971	986.0	
76754	chr16	67177710	67179267	1557	778.0	
76755	chr16	67182998	67186133	3135	1568.0	
76756	chr16	67191637	67193404	1767	884.0	
76757	chr16	67198178	67198696	518	259.0	
76758	chr16	67216861	67217518	657	328.0	
76759	chr16	67226250	67227870	1620	810.0	
76760	chr16	67230526	67230633	107	54.0	
76761	chr16	67235948	67237090	1142	571.0	
76762	chr16	67243462	67249471	6009	3004.0	
76763	chr16	67260631	67261079	448	224.0	
76764	chr16	67278472	67280216	1744	872.0	
76765	chr16	67289649	67290274	625	312.0	
76766	chr16	67308498	67308883	385	192.0	
76767	chr16	67324895	67325324	429	214.0	
76768	chr16	67326352	67327224	872	436.0	
76769	chr16	67327750	67328094	344	172.0	
76770	chr16	67349185	67349555	370	185.0	
76771	chr16	67364612	67365539	927	464.0	
76772	chr16	67372720	67372947	227	114.0	
76773	chr16	67390110	67392012	1902	951.0	
76774	chr16	67393074	67396581	3507	1754.0	
76775	chr16	67399241	67399869	628	314.0	
76776	chr16	67415804	67416919	1115	558.0	
76777	chr16	67427916	67428602	686	343.0	
76778	chr16	67430368	67432099	1731	866.0	
76779	chr16	67435043	67435777	734	367.0	
76780	chr16	67447529	67448092	563	282.0	
76781	chr16	67456330	67457212	882	441.0	
76782	chr16	67458283	67458461	178	89.0	
76783	chr16	67459329	67460235	906	453.0	
76784	chr16	67462039	67462208	169	84.0	
76785	chr16	67465378	67466560	1182	591.0	
76786	chr16	67467731	67467768	37	18.0	
76787	chr16	67468590	67468931	341	170.0	
76788	chr16	67470364	67471005	641	320.0	
76789	chr16	67473178	67473628	450	225.0	
76790	chr16	67474871	67475766	895	448.0	
76791	chr16	67478308	67479221	913	456.0	
76792	chr16	67479985	67482887	2902	1451.0	
76793	chr16	67486600	67487241	641	320.0	
76794	chr16	67488624	67489461	837	418.0	
76795	chr16	67490265	67492099	1834	917.0	
76796	chr16	67493738	67494604	866	433.0	
76797	chr16	67503682	67504997	1315	658.0	
76798	chr16	67507173	67507694	521	260.0	
76799	chr16	67514081	67515176	1095	548.0	
76800	chr16	67517109	67517269	160	80.0	
76801	chr16	67517859	67519636	1777	888.0	
76802	chr16	67520732	67522269	1537	768.0	
76803	chr16	67528089	67532132	4043	2022.0	
76804	chr16	67535594	67540268	4674	2337.0	
76805	chr16	67541449	67541464	15	8.0	
76806	chr16	67542139	67543332	1193	596.0	
76807	chr16	67544193	67544820	627	314.0	
76808	chr16	67546604	67548703	2099	1050.0	
76809	chr16	67555525	67556365	840	420.0	
76810	chr16	67561393	67564460	3067	1534.0	
76811	chr16	67644200	67645954	1754	877.0	
76812	chr16	67652721	67653350	629	314.0	
76813	chr16	67653989	67654649	660	330.0	
76814	chr16	67656044	67661953	5909	2954.0	
76815	chr16	67663095	67664301	1206	603.0	
76816	chr16	67665886	67669219	3333	1666.0	
76817	chr16	67672624	67674339	1715	858.0	
76818	chr16	67703658	67703773	115	58.0	
76819	chr16	67718570	67720506	1936	968.0	
76820	chr16	67781566	67781633	67	34.0	
76821	chr16	67801765	67802341	576	288.0	
76822	chr16	67803847	67804360	513	256.0	
76823	chr16	67805769	67807622	1853	926.0	
76824	chr16	67816243	67817071	828	414.0	
76825	chr16	67833131	67834537	1406	703.0	
76826	chr16	67841355	67843829	2474	1237.0	
76827	chr16	67845707	67847950	2243	1122.0	
76828	chr16	67857523	67859022	1499	750.0	
76829	chr16	67865325	67865744	419	210.0	
76830	chr16	67871789	67873872	2083	1042.0	
76831	chr16	67883306	67884479	1173	586.0	
76832	chr16	67892692	67894101	1409	704.0	
76833	chr16	67919730	67919948	218	109.0	
76834	chr16	67928115	67929070	955	478.0	
76835	chr16	67933772	67934215	443	222.0	
76836	chr16	67935056	67937881	2825	1412.0	
76837	chr16	67939477	67940656	1179	590.0	
76838	chr16	67941754	67942685	931	466.0	
76839	chr16	67966671	67969865	3194	1597.0	
76840	chr16	67980551	67980631	80	40.0	
76841	chr16	67983602	67985300	1698	849.0	
76842	chr16	67992816	67994412	1596	798.0	
76843	chr16	67995194	67996010	816	408.0	
76844	chr16	67998665	68000867	2202	1101.0	
76845	chr16	68005392	68006572	1180	590.0	
76846	chr16	68013293	68013793	500	250.0	
76847	chr16	68022326	68024066	1740	870.0	
76848	chr16	68037752	68038290	538	269.0	
76849	chr16	68039798	68041184	1386	693.0	
76850	chr16	68041706	68042521	815	408.0	
76851	chr16	68049462	68049826	364	182.0	
76852	chr16	68062604	68063498	894	447.0	
76853	chr16	68064095	68065448	1353	676.0	
76854	chr16	68069547	68071651	2104	1052.0	
76855	chr16	68074503	68075609	1106	553.0	
76856	chr16	68078682	68081447	2765	1382.0	
76857	chr16	68082033	68082871	838	419.0	
76858	chr16	68083902	68087143	3241	1620.0	
76859	chr16	68090237	68090445	208	104.0	
76860	chr16	68093804	68094683	879	440.0	
76861	chr16	68100561	68100738	177	88.0	
76862	chr16	68104435	68104885	450	225.0	
76863	chr16	68116211	68116656	445	222.0	
76864	chr16	68118804	68119442	638	319.0	
76865	chr16	68131809	68132495	686	343.0	
76866	chr16	68210827	68211538	711	356.0	
76867	chr16	68227274	68227569	295	148.0	
76868	chr16	68228961	68230145	1184	592.0	
76869	chr16	68231674	68238404	6730	3365.0	
76870	chr16	68239687	68240395	708	354.0	
76871	chr16	68244358	68246108	1750	875.0	
76872	chr16	68247138	68247959	821	410.0	
76873	chr16	68257212	68258552	1340	670.0	
76874	chr16	68261118	68262192	1074	537.0	
76875	chr16	68263602	68266344	2742	1371.0	
76876	chr16	68267852	68268040	188	94.0	
76877	chr16	68269046	68270764	1718	859.0	
76878	chr16	68272567	68273422	855	428.0	
76879	chr16	68275517	68276509	992	496.0	
76880	chr16	68281579	68282091	512	256.0	
76881	chr16	68283395	68288332	4937	2468.0	
76882	chr16	68289204	68290594	1390	695.0	
76883	chr16	68291922	68291957	35	18.0	
76884	chr16	68296671	68297070	399	200.0	
76885	chr16	68309816	68311803	1987	994.0	
76886	chr16	68319350	68319440	90	45.0	
76887	chr16	68328304	68329209	905	452.0	
76888	chr16	68332413	68332964	551	276.0	
76889	chr16	68355870	68357200	1330	665.0	
76890	chr16	68365154	68365797	643	322.0	
76891	chr16	68366959	68367415	456	228.0	
76892	chr16	68368456	68371393	2937	1468.0	
76893	chr16	68379468	68379814	346	173.0	
76894	chr16	68382254	68382775	521	260.0	
76895	chr16	68396491	68397159	668	334.0	
76896	chr16	68417299	68418813	1514	757.0	
76897	chr16	68445392	68445904	512	256.0	
76898	chr16	68447839	68449733	1894	947.0	
76899	chr16	68469884	68471197	1313	656.0	
76900	chr16	68473682	68474213	531	266.0	
76901	chr16	68509952	68510667	715	358.0	
76902	chr16	68517851	68517870	19	10.0	
76903	chr16	68520336	68521377	1041	520.0	
76904	chr16	68526325	68526591	266	133.0	
76905	chr16	68528347	68530766	2419	1210.0	
76906	chr16	68538479	68540435	1956	978.0	
76907	chr16	68548915	68549340	425	212.0	
76908	chr16	68590465	68590905	440	220.0	
76909	chr16	68592526	68592828	302	151.0	
76910	chr16	68644707	68645493	786	393.0	
76911	chr16	68700141	68700490	349	174.0	
76912	chr16	68704284	68704791	507	254.0	
76913	chr16	68710169	68710547	378	189.0	
76914	chr16	68711324	68712120	796	398.0	
76915	chr16	68737039	68737617	578	289.0	
76916	chr16	68752671	68752971	300	150.0	
76917	chr16	68756341	68756681	340	170.0	
76918	chr16	68760862	68761161	299	150.0	
76919	chr16	68782186	68783053	867	434.0	
76920	chr16	68800241	68800649	408	204.0	
76921	chr16	68831492	68832232	740	370.0	
76922	chr16	68842943	68844567	1624	812.0	
76923	chr16	68847184	68847880	696	348.0	
76924	chr16	68961915	68962465	550	275.0	
76925	chr16	69057774	69058106	332	166.0	
76926	chr16	69105693	69106488	795	398.0	
76927	chr16	69112649	69113078	429	214.0	
76928	chr16	69123867	69124466	599	300.0	
76929	chr16	69130683	69133627	2944	1472.0	
76930	chr16	69150098	69150761	663	332.0	
76931	chr16	69171239	69171884	645	322.0	
76932	chr16	69173410	69174115	705	352.0	
76933	chr16	69186200	69188614	2414	1207.0	
76934	chr16	69190580	69190931	351	176.0	
76935	chr16	69204148	69204405	257	128.0	
76936	chr16	69254095	69254115	20	10.0	
76937	chr16	69286876	69287335	459	230.0	
76938	chr16	69298714	69299289	575	288.0	
76939	chr16	69300450	69300814	364	182.0	
76940	chr16	69310514	69312371	1857	928.0	
76941	chr16	69329571	69331431	1860	930.0	
76942	chr16	69338721	69340695	1974	987.0	
76943	chr16	69345826	69346348	522	261.0	
76944	chr16	69381574	69381612	38	19.0	
76945	chr16	69385090	69386599	1509	754.0	
76946	chr16	69395972	69396826	854	427.0	
76947	chr16	69398304	69398392	88	44.0	
76948	chr16	69402348	69402858	510	255.0	
76949	chr16	69423825	69425432	1607	804.0	
76950	chr16	69428974	69429554	580	290.0	
76951	chr16	69436545	69436766	221	110.0	
76952	chr16	69440273	69440612	339	170.0	
76953	chr16	69443726	69445281	1555	778.0	
76954	chr16	69454784	69455638	854	427.0	
76955	chr16	69464980	69465604	624	312.0	
76956	chr16	69469705	69470444	739	370.0	
76957	chr16	69494884	69495270	386	193.0	
76958	chr16	69501885	69502436	551	276.0	
76959	chr16	69511619	69512150	531	266.0	
76960	chr16	69514268	69514985	717	358.0	
76961	chr16	69530301	69531454	1153	576.0	
76962	chr16	69536790	69537322	532	266.0	
76963	chr16	69539331	69540154	823	412.0	
76964	chr16	69555431	69555879	448	224.0	
76965	chr16	69563608	69568482	4874	2437.0	
76966	chr16	69600254	69600528	274	137.0	
76967	chr16	69613559	69613602	43	22.0	
76968	chr16	69709421	69709954	533	266.0	
76969	chr16	69726011	69727432	1421	710.0	
76970	chr16	69754219	69755486	1267	634.0	
76971	chr16	69761812	69763650	1838	919.0	
76972	chr16	69796441	69796920	479	240.0	
76973	chr16	69823837	69824515	678	339.0	
76974	chr16	69930124	69930615	491	246.0	
76975	chr16	70018206	70018774	568	284.0	
76976	chr16	70025962	70027027	1065	532.0	
76977	chr16	70064710	70066704	1994	997.0	
76978	chr16	70112143	70112564	421	210.0	
76979	chr16	70113754	70115011	1257	628.0	
76980	chr16	70160262	70160606	344	172.0	
76981	chr16	70164978	70165677	699	350.0	
76982	chr16	70238792	70239162	370	185.0	
76983	chr16	70250837	70254263	3426	1713.0	
76984	chr16	70267510	70267973	463	232.0	
76985	chr16	70283630	70284155	525	262.0	
76986	chr16	70287950	70290212	2262	1131.0	
76987	chr16	70298575	70300461	1886	943.0	
76988	chr16	70304674	70305108	434	217.0	
76989	chr16	70331788	70331972	184	92.0	
76990	chr16	70346173	70347635	1462	731.0	
76991	chr16	70369959	70370582	623	312.0	
76992	chr16	70379211	70382304	3093	1546.0	
76993	chr16	70395291	70395957	666	333.0	
76994	chr16	70403006	70405720	2714	1357.0	
76995	chr16	70408785	70409259	474	237.0	
76996	chr16	70418754	70419295	541	270.0	
76997	chr16	70422916	70424092	1176	588.0	
76998	chr16	70427816	70428993	1177	588.0	
76999	chr16	70430125	70431664	1539	770.0	
77000	chr16	70432288	70433798	1510	755.0	
77001	chr16	70436964	70440034	3070	1535.0	
77002	chr16	70453751	70455225	1474	737.0	
77003	chr16	70470888	70471974	1086	543.0	
77004	chr16	70508776	70509227	451	226.0	
77005	chr16	70520395	70521350	955	478.0	
77006	chr16	70522373	70526130	3757	1878.0	
77007	chr16	70529334	70529788	454	227.0	
77008	chr16	70576279	70577043	764	382.0	
77009	chr16	70653606	70654364	758	379.0	
77010	chr16	70685444	70686619	1175	588.0	
77011	chr16	70695669	70695887	218	109.0	
77012	chr16	70696860	70697462	602	301.0	
77013	chr16	70736967	70738750	1783	892.0	
77014	chr16	70746829	70746830	1	0.0	
77015	chr16	70771012	70771495	483	242.0	
77016	chr16	70800310	70801939	1629	814.0	
77017	chr16	70804303	70804947	644	322.0	
77018	chr16	71259209	71259383	174	87.0	
77019	chr16	71288420	71290002	1582	791.0	
77020	chr16	71311579	71312017	438	219.0	
77021	chr16	71358415	71358935	520	260.0	
77022	chr16	71412269	71413147	878	439.0	
77023	chr16	71441477	71441805	328	164.0	
77024	chr16	71461514	71462694	1180	590.0	
77025	chr16	71467697	71468232	535	268.0	
77026	chr16	71481657	71481741	84	42.0	
77027	chr16	71483788	71485174	1386	693.0	
77028	chr16	71499720	71500160	440	220.0	
77029	chr16	71537939	71538006	67	34.0	
77030	chr16	71542249	71542718	469	234.0	
77031	chr16	71564080	71566493	2413	1206.0	
77032	chr16	71610906	71611499	593	296.0	
77033	chr16	71645550	71645599	49	24.0	
77034	chr16	71722658	71724625	1967	984.0	
77035	chr16	71726261	71728240	1979	990.0	
77036	chr16	71746423	71746853	430	215.0	
77037	chr16	71790378	71790658	280	140.0	
77038	chr16	71792390	71792489	99	50.0	
77039	chr16	71795228	71796023	795	398.0	
77040	chr16	71802319	71802661	342	171.0	
77041	chr16	71807684	71810555	2871	1436.0	
77042	chr16	71811282	71811604	322	161.0	
77043	chr16	71816577	71817007	430	215.0	
77044	chr16	71817920	71818629	709	354.0	
77045	chr16	71842164	71842571	407	204.0	
77046	chr16	71845132	71846959	1827	914.0	
77047	chr16	71853475	71853749	274	137.0	
77048	chr16	71855901	71856827	926	463.0	
77049	chr16	71880158	71885596	5438	2719.0	
77050	chr16	71890626	71890935	309	154.0	
77051	chr16	71893982	71897118	3136	1568.0	
77052	chr16	71898506	71898526	20	10.0	
77053	chr16	71899734	71900826	1092	546.0	
77054	chr16	71905508	71906256	748	374.0	
77055	chr16	71912683	71913233	550	275.0	
77056	chr16	71919001	71919489	488	244.0	
77057	chr16	71956460	71956863	403	202.0	
77058	chr16	71961174	71961890	716	358.0	
77059	chr16	72008249	72009327	1078	539.0	
77060	chr16	72051135	72052282	1147	574.0	
77061	chr16	72066687	72067076	389	194.0	
77062	chr16	72092849	72094633	1784	892.0	
77063	chr16	72099021	72099779	758	379.0	
77064	chr16	72124799	72125983	1184	592.0	
77065	chr16	72166208	72166333	125	62.0	
77066	chr16	72171976	72172947	971	486.0	
77067	chr16	72174702	72175228	526	263.0	
77068	chr16	72183062	72183288	226	113.0	
77069	chr16	72189748	72190123	375	188.0	
77070	chr16	72202061	72204130	2069	1034.0	
77071	chr16	72400274	72400657	383	192.0	
77072	chr16	72444780	72444937	157	78.0	
77073	chr16	72467210	72467494	284	142.0	
77074	chr16	72482766	72482992	226	113.0	
77075	chr16	72664214	72665719	1505	752.0	
77076	chr16	72787256	72788715	1459	730.0	
77077	chr16	72832490	72833003	513	256.0	
77078	chr16	72840734	72840887	153	76.0	
77079	chr16	72848588	72849122	534	267.0	
77080	chr16	72853282	72854634	1352	676.0	
77081	chr16	72876175	72876645	470	235.0	
77082	chr16	72907999	72908932	933	466.0	
77083	chr16	72921220	72921484	264	132.0	
77084	chr16	72924589	72924952	363	182.0	
77085	chr16	72927344	72928088	744	372.0	
77086	chr16	72931024	72932572	1548	774.0	
77087	chr16	72934687	72934905	218	109.0	
77088	chr16	72938818	72939157	339	170.0	
77089	chr16	72977142	72978506	1364	682.0	
77090	chr16	72990023	72990681	658	329.0	
77091	chr16	72995158	72995580	422	211.0	
77092	chr16	72997109	72997678	569	284.0	
77093	chr16	73010202	73010590	388	194.0	
77094	chr16	73035982	73036763	781	390.0	
77095	chr16	73037545	73037547	2	1.0	
77096	chr16	73047453	73048924	1471	736.0	
77097	chr16	73055516	73059482	3966	1983.0	
77098	chr16	73063234	73065230	1996	998.0	
77099	chr16	73065790	73066686	896	448.0	
77100	chr16	73068351	73069476	1125	562.0	
77101	chr16	73071261	73071599	338	169.0	
77102	chr16	73082560	73083007	447	224.0	
77103	chr16	73086050	73086647	597	298.0	
77104	chr16	73122522	73123513	991	496.0	
77105	chr16	73124392	73125091	699	350.0	"enhancer	sequence_feature"
77106	chr16	73125895	73126777	882	441.0	
77107	chr16	73131265	73131522	257	128.0	
77108	chr16	73150742	73151179	437	218.0	
77109	chr16	73153848	73154855	1007	504.0	
77110	chr16	73166264	73166968	704	352.0	
77111	chr16	73196729	73197192	463	232.0	
77112	chr16	74094621	74094917	296	148.0	
77113	chr16	74295903	74297830	1927	964.0	
77114	chr16	74309754	74310373	619	310.0	
77115	chr16	74329369	74329787	418	209.0	
77116	chr16	74367203	74368893	1690	845.0	
77117	chr16	74370024	74370300	276	138.0	
77118	chr16	74430036	74430510	474	237.0	
77119	chr16	74438349	74438930	581	290.0	
77120	chr16	74439682	74440122	440	220.0	
77121	chr16	74448470	74449896	1426	713.0	
77122	chr16	74463919	74464375	456	228.0	
77123	chr16	74563507	74564272	765	382.0	
77124	chr16	74567194	74567729	535	268.0	
77125	chr16	74589354	74590008	654	327.0	
77126	chr16	74600727	74601911	1184	592.0	
77127	chr16	74605922	74609505	3583	1792.0	
77128	chr16	74623189	74623693	504	252.0	
77129	chr16	74657972	74658245	273	136.0	
77130	chr16	74666245	74667797	1552	776.0	
77131	chr16	74683655	74684011	356	178.0	
77132	chr16	74695449	74696486	1037	518.0	
77133	chr16	74698033	74698696	663	332.0	
77134	chr16	74699718	74702262	2544	1272.0	
77135	chr16	74709146	74710031	885	442.0	
77136	chr16	74726702	74727137	435	218.0	
77137	chr16	74774200	74775359	1159	580.0	
77138	chr16	74813018	74813605	587	294.0	
77139	chr16	74862742	74863120	378	189.0	
77140	chr16	74868440	74868895	455	228.0	
77141	chr16	74888188	74888911	723	362.0	
77142	chr16	74936850	74937413	563	282.0	
77143	chr16	74984265	74985903	1638	819.0	
77144	chr16	74997903	75001150	3247	1624.0	
77145	chr16	75011821	75013028	1207	604.0	
77146	chr16	75024539	75024967	428	214.0	
77147	chr16	75042528	75042862	334	167.0	
77148	chr16	75060751	75061053	302	151.0	
77149	chr16	75064455	75065568	1113	556.0	
77150	chr16	75074903	75076059	1156	578.0	
77151	chr16	75098371	75100455	2084	1042.0	
77152	chr16	75105205	75106257	1052	526.0	
77153	chr16	75108726	75110029	1303	652.0	
77154	chr16	75110652	75112021	1369	684.0	
77155	chr16	75115963	75117025	1062	531.0	
77156	chr16	75138576	75138899	323	162.0	
77157	chr16	75148107	75149460	1353	676.0	
77158	chr16	75199244	75200338	1094	547.0	
77159	chr16	75201188	75201653	465	232.0	
77160	chr16	75219801	75220282	481	240.0	
77161	chr16	75233775	75234458	683	342.0	
77162	chr16	75265863	75266242	379	190.0	
77163	chr16	75288392	75289062	670	335.0	
77164	chr16	75319750	75320202	452	226.0	
77165	chr16	75333722	75334116	394	197.0	
77166	chr16	75379975	75381028	1053	526.0	
77167	chr16	75385470	75385942	472	236.0	
77168	chr16	75402901	75403298	397	198.0	
77169	chr16	75420952	75421333	381	190.0	
77170	chr16	75432492	75435062	2570	1285.0	
77171	chr16	75462553	75465454	2901	1450.0	
77172	chr16	75468616	75469426	810	405.0	
77173	chr16	75471676	75472222	546	273.0	
77174	chr16	75477943	75478562	619	310.0	
77175	chr16	75495185	75495716	531	266.0	
77176	chr16	75506410	75507106	696	348.0	
77177	chr16	75516339	75518029	1690	845.0	
77178	chr16	75521417	75521703	286	143.0	
77179	chr16	75549935	75550724	789	394.0	
77180	chr16	75555156	75556943	1787	894.0	
77181	chr16	75564629	75567305	2676	1338.0	
77182	chr16	75569374	75569450	76	38.0	
77183	chr16	75570592	75571126	534	267.0	
77184	chr16	75571940	75572302	362	181.0	
77185	chr16	75576410	75576527	117	58.0	
77186	chr16	75616202	75617072	870	435.0	
77187	chr16	75619870	75623871	4001	2000.0	
77188	chr16	75627738	75628255	517	258.0	
77189	chr16	75644494	75645095	601	300.0	
77190	chr16	75646856	75650600	3744	1872.0	
77191	chr16	75651172	75651858	686	343.0	
77192	chr16	75761517	75761991	474	237.0	
77193	chr16	75764056	75764600	544	272.0	
77194	chr16	75789168	75789551	383	192.0	
77195	chr16	77169667	77170047	380	190.0	
77196	chr16	77171741	77172199	458	229.0	
77197	chr16	77180347	77181151	804	402.0	
77198	chr16	77190052	77192180	2128	1064.0	
77199	chr16	77193508	77194605	1097	548.0	
77200	chr16	77195114	77195126	12	6.0	
77201	chr16	77211605	77213515	1910	955.0	
77202	chr16	77223253	77223255	2	1.0	
77203	chr16	77235755	77236735	980	490.0	
77204	chr16	77584231	77584642	411	206.0	
77205	chr16	77675707	77676146	439	220.0	
77206	chr16	77721788	77723594	1806	903.0	
77207	chr16	77963782	77964014	232	116.0	
77208	chr16	77971531	77971966	435	218.0	
77209	chr16	77977403	77977722	319	160.0	
77210	chr16	78002865	78003388	523	262.0	
77211	chr16	78098700	78100681	1981	990.0	
77212	chr16	78122700	78123228	528	264.0	
77213	chr16	78235156	78235600	444	222.0	
77214	chr16	78478479	78478783	304	152.0	
77215	chr16	78494707	78495011	304	152.0	
77216	chr16	78503518	78503881	363	182.0	
77217	chr16	78705669	78706130	461	230.0	
77218	chr16	78742111	78743951	1840	920.0	
77219	chr16	78749622	78750371	749	374.0	
77220	chr16	78761536	78761683	147	74.0	
77221	chr16	78768720	78769124	404	202.0	
77222	chr16	78770227	78771195	968	484.0	
77223	chr16	78794616	78795353	737	368.0	
77224	chr16	78796180	78796687	507	254.0	
77225	chr16	78893279	78893677	398	199.0	
77226	chr16	78894835	78895421	586	293.0	
77227	chr16	78896277	78896678	401	200.0	
77228	chr16	78925023	78925471	448	224.0	
77229	chr16	78939669	78939910	241	120.0	
77230	chr16	78961577	78961863	286	143.0	
77231	chr16	78962730	78962785	55	28.0	
77232	chr16	78989574	78990028	454	227.0	
77233	chr16	79043025	79043204	179	90.0	
77234	chr16	79083005	79083389	384	192.0	
77235	chr16	79083939	79084284	345	172.0	
77236	chr16	79089515	79091288	1773	886.0	
77237	chr16	79093392	79094307	915	458.0	
77238	chr16	79097240	79097601	361	180.0	
77239	chr16	79098890	79099267	377	188.0	
77240	chr16	79127847	79127901	54	27.0	
77241	chr16	79150812	79151365	553	276.0	
77242	chr16	79163566	79164230	664	332.0	
77243	chr16	79169456	79169478	22	11.0	
77244	chr16	79170683	79171443	760	380.0	
77245	chr16	79176990	79177358	368	184.0	
77246	chr16	79194383	79194543	160	80.0	
77247	chr16	79217598	79218065	467	234.0	
77248	chr16	79261457	79261903	446	223.0	
77249	chr16	79263490	79263590	100	50.0	
77250	chr16	79264580	79265305	725	362.0	
77251	chr16	79269290	79269999	709	354.0	
77252	chr16	79271724	79272848	1124	562.0	
77253	chr16	79276621	79276792	171	86.0	
77254	chr16	79278371	79279358	987	494.0	
77255	chr16	79283475	79284061	586	293.0	
77256	chr16	79286676	79287633	957	478.0	
77257	chr16	79288294	79288296	2	1.0	
77258	chr16	79296675	79296800	125	62.0	
77259	chr16	79307148	79307718	570	285.0	
77260	chr16	79328613	79329659	1046	523.0	
77261	chr16	79334244	79334583	339	170.0	
77262	chr16	79370417	79371201	784	392.0	
77263	chr16	79372372	79373073	701	350.0	
77264	chr16	79380861	79382207	1346	673.0	
77265	chr16	79395704	79396037	333	166.0	
77266	chr16	79409979	79410378	399	200.0	
77267	chr16	79415923	79416723	800	400.0	
77268	chr16	79417491	79417838	347	174.0	
77269	chr16	79419043	79419665	622	311.0	
77270	chr16	79422118	79422465	347	174.0	
77271	chr16	79439844	79440288	444	222.0	
77272	chr16	79451160	79451711	551	276.0	
77273	chr16	79482030	79482563	533	266.0	
77274	chr16	79498054	79498148	94	47.0	
77275	chr16	79509121	79509484	363	182.0	
77276	chr16	79519402	79519978	576	288.0	
77277	chr16	79535139	79535590	451	226.0	
77278	chr16	79589485	79590276	791	396.0	
77279	chr16	79592980	79593449	469	234.0	
77280	chr16	79595400	79595533	133	66.0	
77281	chr16	79596174	79596523	349	174.0	
77282	chr16	79598087	79602850	4763	2382.0	
77283	chr16	79628414	79628958	544	272.0	
77284	chr16	79769302	79771187	1885	942.0	
77285	chr16	80027046	80027650	604	302.0	
77286	chr16	80466143	80466816	673	336.0	
77287	chr16	80518508	80518825	317	158.0	
77288	chr16	80526403	80527743	1340	670.0	
77289	chr16	80540294	80541568	1274	637.0	
77290	chr16	80569549	80570357	808	404.0	
77291	chr16	80579993	80580901	908	454.0	
77292	chr16	80585973	80586213	240	120.0	
77293	chr16	80590921	80591887	966	483.0	
77294	chr16	80650272	80650815	543	272.0	
77295	chr16	80656482	80657204	722	361.0	
77296	chr16	80670093	80670662	569	284.0	
77297	chr16	80671415	80671844	429	214.0	
77298	chr16	80676221	80677153	932	466.0	
77299	chr16	80719816	80719899	83	42.0	
77300	chr16	80803173	80805194	2021	1010.0	
77301	chr16	80806828	80807340	512	256.0	
77302	chr16	80824758	80825181	423	212.0	
77303	chr16	80996821	80998644	1823	912.0	
77304	chr16	81003649	81008421	4772	2386.0	
77305	chr16	81035257	81037357	2100	1050.0	
77306	chr16	81076219	81078026	1807	904.0	
77307	chr16	81095591	81097230	1639	820.0	
77308	chr16	81205373	81205379	6	3.0	
77309	chr16	81314129	81316214	2085	1042.0	
77310	chr16	81366278	81366808	530	265.0	
77311	chr16	81403388	81404288	900	450.0	
77312	chr16	81424633	81425552	919	460.0	
77313	chr16	81428905	81429438	533	266.0	
77314	chr16	81431503	81432569	1066	533.0	
77315	chr16	81437806	81438877	1071	536.0	
77316	chr16	81442234	81448893	6659	3330.0	
77317	chr16	81450948	81452585	1637	818.0	
77318	chr16	81457380	81458730	1350	675.0	
77319	chr16	81461741	81462228	487	244.0	
77320	chr16	81466438	81466757	319	160.0	
77321	chr16	81469254	81470732	1478	739.0	
77322	chr16	81477350	81479703	2353	1176.0	
77323	chr16	81480702	81482789	2087	1044.0	
77324	chr16	81483338	81483947	609	304.0	
77325	chr16	81487507	81487676	169	84.0	
77326	chr16	81489913	81490240	327	164.0	
77327	chr16	81493667	81494078	411	206.0	
77328	chr16	81495114	81495708	594	297.0	
77329	chr16	81497544	81498407	863	432.0	
77330	chr16	81500616	81501911	1295	648.0	
77331	chr16	81504922	81505801	879	440.0	
77332	chr16	81513724	81514560	836	418.0	
77333	chr16	81519279	81525063	5784	2892.0	
77334	chr16	81526654	81527468	814	407.0	
77335	chr16	81544071	81545035	964	482.0	
77336	chr16	81547532	81547890	358	179.0	
77337	chr16	81548708	81549080	372	186.0	
77338	chr16	81551124	81551973	849	424.0	
77339	chr16	81558803	81559331	528	264.0	
77340	chr16	81576730	81577048	318	159.0	
77341	chr16	81578226	81578401	175	88.0	
77342	chr16	81595801	81596035	234	117.0	
77343	chr16	81608480	81609144	664	332.0	
77344	chr16	81615984	81617353	1369	684.0	
77345	chr16	81623297	81623827	530	265.0	
77346	chr16	81625811	81626016	205	102.0	
77347	chr16	81628994	81629499	505	252.0	
77348	chr16	81632428	81633666	1238	619.0	
77349	chr16	81636628	81637024	396	198.0	
77350	chr16	81697209	81697632	423	212.0	
77351	chr16	81703692	81703864	172	86.0	
77352	chr16	81711769	81712147	378	189.0	
77353	chr16	81713537	81713603	66	33.0	
77354	chr16	81714798	81716954	2156	1078.0	
77355	chr16	81717524	81719743	2219	1110.0	
77356	chr16	81721504	81721915	411	206.0	
77357	chr16	81722718	81723609	891	446.0	
77358	chr16	81729403	81731235	1832	916.0	
77359	chr16	81737638	81739478	1840	920.0	
77360	chr16	81740158	81741221	1063	532.0	
77361	chr16	81745733	81746826	1093	546.0	
77362	chr16	81748796	81748930	134	67.0	
77363	chr16	81751984	81753024	1040	520.0	
77364	chr16	81755881	81756324	443	222.0	
77365	chr16	81758453	81758658	205	102.0	
77366	chr16	81767066	81767075	9	4.0	
77367	chr16	81770067	81770388	321	160.0	
77368	chr16	81771116	81771337	221	110.0	
77369	chr16	81774296	81774708	412	206.0	
77370	chr16	81778732	81780656	1924	962.0	
77371	chr16	81795931	81796439	508	254.0	
77372	chr16	81797324	81799364	2040	1020.0	
77373	chr16	81804011	81804895	884	442.0	
77374	chr16	81808822	81809638	816	408.0	
77375	chr16	81810335	81811212	877	438.0	
77376	chr16	81813975	81813989	14	7.0	
77377	chr16	81816698	81818543	1845	922.0	
77378	chr16	81820775	81822219	1444	722.0	
77379	chr16	81822826	81823779	953	476.0	
77380	chr16	81828134	81828523	389	194.0	
77381	chr16	81831228	81833318	2090	1045.0	
77382	chr16	81834876	81835100	224	112.0	
77383	chr16	81836616	81837788	1172	586.0	
77384	chr16	81841539	81844220	2681	1340.0	
77385	chr16	81851322	81851667	345	172.0	
77386	chr16	81863562	81864016	454	227.0	
77387	chr16	81866757	81867462	705	352.0	
77388	chr16	81873808	81874296	488	244.0	
77389	chr16	81885964	81886422	458	229.0	
77390	chr16	81890301	81890770	469	234.0	
77391	chr16	81956549	81956945	396	198.0	
77392	chr16	81967343	81967741	398	199.0	
77393	chr16	82011071	82011815	744	372.0	
77394	chr16	82133822	82134111	289	144.0	
77395	chr16	82169513	82170991	1478	739.0	
77396	chr16	82182924	82183453	529	264.0	
77397	chr16	82190374	82190943	569	284.0	
77398	chr16	82192432	82193396	964	482.0	
77399	chr16	82195702	82196631	929	464.0	
77400	chr16	82200003	82200263	260	130.0	
77401	chr16	82230021	82230422	401	200.0	
77402	chr16	82263529	82263863	334	167.0	
77403	chr16	82432105	82432701	596	298.0	
77404	chr16	82452325	82452705	380	190.0	
77405	chr16	82456592	82456983	391	196.0	
77406	chr16	82639709	82640067	358	179.0	
77407	chr16	82641382	82641687	305	152.0	
77408	chr16	82651799	82652530	731	366.0	
77409	chr16	82653483	82654528	1045	522.0	
77410	chr16	82655038	82656079	1041	520.0	
77411	chr16	82660170	82660656	486	243.0	
77412	chr16	82776433	82777016	583	292.0	
77413	chr16	82781827	82782173	346	173.0	
77414	chr16	82784635	82784967	332	166.0	
77415	chr16	82924216	82924813	597	298.0	
77416	chr16	82935708	82936182	474	237.0	
77417	chr16	82936870	82937455	585	292.0	
77418	chr16	82945357	82946193	836	418.0	
77419	chr16	83137288	83137857	569	284.0	
77420	chr16	83727033	83727385	352	176.0	
77421	chr16	83744275	83745237	962	481.0	
77422	chr16	83769380	83769846	466	233.0	
77423	chr16	83780554	83780638	84	42.0	
77424	chr16	83802156	83802541	385	192.0	
77425	chr16	83805761	83806547	786	393.0	
77426	chr16	83807234	83808847	1613	806.0	
77427	chr16	83814015	83814383	368	184.0	
77428	chr16	83825880	83826694	814	407.0	
77429	chr16	83842460	83844121	1661	830.0	
77430	chr16	83847073	83847859	786	393.0	
77431	chr16	83898303	83900169	1866	933.0	
77432	chr16	83926589	83927058	469	234.0	
77433	chr16	83939373	83939889	516	258.0	
77434	chr16	83952705	83954917	2212	1106.0	
77435	chr16	83956666	83957197	531	266.0	
77436	chr16	83967973	83968460	487	244.0	
77437	chr16	83993869	83996187	2318	1159.0	
77438	chr16	84013755	84014763	1008	504.0	
77439	chr16	84062695	84063236	541	270.0	
77440	chr16	84065525	84065917	392	196.0	
77441	chr16	84068976	84069969	993	496.0	
77442	chr16	84082837	84083305	468	234.0	
77443	chr16	84084717	84086340	1623	812.0	
77444	chr16	84088597	84089147	550	275.0	
77445	chr16	84099524	84100010	486	243.0	
77446	chr16	84101264	84101665	401	200.0	
77447	chr16	84114228	84114749	521	260.0	
77448	chr16	84115972	84117900	1928	964.0	
77449	chr16	84120125	84120399	274	137.0	
77450	chr16	84144032	84145893	1861	930.0	
77451	chr16	84175132	84176376	1244	622.0	
77452	chr16	84186312	84187684	1372	686.0	
77453	chr16	84193517	84195118	1601	800.0	
77454	chr16	84199608	84200540	932	466.0	
77455	chr16	84239232	84239579	347	174.0	
77456	chr16	84266340	84266819	479	240.0	
77457	chr16	84277231	84277655	424	212.0	
77458	chr16	84357288	84358020	732	366.0	
77459	chr16	84423496	84423939	443	222.0	
77460	chr16	84503843	84507651	3808	1904.0	
77461	chr16	84508417	84509008	591	296.0	
77462	chr16	84511047	84511956	909	454.0	
77463	chr16	84514178	84515862	1684	842.0	
77464	chr16	84518520	84519949	1429	714.0	
77465	chr16	84527789	84528679	890	445.0	
77466	chr16	84532436	84532719	283	142.0	
77467	chr16	84548494	84550399	1905	952.0	
77468	chr16	84552074	84554872	2798	1399.0	
77469	chr16	84555484	84555887	403	202.0	
77470	chr16	84562268	84562942	674	337.0	
77471	chr16	84569511	84570243	732	366.0	
77472	chr16	84576832	84577207	375	188.0	
77473	chr16	84585394	84586466	1072	536.0	
77474	chr16	84593359	84595454	2095	1048.0	
77475	chr16	84597209	84604532	7323	3662.0	
77476	chr16	84606111	84611138	5027	2514.0	
77477	chr16	84611806	84612056	250	125.0	
77478	chr16	84613723	84614097	374	187.0	
77479	chr16	84614599	84619253	4654	2327.0	
77480	chr16	84621870	84623204	1334	667.0	
77481	chr16	84630907	84631227	320	160.0	
77482	chr16	84631869	84632332	463	232.0	
77483	chr16	84636962	84637230	268	134.0	
77484	chr16	84641107	84641816	709	354.0	
77485	chr16	84643068	84643550	482	241.0	
77486	chr16	84647670	84649742	2072	1036.0	
77487	chr16	84652523	84653009	486	243.0	
77488	chr16	84656555	84656943	388	194.0	
77489	chr16	84672220	84672819	599	300.0	
77490	chr16	84687644	84688185	541	270.0	
77491	chr16	84692163	84692880	717	358.0	
77492	chr16	84699260	84701318	2058	1029.0	
77493	chr16	84714053	84714483	430	215.0	
77494	chr16	84725778	84727233	1455	728.0	
77495	chr16	84730362	84730843	481	240.0	
77496	chr16	84735762	84736383	621	310.0	
77497	chr16	84737939	84739122	1183	592.0	
77498	chr16	84739733	84740121	388	194.0	
77499	chr16	84741403	84741536	133	66.0	
77500	chr16	84742526	84743203	677	338.0	
77501	chr16	84751107	84752559	1452	726.0	
77502	chr16	84753941	84755405	1464	732.0	
77503	chr16	84758972	84759663	691	346.0	
77504	chr16	84768090	84768389	299	150.0	
77505	chr16	84774559	84775253	694	347.0	
77506	chr16	84794286	84794410	124	62.0	
77507	chr16	84805939	84807021	1082	541.0	
77508	chr16	84808801	84809356	555	278.0	
77509	chr16	84810626	84811447	821	410.0	
77510	chr16	84819330	84820663	1333	666.0	
77511	chr16	84823604	84823877	273	136.0	
77512	chr16	84827040	84827628	588	294.0	
77513	chr16	84865942	84866315	373	186.0	
77514	chr16	84893666	84894619	953	476.0	
77515	chr16	84896969	84897107	138	69.0	
77516	chr16	84897783	84898982	1199	600.0	
77517	chr16	84907561	84907994	433	216.0	
77518	chr16	84910112	84913701	3589	1794.0	
77519	chr16	84925092	84925561	469	234.0	
77520	chr16	84930430	84930836	406	203.0	
77521	chr16	84947009	84947393	384	192.0	
77522	chr16	84950957	84951358	401	200.0	
77523	chr16	84952102	84952838	736	368.0	
77524	chr16	84970425	84971129	704	352.0	
77525	chr16	84972436	84973009	573	286.0	
77526	chr16	84977111	84977503	392	196.0	
77527	chr16	84982492	84984104	1612	806.0	
77528	chr16	84994474	84995948	1474	737.0	
77529	chr16	84997019	84997383	364	182.0	
77530	chr16	85002338	85004161	1823	912.0	
77531	chr16	85007525	85008699	1174	587.0	
77532	chr16	85010430	85012325	1895	948.0	
77533	chr16	85014168	85014806	638	319.0	
77534	chr16	85016649	85017721	1072	536.0	
77535	chr16	85025350	85026604	1254	627.0	
77536	chr16	85027172	85030342	3170	1585.0	
77537	chr16	85036471	85037071	600	300.0	
77538	chr16	85041470	85041886	416	208.0	
77539	chr16	85046239	85048330	2091	1046.0	
77540	chr16	85054919	85056698	1779	890.0	
77541	chr16	85061318	85063919	2601	1300.0	
77542	chr16	85077058	85077417	359	180.0	
77543	chr16	85082502	85083258	756	378.0	
77544	chr16	85086466	85087267	801	400.0	
77545	chr16	85091457	85091553	96	48.0	
77546	chr16	85099288	85099865	577	288.0	
77547	chr16	85102024	85102382	358	179.0	
77548	chr16	85103400	85104067	667	334.0	
77549	chr16	85104615	85105605	990	495.0	
77550	chr16	85114672	85115732	1060	530.0	
77551	chr16	85135620	85137953	2333	1166.0	
77552	chr16	85157721	85158452	731	366.0	
77553	chr16	85245567	85246101	534	267.0	
77554	chr16	85253115	85253656	541	270.0	
77555	chr16	85275563	85276082	519	260.0	
77556	chr16	85290271	85290351	80	40.0	
77557	chr16	85291313	85292014	701	350.0	
77558	chr16	85296929	85297480	551	276.0	
77559	chr16	85302958	85303851	893	446.0	
77560	chr16	85305918	85306937	1019	510.0	
77561	chr16	85308662	85311789	3127	1564.0	
77562	chr16	85316353	85316836	483	242.0	
77563	chr16	85330328	85331193	865	432.0	
77564	chr16	85335101	85335185	84	42.0	
77565	chr16	85369915	85370381	466	233.0	
77566	chr16	85372760	85373079	319	160.0	
77567	chr16	85393620	85394142	522	261.0	
77568	chr16	85416109	85416831	722	361.0	
77569	chr16	85420435	85421361	926	463.0	
77570	chr16	85428158	85428617	459	230.0	
77571	chr16	85441146	85441222	76	38.0	
77572	chr16	85447332	85447821	489	244.0	
77573	chr16	85448378	85449238	860	430.0	
77574	chr16	85461950	85463054	1104	552.0	
77575	chr16	85480164	85480583	419	210.0	
77576	chr16	85484463	85484779	316	158.0	
77577	chr16	85490964	85491398	434	217.0	
77578	chr16	85498626	85499013	387	194.0	
77579	chr16	85518516	85520146	1630	815.0	
77580	chr16	85524448	85525708	1260	630.0	
77581	chr16	85528826	85529317	491	246.0	
77582	chr16	85535437	85536819	1382	691.0	
77583	chr16	85543959	85544529	570	285.0	
77584	chr16	85545343	85545565	222	111.0	
77585	chr16	85549844	85549846	2	1.0	
77586	chr16	85551320	85551911	591	296.0	
77587	chr16	85552717	85559783	7066	3533.0	
77588	chr16	85561511	85562291	780	390.0	
77589	chr16	85563422	85564970	1548	774.0	
77590	chr16	85565751	85565950	199	100.0	
77591	chr16	85566535	85572583	6048	3024.0	
77592	chr16	85574175	85574761	586	293.0	
77593	chr16	85583461	85583774	313	156.0	
77594	chr16	85603166	85603571	405	202.0	
77595	chr16	85605824	85606039	215	108.0	
77596	chr16	85607208	85607839	631	316.0	
77597	chr16	85609951	85617520	7569	3784.0	
77598	chr16	85627193	85627407	214	107.0	
77599	chr16	85641623	85641998	375	188.0	
77600	chr16	85642834	85643635	801	400.0	
77601	chr16	85651122	85651510	388	194.0	
77602	chr16	85652598	85653582	984	492.0	
77603	chr16	85659685	85660326	641	320.0	
77604	chr16	85680612	85680637	25	12.0	
77605	chr16	85687211	85687628	417	208.0	
77606	chr16	85688337	85689636	1299	650.0	
77607	chr16	85717774	85718271	497	248.0	
77608	chr16	85729670	85730595	925	462.0	
77609	chr16	85733114	85734170	1056	528.0	
77610	chr16	85734967	85735948	981	490.0	
77611	chr16	85749924	85751742	1818	909.0	
77612	chr16	85753169	85753172	3	2.0	
77613	chr16	85754394	85754798	404	202.0	
77614	chr16	85756084	85757611	1527	764.0	
77615	chr16	85758710	85760240	1530	765.0	
77616	chr16	85761847	85762291	444	222.0	
77617	chr16	85778971	85779321	350	175.0	
77618	chr16	85798643	85800804	2161	1080.0	
77619	chr16	85810558	85810815	257	128.0	
77620	chr16	85819093	85819795	702	351.0	
77621	chr16	85821125	85822234	1109	554.0	
77622	chr16	85824304	85825028	724	362.0	
77623	chr16	85829203	85830376	1173	586.0	
77624	chr16	85832558	85833651	1093	546.0	
77625	chr16	85836957	85837359	402	201.0	
77626	chr16	85838325	85838877	552	276.0	
77627	chr16	85839620	85840010	390	195.0	
77628	chr16	85844778	85845210	432	216.0	
77629	chr16	85851371	85851724	353	176.0	
77630	chr16	85853564	85854436	872	436.0	
77631	chr16	85859346	85860785	1439	720.0	
77632	chr16	85862887	85863043	156	78.0	
77633	chr16	85869182	85869277	95	48.0	
77634	chr16	85870016	85871120	1104	552.0	
77635	chr16	85872770	85873458	688	344.0	
77636	chr16	85874061	85874459	398	199.0	
77637	chr16	85880155	85880539	384	192.0	
77638	chr16	85882445	85882937	492	246.0	
77639	chr16	85888419	85889416	997	498.0	
77640	chr16	85897331	85897786	455	228.0	
77641	chr16	85898354	85900832	2478	1239.0	
77642	chr16	85902132	85904125	1993	996.0	
77643	chr16	85905143	85905768	625	312.0	
77644	chr16	85908366	85909614	1248	624.0	
77645	chr16	85910410	85910944	534	267.0	
77646	chr16	85912367	85914449	2082	1041.0	
77647	chr16	85915061	85915570	509	254.0	
77648	chr16	85916177	85917208	1031	516.0	
77649	chr16	85919356	85919695	339	170.0	
77650	chr16	85923300	85923463	163	82.0	
77651	chr16	85924607	85924672	65	32.0	
77652	chr16	85927983	85928955	972	486.0	
77653	chr16	85931557	85932415	858	429.0	
77654	chr16	85935446	85937271	1825	912.0	
77655	chr16	85940491	85940496	5	2.0	
77656	chr16	85941019	85941530	511	256.0	
77657	chr16	85947048	85948547	1499	750.0	
77658	chr16	85949957	85950546	589	294.0	
77659	chr16	85955557	85955958	401	200.0	
77660	chr16	85957634	85957716	82	41.0	
77661	chr16	85965373	85965451	78	39.0	
77662	chr16	85967139	85967512	373	186.0	
77663	chr16	85978127	85978935	808	404.0	
77664	chr16	85982222	85985973	3751	1876.0	
77665	chr16	85986954	85987962	1008	504.0	
77666	chr16	85988780	85989322	542	271.0	
77667	chr16	85990762	85991212	450	225.0	
77668	chr16	85995629	85996404	775	388.0	
77669	chr16	85999211	85999323	112	56.0	
77670	chr16	86011586	86011904	318	159.0	
77671	chr16	86016171	86016833	662	331.0	
77672	chr16	86018027	86019082	1055	528.0	
77673	chr16	86044201	86044623	422	211.0	
77674	chr16	86045248	86045721	473	236.0	
77675	chr16	86090115	86090199	84	42.0	
77676	chr16	86213037	86213449	412	206.0	
77677	chr16	86341050	86341057	7	4.0	
77678	chr16	86509315	86509828	513	256.0	
77679	chr16	86519844	86520474	630	315.0	
77680	chr16	86553705	86555898	2193	1096.0	
77681	chr16	86563447	86564469	1022	511.0	
77682	chr16	86566543	86567574	1031	516.0	
77683	chr16	86575908	86576563	655	328.0	
77684	chr16	86604155	86605253	1098	549.0	
77685	chr16	86664448	86665216	768	384.0	
77686	chr16	86975488	86975674	186	93.0	
77687	chr16	86990506	86990787	281	140.0	
77688	chr16	86994630	86994636	6	3.0	
77689	chr16	87015025	87015380	355	178.0	
77690	chr16	87016390	87016677	287	144.0	
77691	chr16	87017428	87017678	250	125.0	
77692	chr16	87060342	87060438	96	48.0	
77693	chr16	87062619	87063087	468	234.0	
77694	chr16	87077266	87077620	354	177.0	
77695	chr16	87236116	87236337	221	110.0	
77696	chr16	87278690	87278991	301	150.0	
77697	chr16	87297910	87298311	401	200.0	
77698	chr16	87316669	87318227	1558	779.0	
77699	chr16	87324623	87325293	670	335.0	
77700	chr16	87344940	87345803	863	432.0	
77701	chr16	87364579	87364587	8	4.0	
77702	chr16	87368383	87368880	497	248.0	
77703	chr16	87380892	87381293	401	200.0	
77704	chr16	87382302	87385044	2742	1371.0	
77705	chr16	87387764	87389027	1263	632.0	
77706	chr16	87391247	87395614	4367	2184.0	
77707	chr16	87396212	87396613	401	200.0	
77708	chr16	87398909	87399322	413	206.0	
77709	chr16	87399957	87400316	359	180.0	
77710	chr16	87403567	87408223	4656	2328.0	
77711	chr16	87410533	87410681	148	74.0	
77712	chr16	87461445	87461809	364	182.0	
77713	chr16	87464067	87465711	1644	822.0	
77714	chr16	87485156	87485163	7	4.0	
77715	chr16	87487410	87488048	638	319.0	
77716	chr16	87489879	87493885	4006	2003.0	
77717	chr16	87495711	87497079	1368	684.0	
77718	chr16	87507461	87507992	531	266.0	
77719	chr16	87550312	87550796	484	242.0	
77720	chr16	87554580	87556021	1441	720.0	
77721	chr16	87560404	87561341	937	468.0	
77722	chr16	87588965	87589067	102	51.0	
77723	chr16	87635272	87636980	1708	854.0	
77724	chr16	87661501	87662065	564	282.0	
77725	chr16	87671739	87672073	334	167.0	
77726	chr16	87681972	87682513	541	270.0	
77727	chr16	87698778	87699183	405	202.0	
77728	chr16	87700629	87702977	2348	1174.0	
77729	chr16	87713047	87714272	1225	612.0	
77730	chr16	87723182	87723751	569	284.0	
77731	chr16	87724489	87726210	1721	860.0	
77732	chr16	87733319	87733459	140	70.0	
77733	chr16	87754395	87755035	640	320.0	
77734	chr16	87761912	87762833	921	460.0	
77735	chr16	87764141	87766710	2569	1284.0	
77736	chr16	87768967	87769589	622	311.0	
77737	chr16	87777464	87781314	3850	1925.0	
77738	chr16	87806364	87807639	1275	638.0	
77739	chr16	87809433	87810862	1429	714.0	
77740	chr16	87824132	87824379	247	124.0	
77741	chr16	87827037	87827265	228	114.0	
77742	chr16	87828049	87830759	2710	1355.0	
77743	chr16	87831617	87863381	31764	15882.0	
77744	chr16	87864433	87864733	300	150.0	
77745	chr16	87865244	87870141	4897	2448.0	
77746	chr16	87870865	87872189	1324	662.0	
77747	chr16	87875085	87875560	475	238.0	
77748	chr16	87887930	87888331	401	200.0	
77749	chr16	87895501	87896465	964	482.0	
77750	chr16	87897505	87898012	507	254.0	
77751	chr16	87909101	87909801	700	350.0	
77752	chr16	87918849	87919191	342	171.0	
77753	chr16	87924375	87924866	491	246.0	
77754	chr16	87926215	87926707	492	246.0	
77755	chr16	87930797	87930798	1	0.0	
77756	chr16	87945243	87945874	631	316.0	
77757	chr16	87947796	87948722	926	463.0	
77758	chr16	87950320	87952582	2262	1131.0	
77759	chr16	87953458	87957262	3804	1902.0	
77760	chr16	87959282	87960095	813	406.0	
77761	chr16	87963142	87964015	873	436.0	
77762	chr16	87966713	87967119	406	203.0	
77763	chr16	87974296	87974657	361	180.0	
77764	chr16	87979851	87980610	759	380.0	
77765	chr16	87981416	87981778	362	181.0	
77766	chr16	87986439	87986823	384	192.0	
77767	chr16	88005081	88005720	639	320.0	
77768	chr16	88024958	88025678	720	360.0	
77769	chr16	88043944	88044799	855	428.0	
77770	chr16	88045623	88046545	922	461.0	
77771	chr16	88069240	88070184	944	472.0	
77772	chr16	88089828	88090203	375	188.0	
77773	chr16	88170505	88171037	532	266.0	
77774	chr16	88194065	88194403	338	169.0	
77775	chr16	88238783	88239090	307	154.0	
77776	chr16	88264575	88266101	1526	763.0	
77777	chr16	88348060	88348218	158	79.0	
77778	chr16	88383780	88383886	106	53.0	
77779	chr16	88407800	88408240	440	220.0	
77780	chr16	88410188	88410633	445	222.0	
77781	chr16	88430132	88431377	1245	622.0	
77782	chr16	88437293	88437795	502	251.0	
77783	chr16	88442716	88443766	1050	525.0	
77784	chr16	88448363	88449581	1218	609.0	
77785	chr16	88451560	88457506	5946	2973.0	
77786	chr16	88458996	88459449	453	226.0	
77787	chr16	88461857	88463234	1377	688.0	
77788	chr16	88464926	88467843	2917	1458.0	
77789	chr16	88468490	88473136	4646	2323.0	
77790	chr16	88473645	88473697	52	26.0	
77791	chr16	88474254	88474322	68	34.0	
77792	chr16	88476075	88476141	66	33.0	
77793	chr16	88477346	88480802	3456	1728.0	
77794	chr16	88499954	88500241	287	144.0	
77795	chr16	88505204	88506120	916	458.0	
77796	chr16	88525916	88528066	2150	1075.0	
77797	chr16	88531062	88531067	5	2.0	
77798	chr16	88532411	88535910	3499	1750.0	
77799	chr16	88539748	88540192	444	222.0	
77800	chr16	88547953	88548609	656	328.0	
77801	chr16	88549737	88550822	1085	542.0	
77802	chr16	88559025	88559453	428	214.0	
77803	chr16	88560760	88561087	327	164.0	
77804	chr16	88561784	88562538	754	377.0	
77805	chr16	88569448	88571280	1832	916.0	
77806	chr16	88591345	88592178	833	416.0	
77807	chr16	88598917	88599897	980	490.0	
77808	chr16	88619294	88620953	1659	830.0	
77809	chr16	88628679	88628804	125	62.0	
77810	chr16	88630776	88630796	20	10.0	
77811	chr16	88632035	88632398	363	182.0	
77812	chr16	88633141	88641846	8705	4352.0	
77813	chr16	88644139	88644371	232	116.0	
77814	chr16	88646853	88647025	172	86.0	
77815	chr16	88647754	88648873	1119	560.0	
77816	chr16	88649505	88654463	4958	2479.0	
77817	chr16	88657440	88657837	397	198.0	
77818	chr16	88660954	88661195	241	120.0	
77819	chr16	88662088	88664414	2326	1163.0	
77820	chr16	88680977	88682832	1855	928.0	
77821	chr16	88684751	88688248	3497	1748.0	
77822	chr16	88690616	88693576	2960	1480.0	
77823	chr16	88694844	88695493	649	324.0	
77824	chr16	88696181	88696304	123	62.0	
77825	chr16	88697951	88707701	9750	4875.0	
77826	chr16	88709573	88709748	175	88.0	
77827	chr16	88710794	88711317	523	262.0	
77828	chr16	88714795	88714987	192	96.0	
77829	chr16	88716003	88716221	218	109.0	
77830	chr16	88718130	88718531	401	200.0	
77831	chr16	88731742	88732153	411	206.0	
77832	chr16	88733563	88733658	95	48.0	
77833	chr16	88737060	88739045	1985	992.0	
77834	chr16	88740627	88740945	318	159.0	
77835	chr16	88743576	88744502	926	463.0	
77836	chr16	88745327	88746594	1267	634.0	
77837	chr16	88747820	88748370	550	275.0	
77838	chr16	88759320	88759809	489	244.0	
77839	chr16	88765890	88766186	296	148.0	
77840	chr16	88769550	88771615	2065	1032.0	
77841	chr16	88773901	88774415	514	257.0	
77842	chr16	88779839	88786232	6393	3196.0	
77843	chr16	88789546	88794050	4504	2252.0	
77844	chr16	88794738	88795509	771	386.0	
77845	chr16	88799942	88800436	494	247.0	
77846	chr16	88801921	88805206	3285	1642.0	
77847	chr16	88810253	88813405	3152	1576.0	
77848	chr16	88815799	88816479	680	340.0	
77849	chr16	88853300	88858311	5011	2506.0	
77850	chr16	88870480	88871680	1200	600.0	
77851	chr16	88882343	88882555	212	106.0	
77852	chr16	88905459	88905992	533	266.0	
77853	chr16	88911215	88911231	16	8.0	
77854	chr16	88920842	88922009	1167	584.0	
77855	chr16	88925176	88925645	469	234.0	
77856	chr16	88935944	88937579	1635	818.0	
77857	chr16	88938707	88942406	3699	1850.0	
77858	chr16	88943351	88943415	64	32.0	
77859	chr16	88957571	88959126	1555	778.0	
77860	chr16	88967294	88969216	1922	961.0	
77861	chr16	88971559	88972603	1044	522.0	
77862	chr16	88974635	88977694	3059	1530.0	
77863	chr16	88978380	88979398	1018	509.0	
77864	chr16	88982631	88982936	305	152.0	
77865	chr16	88983606	88984184	578	289.0	
77866	chr16	88993048	88993895	847	424.0	enhancer
77867	chr16	88999796	89000389	593	296.0	
77868	chr16	89004354	89004601	247	124.0	
77869	chr16	89009443	89009776	333	166.0	
77870	chr16	89020282	89020719	437	218.0	
77871	chr16	89025892	89026674	782	391.0	
77872	chr16	89031683	89032685	1002	501.0	
77873	chr16	89037552	89037936	384	192.0	
77874	chr16	89052450	89053429	979	490.0	
77875	chr16	89060295	89060308	13	6.0	
77876	chr16	89065112	89065539	427	214.0	
77877	chr16	89093435	89094727	1292	646.0	
77878	chr16	89096554	89098950	2396	1198.0	
77879	chr16	89099773	89100938	1165	582.0	
77880	chr16	89102247	89102530	283	142.0	
77881	chr16	89114328	89116388	2060	1030.0	
77882	chr16	89118415	89119711	1296	648.0	
77883	chr16	89122323	89123337	1014	507.0	
77884	chr16	89153225	89153689	464	232.0	
77885	chr16	89154300	89154739	439	220.0	
77886	chr16	89156257	89156743	486	243.0	
77887	chr16	89167039	89168072	1033	516.0	
77888	chr16	89170492	89174209	3717	1858.0	
77889	chr16	89175271	89175890	619	310.0	
77890	chr16	89185450	89185667	217	108.0	
77891	chr16	89187017	89188163	1146	573.0	
77892	chr16	89189553	89195539	5986	2993.0	
77893	chr16	89200415	89202417	2002	1001.0	
77894	chr16	89216188	89218337	2149	1074.0	
77895	chr16	89240329	89242247	1918	959.0	
77896	chr16	89242871	89243626	755	378.0	
77897	chr16	89246771	89248367	1596	798.0	
77898	chr16	89254752	89255457	705	352.0	
77899	chr16	89256536	89257768	1232	616.0	
77900	chr16	89261862	89262001	139	70.0	
77901	chr16	89265396	89265756	360	180.0	
77902	chr16	89270163	89270189	26	13.0	
77903	chr16	89277979	89278082	103	52.0	
77904	chr16	89278822	89278944	122	61.0	
77905	chr16	89280111	89280149	38	19.0	
77906	chr16	89289216	89289909	693	346.0	
77907	chr16	89297708	89298292	584	292.0	
77908	chr16	89303701	89304132	431	216.0	
77909	chr16	89308399	89309335	936	468.0	
77910	chr16	89314010	89317419	3409	1704.0	
77911	chr16	89319865	89321014	1149	574.0	
77912	chr16	89322306	89322731	425	212.0	
77913	chr16	89325804	89326646	842	421.0	
77914	chr16	89330054	89332152	2098	1049.0	
77915	chr16	89333507	89335837	2330	1165.0	
77916	chr16	89341656	89342101	445	222.0	
77917	chr16	89352523	89352650	127	64.0	
77918	chr16	89353313	89353738	425	212.0	
77919	chr16	89356987	89359639	2652	1326.0	
77920	chr16	89360641	89362716	2075	1038.0	
77921	chr16	89363519	89364422	903	452.0	
77922	chr16	89365013	89365501	488	244.0	
77923	chr16	89374551	89375435	884	442.0	
77924	chr16	89383005	89383427	422	211.0	
77925	chr16	89387794	89388467	673	336.0	
77926	chr16	89393529	89393889	360	180.0	
77927	chr16	89402578	89403622	1044	522.0	
77928	chr16	89407141	89409835	2694	1347.0	
77929	chr16	89410539	89411555	1016	508.0	
77930	chr16	89422436	89424151	1715	858.0	
77931	chr16	89431216	89432300	1084	542.0	
77932	chr16	89434850	89436768	1918	959.0	
77933	chr16	89440392	89441317	925	462.0	
77934	chr16	89442099	89445168	3069	1534.0	
77935	chr16	89446214	89447461	1247	624.0	
77936	chr16	89449754	89450407	653	326.0	
77937	chr16	89452202	89452918	716	358.0	
77938	chr16	89453491	89454479	988	494.0	
77939	chr16	89455448	89455849	401	200.0	
77940	chr16	89460575	89460971	396	198.0	
77941	chr16	89467314	89467864	550	275.0	
77942	chr16	89470811	89471220	409	204.0	
77943	chr16	89472367	89474616	2249	1124.0	
77944	chr16	89475158	89475212	54	27.0	
77945	chr16	89476369	89477462	1093	546.0	
77946	chr16	89478246	89479213	967	484.0	
77947	chr16	89482314	89482870	556	278.0	
77948	chr16	89483874	89486122	2248	1124.0	
77949	chr16	89487562	89492059	4497	2248.0	
77950	chr16	89495155	89495177	22	11.0	
77951	chr16	89504927	89509371	4444	2222.0	
77952	chr16	89533867	89535130	1263	632.0	
77953	chr16	89548904	89549486	582	291.0	
77954	chr16	89557000	89558033	1033	516.0	
77955	chr16	89558994	89562932	3938	1969.0	
77956	chr16	89563941	89566562	2621	1310.0	
77957	chr16	89571611	89572308	697	348.0	
77958	chr16	89574360	89576275	1915	958.0	
77959	chr16	89593709	89594481	772	386.0	
77960	chr16	89599418	89599672	254	127.0	
77961	chr16	89602202	89603045	843	422.0	
77962	chr16	89615827	89615863	36	18.0	
77963	chr16	89616457	89617190	733	366.0	
77964	chr16	89627520	89627780	260	130.0	
77965	chr16	89640895	89641631	736	368.0	
77966	chr16	89655872	89655873	1	0.0	
77967	chr16	89657081	89658721	1640	820.0	
77968	chr16	89668455	89668768	313	156.0	
77969	chr16	89686086	89687695	1609	804.0	
77970	chr16	89693408	89698714	5306	2653.0	
77971	chr16	89699458	89702809	3351	1676.0	
77972	chr16	89705665	89707784	2119	1060.0	
77973	chr16	89709694	89709941	247	124.0	
77974	chr16	89711019	89712689	1670	835.0	
77975	chr16	89718918	89724771	5853	2926.0	
77976	chr16	89727394	89728278	884	442.0	
77977	chr16	89737017	89738132	1115	558.0	
77978	chr16	89739548	89739816	268	134.0	
77979	chr16	89741231	89741749	518	259.0	
77980	chr16	89743114	89743293	179	90.0	
77981	chr16	89749558	89750123	565	282.0	
77982	chr16	89752560	89752932	372	186.0	
77983	chr16	89759882	89762072	2190	1095.0	
77984	chr16	89764220	89765695	1475	738.0	
77985	chr16	89784264	89786107	1843	922.0	
77986	chr16	89792884	89793555	671	336.0	
77987	chr16	89815638	89817448	1810	905.0	
77988	chr16	89821400	89822104	704	352.0	
77989	chr16	89827637	89829239	1602	801.0	
77990	chr16	89837444	89838426	982	491.0	
77991	chr16	89841007	89841793	786	393.0	
77992	chr16	89845340	89845966	626	313.0	
77993	chr16	89855594	89856243	649	324.0	
77994	chr16	89860457	89861441	984	492.0	
77995	chr16	89863260	89864824	1564	782.0	
77996	chr16	89872029	89875243	3214	1607.0	
77997	chr16	89881094	89881103	9	4.0	
77998	chr16	89890301	89890366	65	32.0	
77999	chr16	89892902	89892964	62	31.0	
78000	chr16	89894139	89894260	121	60.0	
78001	chr16	89895842	89895850	8	4.0	
78002	chr16	89904320	89904366	46	23.0	
78003	chr16	89904955	89907036	2081	1040.0	
78004	chr16	89909731	89911067	1336	668.0	
78005	chr16	89913490	89913884	394	197.0	
78006	chr16	89917492	89924988	7496	3748.0	
78007	chr16	89925539	89926945	1406	703.0	
78008	chr16	89944758	89945163	405	202.0	
78009	chr16	89947750	89949591	1841	920.0	
78010	chr16	89953849	89954366	517	258.0	
78011	chr16	89956613	89958507	1894	947.0	
78012	chr16	89967387	89967881	494	247.0	
78013	chr16	89969964	89970466	502	251.0	
78014	chr16	89971825	89973436	1611	806.0	
78015	chr16	89994628	89996224	1596	798.0	
78016	chr16	90008678	90009524	846	423.0	
78017	chr16	90018599	90020038	1439	720.0	
78018	chr16	90022157	90023265	1108	554.0	
78019	chr16	90026068	90026562	494	247.0	
78020	chr16	90031946	90032458	512	256.0	
78021	chr16	90033102	90034486	1384	692.0	
78022	chr16	90046794	90048525	1731	866.0	
78023	chr16	90070362	90070883	521	260.0	
78024	chr16	90076926	90078774	1848	924.0	
78025	chr16	90081637	90083107	1470	735.0	
78026	chr16	90106206	90106696	490	245.0	
78027	chr17	164534	164907	373	186.0	
78028	chr17	181658	181908	250	125.0	
78029	chr17	233481	233932	451	226.0	
78030	chr17	309520	309699	179	90.0	
78031	chr17	331006	331729	723	362.0	
78032	chr17	335910	336634	724	362.0	
78033	chr17	350640	351041	401	200.0	
78034	chr17	352990	353178	188	94.0	
78035	chr17	385091	386673	1582	791.0	
78036	chr17	394145	394467	322	161.0	
78037	chr17	395168	395608	440	220.0	
78038	chr17	409472	413445	3973	1986.0	
78039	chr17	414263	414395	132	66.0	
78040	chr17	416075	417418	1343	672.0	
78041	chr17	418256	419842	1586	793.0	
78042	chr17	443673	444176	503	252.0	
78043	chr17	494775	495079	304	152.0	
78044	chr17	499866	500754	888	444.0	
78045	chr17	524540	524834	294	147.0	
78046	chr17	533913	535739	1826	913.0	
78047	chr17	538627	538911	284	142.0	
78048	chr17	559845	561153	1308	654.0	
78049	chr17	570529	570706	177	88.0	
78050	chr17	611060	611785	725	362.0	
78051	chr17	614635	615595	960	480.0	
78052	chr17	628343	628799	456	228.0	
78053	chr17	630919	631263	344	172.0	
78054	chr17	633800	634283	483	242.0	
78055	chr17	640381	640901	520	260.0	
78056	chr17	688100	688491	391	196.0	
78057	chr17	689562	690290	728	364.0	
78058	chr17	700458	700917	459	230.0	
78059	chr17	714052	715842	1790	895.0	
78060	chr17	731714	733453	1739	870.0	
78061	chr17	740002	740858	856	428.0	
78062	chr17	751181	753080	1899	950.0	
78063	chr17	781212	783155	1943	972.0	
78064	chr17	794766	795223	457	228.0	
78065	chr17	876312	876652	340	170.0	
78066	chr17	879534	880039	505	252.0	
78067	chr17	975366	975743	377	188.0	
78068	chr17	978169	981642	3473	1736.0	
78069	chr17	996130	997733	1603	802.0	
78070	chr17	999026	999537	511	256.0	
78071	chr17	1033589	1033883	294	147.0	
78072	chr17	1039351	1041205	1854	927.0	
78073	chr17	1055999	1056476	477	238.0	
78074	chr17	1058336	1058805	469	234.0	
78075	chr17	1060950	1061332	382	191.0	
78076	chr17	1080673	1081206	533	266.0	
78077	chr17	1087383	1087738	355	178.0	
78078	chr17	1094836	1097343	2507	1254.0	
78079	chr17	1097905	1098971	1066	533.0	
78080	chr17	1107319	1112297	4978	2489.0	
78081	chr17	1114885	1115734	849	424.0	
78082	chr17	1119998	1121196	1198	599.0	
78083	chr17	1122679	1123568	889	444.0	
78084	chr17	1151116	1151506	390	195.0	
78085	chr17	1178605	1182004	3399	1700.0	
78086	chr17	1183151	1183920	769	384.0	
78087	chr17	1186895	1187794	899	450.0	
78088	chr17	1188680	1189612	932	466.0	
78089	chr17	1197236	1199592	2356	1178.0	
78090	chr17	1200630	1201931	1301	650.0	
78091	chr17	1202986	1206818	3832	1916.0	
78092	chr17	1207381	1207940	559	280.0	
78093	chr17	1212983	1213977	994	497.0	
78094	chr17	1216295	1216492	197	98.0	
78095	chr17	1227806	1230463	2657	1328.0	
78096	chr17	1231421	1231918	497	248.0	
78097	chr17	1253643	1254148	505	252.0	
78098	chr17	1256853	1256926	73	36.0	
78099	chr17	1258412	1260179	1767	884.0	
78100	chr17	1267349	1269092	1743	872.0	
78101	chr17	1275714	1276620	906	453.0	
78102	chr17	1286177	1287029	852	426.0	
78103	chr17	1293678	1294928	1250	625.0	
78104	chr17	1298472	1299101	629	314.0	
78105	chr17	1332469	1333015	546	273.0	
78106	chr17	1347693	1348094	401	200.0	
78107	chr17	1360561	1361407	846	423.0	
78108	chr17	1362235	1363791	1556	778.0	
78109	chr17	1365302	1366059	757	378.0	
78110	chr17	1374383	1376404	2021	1010.0	
78111	chr17	1377028	1377635	607	304.0	
78112	chr17	1379185	1380344	1159	580.0	
78113	chr17	1386306	1386886	580	290.0	
78114	chr17	1390334	1391372	1038	519.0	
78115	chr17	1392260	1392274	14	7.0	
78116	chr17	1392916	1394407	1491	746.0	
78117	chr17	1395252	1396102	850	425.0	
78118	chr17	1396855	1400938	4083	2042.0	
78119	chr17	1404546	1405280	734	367.0	
78120	chr17	1454974	1457273	2299	1150.0	
78121	chr17	1460274	1460524	250	125.0	
78122	chr17	1461074	1461777	703	352.0	
78123	chr17	1462376	1464065	1689	844.0	
78124	chr17	1467762	1468629	867	434.0	
78125	chr17	1473144	1474286	1142	571.0	
78126	chr17	1484308	1489266	4958	2479.0	
78127	chr17	1490191	1494631	4440	2220.0	
78128	chr17	1509447	1509830	383	192.0	
78129	chr17	1515274	1517628	2354	1177.0	
78130	chr17	1526776	1527252	476	238.0	
78131	chr17	1533130	1533656	526	263.0	
78132	chr17	1555539	1556742	1203	602.0	
78133	chr17	1558698	1558748	50	25.0	
78134	chr17	1561451	1564563	3112	1556.0	
78135	chr17	1565799	1567412	1613	806.0	
78136	chr17	1571009	1571122	113	56.0	
78137	chr17	1572564	1573062	498	249.0	
78138	chr17	1574201	1578275	4074	2037.0	
78139	chr17	1582412	1582641	229	114.0	
78140	chr17	1586697	1587813	1116	558.0	
78141	chr17	1588701	1591127	2426	1213.0	
78142	chr17	1592645	1593529	884	442.0	
78143	chr17	1604764	1605168	404	202.0	
78144	chr17	1606763	1608363	1600	800.0	
78145	chr17	1611352	1612275	923	462.0	
78146	chr17	1614029	1614900	871	436.0	
78147	chr17	1617676	1618275	599	300.0	
78148	chr17	1623223	1623602	379	190.0	
78149	chr17	1625720	1632081	6361	3180.0	
78150	chr17	1638233	1638723	490	245.0	
78151	chr17	1639551	1641107	1556	778.0	
78152	chr17	1642547	1646107	3560	1780.0	
78153	chr17	1647845	1651906	4061	2030.0	
78154	chr17	1665251	1665733	482	241.0	
78155	chr17	1669255	1669932	677	338.0	
78156	chr17	1673017	1673547	530	265.0	
78157	chr17	1683507	1685620	2113	1056.0	
78158	chr17	1707017	1707614	597	298.0	
78159	chr17	1709307	1711529	2222	1111.0	
78160	chr17	1712168	1718264	6096	3048.0	
78161	chr17	1720500	1721437	937	468.0	
78162	chr17	1722694	1725652	2958	1479.0	
78163	chr17	1733112	1733146	34	17.0	
78164	chr17	1736619	1737348	729	364.0	
78165	chr17	1752316	1753183	867	434.0	
78166	chr17	1758610	1759269	659	330.0	
78167	chr17	1762790	1763280	490	245.0	
78168	chr17	1764038	1764780	742	371.0	
78169	chr17	1769959	1770512	553	276.0	
78170	chr17	1771361	1771942	581	290.0	
78171	chr17	1782440	1784445	2005	1002.0	
78172	chr17	1823132	1824240	1108	554.0	
78173	chr17	1829191	1830887	1696	848.0	
78174	chr17	1834346	1834815	469	234.0	
78175	chr17	1865426	1865837	411	206.0	
78176	chr17	1870302	1871067	765	382.0	
78177	chr17	1871614	1872389	775	388.0	
78178	chr17	1882781	1883171	390	195.0	
78179	chr17	1890689	1891531	842	421.0	
78180	chr17	1908395	1909070	675	338.0	
78181	chr17	2022734	2026435	3701	1850.0	
78182	chr17	2028651	2031191	2540	1270.0	
78183	chr17	2040286	2043268	2982	1491.0	
78184	chr17	2043914	2044292	378	189.0	
78185	chr17	2049159	2052357	3198	1599.0	
78186	chr17	2053207	2059976	6769	3384.0	
78187	chr17	2060641	2061663	1022	511.0	
78188	chr17	2064579	2065470	891	446.0	
78189	chr17	2068801	2068938	137	68.0	
78190	chr17	2070208	2071897	1689	844.0	
78191	chr17	2075731	2076361	630	315.0	
78192	chr17	2083319	2084656	1337	668.0	
78193	chr17	2087240	2090598	3358	1679.0	
78194	chr17	2101366	2102025	659	330.0	
78195	chr17	2120511	2121011	500	250.0	
78196	chr17	2122673	2124359	1686	843.0	
78197	chr17	2137331	2139069	1738	869.0	
78198	chr17	2156907	2158464	1557	778.0	
78199	chr17	2170118	2170383	265	132.0	
78200	chr17	2178895	2179376	481	240.0	enhancer
78201	chr17	2181740	2181921	181	90.0	
78202	chr17	2185483	2185814	331	166.0	
78203	chr17	2192414	2193128	714	357.0	
78204	chr17	2214069	2214465	396	198.0	
78205	chr17	2215027	2216532	1505	752.0	enhancer
78206	chr17	2222760	2223780	1020	510.0	
78207	chr17	2240150	2240182	32	16.0	
78208	chr17	2244630	2245363	733	366.0	
78209	chr17	2250564	2251180	616	308.0	
78210	chr17	2253976	2254255	279	140.0	
78211	chr17	2258639	2260617	1978	989.0	
78212	chr17	2263396	2264818	1422	711.0	
78213	chr17	2265655	2267398	1743	872.0	
78214	chr17	2272005	2272349	344	172.0	
78215	chr17	2275765	2276045	280	140.0	
78216	chr17	2282021	2282893	872	436.0	
78217	chr17	2302750	2304470	1720	860.0	
78218	chr17	2335799	2338644	2845	1422.0	
78219	chr17	2339492	2339604	112	56.0	
78220	chr17	2352937	2354358	1421	710.0	
78221	chr17	2382304	2383533	1229	614.0	
78222	chr17	2391645	2398062	6417	3208.0	
78223	chr17	2398591	2402883	4292	2146.0	
78224	chr17	2403931	2404765	834	417.0	
78225	chr17	2415929	2416503	574	287.0	
78226	chr17	2438755	2439276	521	260.0	
78227	chr17	2439919	2440496	577	288.0	
78228	chr17	2482088	2482744	656	328.0	
78229	chr17	2511053	2512768	1715	858.0	
78230	chr17	2531386	2531787	401	200.0	
78231	chr17	2542519	2542808	289	144.0	
78232	chr17	2572202	2572368	166	83.0	
78233	chr17	2592765	2596130	3365	1682.0	
78234	chr17	2596656	2597625	969	484.0	
78235	chr17	2602720	2603407	687	344.0	
78236	chr17	2606254	2606501	247	124.0	
78237	chr17	2608475	2608819	344	172.0	
78238	chr17	2613355	2613402	47	24.0	
78239	chr17	2624072	2624887	815	408.0	
78240	chr17	2628973	2629361	388	194.0	
78241	chr17	2648007	2648311	304	152.0	
78242	chr17	2655417	2656088	671	336.0	
78243	chr17	2659287	2659829	542	271.0	
78244	chr17	2675187	2675738	551	276.0	
78245	chr17	2686493	2687213	720	360.0	
78246	chr17	2688815	2690092	1277	638.0	
78247	chr17	2693455	2694619	1164	582.0	
78248	chr17	2701934	2702594	660	330.0	
78249	chr17	2707636	2707927	291	146.0	
78250	chr17	2709000	2709583	583	292.0	
78251	chr17	2710261	2712541	2280	1140.0	
78252	chr17	2724271	2725117	846	423.0	
78253	chr17	2749521	2750252	731	366.0	
78254	chr17	2755487	2755629	142	71.0	
78255	chr17	2776520	2777343	823	412.0	
78256	chr17	2785959	2786970	1011	506.0	
78257	chr17	2790476	2794740	4264	2132.0	
78258	chr17	2795324	2799116	3792	1896.0	
78259	chr17	2803359	2803760	401	200.0	
78260	chr17	2812176	2812575	399	200.0	
78261	chr17	2813834	2816311	2477	1238.0	
78262	chr17	2824585	2825572	987	494.0	
78263	chr17	2828320	2829046	726	363.0	
78264	chr17	2837100	2837653	553	276.0	
78265	chr17	2847574	2849333	1759	880.0	
78266	chr17	2852283	2854628	2345	1172.0	
78267	chr17	2905282	2905687	405	202.0	
78268	chr17	2929999	2931583	1584	792.0	
78269	chr17	2939894	2940063	169	84.0	
78270	chr17	2943570	2944781	1211	606.0	
78271	chr17	2945429	2945512	83	42.0	
78272	chr17	2955125	2955492	367	184.0	
78273	chr17	2990173	2990931	758	379.0	
78274	chr17	3001805	3004915	3110	1555.0	
78275	chr17	3012867	3013428	561	280.0	
78276	chr17	3030077	3030522	445	222.0	
78277	chr17	3032661	3033165	504	252.0	
78278	chr17	3039482	3040352	870	435.0	
78279	chr17	3048419	3049704	1285	642.0	
78280	chr17	3065139	3065578	439	220.0	
78281	chr17	3167279	3168068	789	394.0	
78282	chr17	3222697	3222720	23	12.0	
78283	chr17	3271015	3271510	495	248.0	
78284	chr17	3386135	3386614	479	240.0	
78285	chr17	3514807	3515414	607	304.0	
78286	chr17	3534864	3535978	1114	557.0	
78287	chr17	3557631	3559111	1480	740.0	
78288	chr17	3635021	3637484	2463	1232.0	
78289	chr17	3639828	3640567	739	370.0	
78290	chr17	3645904	3646342	438	219.0	
78291	chr17	3647784	3648195	411	206.0	
78292	chr17	3658029	3658033	4	2.0	
78293	chr17	3659108	3659432	324	162.0	
78294	chr17	3667364	3669634	2270	1135.0	
78295	chr17	3679077	3679485	408	204.0	
78296	chr17	3682888	3683821	933	466.0	
78297	chr17	3684334	3684395	61	30.0	
78298	chr17	3693688	3697041	3353	1676.0	
78299	chr17	3710548	3711781	1233	616.0	
78300	chr17	3712880	3713224	344	172.0	
78301	chr17	3719913	3720849	936	468.0	
78302	chr17	3723029	3724655	1626	813.0	
78303	chr17	3737410	3739271	1861	930.0	
78304	chr17	3740560	3741432	872	436.0	
78305	chr17	3750748	3751361	613	306.0	
78306	chr17	3753738	3753832	94	47.0	
78307	chr17	3754384	3755693	1309	654.0	
78308	chr17	3763180	3767235	4055	2028.0	
78309	chr17	3770271	3771549	1278	639.0	
78310	chr17	3788119	3788704	585	292.0	
78311	chr17	3790294	3790674	380	190.0	
78312	chr17	3794785	3797254	2469	1234.0	enhancer
78313	chr17	3798510	3799030	520	260.0	
78314	chr17	3799602	3799923	321	160.0	
78315	chr17	3802892	3803683	791	396.0	
78316	chr17	3827085	3827573	488	244.0	
78317	chr17	3843892	3844383	491	246.0	
78318	chr17	3845158	3847054	1896	948.0	
78319	chr17	3848319	3848412	93	46.0	
78320	chr17	3863624	3864122	498	249.0	
78321	chr17	3870765	3871579	814	407.0	
78322	chr17	3886633	3887958	1325	662.0	
78323	chr17	3889996	3890828	832	416.0	
78324	chr17	3891535	3894080	2545	1272.0	
78325	chr17	3894771	3895448	677	338.0	
78326	chr17	3904407	3905574	1167	584.0	
78327	chr17	3907472	3907841	369	184.0	
78328	chr17	3910881	3912048	1167	584.0	
78329	chr17	3913429	3917855	4426	2213.0	
78330	chr17	3918971	3919346	375	188.0	
78331	chr17	3921092	3921376	284	142.0	
78332	chr17	3922059	3922358	299	150.0	
78333	chr17	3923816	3924206	390	195.0	
78334	chr17	3934997	3935534	537	268.0	
78335	chr17	3944628	3945214	586	293.0	
78336	chr17	3960400	3965879	5479	2740.0	
78337	chr17	3966648	3967288	640	320.0	
78338	chr17	3972179	3972897	718	359.0	
78339	chr17	3974117	3974670	553	276.0	
78340	chr17	3983920	3984488	568	284.0	
78341	chr17	4002090	4006332	4242	2121.0	
78342	chr17	4017590	4017761	171	86.0	
78343	chr17	4043619	4044372	753	376.0	
78344	chr17	4045497	4045980	483	242.0	
78345	chr17	4074078	4075251	1173	586.0	
78346	chr17	4083169	4083700	531	266.0	
78347	chr17	4101168	4101746	578	289.0	
78348	chr17	4126884	4127134	250	125.0	
78349	chr17	4130559	4131247	688	344.0	
78350	chr17	4142070	4144754	2684	1342.0	
78351	chr17	4161616	4163376	1760	880.0	
78352	chr17	4167553	4168365	812	406.0	
78353	chr17	4175579	4177158	1579	790.0	
78354	chr17	4199782	4200292	510	255.0	
78355	chr17	4206953	4207442	489	244.0	
78356	chr17	4207989	4208028	39	20.0	
78357	chr17	4215245	4215807	562	281.0	
78358	chr17	4249545	4249770	225	112.0	
78359	chr17	4263004	4264620	1616	808.0	
78360	chr17	4304359	4305051	692	346.0	
78361	chr17	4313464	4313862	398	199.0	
78362	chr17	4333721	4334150	429	214.0	
78363	chr17	4334796	4335551	755	378.0	
78364	chr17	4341819	4341829	10	5.0	
78365	chr17	4362260	4362531	271	136.0	
78366	chr17	4364702	4367443	2741	1370.0	
78367	chr17	4374916	4375790	874	437.0	
78368	chr17	4381305	4381620	315	158.0	
78369	chr17	4396231	4396496	265	132.0	
78370	chr17	4397006	4397569	563	282.0	
78371	chr17	4403282	4403284	2	1.0	
78372	chr17	4412769	4413700	931	466.0	
78373	chr17	4420536	4421217	681	340.0	
78374	chr17	4429471	4429928	457	228.0	
78375	chr17	4433347	4434187	840	420.0	
78376	chr17	4436801	4437278	477	238.0	
78377	chr17	4444676	4445040	364	182.0	
78378	chr17	4480742	4481796	1054	527.0	
78379	chr17	4485914	4486785	871	436.0	
78380	chr17	4493260	4493472	212	106.0	
78381	chr17	4497105	4497465	360	180.0	
78382	chr17	4498090	4500441	2351	1176.0	
78383	chr17	4504257	4504589	332	166.0	
78384	chr17	4509364	4509733	369	184.0	
78385	chr17	4518738	4518865	127	64.0	
78386	chr17	4536545	4537103	558	279.0	
78387	chr17	4554482	4556150	1668	834.0	
78388	chr17	4562318	4562512	194	97.0	
78389	chr17	4565474	4566051	577	288.0	
78390	chr17	4566655	4567125	470	235.0	
78391	chr17	4573540	4574031	491	246.0	
78392	chr17	4583986	4584763	777	388.0	
78393	chr17	4595026	4595433	407	204.0	
78394	chr17	4607752	4608130	378	189.0	
78395	chr17	4625919	4626375	456	228.0	
78396	chr17	4635937	4636624	687	344.0	
78397	chr17	4639276	4639753	477	238.0	
78398	chr17	4645521	4646050	529	264.0	
78399	chr17	4696084	4697172	1088	544.0	
78400	chr17	4703247	4704879	1632	816.0	
78401	chr17	4708268	4712900	4632	2316.0	
78402	chr17	4713862	4715870	2008	1004.0	
78403	chr17	4717789	4718152	363	182.0	
78404	chr17	4721448	4722216	768	384.0	
78405	chr17	4724629	4726375	1746	873.0	
78406	chr17	4730571	4732327	1756	878.0	
78407	chr17	4732976	4733866	890	445.0	
78408	chr17	4735794	4736763	969	484.0	
78409	chr17	4738299	4740477	2178	1089.0	
78410	chr17	4745122	4745125	3	2.0	
78411	chr17	4747219	4748849	1630	815.0	
78412	chr17	4759810	4760345	535	268.0	
78413	chr17	4764229	4765118	889	444.0	
78414	chr17	4765893	4767235	1342	671.0	
78415	chr17	4768185	4768855	670	335.0	
78416	chr17	4770572	4771070	498	249.0	
78417	chr17	4782693	4783083	390	195.0	
78418	chr17	4785230	4787667	2437	1218.0	
78419	chr17	4789023	4790950	1927	964.0	
78420	chr17	4795437	4796963	1526	763.0	
78421	chr17	4806440	4807871	1431	716.0	
78422	chr17	4832605	4836133	3528	1764.0	
78423	chr17	4843195	4844002	807	404.0	
78424	chr17	4844829	4845772	943	472.0	
78425	chr17	4851424	4851476	52	26.0	
78426	chr17	4852473	4853701	1228	614.0	
78427	chr17	4879520	4880039	519	260.0	
78428	chr17	4881755	4882427	672	336.0	
78429	chr17	4888780	4889695	915	458.0	
78430	chr17	4893919	4893994	75	38.0	
78431	chr17	4894600	4904197	9597	4798.0	
78432	chr17	4908399	4909708	1309	654.0	
78433	chr17	4920166	4921066	900	450.0	
78434	chr17	4932013	4932399	386	193.0	
78435	chr17	4934047	4934723	676	338.0	
78436	chr17	4939010	4942460	3450	1725.0	
78437	chr17	4943891	4951319	7428	3714.0	
78438	chr17	4956623	4957054	431	216.0	
78439	chr17	4966080	4969936	3856	1928.0	
78440	chr17	4973236	4973988	752	376.0	
78441	chr17	4978674	4979208	534	267.0	
78442	chr17	4980454	4981207	753	376.0	
78443	chr17	4982082	4982653	571	286.0	
78444	chr17	4986288	4988960	2672	1336.0	
78445	chr17	4996808	4999616	2808	1404.0	
78446	chr17	5016639	5017478	839	420.0	
78447	chr17	5019574	5020325	751	376.0	
78448	chr17	5030840	5032381	1541	770.0	
78449	chr17	5042040	5042825	785	392.0	
78450	chr17	5049011	5049920	909	454.0	
78451	chr17	5062305	5062940	635	318.0	
78452	chr17	5077812	5079197	1385	692.0	
78453	chr17	5096692	5098000	1308	654.0	
78454	chr17	5110884	5112531	1647	824.0	
78455	chr17	5122864	5123550	686	343.0	
78456	chr17	5164392	5164886	494	247.0	
78457	chr17	5166412	5166518	106	53.0	
78458	chr17	5184198	5184800	602	301.0	
78459	chr17	5191193	5192534	1341	670.0	
78460	chr17	5196715	5197456	741	370.0	
78461	chr17	5198501	5198831	330	165.0	
78462	chr17	5210990	5211777	787	394.0	
78463	chr17	5220771	5222413	1642	821.0	
78464	chr17	5225672	5227951	2279	1140.0	
78465	chr17	5228886	5229480	594	297.0	
78466	chr17	5232438	5233626	1188	594.0	
78467	chr17	5234401	5235606	1205	602.0	
78468	chr17	5237000	5238164	1164	582.0	
78469	chr17	5241823	5243450	1627	814.0	
78470	chr17	5249464	5250218	754	377.0	
78471	chr17	5254891	5255623	732	366.0	
78472	chr17	5281450	5283953	2503	1252.0	
78473	chr17	5307353	5308158	805	402.0	
78474	chr17	5330043	5330383	340	170.0	
78475	chr17	5418345	5420829	2484	1242.0	
78476	chr17	5438480	5439887	1407	704.0	
78477	chr17	5462113	5463206	1093	546.0	
78478	chr17	5467828	5469542	1714	857.0	
78479	chr17	5485470	5487431	1961	980.0	
78480	chr17	5500334	5501761	1427	714.0	
78481	chr17	5513548	5514003	455	228.0	
78482	chr17	5580303	5580774	471	236.0	
78483	chr17	5582224	5585443	3219	1610.0	
78484	chr17	5586030	5586474	444	222.0	
78485	chr17	5587309	5588063	754	377.0	
78486	chr17	5592331	5593011	680	340.0	
78487	chr17	5610810	5611508	698	349.0	
78488	chr17	5612241	5612516	275	138.0	
78489	chr17	5621089	5621377	288	144.0	
78490	chr17	5672772	5673231	459	230.0	
78491	chr17	5706780	5707255	475	238.0	
78492	chr17	5715460	5715895	435	218.0	
78493	chr17	6068982	6069268	286	143.0	
78494	chr17	6070298	6070306	8	4.0	
78495	chr17	6413641	6413830	189	94.0	
78496	chr17	6420431	6420541	110	55.0	
78497	chr17	6421849	6422618	769	384.0	
78498	chr17	6427237	6427963	726	363.0	
78499	chr17	6435869	6436613	744	372.0	
78500	chr17	6443382	6445112	1730	865.0	
78501	chr17	6455118	6455860	742	371.0	
78502	chr17	6473077	6473580	503	252.0	
78503	chr17	6555323	6555492	169	84.0	
78504	chr17	6556450	6556684	234	117.0	
78505	chr17	6575159	6575725	566	283.0	
78506	chr17	6599325	6599865	540	270.0	
78507	chr17	6638969	6641959	2990	1495.0	
78508	chr17	6648202	6648555	353	176.0	
78509	chr17	6650508	6652608	2100	1050.0	
78510	chr17	6656901	6657741	840	420.0	
78511	chr17	6660339	6661229	890	445.0	
78512	chr17	6665935	6666466	531	266.0	
78513	chr17	6677477	6677750	273	136.0	
78514	chr17	6701732	6702116	384	192.0	
78515	chr17	6711763	6711987	224	112.0	
78516	chr17	6752111	6753624	1513	756.0	
78517	chr17	6755468	6757498	2030	1015.0	
78518	chr17	6775940	6776216	276	138.0	
78519	chr17	6830949	6832412	1463	732.0	
78520	chr17	6843253	6843675	422	211.0	
78521	chr17	6853727	6854278	551	276.0	
78522	chr17	6862879	6863048	169	84.0	
78523	chr17	6910946	6911385	439	220.0	
78524	chr17	6913743	6914606	863	432.0	
78525	chr17	6936264	6937003	739	370.0	
78526	chr17	6940350	6940604	254	127.0	
78527	chr17	6948555	6949128	573	286.0	
78528	chr17	7001571	7001988	417	208.0	
78529	chr17	7004494	7005616	1122	561.0	
78530	chr17	7007199	7007355	156	78.0	
78531	chr17	7011870	7018612	6742	3371.0	
78532	chr17	7021518	7024902	3384	1692.0	
78533	chr17	7029656	7030144	488	244.0	
78534	chr17	7034960	7036970	2010	1005.0	
78535	chr17	7039836	7040206	370	185.0	
78536	chr17	7041812	7044327	2515	1258.0	
78537	chr17	7045491	7047562	2071	1036.0	
78538	chr17	7051951	7052663	712	356.0	
78539	chr17	7080106	7080634	528	264.0	
78540	chr17	7081617	7082134	517	258.0	
78541	chr17	7084322	7084416	94	47.0	
78542	chr17	7091497	7091715	218	109.0	
78543	chr17	7093903	7095083	1180	590.0	
78544	chr17	7095599	7096073	474	237.0	
78545	chr17	7099023	7099381	358	179.0	
78546	chr17	7112136	7112669	533	266.0	
78547	chr17	7114668	7115545	877	438.0	
78548	chr17	7120421	7121844	1423	712.0	
78549	chr17	7122444	7122781	337	168.0	
78550	chr17	7130485	7134313	3828	1914.0	
78551	chr17	7135616	7137857	2241	1120.0	
78552	chr17	7138617	7139334	717	358.0	
78553	chr17	7158439	7158840	401	200.0	
78554	chr17	7167698	7168310	612	306.0	
78555	chr17	7169175	7169631	456	228.0	
78556	chr17	7171479	7171805	326	163.0	
78557	chr17	7173915	7175031	1116	558.0	
78558	chr17	7177101	7178420	1319	660.0	
78559	chr17	7184091	7184379	288	144.0	
78560	chr17	7186290	7186653	363	182.0	
78561	chr17	7191393	7191905	512	256.0	
78562	chr17	7202924	7203067	143	72.0	
78563	chr17	7204113	7207546	3433	1716.0	
78564	chr17	7213572	7218465	4893	2446.0	
78565	chr17	7219120	7221535	2415	1208.0	
78566	chr17	7233182	7236027	2845	1422.0	
78567	chr17	7237148	7243730	6582	3291.0	
78568	chr17	7249855	7253145	3290	1645.0	
78569	chr17	7260402	7264088	3686	1843.0	
78570	chr17	7280267	7283363	3096	1548.0	
78571	chr17	7293736	7297072	3336	1668.0	
78572	chr17	7306430	7309909	3479	1740.0	
78573	chr17	7311835	7311916	81	40.0	
78574	chr17	7312671	7316217	3546	1773.0	
78575	chr17	7323943	7324645	702	351.0	
78576	chr17	7328344	7330974	2630	1315.0	
78577	chr17	7332389	7333189	800	400.0	
78578	chr17	7335989	7338014	2025	1012.0	
78579	chr17	7345780	7346216	436	218.0	
78580	chr17	7349161	7352966	3805	1902.0	
78581	chr17	7354277	7354493	216	108.0	
78582	chr17	7355729	7356631	902	451.0	
78583	chr17	7380416	7381617	1201	600.0	
78584	chr17	7383515	7385082	1567	784.0	
78585	chr17	7386019	7386477	458	229.0	
78586	chr17	7393486	7395429	1943	972.0	
78587	chr17	7403090	7406823	3733	1866.0	
78588	chr17	7407998	7409143	1145	572.0	
78589	chr17	7411315	7411379	64	32.0	
78590	chr17	7434658	7438850	4192	2096.0	
78591	chr17	7439412	7441367	1955	978.0	
78592	chr17	7444728	7446608	1880	940.0	
78593	chr17	7454883	7457012	2129	1064.0	
78594	chr17	7466260	7467570	1310	655.0	
78595	chr17	7471676	7472148	472	236.0	
78596	chr17	7475684	7480419	4735	2368.0	
78597	chr17	7482698	7494703	12005	6002.0	
78598	chr17	7495249	7499573	4324	2162.0	
78599	chr17	7500146	7517327	17181	8590.0	
78600	chr17	7517863	7519455	1592	796.0	
78601	chr17	7521033	7521706	673	336.0	
78602	chr17	7522801	7525519	2718	1359.0	
78603	chr17	7526225	7526301	76	38.0	
78604	chr17	7548136	7550222	2086	1043.0	
78605	chr17	7551361	7551596	235	118.0	
78606	chr17	7552249	7553543	1294	647.0	
78607	chr17	7557853	7559355	1502	751.0	
78608	chr17	7559889	7562743	2854	1427.0	
78609	chr17	7570795	7570984	189	94.0	
78610	chr17	7571858	7584908	13050	6525.0	
78611	chr17	7585657	7591806	6149	3074.0	
78612	chr17	7592843	7592916	73	36.0	
78613	chr17	7613732	7615866	2134	1067.0	
78614	chr17	7626145	7628361	2216	1108.0	
78615	chr17	7632388	7632938	550	275.0	
78616	chr17	7634446	7634669	223	112.0	
78617	chr17	7644654	7645309	655	328.0	
78618	chr17	7647064	7647465	401	200.0	
78619	chr17	7650187	7653197	3010	1505.0	
78620	chr17	7673295	7673602	307	154.0	
78621	chr17	7684878	7689084	4206	2103.0	
78622	chr17	7703573	7703908	335	168.0	
78623	chr17	7704672	7705966	1294	647.0	
78624	chr17	7710282	7710738	456	228.0	
78625	chr17	7711382	7711683	301	150.0	
78626	chr17	7717058	7718409	1351	676.0	
78627	chr17	7729830	7730213	383	192.0	
78628	chr17	7743452	7743983	531	266.0	
78629	chr17	7806612	7807040	428	214.0	
78630	chr17	7822633	7823292	659	330.0	
78631	chr17	7825339	7825433	94	47.0	
78632	chr17	7832764	7860423	27659	13830.0	
78633	chr17	7862512	7863237	725	362.0	
78634	chr17	7867802	7868477	675	338.0	
78635	chr17	7871553	7871855	302	151.0	
78636	chr17	7880149	7880862	713	356.0	
78637	chr17	7881455	7882388	933	466.0	
78638	chr17	7883609	7889694	6085	3042.0	
78639	chr17	7897717	7898242	525	262.0	
78640	chr17	7912787	7913573	786	393.0	
78641	chr17	7915062	7917195	2133	1066.0	
78642	chr17	7922304	7924498	2194	1097.0	
78643	chr17	7929623	7930132	509	254.0	
78644	chr17	7931279	7933473	2194	1097.0	
78645	chr17	7969303	7970032	729	364.0	
78646	chr17	7988470	7990838	2368	1184.0	
78647	chr17	7992892	7993428	536	268.0	
78648	chr17	7997209	7997493	284	142.0	
78649	chr17	8001938	8002838	900	450.0	
78650	chr17	8005943	8006355	412	206.0	
78651	chr17	8013274	8013677	403	202.0	
78652	chr17	8015883	8017704	1821	910.0	
78653	chr17	8020300	8020696	396	198.0	
78654	chr17	8024050	8024114	64	32.0	
78655	chr17	8039401	8039443	42	21.0	
78656	chr17	8040880	8041960	1080	540.0	
78657	chr17	8055883	8056822	939	470.0	
78658	chr17	8057439	8058164	725	362.0	
78659	chr17	8060128	8060674	546	273.0	
78660	chr17	8068708	8069675	967	484.0	
78661	chr17	8072265	8074409	2144	1072.0	
78662	chr17	8079048	8080570	1522	761.0	
78663	chr17	8090898	8091447	549	274.0	
78664	chr17	8093777	8094612	835	418.0	
78665	chr17	8109780	8110878	1098	549.0	
78666	chr17	8117188	8127484	10296	5148.0	
78667	chr17	8133439	8134998	1559	780.0	
78668	chr17	8136054	8165683	29629	14814.0	
78669	chr17	8171504	8174472	2968	1484.0	
78670	chr17	8175566	8177051	1485	742.0	
78671	chr17	8181818	8182333	515	258.0	
78672	chr17	8185125	8191091	5966	2983.0	
78673	chr17	8191885	8192887	1002	501.0	
78674	chr17	8195911	8196514	603	302.0	
78675	chr17	8199622	8200865	1243	622.0	enhancer
78676	chr17	8209885	8211231	1346	673.0	
78677	chr17	8220547	8224136	3589	1794.0	
78678	chr17	8224776	8225085	309	154.0	
78679	chr17	8225762	8227541	1779	890.0	
78680	chr17	8243791	8244238	447	224.0	
78681	chr17	8246228	8249854	3626	1813.0	
78682	chr17	8285589	8286035	446	223.0	
78683	chr17	8287978	8289625	1647	824.0	
78684	chr17	8292974	8293333	359	180.0	
78685	chr17	8294771	8296230	1459	730.0	
78686	chr17	8300376	8301246	870	435.0	
78687	chr17	8324916	8325261	345	172.0	
78688	chr17	8326417	8327330	913	456.0	
78689	chr17	8338023	8338886	863	432.0	
78690	chr17	8369899	8370386	487	244.0	
78691	chr17	8374966	8375043	77	38.0	
78692	chr17	8375855	8377298	1443	722.0	
78693	chr17	8382405	8384428	2023	1012.0	
78694	chr17	8388159	8389003	844	422.0	
78695	chr17	8393432	8394187	755	378.0	
78696	chr17	8410013	8411000	987	494.0	
78697	chr17	8412766	8413683	917	458.0	
78698	chr17	8417509	8418322	813	406.0	
78699	chr17	8419931	8421097	1166	583.0	
78700	chr17	8435105	8437201	2096	1048.0	
78701	chr17	8438430	8439108	678	339.0	
78702	chr17	8441209	8442040	831	416.0	
78703	chr17	8444015	8444054	39	20.0	
78704	chr17	8455708	8456009	301	150.0	
78705	chr17	8629592	8631864	2272	1136.0	
78706	chr17	8726526	8726820	294	147.0	
78707	chr17	8739687	8741325	1638	819.0	
78708	chr17	8744374	8746809	2435	1218.0	
78709	chr17	8785756	8786242	486	243.0	
78710	chr17	8791823	8792272	449	224.0	
78711	chr17	8793674	8794065	391	196.0	
78712	chr17	8794887	8795288	401	200.0	
78713	chr17	8806472	8807636	1164	582.0	
78714	chr17	8832747	8832961	214	107.0	
78715	chr17	8846677	8847060	383	192.0	
78716	chr17	8857866	8859788	1922	961.0	
78717	chr17	8860951	8861824	873	436.0	
78718	chr17	8867341	8868955	1614	807.0	
78719	chr17	8872394	8872795	401	200.0	
78720	chr17	8873305	8873434	129	64.0	
78721	chr17	8874049	8874501	452	226.0	
78722	chr17	8875675	8876142	467	234.0	
78723	chr17	8878371	8878572	201	100.0	
78724	chr17	8881521	8881740	219	110.0	
78725	chr17	8885047	8886752	1705	852.0	
78726	chr17	8888998	8889204	206	103.0	
78727	chr17	8892270	8892720	450	225.0	
78728	chr17	8894693	8895579	886	443.0	
78729	chr17	8898423	8901573	3150	1575.0	
78730	chr17	8905265	8905827	562	281.0	
78731	chr17	8915472	8917038	1566	783.0	
78732	chr17	8922246	8924191	1945	972.0	
78733	chr17	8925735	8926271	536	268.0	
78734	chr17	8930669	8931057	388	194.0	
78735	chr17	8934786	8935753	967	484.0	
78736	chr17	8939372	8942770	3398	1699.0	
78737	chr17	8944699	8945418	719	360.0	
78738	chr17	8948473	8949705	1232	616.0	
78739	chr17	8951085	8956786	5701	2850.0	
78740	chr17	8958233	8961095	2862	1431.0	
78741	chr17	8963370	8968238	4868	2434.0	
78742	chr17	8975376	8975747	371	186.0	
78743	chr17	8985231	8985764	533	266.0	
78744	chr17	8986273	8986345	72	36.0	
78745	chr17	8991480	8992124	644	322.0	
78746	chr17	8994175	8994758	583	292.0	
78747	chr17	8997766	8998648	882	441.0	
78748	chr17	9001830	9001971	141	70.0	
78749	chr17	9002741	9004632	1891	946.0	
78750	chr17	9020607	9023425	2818	1409.0	
78751	chr17	9115652	9115855	203	102.0	
78752	chr17	9204956	9205094	138	69.0	
78753	chr17	9226605	9227171	566	283.0	
78754	chr17	9239081	9241980	2899	1450.0	
78755	chr17	9252607	9252950	343	172.0	
78756	chr17	9256854	9256894	40	20.0	
78757	chr17	9292153	9292535	382	191.0	
78758	chr17	9356482	9356875	393	196.0	
78759	chr17	9414560	9414779	219	110.0	
78760	chr17	9470189	9470571	382	191.0	
78761	chr17	9546317	9546702	385	192.0	
78762	chr17	9554787	9555092	305	152.0	
78763	chr17	9566008	9566448	440	220.0	
78764	chr17	9575202	9577574	2372	1186.0	
78765	chr17	9644511	9646262	1751	876.0	
78766	chr17	9729148	9729202	54	27.0	
78767	chr17	9880445	9880987	542	271.0	
78768	chr17	9905900	9906301	401	200.0	
78769	chr17	9924677	9925512	835	418.0	
78770	chr17	9958831	9959701	870	435.0	
78771	chr17	9965572	9966059	487	244.0	
78772	chr17	9974381	9975523	1142	571.0	
78773	chr17	9977145	9977556	411	206.0	
78774	chr17	9987742	9988241	499	250.0	
78775	chr17	10001369	10001601	232	116.0	
78776	chr17	10013178	10014135	957	478.0	
78777	chr17	10018234	10019014	780	390.0	
78778	chr17	10019785	10020577	792	396.0	
78779	chr17	10021141	10021857	716	358.0	
78780	chr17	10022477	10022738	261	130.0	
78781	chr17	10023577	10023834	257	128.0	
78782	chr17	10028111	10028641	530	265.0	
78783	chr17	10033581	10034600	1019	510.0	
78784	chr17	10036318	10037174	856	428.0	
78785	chr17	10040510	10040911	401	200.0	
78786	chr17	10046760	10047653	893	446.0	
78787	chr17	10048639	10049259	620	310.0	
78788	chr17	10050448	10051532	1084	542.0	
78789	chr17	10052449	10052807	358	179.0	
78790	chr17	10059140	10060159	1019	510.0	
78791	chr17	10060926	10061468	542	271.0	
78792	chr17	10062649	10064595	1946	973.0	
78793	chr17	10072603	10073001	398	199.0	
78794	chr17	10077591	10078402	811	406.0	
78795	chr17	10081384	10082136	752	376.0	
78796	chr17	10085150	10085812	662	331.0	
78797	chr17	10087316	10087809	493	246.0	
78798	chr17	10107045	10107718	673	336.0	
78799	chr17	10114010	10116379	2369	1184.0	
78800	chr17	10116890	10118162	1272	636.0	
78801	chr17	10118824	10121224	2400	1200.0	
78802	chr17	10122037	10122748	711	356.0	
78803	chr17	10126752	10128554	1802	901.0	
78804	chr17	10135883	10136450	567	284.0	
78805	chr17	10145088	10145512	424	212.0	
78806	chr17	10149879	10150715	836	418.0	
78807	chr17	10151688	10152774	1086	543.0	
78808	chr17	10156547	10157832	1285	642.0	
78809	chr17	10162076	10162457	381	190.0	
78810	chr17	10168414	10168715	301	150.0	
78811	chr17	10169298	10169599	301	150.0	
78812	chr17	10171207	10173119	1912	956.0	
78813	chr17	10186928	10187037	109	54.0	
78814	chr17	10197601	10199489	1888	944.0	
78815	chr17	10205790	10205797	7	4.0	
78816	chr17	10226813	10227296	483	242.0	
78817	chr17	10295757	10296120	363	182.0	
78818	chr17	10317242	10317650	408	204.0	
78819	chr17	10327553	10327968	415	208.0	
78820	chr17	10616459	10616989	530	265.0	
78821	chr17	10618065	10618558	493	246.0	
78822	chr17	10631150	10631154	4	2.0	
78823	chr17	10633813	10634170	357	178.0	
78824	chr17	10646358	10646830	472	236.0	
78825	chr17	10652971	10653371	400	200.0	
78826	chr17	10696557	10698652	2095	1048.0	
78827	chr17	10699787	10700290	503	252.0	
78828	chr17	10729211	10730633	1422	711.0	
78829	chr17	10737063	10737545	482	241.0	
78830	chr17	10744375	10744821	446	223.0	
78831	chr17	10772591	10772616	25	12.0	
78832	chr17	10792149	10792455	306	153.0	
78833	chr17	10844871	10845572	701	350.0	
78834	chr17	11996560	11998238	1678	839.0	
78835	chr17	11999628	12000202	574	287.0	
78836	chr17	12020128	12022011	1883	942.0	
78837	chr17	12031246	12031350	104	52.0	
78838	chr17	12815923	12815993	70	35.0	
78839	chr17	12982034	12982863	829	414.0	
78840	chr17	13003050	13003733	683	342.0	
78841	chr17	13017173	13018928	1755	878.0	
78842	chr17	13024166	13025415	1249	624.0	
78843	chr17	13030379	13031027	648	324.0	
78844	chr17	13031556	13032447	891	446.0	
78845	chr17	13385345	13386038	693	346.0	
78846	chr17	13420488	13421206	718	359.0	
78847	chr17	13594716	13595191	475	238.0	
78848	chr17	13597768	13598138	370	185.0	
78849	chr17	13601751	13601753	2	1.0	
78850	chr17	13862405	13862720	315	158.0	
78851	chr17	13917405	13918060	655	328.0	
78852	chr17	13920480	13920851	371	186.0	
78853	chr17	13930910	13932306	1396	698.0	
78854	chr17	14048369	14048408	39	20.0	
78855	chr17	14068823	14070166	1343	672.0	
78856	chr17	14193070	14193259	189	94.0	recombination_feature
78857	chr17	14196504	14198209	1705	852.0	
78858	chr17	14199906	14199927	21	10.0	
78859	chr17	14200643	14204538	3895	1948.0	
78860	chr17	14205440	14206889	1449	724.0	
78861	chr17	14211791	14212192	401	200.0	
78862	chr17	14294917	14295253	336	168.0	
78863	chr17	14297098	14304217	7119	3560.0	
78864	chr17	14305109	14305510	401	200.0	
78865	chr17	14308839	14310017	1178	589.0	
78866	chr17	14311946	14312465	519	260.0	
78867	chr17	14318787	14319220	433	216.0	
78868	chr17	14330116	14330708	592	296.0	
78869	chr17	14334266	14335287	1021	510.0	
78870	chr17	14351328	14353517	2189	1094.0	
78871	chr17	14356671	14357064	393	196.0	
78872	chr17	14359013	14360121	1108	554.0	
78873	chr17	14404324	14404949	625	312.0	
78874	chr17	14427938	14429398	1460	730.0	
78875	chr17	14557523	14557839	316	158.0	
78876	chr17	14604584	14605764	1180	590.0	
78877	chr17	14621834	14622235	401	200.0	
78878	chr17	14672868	14673271	403	202.0	
78879	chr17	14693482	14693508	26	13.0	
78880	chr17	14712517	14713121	604	302.0	
78881	chr17	14733367	14733703	336	168.0	
78882	chr17	14737848	14738845	997	498.0	
78883	chr17	14745090	14745489	399	200.0	
78884	chr17	14747478	14747590	112	56.0	
78885	chr17	14748266	14748706	440	220.0	
78886	chr17	14813681	14814023	342	171.0	
78887	chr17	14926532	14926930	398	199.0	
78888	chr17	15171442	15171743	301	150.0	
78889	chr17	15233041	15233411	370	185.0	
78890	chr17	15236246	15236902	656	328.0	
78891	chr17	15237929	15239040	1111	556.0	
78892	chr17	15250459	15250860	401	200.0	
78893	chr17	15257229	15257879	650	325.0	
78894	chr17	15260377	15261656	1279	640.0	
78895	chr17	15262346	15263105	759	380.0	
78896	chr17	15341530	15341786	256	128.0	
78897	chr17	15436718	15437201	483	242.0	
78898	chr17	15440449	15440773	324	162.0	
78899	chr17	15502492	15503231	739	370.0	
78900	chr17	15563029	15564082	1053	526.0	
78901	chr17	15651236	15652205	969	484.0	
78902	chr17	15683694	15684771	1077	538.0	
78903	chr17	15699084	15700127	1043	522.0	
78904	chr17	15828661	15829208	547	274.0	
78905	chr17	15831122	15831829	707	354.0	
78906	chr17	15849023	15849506	483	242.0	
78907	chr17	15883576	15884364	788	394.0	
78908	chr17	15886832	15887186	354	177.0	
78909	chr17	15897569	15897970	401	200.0	
78910	chr17	15914326	15915257	931	466.0	
78911	chr17	15920726	15921063	337	168.0	
78912	chr17	15927851	15928804	953	476.0	
78913	chr17	15942284	15942956	672	336.0	
78914	chr17	15944262	15946213	1951	976.0	
78915	chr17	15958511	15959792	1281	640.0	
78916	chr17	15966048	15967315	1267	634.0	
78917	chr17	15981174	15981530	356	178.0	
78918	chr17	15993887	15994181	294	147.0	
78919	chr17	15997953	16002059	4106	2053.0	
78920	chr17	16007710	16008036	326	163.0	
78921	chr17	16011070	16011965	895	448.0	
78922	chr17	16019454	16019817	363	182.0	
78923	chr17	16021366	16021553	187	94.0	
78924	chr17	16028040	16028539	499	250.0	
78925	chr17	16199139	16199513	374	187.0	
78926	chr17	16202792	16203266	474	237.0	
78927	chr17	16213552	16213730	178	89.0	
78928	chr17	16214423	16218033	3610	1805.0	
78929	chr17	16229479	16229996	517	258.0	
78930	chr17	16267704	16268728	1024	512.0	
78931	chr17	16285673	16288242	2569	1284.0	
78932	chr17	16304811	16305065	254	127.0	
78933	chr17	16352182	16354017	1835	918.0	
78934	chr17	16363671	16364358	687	344.0	
78935	chr17	16380113	16387599	7486	3743.0	
78936	chr17	16406927	16408726	1799	900.0	
78937	chr17	16414715	16417391	2676	1338.0	
78938	chr17	16418975	16420412	1437	718.0	
78939	chr17	16428038	16428507	469	234.0	
78940	chr17	16438089	16440495	2406	1203.0	
78941	chr17	16442331	16443184	853	426.0	
78942	chr17	16452950	16453851	901	450.0	
78943	chr17	16491228	16492742	1514	757.0	
78944	chr17	16511968	16512333	365	182.0	
78945	chr17	16513839	16514405	566	283.0	
78946	chr17	16516076	16516235	159	80.0	
78947	chr17	16520962	16521732	770	385.0	
78948	chr17	16535237	16537491	2254	1127.0	
78949	chr17	16568560	16569888	1328	664.0	
78950	chr17	16583795	16585005	1210	605.0	
78951	chr17	16588831	16589976	1145	572.0	
78952	chr17	16653051	16654317	1266	633.0	
78953	chr17	16667026	16667654	628	314.0	
78954	chr17	16911546	16911901	355	178.0	
78955	chr17	16972244	16972249	5	2.0	
78956	chr17	16973724	16974164	440	220.0	
78957	chr17	16980820	16981706	886	443.0	
78958	chr17	16987214	16989993	2779	1390.0	
78959	chr17	16991123	16991983	860	430.0	
78960	chr17	17001517	17002394	877	438.0	
78961	chr17	17016230	17017003	773	386.0	
78962	chr17	17036323	17037129	806	403.0	
78963	chr17	17041255	17044144	2889	1444.0	
78964	chr17	17044808	17046044	1236	618.0	
78965	chr17	17052590	17053039	449	224.0	
78966	chr17	17062890	17064236	1346	673.0	
78967	chr17	17092143	17092413	270	135.0	
78968	chr17	17109245	17110926	1681	840.0	
78969	chr17	17119149	17121534	2385	1192.0	
78970	chr17	17125099	17127515	2416	1208.0	
78971	chr17	17141821	17142300	479	240.0	
78972	chr17	17146704	17147063	359	180.0	
78973	chr17	17149833	17150819	986	493.0	
78974	chr17	17151878	17152490	612	306.0	
78975	chr17	17172989	17173359	370	185.0	
78976	chr17	17175883	17176706	823	412.0	
78977	chr17	17177208	17177359	151	76.0	
78978	chr17	17179293	17180504	1211	606.0	
78979	chr17	17181664	17182986	1322	661.0	
78980	chr17	17186209	17186279	70	35.0	
78981	chr17	17192682	17192909	227	114.0	
78982	chr17	17203944	17208413	4469	2234.0	
78983	chr17	17235500	17238305	2805	1402.0	
78984	chr17	17270004	17270100	96	48.0	
78985	chr17	17275889	17276807	918	459.0	
78986	chr17	17279298	17279462	164	82.0	
78987	chr17	17280125	17281968	1843	922.0	
78988	chr17	17300554	17301447	893	446.0	
78989	chr17	17302828	17306054	3226	1613.0	
78990	chr17	17306564	17306898	334	167.0	
78991	chr17	17308481	17308817	336	168.0	
78992	chr17	17313371	17314072	701	350.0	
78993	chr17	17354677	17356695	2018	1009.0	
78994	chr17	17363411	17364293	882	441.0	
78995	chr17	17391416	17392694	1278	639.0	
78996	chr17	17403575	17404594	1019	510.0	
78997	chr17	17408379	17408965	586	293.0	
78998	chr17	17415966	17416828	862	431.0	
78999	chr17	17433088	17433723	635	318.0	
79000	chr17	17439924	17440435	511	256.0	
79001	chr17	17476182	17477599	1417	708.0	
79002	chr17	17493678	17494005	327	164.0	
79003	chr17	17494773	17497461	2688	1344.0	
79004	chr17	17561600	17562258	658	329.0	
79005	chr17	17568706	17569106	400	200.0	
79006	chr17	17590671	17593478	2807	1404.0	
79007	chr17	17613443	17614123	680	340.0	
79008	chr17	17621132	17621720	588	294.0	
79009	chr17	17628447	17629128	681	340.0	
79010	chr17	17632618	17633033	415	208.0	
79011	chr17	17635896	17636359	463	232.0	
79012	chr17	17639531	17640311	780	390.0	
79013	chr17	17641559	17642411	852	426.0	
79014	chr17	17662828	17664162	1334	667.0	
79015	chr17	17672381	17672960	579	290.0	
79016	chr17	17676031	17676715	684	342.0	
79017	chr17	17680785	17683637	2852	1426.0	
79018	chr17	17690276	17690725	449	224.0	
79019	chr17	17691630	17692218	588	294.0	
79020	chr17	17692766	17695826	3060	1530.0	
79021	chr17	17712364	17712976	612	306.0	
79022	chr17	17714371	17714917	546	273.0	
79023	chr17	17722509	17725026	2517	1258.0	
79024	chr17	17726271	17726650	379	190.0	
79025	chr17	17729584	17730098	514	257.0	
79026	chr17	17734901	17735184	283	142.0	
79027	chr17	17738175	17738841	666	333.0	
79028	chr17	17740776	17741325	549	274.0	
79029	chr17	17749176	17754349	5173	2586.0	
79030	chr17	17757186	17758439	1253	626.0	
79031	chr17	17766212	17766695	483	242.0	
79032	chr17	17781029	17785210	4181	2090.0	
79033	chr17	17792152	17793566	1414	707.0	
79034	chr17	17808941	17809551	610	305.0	
79035	chr17	17811819	17814276	2457	1228.0	
79036	chr17	17815089	17815608	519	260.0	
79037	chr17	17818011	17818417	406	203.0	
79038	chr17	17819400	17821324	1924	962.0	
79039	chr17	17822413	17827966	5553	2776.0	
79040	chr17	17830748	17830967	219	110.0	
79041	chr17	17834046	17842369	8323	4162.0	
79042	chr17	17848644	17851766	3122	1561.0	
79043	chr17	17859930	17860829	899	450.0	
79044	chr17	17890985	17891446	461	230.0	
79045	chr17	17900757	17901002	245	122.0	
79046	chr17	17919123	17919599	476	238.0	
79047	chr17	17924949	17925147	198	99.0	
79048	chr17	17934818	17936207	1389	694.0	
79049	chr17	17957851	17960440	2589	1294.0	
79050	chr17	17971296	17973475	2179	1090.0	
79051	chr17	17975338	17976148	810	405.0	
79052	chr17	17978805	17979329	524	262.0	
79053	chr17	17994336	17994666	330	165.0	
79054	chr17	18025323	18026832	1509	754.0	
79055	chr17	18033095	18034152	1057	528.0	
79056	chr17	18036432	18036644	212	106.0	
79057	chr17	18037345	18040714	3369	1684.0	
79058	chr17	18071171	18071314	143	72.0	
79059	chr17	18087280	18089199	1919	960.0	
79060	chr17	18089969	18090030	61	30.0	
79061	chr17	18102799	18102926	127	64.0	
79062	chr17	18139979	18140127	148	74.0	
79063	chr17	18140996	18141852	856	428.0	
79064	chr17	18153471	18154604	1133	566.0	
79065	chr17	18156405	18158873	2468	1234.0	
79066	chr17	18176083	18176643	560	280.0	
79067	chr17	18182145	18188794	6649	3324.0	
79068	chr17	18190855	18192354	1499	750.0	
79069	chr17	18210836	18210870	34	17.0	
79070	chr17	18212432	18212876	444	222.0	
79071	chr17	18217190	18218957	1767	884.0	
79072	chr17	18224685	18226719	2034	1017.0	
79073	chr17	18242521	18242676	155	78.0	
79074	chr17	18247244	18248851	1607	804.0	
79075	chr17	18257216	18259263	2047	1024.0	
79076	chr17	18259982	18261795	1813	906.0	
79077	chr17	18296792	18297637	845	422.0	
79078	chr17	18300701	18301768	1067	534.0	
79079	chr17	18313961	18316310	2349	1174.0	
79080	chr17	18317842	18318568	726	363.0	
79081	chr17	18319822	18320235	413	206.0	
79082	chr17	18321300	18321701	401	200.0	
79083	chr17	18325415	18325885	470	235.0	
79084	chr17	18332154	18332170	16	8.0	
79085	chr17	18356598	18356984	386	193.0	
79086	chr17	18362685	18364018	1333	666.0	
79087	chr17	18377308	18377913	605	302.0	
79088	chr17	18382898	18383547	649	324.0	
79089	chr17	18408857	18409465	608	304.0	
79090	chr17	18411493	18411895	402	201.0	
79091	chr17	18474770	18475149	379	190.0	
79092	chr17	18476503	18477256	753	376.0	
79093	chr17	18563504	18564531	1027	514.0	
79094	chr17	18625026	18626365	1339	670.0	
79095	chr17	18681843	18682751	908	454.0	
79096	chr17	18697547	18698612	1065	532.0	
79097	chr17	18712365	18712768	403	202.0	
79098	chr17	18751068	18751406	338	169.0	
79099	chr17	18780737	18781861	1124	562.0	
79100	chr17	18816731	18817208	477	238.0	
79101	chr17	18818000	18818307	307	154.0	
79102	chr17	18850019	18850209	190	95.0	
79103	chr17	18855625	18856912	1287	644.0	
79104	chr17	18857456	18859027	1571	786.0	
79105	chr17	18860555	18860905	350	175.0	
79106	chr17	18900508	18901628	1120	560.0	
79107	chr17	18922046	18922357	311	156.0	
79108	chr17	18925306	18925487	181	90.0	
79109	chr17	18932609	18933896	1287	644.0	
79110	chr17	18955467	18956080	613	306.0	
79111	chr17	18960587	18961389	802	401.0	
79112	chr17	18992419	18993552	1133	566.0	
79113	chr17	19002594	19006272	3678	1839.0	
79114	chr17	19021489	19021979	490	245.0	
79115	chr17	19031777	19032067	290	145.0	
79116	chr17	19062102	19062385	283	142.0	
79117	chr17	19063219	19064620	1401	700.0	
79118	chr17	19076462	19076825	363	182.0	
79119	chr17	19110909	19112588	1679	840.0	
79120	chr17	19237072	19238399	1327	664.0	
79121	chr17	19270911	19271435	524	262.0	
79122	chr17	19279300	19279574	274	137.0	
79123	chr17	19284483	19284889	406	203.0	
79124	chr17	19302756	19304782	2026	1013.0	
79125	chr17	19306010	19306972	962	481.0	
79126	chr17	19311709	19312291	582	291.0	
79127	chr17	19337985	19338535	550	275.0	
79128	chr17	19361976	19363678	1702	851.0	
79129	chr17	19369472	19372312	2840	1420.0	
79130	chr17	19373090	19373540	450	225.0	
79131	chr17	19377025	19379768	2743	1372.0	
79132	chr17	19384629	19385356	727	364.0	
79133	chr17	19386089	19387296	1207	604.0	
79134	chr17	19388861	19389592	731	366.0	
79135	chr17	19398119	19399074	955	478.0	
79136	chr17	19418678	19419142	464	232.0	
79137	chr17	19446967	19447698	731	366.0	
79138	chr17	19462475	19464180	1705	852.0	
79139	chr17	19469331	19469742	411	206.0	
79140	chr17	19502420	19502922	502	251.0	
79141	chr17	19507141	19508906	1765	882.0	
79142	chr17	19513785	19514356	571	286.0	
79143	chr17	19519824	19520440	616	308.0	
79144	chr17	19521333	19521861	528	264.0	
79145	chr17	19533285	19534476	1191	596.0	
79146	chr17	19544852	19545360	508	254.0	
79147	chr17	19546670	19547152	482	241.0	
79148	chr17	19569791	19570014	223	112.0	
79149	chr17	19579930	19580130	200	100.0	
79150	chr17	19610892	19611336	444	222.0	
79151	chr17	19645790	19646490	700	350.0	
79152	chr17	19647302	19649499	2197	1098.0	
79153	chr17	19724191	19725893	1702	851.0	
79154	chr17	19744534	19745363	829	414.0	
79155	chr17	19752862	19753484	622	311.0	
79156	chr17	19762444	19762927	483	242.0	
79157	chr17	19766250	19766955	705	352.0	
79158	chr17	19771777	19772681	904	452.0	
79159	chr17	19866646	19868370	1724	862.0	
79160	chr17	19870138	19870602	464	232.0	
79161	chr17	19873359	19873795	436	218.0	
79162	chr17	19875961	19877389	1428	714.0	
79163	chr17	19904974	19905888	914	457.0	
79164	chr17	19923286	19923716	430	215.0	
79165	chr17	19972136	19972471	335	168.0	
79166	chr17	19976834	19979303	2469	1234.0	
79167	chr17	19980094	19980811	717	358.0	
79168	chr17	19992644	19993414	770	385.0	
79169	chr17	20008447	20010693	2246	1123.0	
79170	chr17	20026710	20027326	616	308.0	
79171	chr17	20032641	20033799	1158	579.0	
79172	chr17	20043055	20043432	377	188.0	
79173	chr17	20053552	20053717	165	82.0	
79174	chr17	20059670	20060157	487	244.0	
79175	chr17	20063732	20064667	935	468.0	
79176	chr17	20067823	20068095	272	136.0	
79177	chr17	20072800	20074961	2161	1080.0	
79178	chr17	20116596	20117269	673	336.0	
79179	chr17	20121529	20122873	1344	672.0	
79180	chr17	20154639	20156956	2317	1158.0	
79181	chr17	20185016	20185449	433	216.0	
79182	chr17	20226677	20227212	535	268.0	
79183	chr17	20234206	20234705	499	250.0	
79184	chr17	20254287	20254460	173	86.0	
79185	chr17	20267418	20267903	485	242.0	
79186	chr17	20271188	20271508	320	160.0	
79187	chr17	20280664	20282396	1732	866.0	
79188	chr17	20307244	20307808	564	282.0	
79189	chr17	20320483	20321305	822	411.0	
79190	chr17	20381300	20381850	550	275.0	
79191	chr17	20531929	20532291	362	181.0	
79192	chr17	20646687	20647020	333	166.0	
79193	chr17	20649183	20649514	331	166.0	
79194	chr17	20677432	20677914	482	241.0	
79195	chr17	20698528	20699340	812	406.0	
79196	chr17	20702609	20703118	509	254.0	
79197	chr17	20797415	20797446	31	16.0	
79198	chr17	20801842	20801941	99	50.0	
79199	chr17	20840898	20841286	388	194.0	
79200	chr17	20843732	20844245	513	256.0	
79201	chr17	20852697	20852831	134	67.0	
79202	chr17	20896154	20896477	323	162.0	
79203	chr17	20908060	20909110	1050	525.0	
79204	chr17	20944298	20944596	298	149.0	
79205	chr17	20992823	20993487	664	332.0	
79206	chr17	21001137	21001228	91	46.0	
79207	chr17	21020147	21020842	695	348.0	
79208	chr17	21024242	21024339	97	48.0	
79209	chr17	21029068	21029427	359	180.0	
79210	chr17	21033702	21036757	3055	1528.0	
79211	chr17	21040119	21044334	4215	2108.0	
79212	chr17	21051631	21052397	766	383.0	
79213	chr17	21098818	21100143	1325	662.0	
79214	chr17	21112988	21114035	1047	524.0	
79215	chr17	21119528	21120235	707	354.0	
79216	chr17	21124029	21124504	475	238.0	
79217	chr17	21125772	21128054	2282	1141.0	
79218	chr17	21131033	21131618	585	292.0	
79219	chr17	21132402	21132835	433	216.0	
79220	chr17	21141019	21141270	251	126.0	
79221	chr17	21146634	21146745	111	56.0	
79222	chr17	21152744	21153092	348	174.0	
79223	chr17	21171354	21171858	504	252.0	
79224	chr17	21186357	21186767	410	205.0	
79225	chr17	21191908	21192305	397	198.0	
79226	chr17	21210624	21211129	505	252.0	
79227	chr17	21213310	21215601	2291	1146.0	
79228	chr17	21220226	21220323	97	48.0	
79229	chr17	21225850	21226196	346	173.0	
79230	chr17	21239651	21241122	1471	736.0	
79231	chr17	21242793	21243952	1159	580.0	
79232	chr17	21248300	21248888	588	294.0	
79233	chr17	21249817	21254150	4333	2166.0	
79234	chr17	21267790	21268749	959	480.0	
79235	chr17	21275063	21276680	1617	808.0	
79236	chr17	21278219	21282228	4009	2004.0	
79237	chr17	21283438	21307666	24228	12114.0	
79238	chr17	21308298	21309232	934	467.0	
79239	chr17	21310380	21311824	1444	722.0	
79240	chr17	21312987	21320203	7216	3608.0	
79241	chr17	21321211	21324059	2848	1424.0	
79242	chr17	21325431	21325922	491	246.0	
79243	chr17	21327939	21328583	644	322.0	
79244	chr17	21334950	21335078	128	64.0	
79245	chr17	21337572	21338437	865	432.0	
79246	chr17	21340442	21340449	7	4.0	
79247	chr17	21342290	21342613	323	162.0	
79248	chr17	21347032	21349085	2053	1026.0	
79249	chr17	21350551	21350978	427	214.0	
79250	chr17	21400300	21400525	225	112.0	
79251	chr17	21403662	21407385	3723	1862.0	
79252	chr17	21408266	21408569	303	152.0	
79253	chr17	21409693	21409694	1	0.0	
79254	chr17	21410622	21410677	55	28.0	
79255	chr17	21411846	21412290	444	222.0	
79256	chr17	21415985	21416206	221	110.0	
79257	chr17	21417026	21417846	820	410.0	
79258	chr17	21419073	21421289	2216	1108.0	
79259	chr17	21423284	21423635	351	176.0	
79260	chr17	21452258	21452883	625	312.0	
79261	chr17	21456715	21457907	1192	596.0	
79262	chr17	21463049	21463727	678	339.0	
79263	chr17	21507975	21508317	342	171.0	
79264	chr17	21510935	21513449	2514	1257.0	
79265	chr17	21517833	21517937	104	52.0	
79266	chr17	21533128	21533304	176	88.0	
79267	chr17	21542964	21543395	431	216.0	
79268	chr17	21550901	21552151	1250	625.0	
79269	chr17	21574042	21574763	721	360.0	
79270	chr17	22402021	22402588	567	284.0	
79271	chr17	22405331	22407563	2232	1116.0	
79272	chr17	22521164	22521675	511	256.0	
79273	chr17	22752659	22753102	443	222.0	
79274	chr17	22753651	22754077	426	213.0	
79275	chr17	22760521	22760969	448	224.0	
79276	chr17	22761708	22762503	795	398.0	
79277	chr17	26935988	26941093	5105	2552.0	
79278	chr17	27181592	27181901	309	154.0	
79279	chr17	27197521	27197944	423	212.0	
79280	chr17	27206506	27207581	1075	538.0	
79281	chr17	27216548	27218215	1667	834.0	
79282	chr17	27219038	27219420	382	191.0	
79283	chr17	27233522	27234225	703	352.0	
79284	chr17	27236647	27237287	640	320.0	
79285	chr17	27238951	27239527	576	288.0	
79286	chr17	27241284	27241878	594	297.0	
79287	chr17	27244007	27245841	1834	917.0	
79288	chr17	27247402	27247766	364	182.0	
79289	chr17	27264310	27264845	535	268.0	
79290	chr17	27281442	27283568	2126	1063.0	
79291	chr17	27293246	27297940	4694	2347.0	
79292	chr17	27299184	27301194	2010	1005.0	
79293	chr17	27314344	27317173	2829	1414.0	
79294	chr17	27317869	27325665	7796	3898.0	
79295	chr17	27326353	27326357	4	2.0	
79296	chr17	27329292	27329669	377	188.0	
79297	chr17	27331935	27333825	1890	945.0	
79298	chr17	27336149	27336711	562	281.0	
79299	chr17	27342135	27342226	91	46.0	
79300	chr17	27348640	27349873	1233	616.0	
79301	chr17	27352414	27352418	4	2.0	
79302	chr17	27353101	27354839	1738	869.0	
79303	chr17	27367385	27368462	1077	538.0	
79304	chr17	27380260	27381537	1277	638.0	
79305	chr17	27388080	27388529	449	224.0	
79306	chr17	27413264	27414629	1365	682.0	
79307	chr17	27430872	27431315	443	222.0	
79308	chr17	27454146	27458055	3909	1954.0	
79309	chr17	27466236	27467200	964	482.0	
79310	chr17	27471466	27475453	3987	1994.0	
79311	chr17	27481303	27481796	493	246.0	
79312	chr17	27486656	27487164	508	254.0	
79313	chr17	27488188	27489585	1397	698.0	
79314	chr17	27494458	27495128	670	335.0	
79315	chr17	27526305	27527076	771	386.0	
79316	chr17	27529064	27529762	698	349.0	
79317	chr17	27530751	27533377	2626	1313.0	
79318	chr17	27540173	27541222	1049	524.0	
79319	chr17	27544262	27545228	966	483.0	
79320	chr17	27559139	27559821	682	341.0	
79321	chr17	27568900	27569735	835	418.0	
79322	chr17	27599766	27600281	515	258.0	
79323	chr17	27601483	27602161	678	339.0	
79324	chr17	27603072	27603592	520	260.0	
79325	chr17	27609631	27609929	298	149.0	
79326	chr17	27630719	27633311	2592	1296.0	
79327	chr17	27635362	27635911	549	274.0	
79328	chr17	27651167	27652040	873	436.0	
79329	chr17	27654455	27655304	849	424.0	
79330	chr17	27743248	27743726	478	239.0	
79331	chr17	27756704	27757149	445	222.0	
79332	chr17	27759915	27760622	707	354.0	
79333	chr17	27782921	27783171	250	125.0	
79334	chr17	27793733	27793846	113	56.0	
79335	chr17	27805223	27806337	1114	557.0	
79336	chr17	27807722	27808997	1275	638.0	
79337	chr17	27810361	27810574	213	106.0	
79338	chr17	27845938	27846923	985	492.0	
79339	chr17	27879965	27880457	492	246.0	
79340	chr17	27892660	27894457	1797	898.0	
79341	chr17	28040479	28042386	1907	954.0	
79342	chr17	28043544	28043625	81	40.0	
79343	chr17	28057895	28058350	455	228.0	
79344	chr17	28065808	28066090	282	141.0	
79345	chr17	28071943	28072057	114	57.0	
79346	chr17	28078846	28079141	295	148.0	
79347	chr17	28097965	28097993	28	14.0	
79348	chr17	28118307	28118820	513	256.0	
79349	chr17	28174599	28175059	460	230.0	
79350	chr17	28193129	28193576	447	224.0	
79351	chr17	28227359	28227957	598	299.0	
79352	chr17	28251140	28252072	932	466.0	
79353	chr17	28278124	28278960	836	418.0	
79354	chr17	28294048	28294396	348	174.0	
79355	chr17	28318029	28319876	1847	924.0	
79356	chr17	28324850	28324893	43	22.0	
79357	chr17	28333675	28336714	3039	1520.0	
79358	chr17	28356724	28358244	1520	760.0	
79359	chr17	28369719	28372725	3006	1503.0	
79360	chr17	28381546	28381694	148	74.0	
79361	chr17	28384143	28385820	1677	838.0	
79362	chr17	28403976	28404358	382	191.0	
79363	chr17	28405556	28406612	1056	528.0	
79364	chr17	28416753	28417250	497	248.0	
79365	chr17	28475444	28475744	300	150.0	
79366	chr17	28494470	28495316	846	423.0	
79367	chr17	28501015	28501238	223	112.0	
79368	chr17	28509814	28510247	433	216.0	
79369	chr17	28518103	28518573	470	235.0	
79370	chr17	28540614	28541114	500	250.0	
79371	chr17	28547371	28553182	5811	2906.0	
79372	chr17	28567492	28568068	576	288.0	
79373	chr17	28570566	28572781	2215	1108.0	
79374	chr17	28574171	28574867	696	348.0	
79375	chr17	28575608	28577662	2054	1027.0	
79376	chr17	28597589	28600278	2689	1344.0	
79377	chr17	28612519	28613865	1346	673.0	
79378	chr17	28643863	28647527	3664	1832.0	
79379	chr17	28660072	28660426	354	177.0	
79380	chr17	28661266	28663635	2369	1184.0	
79381	chr17	28666247	28666252	5	2.0	
79382	chr17	28710428	28712929	2501	1250.0	
79383	chr17	28714601	28714603	2	1.0	
79384	chr17	28717062	28721104	4042	2021.0	
79385	chr17	28721728	28722363	635	318.0	
79386	chr17	28724376	28729697	5321	2660.0	
79387	chr17	28737855	28739185	1330	665.0	
79388	chr17	28741081	28742305	1224	612.0	
79389	chr17	28743113	28750807	7694	3847.0	
79390	chr17	28752416	28752790	374	187.0	
79391	chr17	28761166	28761661	495	248.0	
79392	chr17	28763456	28764348	892	446.0	
79393	chr17	28793278	28793679	401	200.0	
79394	chr17	28811495	28813322	1827	914.0	
79395	chr17	28841978	28843374	1396	698.0	
79396	chr17	28848622	28849114	492	246.0	
79397	chr17	28854289	28855508	1219	610.0	
79398	chr17	28865884	28866285	401	200.0	
79399	chr17	28871093	28871634	541	270.0	
79400	chr17	28892803	28894672	1869	934.0	
79401	chr17	28895945	28898502	2557	1278.0	
79402	chr17	28902011	28903762	1751	876.0	
79403	chr17	28916132	28916818	686	343.0	
79404	chr17	28923648	28924124	476	238.0	
79405	chr17	28924982	28927368	2386	1193.0	
79406	chr17	28928015	28928374	359	180.0	
79407	chr17	28937361	28937770	409	204.0	
79408	chr17	28940196	28940492	296	148.0	
79409	chr17	28947539	28954094	6555	3278.0	
79410	chr17	28965363	28966065	702	351.0	
79411	chr17	28967134	28967982	848	424.0	
79412	chr17	28981561	28984200	2639	1320.0	
79413	chr17	28988657	28988977	320	160.0	
79414	chr17	29005666	29006329	663	332.0	
79415	chr17	29031498	29031873	375	188.0	
79416	chr17	29041606	29041868	262	131.0	
79417	chr17	29042378	29043854	1476	738.0	
79418	chr17	29046374	29046527	153	76.0	
79419	chr17	29074480	29074971	491	246.0	
79420	chr17	29107072	29107626	554	277.0	
79421	chr17	29111645	29112289	644	322.0	
79422	chr17	29115846	29117915	2069	1034.0	
79423	chr17	29123988	29124691	703	352.0	
79424	chr17	29126254	29127033	779	390.0	
79425	chr17	29131984	29132070	86	43.0	
79426	chr17	29138174	29141918	3744	1872.0	
79427	chr17	29143845	29144346	501	250.0	
79428	chr17	29145101	29146109	1008	504.0	
79429	chr17	29148239	29150697	2458	1229.0	
79430	chr17	29154517	29156049	1532	766.0	
79431	chr17	29159378	29159756	378	189.0	
79432	chr17	29176180	29177689	1509	754.0	
79433	chr17	29179663	29181402	1739	870.0	
79434	chr17	29195278	29197664	2386	1193.0	
79435	chr17	29200125	29200622	497	248.0	
79436	chr17	29213189	29213375	186	93.0	
79437	chr17	29214113	29214690	577	288.0	
79438	chr17	29219291	29219924	633	316.0	
79439	chr17	29234954	29235403	449	224.0	
79440	chr17	29237820	29238474	654	327.0	
79441	chr17	29240773	29241743	970	485.0	
79442	chr17	29247085	29247086	1	0.0	
79443	chr17	29251182	29251479	297	148.0	
79444	chr17	29252001	29252643	642	321.0	
79445	chr17	29254612	29256570	1958	979.0	
79446	chr17	29257668	29258196	528	264.0	
79447	chr17	29258936	29261811	2875	1438.0	
79448	chr17	29263784	29264066	282	141.0	
79449	chr17	29264631	29264653	22	11.0	
79450	chr17	29265904	29268370	2466	1233.0	
79451	chr17	29269158	29270392	1234	617.0	
79452	chr17	29271012	29282422	11410	5705.0	
79453	chr17	29283012	29285391	2379	1190.0	
79454	chr17	29285981	29288282	2301	1150.0	
79455	chr17	29288893	29295289	6396	3198.0	
79456	chr17	29302023	29302386	363	182.0	
79457	chr17	29341691	29342484	793	396.0	
79458	chr17	29348048	29348369	321	160.0	
79459	chr17	29369606	29370727	1121	560.0	
79460	chr17	29389625	29391872	2247	1124.0	
79461	chr17	29393687	29393744	57	28.0	
79462	chr17	29401187	29401728	541	270.0	
79463	chr17	29458955	29459260	305	152.0	
79464	chr17	29536926	29537429	503	252.0	
79465	chr17	29557736	29558120	384	192.0	
79466	chr17	29560245	29560907	662	331.0	
79467	chr17	29561778	29562437	659	330.0	
79468	chr17	29563831	29564287	456	228.0	
79469	chr17	29565617	29569783	4166	2083.0	
79470	chr17	29572319	29573415	1096	548.0	
79471	chr17	29580071	29580960	889	444.0	
79472	chr17	29584679	29585627	948	474.0	
79473	chr17	29586610	29594576	7966	3983.0	
79474	chr17	29608863	29609063	200	100.0	
79475	chr17	29611173	29611797	624	312.0	
79476	chr17	29612890	29619432	6542	3271.0	
79477	chr17	29622024	29625451	3427	1714.0	
79478	chr17	29627380	29628082	702	351.0	
79479	chr17	29628593	29628762	169	84.0	
79480	chr17	29639087	29640079	992	496.0	
79481	chr17	29665331	29665770	439	220.0	
79482	chr17	29681980	29682729	749	374.0	
79483	chr17	29692196	29692503	307	154.0	
79484	chr17	29695211	29695612	401	200.0	
79485	chr17	29705051	29707616	2565	1282.0	
79486	chr17	29713713	29714016	303	152.0	
79487	chr17	29716618	29716899	281	140.0	
79488	chr17	29722037	29724318	2281	1140.0	
79489	chr17	29726594	29727453	859	430.0	
79490	chr17	29741883	29742549	666	333.0	
79491	chr17	29744686	29744849	163	82.0	
79492	chr17	29757754	29758283	529	264.0	
79493	chr17	29759293	29759362	69	34.0	
79494	chr17	29760043	29762167	2124	1062.0	
79495	chr17	29772151	29772328	177	88.0	
79496	chr17	29779018	29779894	876	438.0	
79497	chr17	29789356	29789442	86	43.0	
79498	chr17	29807549	29808653	1104	552.0	
79499	chr17	29849969	29850576	607	304.0	
79500	chr17	29854475	29854710	235	118.0	
79501	chr17	29860193	29860621	428	214.0	
79502	chr17	29884927	29885463	536	268.0	
79503	chr17	29928939	29932152	3213	1606.0	
79504	chr17	29948418	29948879	461	230.0	
79505	chr17	29956240	29956725	485	242.0	
79506	chr17	30021682	30022131	449	224.0	
79507	chr17	30026736	30027045	309	154.0	
79508	chr17	30040575	30041209	634	317.0	
79509	chr17	30093431	30094137	706	353.0	
79510	chr17	30095694	30096081	387	194.0	
79511	chr17	30104290	30105304	1014	507.0	
79512	chr17	30116274	30117845	1571	786.0	
79513	chr17	30121731	30122225	494	247.0	
79514	chr17	30125198	30125872	674	337.0	
79515	chr17	30229855	30230465	610	305.0	
79516	chr17	30235673	30236020	347	174.0	
79517	chr17	30236778	30237188	410	205.0	
79518	chr17	30290876	30292829	1953	976.0	
79519	chr17	30300833	30301240	407	204.0	
79520	chr17	30316729	30317111	382	191.0	
79521	chr17	30323185	30324398	1213	606.0	
79522	chr17	30331959	30332817	858	429.0	
79523	chr17	30336294	30337068	774	387.0	
79524	chr17	30337636	30338627	991	496.0	
79525	chr17	30340011	30340713	702	351.0	
79526	chr17	30344477	30345364	887	444.0	
79527	chr17	30350529	30352712	2183	1092.0	
79528	chr17	30360062	30360855	793	396.0	
79529	chr17	30363315	30364484	1169	584.0	
79530	chr17	30369393	30369599	206	103.0	
79531	chr17	30377938	30381380	3442	1721.0	
79532	chr17	30389704	30390271	567	284.0	
79533	chr17	30401100	30401578	478	239.0	
79534	chr17	30476666	30478253	1587	794.0	
79535	chr17	30550808	30551434	626	313.0	
79536	chr17	30564374	30564756	382	191.0	
79537	chr17	30599587	30601603	2016	1008.0	
79538	chr17	30650899	30651298	399	200.0	recombination_feature
79539	chr17	30655965	30656366	401	200.0	
79540	chr17	30668007	30668265	258	129.0	"recombination_feature	recombination_feature	sequence_feature	recombination_feature"
79541	chr17	30693702	30694202	500	250.0	
79542	chr17	30697490	30698597	1107	554.0	
79543	chr17	30705925	30706964	1039	520.0	
79544	chr17	30707582	30710531	2949	1474.0	
79545	chr17	30712214	30712700	486	243.0	
79546	chr17	30715044	30715584	540	270.0	
79547	chr17	30719082	30719913	831	416.0	
79548	chr17	30723995	30724440	445	222.0	
79549	chr17	30728194	30729218	1024	512.0	
79550	chr17	30730925	30732987	2062	1031.0	
79551	chr17	30780243	30780684	441	220.0	
79552	chr17	30805940	30806591	651	326.0	
79553	chr17	30807431	30807698	267	134.0	
79554	chr17	30808485	30809943	1458	729.0	
79555	chr17	30812513	30812941	428	214.0	
79556	chr17	30814701	30815774	1073	536.0	
79557	chr17	30818403	30818984	581	290.0	
79558	chr17	30819997	30826392	6395	3198.0	
79559	chr17	30831283	30832680	1397	698.0	
79560	chr17	30840535	30841287	752	376.0	
79561	chr17	30905609	30907100	1491	746.0	
79562	chr17	30921467	30923128	1661	830.0	
79563	chr17	30939265	30939373	108	54.0	
79564	chr17	30949590	30950023	433	216.0	
79565	chr17	30950564	30951168	604	302.0	
79566	chr17	30952701	30954993	2292	1146.0	
79567	chr17	30956805	30957150	345	172.0	
79568	chr17	30958134	30958824	690	345.0	
79569	chr17	30960058	30962189	2131	1066.0	
79570	chr17	30968081	30972955	4874	2437.0	
79571	chr17	30975005	30975554	549	274.0	
79572	chr17	31008148	31009501	1353	676.0	
79573	chr17	31021104	31021387	283	142.0	
79574	chr17	31051480	31052854	1374	687.0	
79575	chr17	31062414	31062655	241	120.0	
79576	chr17	31067623	31068755	1132	566.0	
79577	chr17	31089743	31089819	76	38.0	
79578	chr17	31094202	31096704	2502	1251.0	
79579	chr17	31158750	31159160	410	205.0	
79580	chr17	31216145	31216498	353	176.0	
79581	chr17	31225891	31226797	906	453.0	
79582	chr17	31266053	31266442	389	194.0	
79583	chr17	31274179	31274664	485	242.0	
79584	chr17	31307655	31312671	5016	2508.0	
79585	chr17	31313330	31315113	1783	892.0	
79586	chr17	31318081	31322593	4512	2256.0	
79587	chr17	31373070	31374480	1410	705.0	
79588	chr17	31389318	31389811	493	246.0	
79589	chr17	31391360	31392106	746	373.0	
79590	chr17	31399026	31399384	358	179.0	
79591	chr17	31415080	31415608	528	264.0	
79592	chr17	31433022	31433533	511	256.0	
79593	chr17	31437156	31437878	722	361.0	
79594	chr17	31451197	31452002	805	402.0	
79595	chr17	31469897	31470481	584	292.0	
79596	chr17	31486588	31495605	9017	4508.0	
79597	chr17	31507994	31510853	2859	1430.0	
79598	chr17	31524921	31525951	1030	515.0	
79599	chr17	31533594	31533994	400	200.0	
79600	chr17	31535414	31536134	720	360.0	
79601	chr17	31537723	31538553	830	415.0	
79602	chr17	31547609	31547927	318	159.0	
79603	chr17	31548810	31551054	2244	1122.0	
79604	chr17	31558283	31560057	1774	887.0	
79605	chr17	31561600	31562285	685	342.0	
79606	chr17	31568043	31568960	917	458.0	
79607	chr17	31577586	31577862	276	138.0	
79608	chr17	31580230	31582847	2617	1308.0	
79609	chr17	31584829	31585166	337	168.0	
79610	chr17	31596403	31597292	889	444.0	
79611	chr17	31654857	31655379	522	261.0	
79612	chr17	31679845	31680587	742	371.0	
79613	chr17	31715412	31715862	450	225.0	
79614	chr17	31717234	31717685	451	226.0	
79615	chr17	31802570	31802984	414	207.0	
79616	chr17	31839301	31839576	275	138.0	
79617	chr17	31842293	31842994	701	350.0	
79618	chr17	31858047	31859912	1865	932.0	
79619	chr17	31882481	31882932	451	226.0	
79620	chr17	31887939	31888601	662	331.0	
79621	chr17	31889121	31890105	984	492.0	
79622	chr17	31900869	31902362	1493	746.0	
79623	chr17	31907407	31907674	267	134.0	
79624	chr17	31917045	31917502	457	228.0	
79625	chr17	31923543	31924277	734	367.0	
79626	chr17	31936249	31938613	2364	1182.0	
79627	chr17	32006584	32009277	2693	1346.0	
79628	chr17	32062546	32062999	453	226.0	"recombination_feature	recombination_feature"
79629	chr17	32066894	32067362	468	234.0	recombination_feature
79630	chr17	32071984	32072411	427	214.0	
79631	chr17	32079663	32080321	658	329.0	
79632	chr17	32083993	32084394	401	200.0	"recombination_feature	recombination_feature	recombination_feature	recombination_feature"
79633	chr17	32104130	32104597	467	234.0	
79634	chr17	32107222	32107520	298	149.0	
79635	chr17	32111327	32111850	523	262.0	
79636	chr17	32126914	32128067	1153	576.0	
79637	chr17	32135490	32135905	415	208.0	
79638	chr17	32136823	32137141	318	159.0	
79639	chr17	32138621	32139517	896	448.0	
79640	chr17	32140928	32143841	2913	1456.0	
79641	chr17	32152100	32152634	534	267.0	
79642	chr17	32243784	32244045	261	130.0	
79643	chr17	32252954	32253672	718	359.0	
79644	chr17	32264397	32264639	242	121.0	
79645	chr17	32265357	32268239	2882	1441.0	
79646	chr17	32275044	32276621	1577	788.0	
79647	chr17	32288675	32288968	293	146.0	
79648	chr17	32318704	32319982	1278	639.0	
79649	chr17	32323706	32324356	650	325.0	
79650	chr17	32331335	32331581	246	123.0	
79651	chr17	32340802	32342676	1874	937.0	
79652	chr17	32349328	32351294	1966	983.0	
79653	chr17	32443717	32446342	2625	1312.0	
79654	chr17	32461498	32462769	1271	636.0	
79655	chr17	32483211	32490450	7239	3620.0	
79656	chr17	32491467	32493365	1898	949.0	
79657	chr17	32494441	32495120	679	340.0	
79658	chr17	32503119	32504639	1520	760.0	
79659	chr17	32507564	32508000	436	218.0	
79660	chr17	32515676	32516151	475	238.0	
79661	chr17	32517124	32517844	720	360.0	
79662	chr17	32518748	32520907	2159	1080.0	
79663	chr17	32522918	32524736	1818	909.0	
79664	chr17	32528588	32529298	710	355.0	
79665	chr17	32551155	32551624	469	234.0	
79666	chr17	32558399	32558704	305	152.0	
79667	chr17	32575919	32576254	335	168.0	
79668	chr17	32608868	32609583	715	358.0	
79669	chr17	32659272	32659743	471	236.0	
79670	chr17	32742878	32743360	482	241.0	
79671	chr17	32746631	32747135	504	252.0	
79672	chr17	32754957	32755517	560	280.0	
79673	chr17	32783504	32783966	462	231.0	
79674	chr17	32822526	32822906	380	190.0	
79675	chr17	32828408	32828654	246	123.0	
79676	chr17	32871630	32872244	614	307.0	
79677	chr17	32875927	32877984	2057	1028.0	
79678	chr17	32909862	32910335	473	236.0	
79679	chr17	32936881	32937352	471	236.0	
79680	chr17	32998324	32998693	369	184.0	
79681	chr17	33233736	33234254	518	259.0	
79682	chr17	33674653	33674987	334	167.0	
79683	chr17	33751096	33751497	401	200.0	enhancer
79684	chr17	33753515	33753786	271	136.0	
79685	chr17	33963204	33963615	411	206.0	
79686	chr17	33964179	33965012	833	416.0	
79687	chr17	33968493	33968990	497	248.0	
79688	chr17	33981853	33982056	203	102.0	
79689	chr17	34171205	34171694	489	244.0	
79690	chr17	34173303	34173444	141	70.0	
79691	chr17	34199830	34200415	585	292.0	
79692	chr17	34201138	34201683	545	272.0	
79693	chr17	34220651	34221338	687	344.0	
79694	chr17	34222707	34223202	495	248.0	
79695	chr17	34233685	34234271	586	293.0	
79696	chr17	34236540	34236803	263	132.0	
79697	chr17	34241040	34241429	389	194.0	
79698	chr17	34242321	34243200	879	440.0	
79699	chr17	34243843	34244322	479	240.0	
79700	chr17	34245423	34245665	242	121.0	
79701	chr17	34246193	34247325	1132	566.0	
79702	chr17	34248642	34249229	587	294.0	
79703	chr17	34252012	34252903	891	446.0	
79704	chr17	34254929	34255400	471	236.0	
79705	chr17	34307074	34307662	588	294.0	
79706	chr17	34308374	34308732	358	179.0	
79707	chr17	34314111	34314646	535	268.0	
79708	chr17	34318554	34319445	891	446.0	
79709	chr17	34361402	34361953	551	276.0	
79710	chr17	34365975	34366873	898	449.0	
79711	chr17	34368604	34369372	768	384.0	
79712	chr17	34370388	34371827	1439	720.0	
79713	chr17	34375495	34375752	257	128.0	
79714	chr17	34378558	34379104	546	273.0	
79715	chr17	34387088	34387691	603	302.0	
79716	chr17	34398799	34399552	753	376.0	
79717	chr17	34420233	34420714	481	240.0	
79718	chr17	34423997	34424094	97	48.0	
79719	chr17	34433993	34434728	735	368.0	
79720	chr17	34485956	34486445	489	244.0	
79721	chr17	34503747	34504205	458	229.0	
79722	chr17	34542700	34543136	436	218.0	
79723	chr17	34637419	34638698	1279	640.0	
79724	chr17	34960678	34962528	1850	925.0	
79725	chr17	34979831	34981747	1916	958.0	
79726	chr17	34991002	34991547	545	272.0	
79727	chr17	34996636	34998975	2339	1170.0	
79728	chr17	35022474	35023404	930	465.0	
79729	chr17	35028535	35028973	438	219.0	
79730	chr17	35045407	35047331	1924	962.0	
79731	chr17	35050936	35052389	1453	726.0	
79732	chr17	35063094	35064392	1298	649.0	
79733	chr17	35072299	35074621	2322	1161.0	
79734	chr17	35082154	35082409	255	128.0	
79735	chr17	35087064	35090349	3285	1642.0	
79736	chr17	35094937	35095298	361	180.0	
79737	chr17	35117989	35118406	417	208.0	
79738	chr17	35119027	35120427	1400	700.0	
79739	chr17	35141519	35142824	1305	652.0	
79740	chr17	35160342	35162026	1684	842.0	
79741	chr17	35171164	35172478	1314	657.0	
79742	chr17	35177036	35178382	1346	673.0	
79743	chr17	35185797	35186135	338	169.0	
79744	chr17	35188173	35188599	426	213.0	
79745	chr17	35189414	35189611	197	98.0	
79746	chr17	35192746	35192974	228	114.0	
79747	chr17	35210733	35211093	360	180.0	
79748	chr17	35212826	35215405	2579	1290.0	
79749	chr17	35218128	35219370	1242	621.0	
79750	chr17	35235949	35236320	371	186.0	
79751	chr17	35238799	35240683	1884	942.0	
79752	chr17	35241418	35245570	4152	2076.0	
79753	chr17	35252542	35253100	558	279.0	
79754	chr17	35254117	35254871	754	377.0	
79755	chr17	35256867	35257028	161	80.0	
79756	chr17	35274708	35275110	402	201.0	
79757	chr17	35285873	35286780	907	454.0	
79758	chr17	35289118	35289696	578	289.0	
79759	chr17	35312426	35315106	2680	1340.0	
79760	chr17	35341156	35342235	1079	540.0	
79761	chr17	35345625	35347292	1667	834.0	
79762	chr17	35347964	35348063	99	50.0	
79763	chr17	35365059	35365102	43	22.0	
79764	chr17	35367710	35369216	1506	753.0	
79765	chr17	35371915	35375164	3249	1624.0	
79766	chr17	35375972	35376716	744	372.0	
79767	chr17	35377735	35378044	309	154.0	
79768	chr17	35381436	35381926	490	245.0	
79769	chr17	35390671	35391062	391	196.0	
79770	chr17	35431983	35434072	2089	1044.0	
79771	chr17	35447913	35450109	2196	1098.0	
79772	chr17	35460138	35461492	1354	677.0	
79773	chr17	35467660	35468510	850	425.0	
79774	chr17	35486699	35488866	2167	1084.0	
79775	chr17	35497985	35498415	430	215.0	
79776	chr17	35519731	35519763	32	16.0	
79777	chr17	35521224	35522273	1049	524.0	
79778	chr17	35529809	35531535	1726	863.0	
79779	chr17	35533220	35535818	2598	1299.0	
79780	chr17	35536500	35541479	4979	2490.0	
79781	chr17	35546521	35546857	336	168.0	
79782	chr17	35567391	35568970	1579	790.0	
79783	chr17	35577739	35579413	1674	837.0	
79784	chr17	35586635	35588911	2276	1138.0	
79785	chr17	35612938	35613320	382	191.0	
79786	chr17	35683657	35683934	277	138.0	
79787	chr17	35731382	35732011	629	314.0	
79788	chr17	35741135	35741667	532	266.0	
79789	chr17	35747373	35747975	602	301.0	
79790	chr17	35756226	35756617	391	196.0	
79791	chr17	35763826	35765194	1368	684.0	
79792	chr17	35766945	35767272	327	164.0	
79793	chr17	35794881	35795989	1108	554.0	
79794	chr17	35801467	35802104	637	318.0	
79795	chr17	35804413	35805389	976	488.0	
79796	chr17	35808427	35810710	2283	1142.0	
79797	chr17	35849242	35850328	1086	543.0	
79798	chr17	35866557	35866629	72	36.0	
79799	chr17	35867218	35881080	13862	6931.0	
79800	chr17	35889026	35892765	3739	1870.0	
79801	chr17	35895549	35896867	1318	659.0	
79802	chr17	35898171	35899289	1118	559.0	
79803	chr17	35900157	35901382	1225	612.0	
79804	chr17	35930352	35931198	846	423.0	
79805	chr17	35947049	35947569	520	260.0	
79806	chr17	35969425	35969986	561	280.0	
79807	chr17	35975917	35976396	479	240.0	
79808	chr17	36017710	36018295	585	292.0	
79809	chr17	36034118	36034615	497	248.0	
79810	chr17	36036245	36036689	444	222.0	
79811	chr17	36056135	36056185	50	25.0	
79812	chr17	36066269	36067259	990	495.0	
79813	chr17	36069099	36069516	417	208.0	
79814	chr17	36070522	36071051	529	264.0	
79815	chr17	36072284	36073137	853	426.0	
79816	chr17	36081714	36083196	1482	741.0	
79817	chr17	36083704	36084079	375	188.0	
79818	chr17	36085207	36086511	1304	652.0	
79819	chr17	36088149	36090873	2724	1362.0	
79820	chr17	36092153	36092751	598	299.0	
79821	chr17	36103049	36108803	5754	2877.0	
79822	chr17	36127196	36128284	1088	544.0	
79823	chr17	36131382	36131859	477	238.0	
79824	chr17	36132417	36132897	480	240.0	
79825	chr17	36148819	36149767	948	474.0	
79826	chr17	36153888	36154436	548	274.0	
79827	chr17_KI270909v1_alt	231251	231526	275	138.0	
79828	chr17_KI270909v1_alt	244602	244765	163	82.0	
79829	chr17	36463881	36464379	498	249.0	
79830	chr17	36482512	36483679	1167	584.0	
79831	chr17	36485947	36487345	1398	699.0	
79832	chr17	36533931	36536177	2246	1123.0	
79833	chr17	36543852	36546777	2925	1462.0	
79834	chr17	36548388	36549114	726	363.0	
79835	chr17	36550394	36551221	827	414.0	
79836	chr17	36553708	36553712	4	2.0	
79837	chr17	36590422	36590444	22	11.0	
79838	chr17	36591117	36593298	2181	1090.0	
79839	chr17	36600719	36603432	2713	1356.0	
79840	chr17	36608772	36609540	768	384.0	
79841	chr17	36625901	36626249	348	174.0	
79842	chr17	36629146	36629724	578	289.0	
79843	chr17	36674106	36674574	468	234.0	
79844	chr17	36675294	36675732	438	219.0	
79845	chr17	36703793	36704222	429	214.0	
79846	chr17	36706103	36706533	430	215.0	
79847	chr17	36721340	36723740	2400	1200.0	
79848	chr17	36726187	36726612	425	212.0	
79849	chr17	36755610	36755909	299	150.0	
79850	chr17	36927969	36928591	622	311.0	
79851	chr17	36931745	36940054	8309	4154.0	
79852	chr17	36940668	36943736	3068	1534.0	
79853	chr17	36946046	36946810	764	382.0	
79854	chr17	36947774	36950105	2331	1166.0	
79855	chr17	36999432	36999989	557	278.0	
79856	chr17	37047424	37048091	667	334.0	
79857	chr17	37088434	37088833	399	200.0	
79858	chr17	37089730	37090690	960	480.0	
79859	chr17	37124103	37124444	341	170.0	
79860	chr17	37147373	37147573	200	100.0	
79861	chr17	37292718	37293091	373	186.0	
79862	chr17	37358262	37360216	1954	977.0	
79863	chr17	37373334	37373999	665	332.0	
79864	chr17	37397472	37398166	694	347.0	
79865	chr17	37406063	37408063	2000	1000.0	
79866	chr17	37475803	37475913	110	55.0	
79867	chr17	37487932	37491582	3650	1825.0	
79868	chr17	37506645	37506957	312	156.0	
79869	chr17	37527258	37527659	401	200.0	
79870	chr17	37605776	37606719	943	472.0	
79871	chr17	37607557	37610392	2835	1418.0	
79872	chr17	37642644	37643975	1331	666.0	
79873	chr17	37701384	37702030	646	323.0	
79874	chr17	37710464	37710767	303	152.0	
79875	chr17	37742460	37745734	3274	1637.0	
79876	chr17	37756047	37756473	426	213.0	
79877	chr17	37760987	37761387	400	200.0	
79878	chr17	37764815	37765371	556	278.0	
79879	chr17	37766969	37767401	432	216.0	
79880	chr17	37770951	37771321	370	185.0	
79881	chr17	37774427	37775011	584	292.0	
79882	chr17	37791322	37791759	437	218.0	
79883	chr17	37799836	37800229	393	196.0	
79884	chr17	37826387	37826975	588	294.0	
79885	chr17	37828620	37830117	1497	748.0	
79886	chr17	37832643	37832944	301	150.0	
79887	chr17	37841299	37841697	398	199.0	
79888	chr17	37843848	37845128	1280	640.0	
79889	chr17	37847782	37848100	318	159.0	
79890	chr17	37849058	37849673	615	308.0	
79891	chr17	37990240	37990255	15	8.0	
79892	chr17	38256005	38257930	1925	962.0	
79893	chr17	38296303	38297635	1332	666.0	
79894	chr17	38322101	38322610	509	254.0	
79895	chr17	38326898	38327451	553	276.0	
79896	chr17	38333682	38334047	365	182.0	
79897	chr17	38348993	38349755	762	381.0	
79898	chr17	38351195	38353426	2231	1116.0	
79899	chr17	38414484	38415895	1411	706.0	
79900	chr17	38418955	38419584	629	314.0	
79901	chr17	38423601	38424090	489	244.0	
79902	chr17	38424989	38425318	329	164.0	
79903	chr17	38427802	38429400	1598	799.0	
79904	chr17	38444040	38444493	453	226.0	
79905	chr17	38484828	38486160	1332	666.0	
79906	chr17	38491939	38492501	562	281.0	
79907	chr17	38509290	38510675	1385	692.0	
79908	chr17	38557761	38560163	2402	1201.0	
79909	chr17	38560866	38562197	1331	666.0	
79910	chr17	38563325	38564313	988	494.0	
79911	chr17	38571802	38573262	1460	730.0	
79912	chr17	38584228	38584975	747	374.0	
79913	chr17	38591018	38592446	1428	714.0	
79914	chr17	38604483	38606871	2388	1194.0	
79915	chr17	38624831	38625270	439	220.0	
79916	chr17	38663148	38663479	331	166.0	
79917	chr17	38667313	38667981	668	334.0	
79918	chr17	38673268	38675591	2323	1162.0	
79919	chr17	38676728	38677688	960	480.0	
79920	chr17	38685431	38686010	579	290.0	
79921	chr17	38696170	38697027	857	428.0	
79922	chr17	38700193	38707476	7283	3642.0	
79923	chr17	38718548	38719045	497	248.0	
79924	chr17	38722918	38723084	166	83.0	
79925	chr17	38724196	38725665	1469	734.0	
79926	chr17	38726833	38726843	10	5.0	
79927	chr17	38727410	38732234	4824	2412.0	enhancer
79928	chr17	38733790	38734236	446	223.0	
79929	chr17	38734942	38735724	782	391.0	
79930	chr17	38742588	38742738	150	75.0	
79931	chr17	38746540	38753494	6954	3477.0	
79932	chr17	38798455	38800643	2188	1094.0	
79933	chr17	38815805	38816303	498	249.0	
79934	chr17	38822476	38822989	513	256.0	
79935	chr17	38824445	38826019	1574	787.0	
79936	chr17	38840129	38840417	288	144.0	
79937	chr17	38840979	38841487	508	254.0	
79938	chr17	38848000	38848128	128	64.0	
79939	chr17	38851646	38854721	3075	1538.0	
79940	chr17	38857605	38858183	578	289.0	
79941	chr17	38863648	38863896	248	124.0	
79942	chr17	38867177	38878761	11584	5792.0	
79943	chr17	38879875	38884655	4780	2390.0	
79944	chr17	38885551	38887992	2441	1220.0	
79945	chr17	38889838	38894906	5068	2534.0	
79946	chr17	38895738	38902302	6564	3282.0	
79947	chr17	38906531	38909291	2760	1380.0	
79948	chr17	38911827	38912654	827	414.0	
79949	chr17	38913413	38913825	412	206.0	
79950	chr17	38915247	38915309	62	31.0	
79951	chr17	38921798	38923202	1404	702.0	
79952	chr17	38923853	38924343	490	245.0	
79953	chr17	38925151	38925742	591	296.0	
79954	chr17	38926537	38927105	568	284.0	
79955	chr17	38960486	38960872	386	193.0	
79956	chr17	38967082	38968016	934	467.0	
79957	chr17	38975725	38976598	873	436.0	
79958	chr17	38983050	38983589	539	270.0	
79959	chr17	38991485	38991864	379	190.0	
79960	chr17	39002202	39003727	1525	762.0	
79961	chr17	39015096	39015538	442	221.0	
79962	chr17	39016671	39017280	609	304.0	
79963	chr17	39018429	39019197	768	384.0	
79964	chr17	39056523	39057696	1173	586.0	
79965	chr17	39069282	39069838	556	278.0	
79966	chr17	39092072	39093301	1229	614.0	
79967	chr17	39094456	39095139	683	342.0	
79968	chr17	39096298	39097506	1208	604.0	
79969	chr17	39098736	39098858	122	61.0	
79970	chr17	39118493	39119398	905	452.0	
79971	chr17	39122950	39123429	479	240.0	
79972	chr17	39150344	39155279	4935	2468.0	
79973	chr17	39161032	39161813	781	390.0	
79974	chr17	39164458	39166296	1838	919.0	
79975	chr17	39166939	39167982	1043	522.0	
79976	chr17	39174515	39176054	1539	770.0	
79977	chr17	39195535	39201529	5994	2997.0	
79978	chr17	39206564	39210518	3954	1977.0	
79979	chr17	39224570	39226383	1813	906.0	
79980	chr17	39231658	39232493	835	418.0	
79981	chr17	39235563	39237310	1747	874.0	
79982	chr17	39237947	39240222	2275	1138.0	
79983	chr17	39243988	39245387	1399	700.0	
79984	chr17	39325808	39326318	510	255.0	
79985	chr17	39334931	39336320	1389	694.0	
79986	chr17	39363476	39363998	522	261.0	
79987	chr17	39364691	39364919	228	114.0	
79988	chr17	39400587	39403238	2651	1326.0	
79989	chr17	39450506	39451982	1476	738.0	
79990	chr17	39460745	39463531	2786	1393.0	
79991	chr17	39464644	39465061	417	208.0	
79992	chr17	39527237	39527580	343	172.0	
79993	chr17	39538788	39539318	530	265.0	
79994	chr17	39547656	39548348	692	346.0	
79995	chr17	39550541	39550956	415	208.0	
79996	chr17	39569053	39569579	526	263.0	
79997	chr17	39573385	39574189	804	402.0	
79998	chr17	39576229	39576495	266	133.0	
79999	chr17	39598009	39599323	1314	657.0	
80000	chr17	39603703	39604439	736	368.0	
80001	chr17	39605461	39607197	1736	868.0	
80002	chr17	39617243	39619369	2126	1063.0	enhancer
80003	chr17	39621652	39624049	2397	1198.0	
80004	chr17	39626325	39627490	1165	582.0	
80005	chr17	39629883	39630438	555	278.0	
80006	chr17	39634032	39638375	4343	2172.0	
80007	chr17	39640568	39641207	639	320.0	
80008	chr17	39641948	39643125	1177	588.0	
80009	chr17	39652804	39654288	1484	742.0	
80010	chr17	39659184	39660016	832	416.0	
80011	chr17	39665307	39665996	689	344.0	
80012	chr17	39667141	39668911	1770	885.0	
80013	chr17	39671962	39672553	591	296.0	
80014	chr17	39675800	39676915	1115	558.0	enhancer
80015	chr17	39679107	39680273	1166	583.0	
80016	chr17	39686016	39686017	1	0.0	
80017	chr17	39687121	39688828	1707	854.0	
80018	chr17	39700250	39700368	118	59.0	
80019	chr17	39707004	39707438	434	217.0	
80020	chr17	39709287	39710075	788	394.0	
80021	chr17	39729722	39731252	1530	765.0	
80022	chr17	39738108	39739585	1477	738.0	
80023	chr17	39752513	39759707	7194	3597.0	
80024	chr17	39766670	39767635	965	482.0	
80025	chr17	39769373	39771036	1663	832.0	
80026	chr17	39771847	39776672	4825	2412.0	
80027	chr17	39777497	39778768	1271	636.0	
80028	chr17	39781088	39781243	155	78.0	
80029	chr17	39791278	39791759	481	240.0	
80030	chr17	39792883	39795059	2176	1088.0	
80031	chr17	39800450	39801065	615	308.0	
80032	chr17	39813321	39814427	1106	553.0	
80033	chr17	39818536	39819957	1421	710.0	
80034	chr17	39820562	39821035	473	236.0	
80035	chr17	39821932	39822413	481	240.0	
80036	chr17	39843300	39843682	382	191.0	
80037	chr17	39848596	39848947	351	176.0	
80038	chr17	39852331	39852714	383	192.0	
80039	chr17	39860603	39861791	1188	594.0	
80040	chr17	39863541	39868600	5059	2530.0	
80041	chr17	39872855	39873085	230	115.0	
80042	chr17	39903442	39903836	394	197.0	
80043	chr17	39918257	39918877	620	310.0	
80044	chr17	39920581	39921774	1193	596.0	
80045	chr17	39924458	39924709	251	126.0	
80046	chr17	39925739	39929725	3986	1993.0	
80047	chr17	39939553	39940408	855	428.0	
80048	chr17	39952072	39954052	1980	990.0	
80049	chr17	39958647	39959616	969	484.0	
80050	chr17	39962722	39963061	339	170.0	
80051	chr17	39966929	39967950	1021	510.0	
80052	chr17	39972169	39972664	495	248.0	
80053	chr17	39979536	39982119	2583	1292.0	
80054	chr17	40013463	40014324	861	430.0	
80055	chr17	40026041	40027647	1606	803.0	
80056	chr17	40053807	40055068	1261	630.0	
80057	chr17	40062231	40064534	2303	1152.0	
80058	chr17	40068102	40072522	4420	2210.0	
80059	chr17	40074884	40076235	1351	676.0	
80060	chr17	40086368	40087007	639	320.0	
80061	chr17	40095078	40101834	6756	3378.0	
80062	chr17	40103354	40104112	758	379.0	
80063	chr17	40104773	40105225	452	226.0	
80064	chr17	40106248	40106295	47	24.0	
80065	chr17	40106857	40109001	2144	1072.0	
80066	chr17	40109554	40109677	123	62.0	
80067	chr17	40111052	40114041	2989	1494.0	
80068	chr17	40118091	40118504	413	206.0	
80069	chr17	40121140	40125040	3900	1950.0	
80070	chr17	40130358	40131287	929	464.0	
80071	chr17	40135801	40136202	401	200.0	
80072	chr17	40139372	40141526	2154	1077.0	
80073	chr17	40151488	40151945	457	228.0	
80074	chr17	40153418	40153777	359	180.0	
80075	chr17	40157936	40158628	692	346.0	
80076	chr17	40168100	40168882	782	391.0	
80077	chr17	40176834	40178395	1561	780.0	
80078	chr17	40190385	40192111	1726	863.0	
80079	chr17	40198032	40198544	512	256.0	
80080	chr17	40201711	40202270	559	280.0	
80081	chr17	40216748	40216830	82	41.0	
80082	chr17	40218108	40220466	2358	1179.0	
80083	chr17	40235143	40235485	342	171.0	
80084	chr17	40274945	40275892	947	474.0	
80085	chr17	40281616	40282206	590	295.0	
80086	chr17	40283469	40284161	692	346.0	
80087	chr17	40287129	40288763	1634	817.0	
80088	chr17	40290643	40291118	475	238.0	
80089	chr17	40302776	40303640	864	432.0	
80090	chr17	40306811	40308361	1550	775.0	
80091	chr17	40308897	40312624	3727	1864.0	
80092	chr17	40313527	40316156	2629	1314.0	
80093	chr17	40316944	40329256	12312	6156.0	
80094	chr17	40329808	40332794	2986	1493.0	
80095	chr17	40333732	40335611	1879	940.0	
80096	chr17	40337126	40349200	12074	6037.0	
80097	chr17	40350072	40350671	599	300.0	
80098	chr17	40351406	40352190	784	392.0	
80099	chr17	40352880	40353462	582	291.0	
80100	chr17	40354451	40355807	1356	678.0	
80101	chr17	40357873	40359352	1479	740.0	
80102	chr17	40362271	40363793	1522	761.0	
80103	chr17	40371182	40371692	510	255.0	
80104	chr17	40373226	40373635	409	204.0	
80105	chr17	40376736	40376885	149	74.0	
80106	chr17	40399084	40399583	499	250.0	
80107	chr17	40402683	40403069	386	193.0	
80108	chr17	40414957	40415791	834	417.0	
80109	chr17	40417105	40418722	1617	808.0	
80110	chr17	40419511	40420133	622	311.0	
80111	chr17	40425456	40425702	246	123.0	
80112	chr17	40426898	40427406	508	254.0	
80113	chr17	40433768	40433815	47	24.0	
80114	chr17	40440928	40441414	486	243.0	
80115	chr17	40442835	40445705	2870	1435.0	
80116	chr17	40448233	40448325	92	46.0	
80117	chr17	40450191	40450567	376	188.0	
80118	chr17	40476063	40476655	592	296.0	
80119	chr17	40479703	40481706	2003	1002.0	
80120	chr17	40482641	40482765	124	62.0	
80121	chr17	40485985	40486476	491	246.0	
80122	chr17	40489292	40490194	902	451.0	
80123	chr17	40515119	40517495	2376	1188.0	
80124	chr17	40519146	40519411	265	132.0	
80125	chr17	40528815	40529516	701	350.0	
80126	chr17	40530995	40532102	1107	554.0	
80127	chr17	40532869	40535037	2168	1084.0	
80128	chr17	40536470	40537076	606	303.0	
80129	chr17	40537672	40538784	1112	556.0	
80130	chr17	40539357	40543436	4079	2040.0	
80131	chr17	40547070	40548304	1234	617.0	
80132	chr17	40548929	40550218	1289	644.0	
80133	chr17	40552265	40555983	3718	1859.0	
80134	chr17	40556927	40557982	1055	528.0	
80135	chr17	40559840	40566432	6592	3296.0	
80136	chr17	40577510	40578154	644	322.0	
80137	chr17	40582109	40583085	976	488.0	
80138	chr17	40586287	40586583	296	148.0	
80139	chr17	40588544	40588945	401	200.0	
80140	chr17	40596118	40599864	3746	1873.0	
80141	chr17	40601678	40603676	1998	999.0	
80142	chr17	40605158	40605914	756	378.0	
80143	chr17	40607110	40609014	1904	952.0	
80144	chr17	40611885	40613504	1619	810.0	
80145	chr17	40614867	40615980	1113	556.0	
80146	chr17	40617619	40618049	430	215.0	
80147	chr17	40619659	40620627	968	484.0	
80148	chr17	40622360	40623087	727	364.0	
80149	chr17	40647048	40649001	1953	976.0	
80150	chr17	40803476	40803999	523	262.0	
80151	chr17	40818320	40819577	1257	628.0	
80152	chr17	40856961	40857377	416	208.0	
80153	chr17	40903215	40903464	249	124.0	
80154	chr17	40909206	40909797	591	296.0	
80155	chr17	40912726	40913271	545	272.0	
80156	chr17	40915149	40916194	1045	522.0	
80157	chr17	40922083	40922766	683	342.0	
80158	chr17	40936506	40936983	477	238.0	
80159	chr17	40952615	40953067	452	226.0	
80160	chr17	40963870	40964264	394	197.0	
80161	chr17	41116302	41116683	381	190.0	
80162	chr17	41120246	41120768	522	261.0	
80163	chr17	41125820	41126257	437	218.0	
80164	chr17	41307730	41309543	1813	906.0	
80165	chr17	41322213	41322787	574	287.0	
80166	chr17	41326739	41327210	471	236.0	
80167	chr17	41329288	41329731	443	222.0	
80168	chr17	41334942	41335412	470	235.0	
80169	chr17	41338721	41339990	1269	634.0	
80170	chr17	41341016	41342011	995	498.0	
80171	chr17	41480346	41480347	1	0.0	
80172	chr17	41486779	41487151	372	186.0	
80173	chr17	41490257	41490996	739	370.0	
80174	chr17	41492310	41493023	713	356.0	
80175	chr17	41496616	41497271	655	328.0	
80176	chr17	41497992	41498891	899	450.0	
80177	chr17	41500196	41500264	68	34.0	
80178	chr17	41506038	41506410	372	186.0	
80179	chr17	41512548	41512975	427	214.0	
80180	chr17	41527568	41527951	383	192.0	
80181	chr17	41547858	41549684	1826	913.0	
80182	chr17	41567343	41567738	395	198.0	
80183	chr17	41579468	41580001	533	266.0	
80184	chr17	41645346	41646253	907	454.0	
80185	chr17	41647645	41649233	1588	794.0	
80186	chr17	41662382	41663362	980	490.0	
80187	chr17	41664136	41664179	43	22.0	
80188	chr17	41665294	41668221	2927	1464.0	
80189	chr17	41673273	41673428	155	78.0	
80190	chr17	41676268	41676893	625	312.0	
80191	chr17	41678335	41679930	1595	798.0	
80192	chr17	41682560	41683022	462	231.0	
80193	chr17	41686246	41686775	529	264.0	
80194	chr17	41687681	41697747	10066	5033.0	
80195	chr17	41698532	41699435	903	452.0	
80196	chr17	41701597	41701599	2	1.0	
80197	chr17	41705801	41706249	448	224.0	
80198	chr17	41717268	41718038	770	385.0	
80199	chr17	41734230	41734432	202	101.0	
80200	chr17	41737721	41738616	895	448.0	
80201	chr17	41778684	41779590	906	453.0	
80202	chr17	41783053	41783433	380	190.0	
80203	chr17	41784463	41784508	45	22.0	
80204	chr17	41785176	41787380	2204	1102.0	
80205	chr17	41788375	41788837	462	231.0	
80206	chr17	41795818	41796151	333	166.0	
80207	chr17	41801337	41802142	805	402.0	
80208	chr17	41803700	41804115	415	208.0	
80209	chr17	41811135	41812926	1791	896.0	
80210	chr17	41835296	41836704	1408	704.0	
80211	chr17	41862927	41865998	3071	1536.0	
80212	chr17	41917834	41919929	2095	1048.0	
80213	chr17	41929247	41929333	86	43.0	
80214	chr17	41929841	41931301	1460	730.0	
80215	chr17	41932156	41933519	1363	682.0	
80216	chr17	41959741	41959755	14	7.0	
80217	chr17	41962595	41963418	823	412.0	
80218	chr17	41965541	41968123	2582	1291.0	
80219	chr17	41972190	41973778	1588	794.0	
80220	chr17	41996032	41996464	432	216.0	
80221	chr17	42009400	42009513	113	56.0	
80222	chr17	42010167	42011489	1322	661.0	
80223	chr17	42015313	42018373	3060	1530.0	
80224	chr17	42019446	42020665	1219	610.0	
80225	chr17	42023534	42025551	2017	1008.0	
80226	chr17	42040119	42040289	170	85.0	
80227	chr17	42049988	42051173	1185	592.0	
80228	chr17	42063473	42064507	1034	517.0	
80229	chr17	42067205	42067866	661	330.0	
80230	chr17	42072151	42073264	1113	556.0	
80231	chr17	42097890	42098945	1055	528.0	
80232	chr17	42101465	42102143	678	339.0	
80233	chr17	42107332	42108527	1195	598.0	
80234	chr17	42111730	42113391	1661	830.0	
80235	chr17	42115836	42117341	1505	752.0	
80236	chr17	42118547	42118984	437	218.0	
80237	chr17	42120561	42121866	1305	652.0	
80238	chr17	42131997	42133852	1855	928.0	
80239	chr17	42135550	42136335	785	392.0	
80240	chr17	42141494	42141756	262	131.0	
80241	chr17	42153764	42155818	2054	1027.0	
80242	chr17	42161380	42162251	871	436.0	
80243	chr17	42163048	42163362	314	157.0	
80244	chr17	42166946	42168207	1261	630.0	
80245	chr17	42178523	42181918	3395	1698.0	
80246	chr17	42183345	42185403	2058	1029.0	
80247	chr17	42188453	42189337	884	442.0	
80248	chr17	42193800	42194979	1179	590.0	
80249	chr17	42198759	42199371	612	306.0	
80250	chr17	42206227	42206688	461	230.0	
80251	chr17	42221894	42222610	716	358.0	
80252	chr17	42246648	42247142	494	247.0	
80253	chr17	42247703	42251506	3803	1902.0	
80254	chr17	42266586	42267592	1006	503.0	
80255	chr17	42270917	42277782	6865	3432.0	
80256	chr17	42286353	42291122	4769	2384.0	
80257	chr17	42291800	42292488	688	344.0	
80258	chr17	42294533	42294956	423	212.0	
80259	chr17	42305605	42306248	643	322.0	
80260	chr17	42308402	42308795	393	196.0	
80261	chr17	42310134	42313289	3155	1578.0	
80262	chr17	42313912	42316089	2177	1088.0	
80263	chr17	42319775	42320336	561	280.0	
80264	chr17	42322545	42323607	1062	531.0	
80265	chr17	42337251	42337954	703	352.0	
80266	chr17	42338778	42338964	186	93.0	
80267	chr17	42340790	42341230	440	220.0	
80268	chr17	42342559	42343056	497	248.0	
80269	chr17	42358674	42358795	121	60.0	
80270	chr17	42361761	42362336	575	288.0	
80271	chr17	42363943	42364167	224	112.0	
80272	chr17	42366278	42367516	1238	619.0	
80273	chr17	42368768	42369127	359	180.0	
80274	chr17	42378584	42380275	1691	846.0	
80275	chr17	42382267	42382895	628	314.0	
80276	chr17	42386808	42389627	2819	1410.0	
80277	chr17	42403134	42403582	448	224.0	
80278	chr17	42405818	42406858	1040	520.0	
80279	chr17	42407415	42407955	540	270.0	
80280	chr17	42414830	42415541	711	356.0	
80281	chr17	42417940	42418470	530	265.0	
80282	chr17	42421683	42423466	1783	892.0	
80283	chr17	42428347	42428838	491	246.0	
80284	chr17	42439099	42439584	485	242.0	
80285	chr17	42441761	42441765	4	2.0	
80286	chr17	42453271	42454128	857	428.0	
80287	chr17	42456347	42460622	4275	2138.0	
80288	chr17	42483791	42485129	1338	669.0	
80289	chr17	42517190	42519232	2042	1021.0	
80290	chr17	42524239	42524549	310	155.0	
80291	chr17	42526986	42527845	859	430.0	
80292	chr17	42529994	42533068	3074	1537.0	
80293	chr17	42535551	42537407	1856	928.0	
80294	chr17	42540698	42541687	989	494.0	
80295	chr17	42547951	42549256	1305	652.0	
80296	chr17	42553309	42555494	2185	1092.0	
80297	chr17	42561469	42563029	1560	780.0	
80298	chr17	42566250	42568170	1920	960.0	
80299	chr17	42577084	42579185	2101	1050.0	
80300	chr17	42584844	42585547	703	352.0	
80301	chr17	42608214	42610457	2243	1122.0	
80302	chr17	42618477	42618936	459	230.0	
80303	chr17	42658866	42659823	957	478.0	
80304	chr17	42669705	42671677	1972	986.0	
80305	chr17	42673651	42680519	6868	3434.0	
80306	chr17	42681216	42683998	2782	1391.0	
80307	chr17	42704900	42705147	247	124.0	
80308	chr17	42706655	42707157	502	251.0	
80309	chr17	42720974	42721472	498	249.0	
80310	chr17	42744153	42745617	1464	732.0	
80311	chr17	42750959	42751408	449	224.0	
80312	chr17	42759933	42761649	1716	858.0	
80313	chr17	42763206	42763876	670	335.0	
80314	chr17	42772956	42774141	1185	592.0	
80315	chr17	42780666	42780768	102	51.0	
80316	chr17	42784395	42785341	946	473.0	
80317	chr17	42798242	42799223	981	490.0	
80318	chr17	42819890	42820399	509	254.0	
80319	chr17	42823639	42824853	1214	607.0	
80320	chr17	42832500	42834269	1769	884.0	
80321	chr17	42835442	42835973	531	266.0	
80322	chr17	42843313	42843780	467	234.0	
80323	chr17	42845946	42847197	1251	626.0	
80324	chr17	42855397	42855458	61	30.0	
80325	chr17	42886214	42886687	473	236.0	
80326	chr17	42928516	42929654	1138	569.0	
80327	chr17	42937752	42938059	307	154.0	
80328	chr17	42963912	42965114	1202	601.0	
80329	chr17	42979740	42981589	1849	924.0	
80330	chr17	42985016	42985912	896	448.0	
80331	chr17	42997388	42999511	2123	1062.0	
80332	chr17	43001523	43002279	756	378.0	
80333	chr17	43006325	43007673	1348	674.0	
80334	chr17	43018037	43019342	1305	652.0	
80335	chr17	43020132	43022848	2716	1358.0	
80336	chr17	43024115	43025805	1690	845.0	
80337	chr17	43026685	43027390	705	352.0	
80338	chr17	43029628	43030140	512	256.0	
80339	chr17	43124336	43126373	2037	1018.0	
80340	chr17	43129625	43129748	123	62.0	
80341	chr17	43140409	43140810	401	200.0	
80342	chr17	43168817	43172732	3915	1958.0	
80343	chr17	43211108	43213344	2236	1118.0	
80344	chr17	43302939	43303353	414	207.0	
80345	chr17	43304092	43305756	1664	832.0	
80346	chr17	43309499	43310391	892	446.0	
80347	chr17	43314559	43318827	4268	2134.0	
80348	chr17	43319723	43319855	132	66.0	
80349	chr17	43322204	43324017	1813	906.0	
80350	chr17	43333823	43334640	817	408.0	
80351	chr17	43338837	43339352	515	258.0	
80352	chr17	43359548	43362621	3073	1536.0	
80353	chr17	43366733	43370025	3292	1646.0	
80354	chr17	43372365	43373031	666	333.0	
80355	chr17	43386028	43390024	3996	1998.0	
80356	chr17	43393548	43394709	1161	580.0	
80357	chr17	43396043	43396501	458	229.0	
80358	chr17	43398333	43399871	1538	769.0	
80359	chr17	43483097	43484892	1795	898.0	
80360	chr17	43520573	43520949	376	188.0	
80361	chr17	43544231	43544241	10	5.0	
80362	chr17	43544915	43547159	2244	1122.0	
80363	chr17	43556058	43556820	762	381.0	
80364	chr17	43576554	43577062	508	254.0	
80365	chr17	43578669	43579239	570	285.0	
80366	chr17	43608139	43608865	726	363.0	
80367	chr17	43646075	43646594	519	260.0	
80368	chr17	43655863	43656594	731	366.0	
80369	chr17	43673749	43674249	500	250.0	
80370	chr17	43677688	43678488	800	400.0	
80371	chr17	43694145	43694871	726	363.0	
80372	chr17	43701139	43701759	620	310.0	
80373	chr17	43702639	43703090	451	226.0	
80374	chr17	43713570	43714248	678	339.0	
80375	chr17	43719544	43721339	1795	898.0	
80376	chr17	43753434	43753920	486	243.0	
80377	chr17	43760131	43761009	878	439.0	
80378	chr17	43766408	43766855	447	224.0	
80379	chr17	43768270	43768863	593	296.0	
80380	chr17	43772825	43773889	1064	532.0	
80381	chr17	43777894	43780534	2640	1320.0	
80382	chr17	43787708	43788159	451	226.0	
80383	chr17	43830807	43830870	63	32.0	
80384	chr17	43832472	43834052	1580	790.0	
80385	chr17	43846163	43846686	523	262.0	
80386	chr17	43868264	43868609	345	172.0	
80387	chr17	43878450	43879101	651	326.0	
80388	chr17	43880344	43880759	415	208.0	
80389	chr17	43900192	43901305	1113	556.0	
80390	chr17	43906144	43908510	2366	1183.0	
80391	chr17	43909930	43910608	678	339.0	
80392	chr17	43917018	43918240	1222	611.0	
80393	chr17	43927232	43928338	1106	553.0	
80394	chr17	43937912	43938956	1044	522.0	
80395	chr17	43943875	43944678	803	402.0	
80396	chr17	43983702	43983929	227	114.0	
80397	chr17	43994466	43995340	874	437.0	
80398	chr17	44004224	44008339	4115	2058.0	
80399	chr17	44014271	44015496	1225	612.0	
80400	chr17	44041293	44041894	601	300.0	
80401	chr17	44043294	44043830	536	268.0	
80402	chr17	44047015	44047278	263	132.0	
80403	chr17	44065474	44067899	2425	1212.0	
80404	chr17	44069933	44072368	2435	1218.0	
80405	chr17	44077269	44078246	977	488.0	
80406	chr17	44079834	44080289	455	228.0	
80407	chr17	44084182	44084585	403	202.0	
80408	chr17	44095475	44096480	1005	502.0	
80409	chr17	44097651	44098697	1046	523.0	
80410	chr17	44110738	44111825	1087	544.0	
80411	chr17	44112759	44113216	457	228.0	
80412	chr17	44115571	44116062	491	246.0	
80413	chr17	44121220	44124488	3268	1634.0	
80414	chr17	44137978	44138624	646	323.0	
80415	chr17	44141208	44142920	1712	856.0	
80416	chr17	44159521	44160036	515	258.0	
80417	chr17	44168335	44168851	516	258.0	
80418	chr17	44185790	44188124	2334	1167.0	
80419	chr17	44188697	44188998	301	150.0	
80420	chr17	44192177	44192630	453	226.0	
80421	chr17	44197906	44201116	3210	1605.0	
80422	chr17	44203610	44204793	1183	592.0	
80423	chr17	44206181	44206883	702	351.0	
80424	chr17	44209835	44211160	1325	662.0	
80425	chr17	44212819	44213283	464	232.0	
80426	chr17	44216012	44222873	6861	3430.0	
80427	chr17	44241112	44241513	401	200.0	
80428	chr17	44246390	44247147	757	378.0	
80429	chr17	44279288	44280611	1323	662.0	
80430	chr17	44288650	44288745	95	48.0	
80431	chr17	44307783	44309518	1735	868.0	
80432	chr17	44314851	44316617	1766	883.0	
80433	chr17	44324047	44327493	3446	1723.0	
80434	chr17	44331044	44332407	1363	682.0	
80435	chr17	44333314	44335049	1735	868.0	
80436	chr17	44338670	44339091	421	210.0	
80437	chr17	44339886	44340431	545	272.0	
80438	chr17	44344666	44346521	1855	928.0	
80439	chr17	44347655	44348952	1297	648.0	
80440	chr17	44350511	44351327	816	408.0	
80441	chr17	44353432	44355028	1596	798.0	
80442	chr17	44362540	44364380	1840	920.0	
80443	chr17	44369615	44369618	3	2.0	
80444	chr17	44384753	44386182	1429	714.0	
80445	chr17	44389635	44390302	667	334.0	
80446	chr17	44438602	44439070	468	234.0	
80447	chr17	44502193	44504334	2141	1070.0	
80448	chr17	44523129	44523540	411	206.0	
80449	chr17	44533432	44534251	819	410.0	
80450	chr17	44546954	44548835	1881	940.0	
80451	chr17	44556129	44558415	2286	1143.0	
80452	chr17	44609961	44610184	223	112.0	
80453	chr17	44628394	44629130	736	368.0	
80454	chr17	44636613	44636935	322	161.0	
80455	chr17	44655929	44656695	766	383.0	
80456	chr17	44683290	44683683	393	196.0	
80457	chr17	44689160	44690514	1354	677.0	
80458	chr17	44707959	44709270	1311	656.0	
80459	chr17	44758398	44759451	1053	526.0	
80460	chr17	44771091	44771602	511	256.0	
80461	chr17	44774388	44776511	2123	1062.0	
80462	chr17	44777539	44777687	148	74.0	
80463	chr17	44778651	44779965	1314	657.0	
80464	chr17	44794730	44795495	765	382.0	
80465	chr17	44829145	44830889	1744	872.0	
80466	chr17	44864940	44865583	643	322.0	
80467	chr17	44887919	44888992	1073	536.0	
80468	chr17	44898509	44900627	2118	1059.0	
80469	chr17	44901344	44901738	394	197.0	
80470	chr17	44905969	44906544	575	288.0	
80471	chr17	44910988	44911864	876	438.0	
80472	chr17	44915765	44916296	531	266.0	
80473	chr17	44919768	44920527	759	380.0	
80474	chr17	44947044	44948542	1498	749.0	
80475	chr17	44965541	44965869	328	164.0	
80476	chr17	44966398	44970955	4557	2278.0	
80477	chr17	44972084	44972399	315	158.0	
80478	chr17	45018469	45019989	1520	760.0	
80479	chr17	45021642	45022579	937	468.0	
80480	chr17	45050424	45054052	3628	1814.0	
80481	chr17	45060412	45062078	1666	833.0	
80482	chr17	45063093	45063638	545	272.0	
80483	chr17	45065349	45066055	706	353.0	
80484	chr17	45077578	45078146	568	284.0	
80485	chr17	45099046	45099589	543	272.0	
80486	chr17	45123863	45124664	801	400.0	
80487	chr17	45131451	45133660	2209	1104.0	
80488	chr17	45134961	45136875	1914	957.0	
80489	chr17	45143288	45145299	2011	1006.0	
80490	chr17	45146846	45152615	5769	2884.0	
80491	chr17	45154990	45155642	652	326.0	
80492	chr17	45158312	45158760	448	224.0	
80493	chr17	45160320	45162567	2247	1124.0	
80494	chr17	45170527	45173416	2889	1444.0	
80495	chr17	45176077	45176626	549	274.0	
80496	chr17	45182793	45182903	110	55.0	
80497	chr17	45197481	45198390	909	454.0	
80498	chr17	45200674	45201123	449	224.0	
80499	chr17	45201805	45202590	785	392.0	
80500	chr17	45218647	45232298	13651	6826.0	
80501	chr17	45233099	45236350	3251	1626.0	
80502	chr17	45243962	45244310	348	174.0	
80503	chr17	45245267	45250216	4949	2474.0	
80504	chr17	45250723	45251022	299	150.0	
80505	chr17	45256640	45256979	339	170.0	
80506	chr17	45258975	45259278	303	152.0	
80507	chr17	45260579	45263003	2424	1212.0	
80508	chr17	45270781	45271278	497	248.0	
80509	chr17	45277105	45277862	757	378.0	
80510	chr17	45283012	45283463	451	226.0	
80511	chr17	45284135	45284515	380	190.0	
80512	chr17	45290966	45291854	888	444.0	
80513	chr17	45293250	45293996	746	373.0	
80514	chr17	45295638	45296763	1125	562.0	
80515	chr17	45299337	45299791	454	227.0	
80516	chr17	45300298	45300441	143	72.0	
80517	chr17	45302552	45303339	787	394.0	
80518	chr17	45307250	45308260	1010	505.0	
80519	chr17	45310426	45313493	3067	1534.0	
80520	chr17	45314155	45318167	4012	2006.0	
80521	chr17	45320400	45320748	348	174.0	
80522	chr17	45329333	45330189	856	428.0	
80523	chr17	45332933	45333588	655	328.0	
80524	chr17	45345662	45345668	6	3.0	
80525	chr17	45352942	45353503	561	280.0	
80526	chr17	45370927	45372076	1149	574.0	
80527	chr17	45373498	45374078	580	290.0	
80528	chr17	45380318	45380332	14	7.0	
80529	chr17	45385181	45386148	967	484.0	
80530	chr17	45394803	45395714	911	456.0	
80531	chr17	45406119	45407086	967	484.0	
80532	chr17	45407900	45412024	4124	2062.0	
80533	chr17	45413247	45414066	819	410.0	
80534	chr17	45414964	45415455	491	246.0	
80535	chr17	45425385	45426163	778	389.0	
80536	chr17	45427654	45429444	1790	895.0	
80537	chr17	45430648	45434185	3537	1768.0	
80538	chr17	45441040	45441049	9	4.0	
80539	chr17	45445915	45446537	622	311.0	
80540	chr17	45461718	45462442	724	362.0	
80541	chr17	45487530	45488206	676	338.0	
80542	chr17	45489277	45489525	248	124.0	
80543	chr17	45490049	45491804	1755	878.0	
80544	chr17	45494453	45495048	595	298.0	
80545	chr17	45500483	45500905	422	211.0	
80546	chr17	45515948	45516291	343	172.0	
80547	chr17	45573707	45573965	258	129.0	
80548	chr17	45575006	45575921	915	458.0	
80549	chr17	45576436	45577317	881	440.0	
80550	chr17	45578743	45580203	1460	730.0	
80551	chr17	45581988	45586705	4717	2358.0	
80552	chr17	45592279	45592794	515	258.0	
80553	chr17	45600379	45600402	23	12.0	
80554	chr17	45619809	45620940	1131	566.0	
80555	chr17	45640038	45640796	758	379.0	
80556	chr17	45740581	45740822	241	120.0	
80557	chr17	45783217	45783551	334	167.0	
80558	chr17	45784881	45785388	507	254.0	
80559	chr17	45832085	45832539	454	227.0	
80560	chr17	45852678	45853057	379	190.0	
80561	chr17	45893735	45896204	2469	1234.0	
80562	chr17	45949002	45949490	488	244.0	
80563	chr17	45975310	45975574	264	132.0	
80564	chr17	46002263	46003188	925	462.0	
80565	chr17	46019704	46021089	1385	692.0	
80566	chr17	46026192	46027796	1604	802.0	
80567	chr17	46031613	46031856	243	122.0	
80568	chr17	46035140	46035283	143	72.0	
80569	chr17	46044255	46044955	700	350.0	
80570	chr17	46061604	46061834	230	115.0	
80571	chr17	46101086	46101543	457	228.0	
80572	chr17	46102341	46102502	161	80.0	
80573	chr17	46105723	46105782	59	30.0	
80574	chr17	46121189	46122474	1285	642.0	
80575	chr17	46137635	46139951	2316	1158.0	
80576	chr17	46141247	46142118	871	436.0	
80577	chr17	46145944	46146491	547	274.0	
80578	chr17	46147171	46147743	572	286.0	
80579	chr17	46153970	46154925	955	478.0	
80580	chr17	46155979	46157419	1440	720.0	
80581	chr17	46158972	46159035	63	32.0	
80582	chr17	46162940	46164316	1376	688.0	
80583	chr17	46171862	46172304	442	221.0	
80584	chr17	46178766	46180295	1529	764.0	
80585	chr17	46182873	46183349	476	238.0	
80586	chr17	46184446	46184787	341	170.0	
80587	chr17	46186661	46187389	728	364.0	
80588	chr17	46188115	46196407	8292	4146.0	
80589	chr17	46212635	46213695	1060	530.0	
80590	chr17	46215388	46215778	390	195.0	
80591	chr17	46224768	46225937	1169	584.0	
80592	chr17	46253585	46254264	679	340.0	
80593	chr17	46259898	46260797	899	450.0	
80594	chr17	46264196	46265283	1087	544.0	
80595	chr17	46266083	46268339	2256	1128.0	
80596	chr17	46286587	46287286	699	350.0	
80597	chr17	46290850	46291844	994	497.0	
80598	chr17	46361644	46362088	444	222.0	
80599	chr17	46579798	46580243	445	222.0	
80600	chr17	46770022	46770113	91	46.0	
80601	chr17	46770793	46772674	1881	940.0	
80602	chr17	46773287	46773474	187	94.0	
80603	chr17	46818434	46820160	1726	863.0	
80604	chr17	46822276	46822721	445	222.0	
80605	chr17	46835813	46836333	520	260.0	
80606	chr17	46841751	46842214	463	232.0	
80607	chr17	46851379	46851709	330	165.0	
80608	chr17	46877953	46878413	460	230.0	
80609	chr17	46922436	46923783	1347	674.0	
80610	chr17	46940539	46941243	704	352.0	
80611	chr17	46942480	46942968	488	244.0	
80612	chr17	46978434	46979555	1121	560.0	
80613	chr17	47000914	47001876	962	481.0	
80614	chr17	47066918	47067830	912	456.0	
80615	chr17	47070459	47071143	684	342.0	
80616	chr17	47072720	47073338	618	309.0	
80617	chr17	47098598	47100981	2383	1192.0	
80618	chr17	47162305	47162329	24	12.0	
80619	chr17	47188130	47190021	1891	946.0	
80620	chr17	47192436	47193075	639	320.0	
80621	chr17	47199930	47200762	832	416.0	
80622	chr17	47203845	47206215	2370	1185.0	
80623	chr17	47217205	47217777	572	286.0	
80624	chr17	47218768	47219084	316	158.0	
80625	chr17	47220355	47221206	851	426.0	
80626	chr17	47229502	47230379	877	438.0	
80627	chr17	47240117	47240213	96	48.0	
80628	chr17	47253485	47254582	1097	548.0	
80629	chr17	47275919	47276054	135	68.0	
80630	chr17	47278948	47279878	930	465.0	
80631	chr17	47286179	47286648	469	234.0	
80632	chr17	47315582	47316116	534	267.0	
80633	chr17	47323263	47325218	1955	978.0	
80634	chr17	47492010	47493178	1168	584.0	
80635	chr17	47511802	47512015	213	106.0	
80636	chr17	47530532	47532550	2018	1009.0	
80637	chr17	47572659	47572931	272	136.0	
80638	chr17	47615787	47616276	489	244.0	
80639	chr17	47634894	47635214	320	160.0	
80640	chr17	47644315	47644751	436	218.0	
80641	chr17	47647052	47651333	4281	2140.0	
80642	chr17	47659841	47660670	829	414.0	
80643	chr17	47663882	47664790	908	454.0	
80644	chr17	47665584	47666292	708	354.0	
80645	chr17	47670002	47670506	504	252.0	
80646	chr17	47692731	47696111	3380	1690.0	
80647	chr17	47696874	47707512	10638	5319.0	
80648	chr17	47712365	47712671	306	153.0	
80649	chr17	47713988	47716483	2495	1248.0	
80650	chr17	47716999	47721734	4735	2368.0	
80651	chr17	47725667	47725771	104	52.0	
80652	chr17	47728569	47728883	314	157.0	
80653	chr17	47730630	47737498	6868	3434.0	"promoter	protein_binding_site	protein_binding_site	protein_binding_site"
80654	chr17	47738056	47738851	795	398.0	
80655	chr17	47739530	47743124	3594	1797.0	
80656	chr17	47745699	47745754	55	28.0	
80657	chr17	47757679	47758063	384	192.0	
80658	chr17	47762743	47763224	481	240.0	
80659	chr17	47773579	47774020	441	220.0	
80660	chr17	47776515	47777191	676	338.0	
80661	chr17	47789557	47790626	1069	534.0	
80662	chr17	47802264	47802995	731	366.0	
80663	chr17	47810038	47810768	730	365.0	
80664	chr17	47820119	47820138	19	10.0	
80665	chr17	47821015	47822501	1486	743.0	
80666	chr17	47829323	47832510	3187	1594.0	
80667	chr17	47840520	47842139	1619	810.0	
80668	chr17	47842965	47843692	727	364.0	
80669	chr17	47847273	47847928	655	328.0	
80670	chr17	47850633	47852543	1910	955.0	
80671	chr17	47882243	47882707	464	232.0	
80672	chr17	47885030	47885350	320	160.0	
80673	chr17	47889664	47890585	921	460.0	
80674	chr17	47895057	47897249	2192	1096.0	
80675	chr17	47898204	47898650	446	223.0	
80676	chr17	47907942	47908343	401	200.0	
80677	chr17	47918032	47918377	345	172.0	
80678	chr17	47940829	47942522	1693	846.0	
80679	chr17	47945053	47947427	2374	1187.0	
80680	chr17	47948864	47950336	1472	736.0	
80681	chr17	47970200	47971789	1589	794.0	
80682	chr17	47978291	47978781	490	245.0	
80683	chr17	48001128	48001678	550	275.0	
80684	chr17	48002382	48003059	677	338.0	
80685	chr17	48003924	48004166	242	121.0	
80686	chr17	48007342	48007715	373	186.0	
80687	chr17	48011244	48012812	1568	784.0	
80688	chr17	48017556	48018746	1190	595.0	
80689	chr17	48021840	48022372	532	266.0	
80690	chr17	48023195	48027083	3888	1944.0	
80691	chr17	48036676	48038268	1592	796.0	
80692	chr17	48047086	48049653	2567	1284.0	
80693	chr17	48051838	48052172	334	167.0	
80694	chr17	48055663	48056091	428	214.0	
80695	chr17	48060183	48060611	428	214.0	
80696	chr17	48074102	48074781	679	340.0	
80697	chr17	48080171	48080608	437	218.0	
80698	chr17	48100603	48103810	3207	1604.0	
80699	chr17	48104529	48104903	374	187.0	
80700	chr17	48106810	48108939	2129	1064.0	
80701	chr17	48110900	48112109	1209	604.0	
80702	chr17	48112842	48113949	1107	554.0	
80703	chr17	48131030	48131669	639	320.0	
80704	chr17	48139867	48140720	853	426.0	
80705	chr17	48240973	48241449	476	238.0	
80706	chr17	48265325	48265906	581	290.0	
80707	chr17	48294173	48295867	1694	847.0	
80708	chr17	48307782	48308238	456	228.0	
80709	chr17	48335833	48336539	706	353.0	
80710	chr17	48351776	48352422	646	323.0	
80711	chr17	48374195	48375047	852	426.0	
80712	chr17	48413600	48414083	483	242.0	
80713	chr17	48416993	48417364	371	186.0	
80714	chr17	48427526	48428187	661	330.0	
80715	chr17	48429010	48431161	2151	1076.0	
80716	chr17	48438561	48438981	420	210.0	
80717	chr17	48439490	48443286	3796	1898.0	
80718	chr17	48444311	48445103	792	396.0	
80719	chr17	48453313	48454212	899	450.0	
80720	chr17	48456977	48457777	800	400.0	
80721	chr17	48472236	48473003	767	384.0	
80722	chr17	48478189	48478904	715	358.0	
80723	chr17	48483578	48483961	383	192.0	
80724	chr17	48491525	48493291	1766	883.0	
80725	chr17	48505645	48506344	699	350.0	
80726	chr17	48511057	48511471	414	207.0	
80727	chr17	48513121	48513525	404	202.0	
80728	chr17	48541179	48545050	3871	1936.0	
80729	chr17	48546719	48547080	361	180.0	
80730	chr17	48547995	48548881	886	443.0	
80731	chr17	48555165	48556074	909	454.0	
80732	chr17	48561896	48562270	374	187.0	
80733	chr17	48564269	48564738	469	234.0	
80734	chr17	48575610	48576057	447	224.0	
80735	chr17	48576771	48579401	2630	1315.0	
80736	chr17	48580616	48580753	137	68.0	
80737	chr17	48581562	48582488	926	463.0	
80738	chr17	48584925	48586707	1782	891.0	
80739	chr17	48587845	48588641	796	398.0	
80740	chr17	48592174	48594478	2304	1152.0	
80741	chr17	48596311	48599119	2808	1404.0	
80742	chr17	48601755	48601759	4	2.0	
80743	chr17	48602273	48603166	893	446.0	
80744	chr17	48603995	48604235	240	120.0	
80745	chr17	48609244	48614792	5548	2774.0	
80746	chr17	48618294	48619442	1148	574.0	
80747	chr17	48624636	48627119	2483	1242.0	
80748	chr17	48633739	48634168	429	214.0	
80749	chr17	48636377	48637005	628	314.0	
80750	chr17	48646227	48647939	1712	856.0	
80751	chr17	48671594	48672186	592	296.0	
80752	chr17	48678141	48678899	758	379.0	
80753	chr17	48718856	48719468	612	306.0	
80754	chr17	48723029	48725290	2261	1130.0	
80755	chr17	48726616	48727070	454	227.0	
80756	chr17	48728168	48729075	907	454.0	
80757	chr17	48733010	48733434	424	212.0	
80758	chr17	48739116	48739360	244	122.0	
80759	chr17	48746255	48746701	446	223.0	
80760	chr17	48747325	48747799	474	237.0	
80761	chr17	48755362	48755719	357	178.0	
80762	chr17	48756932	48757301	369	184.0	
80763	chr17	48791010	48791819	809	404.0	
80764	chr17	48804765	48805451	686	343.0	
80765	chr17	48814344	48815009	665	332.0	
80766	chr17	48816509	48817743	1234	617.0	
80767	chr17	48830482	48831961	1479	740.0	
80768	chr17	48835900	48836488	588	294.0	
80769	chr17	48837211	48838177	966	483.0	
80770	chr17	48840980	48842118	1138	569.0	
80771	chr17	48850904	48851352	448	224.0	
80772	chr17	48852041	48852514	473	236.0	
80773	chr17	48878847	48879572	725	362.0	
80774	chr17	48884440	48885115	675	338.0	
80775	chr17	48891735	48894249	2514	1257.0	
80776	chr17	48907606	48910282	2676	1338.0	
80777	chr17	48915361	48916564	1203	602.0	
80778	chr17	48943994	48945474	1480	740.0	
80779	chr17	48952897	48953271	374	187.0	
80780	chr17	48995499	48998551	3052	1526.0	
80781	chr17	49032095	49032943	848	424.0	
80782	chr17	49036025	49036393	368	184.0	
80783	chr17	49180248	49180942	694	347.0	
80784	chr17	49190955	49194564	3609	1804.0	
80785	chr17	49208783	49211398	2615	1308.0	
80786	chr17	49213353	49215268	1915	958.0	
80787	chr17	49215795	49220260	4465	2232.0	
80788	chr17	49222991	49225408	2417	1208.0	
80789	chr17	49226978	49228057	1079	540.0	
80790	chr17	49229040	49232223	3183	1592.0	
80791	chr17	49235216	49236023	807	404.0	
80792	chr17	49251822	49252733	911	456.0	
80793	chr17	49259734	49261196	1462	731.0	
80794	chr17	49277713	49277960	247	124.0	
80795	chr17	49290753	49291088	335	168.0	
80796	chr17	49315399	49316138	739	370.0	
80797	chr17	49316864	49317731	867	434.0	
80798	chr17	49328386	49328841	455	228.0	
80799	chr17	49338787	49339312	525	262.0	
80800	chr17	49341270	49343769	2499	1250.0	
80801	chr17	49358461	49359130	669	334.0	
80802	chr17	49360044	49363291	3247	1624.0	
80803	chr17	49365602	49366149	547	274.0	
80804	chr17	49368332	49368853	521	260.0	
80805	chr17	49370630	49370771	141	70.0	
80806	chr17	49387484	49388854	1370	685.0	
80807	chr17	49389649	49391305	1656	828.0	
80808	chr17	49393788	49395482	1694	847.0	
80809	chr17	49403542	49404857	1315	658.0	
80810	chr17	49407740	49408740	1000	500.0	
80811	chr17	49414295	49415701	1406	703.0	
80812	chr17	49434944	49435484	540	270.0	
80813	chr17	49439265	49439345	80	40.0	
80814	chr17	49494456	49498399	3943	1972.0	
80815	chr17	49512972	49513387	415	208.0	
80816	chr17	49514973	49515653	680	340.0	
80817	chr17	49523637	49524038	401	200.0	
80818	chr17	49556069	49557824	1755	878.0	
80819	chr17	49566011	49566412	401	200.0	
80820	chr17	49567581	49568791	1210	605.0	
80821	chr17	49569490	49571488	1998	999.0	
80822	chr17	49575342	49577270	1928	964.0	
80823	chr17	49616755	49617157	402	201.0	
80824	chr17	49618042	49618079	37	18.0	
80825	chr17	49675811	49678870	3059	1530.0	
80826	chr17	49681606	49681762	156	78.0	
80827	chr17	49687741	49688801	1060	530.0	
80828	chr17	49695229	49696987	1758	879.0	
80829	chr17	49703902	49704227	325	162.0	
80830	chr17	49707192	49709328	2136	1068.0	
80831	chr17	49714917	49716643	1726	863.0	
80832	chr17	49717372	49717973	601	300.0	
80833	chr17	49728390	49729115	725	362.0	
80834	chr17	49734540	49735202	662	331.0	
80835	chr17	49738435	49743126	4691	2346.0	
80836	chr17	49744773	49749573	4800	2400.0	
80837	chr17	49753903	49755939	2036	1018.0	
80838	chr17	49756690	49757173	483	242.0	
80839	chr17	49758884	49759466	582	291.0	
80840	chr17	49760822	49765123	4301	2150.0	
80841	chr17	49779613	49780302	689	344.0	
80842	chr17	49787695	49789936	2241	1120.0	
80843	chr17	49817750	49819458	1708	854.0	
80844	chr17	49820654	49820991	337	168.0	
80845	chr17	49828259	49828768	509	254.0	
80846	chr17	49850484	49852805	2321	1160.0	
80847	chr17	49860850	49861705	855	428.0	
80848	chr17	49880262	49881124	862	431.0	
80849	chr17	49939220	49939963	743	372.0	
80850	chr17	49952389	49952934	545	272.0	
80851	chr17	49963764	49966552	2788	1394.0	
80852	chr17	49967979	49970769	2790	1395.0	
80853	chr17	49971649	49973415	1766	883.0	
80854	chr17	49978476	49978947	471	236.0	
80855	chr17	49993180	49995651	2471	1236.0	
80856	chr17	49996165	49997419	1254	627.0	
80857	chr17	49997985	49998717	732	366.0	
80858	chr17	50026730	50027910	1180	590.0	
80859	chr17	50054902	50057125	2223	1112.0	
80860	chr17	50087139	50088067	928	464.0	
80861	chr17	50093973	50096531	2558	1279.0	
80862	chr17	50114816	50115327	511	256.0	
80863	chr17	50117068	50118027	959	480.0	
80864	chr17	50127676	50133096	5420	2710.0	
80865	chr17	50139560	50143118	3558	1779.0	
80866	chr17	50144992	50144996	4	2.0	
80867	chr17	50145921	50153075	7154	3577.0	
80868	chr17	50153949	50154664	715	358.0	
80869	chr17	50160861	50162838	1977	988.0	
80870	chr17	50163731	50164218	487	244.0	
80871	chr17	50168750	50170219	1469	734.0	
80872	chr17	50178121	50178794	673	336.0	
80873	chr17	50183504	50185201	1697	848.0	
80874	chr17	50198163	50198682	519	260.0	
80875	chr17	50199352	50201448	2096	1048.0	
80876	chr17	50212932	50213546	614	307.0	
80877	chr17	50221265	50222301	1036	518.0	
80878	chr17	50269956	50270643	687	344.0	
80879	chr17	50272884	50273717	833	416.0	
80880	chr17	50274479	50274834	355	178.0	
80881	chr17	50280566	50281288	722	361.0	
80882	chr17	50283119	50283659	540	270.0	
80883	chr17	50287258	50287674	416	208.0	
80884	chr17	50289784	50290779	995	498.0	
80885	chr17	50297304	50297977	673	336.0	
80886	chr17	50302381	50302534	153	76.0	
80887	chr17	50344762	50347651	2889	1444.0	
80888	chr17	50361711	50362643	932	466.0	
80889	chr17	50372335	50373684	1349	674.0	
80890	chr17	50391459	50392025	566	283.0	
80891	chr17	50396201	50398230	2029	1014.0	
80892	chr17	50421262	50422147	885	442.0	
80893	chr17	50423826	50424249	423	212.0	
80894	chr17	50425240	50427811	2571	1286.0	
80895	chr17	50452571	50453006	435	218.0	
80896	chr17	50468857	50469526	669	334.0	
80897	chr17	50478079	50480213	2134	1067.0	
80898	chr17	50481041	50481513	472	236.0	
80899	chr17	50482207	50483040	833	416.0	
80900	chr17	50503806	50504645	839	420.0	
80901	chr17	50506700	50509238	2538	1269.0	
80902	chr17	50510980	50511624	644	322.0	
80903	chr17	50533678	50534390	712	356.0	
80904	chr17	50541371	50542853	1482	741.0	
80905	chr17	50546627	50548099	1472	736.0	
80906	chr17	50550785	50551181	396	198.0	
80907	chr17	50558562	50564322	5760	2880.0	
80908	chr17	50564851	50566425	1574	787.0	
80909	chr17	50594417	50594768	351	176.0	
80910	chr17	50613809	50614519	710	355.0	
80911	chr17	50618994	50619517	523	262.0	
80912	chr17	50621348	50621998	650	325.0	
80913	chr17	50624480	50624891	411	206.0	
80914	chr17	50626021	50626559	538	269.0	
80915	chr17	50630470	50631029	559	280.0	
80916	chr17	50634000	50635466	1466	733.0	
80917	chr17	50639022	50639755	733	366.0	
80918	chr17	50640583	50641432	849	424.0	
80919	chr17	50660528	50662238	1710	855.0	
80920	chr17	50681196	50681749	553	276.0	
80921	chr17	50695084	50695461	377	188.0	
80922	chr17	50705124	50705525	401	200.0	
80923	chr17	50706811	50709096	2285	1142.0	
80924	chr17	50715865	50717068	1203	602.0	
80925	chr17	50718702	50720616	1914	957.0	
80926	chr17	50721154	50721984	830	415.0	
80927	chr17	50731588	50732547	959	480.0	
80928	chr17	50757085	50757298	213	106.0	
80929	chr17	50762850	50763597	747	374.0	
80930	chr17	50765336	50766036	700	350.0	
80931	chr17	50772233	50772724	491	246.0	
80932	chr17	50779703	50780687	984	492.0	
80933	chr17	50782908	50783614	706	353.0	
80934	chr17	50790511	50791015	504	252.0	
80935	chr17	50792806	50793685	879	440.0	
80936	chr17	50816328	50817673	1345	672.0	
80937	chr17	50841794	50842314	520	260.0	
80938	chr17	50848681	50849087	406	203.0	
80939	chr17	50851600	50852877	1277	638.0	
80940	chr17	50854600	50855061	461	230.0	
80941	chr17	50860904	50862033	1129	564.0	
80942	chr17	50862905	50868391	5486	2743.0	
80943	chr17	50871207	50872179	972	486.0	
80944	chr17	50872688	50873405	717	358.0	
80945	chr17	50883816	50884874	1058	529.0	
80946	chr17	50887197	50887782	585	292.0	
80947	chr17	50902702	50902724	22	11.0	
80948	chr17	50903791	50904771	980	490.0	
80949	chr17	50908086	50908478	392	196.0	
80950	chr17	50909105	50911174	2069	1034.0	
80951	chr17	50916143	50916382	239	120.0	
80952	chr17	50918044	50920408	2364	1182.0	
80953	chr17	50921165	50921549	384	192.0	
80954	chr17	50928627	50929848	1221	610.0	
80955	chr17	50930815	50932166	1351	676.0	
80956	chr17	50933314	50934012	698	349.0	
80957	chr17	50935219	50935816	597	298.0	
80958	chr17	50943886	50945261	1375	688.0	
80959	chr17	50948293	50948405	112	56.0	
80960	chr17	50949888	50951232	1344	672.0	
80961	chr17	50951979	50952333	354	177.0	
80962	chr17	50954316	50954588	272	136.0	
80963	chr17	50956536	50957408	872	436.0	
80964	chr17	51001016	51001513	497	248.0	
80965	chr17	51029140	51030648	1508	754.0	
80966	chr17	51050628	51050952	324	162.0	
80967	chr17	51056764	51057176	412	206.0	
80968	chr17	51071236	51071310	74	37.0	
80969	chr17	51079079	51079211	132	66.0	
80970	chr17	51083969	51084447	478	239.0	
80971	chr17	51087206	51087394	188	94.0	
80972	chr17	51088245	51089374	1129	564.0	
80973	chr17	51091017	51091232	215	108.0	
80974	chr17	51093682	51094058	376	188.0	
80975	chr17	51096096	51098494	2398	1199.0	
80976	chr17	51100415	51100758	343	172.0	
80977	chr17	51105729	51106039	310	155.0	
80978	chr17	51108403	51108723	320	160.0	
80979	chr17	51112448	51113352	904	452.0	
80980	chr17	51115356	51115414	58	29.0	
80981	chr17	51116641	51117117	476	238.0	
80982	chr17	51118281	51118656	375	188.0	
80983	chr17	51119236	51122591	3355	1678.0	
80984	chr17	51127977	51128548	571	286.0	
80985	chr17	51152708	51154550	1842	921.0	
80986	chr17	51165382	51167633	2251	1126.0	
80987	chr17	51200404	51200705	301	150.0	
80988	chr17	51238246	51238886	640	320.0	
80989	chr17	51258683	51262190	3507	1754.0	
80990	chr17	51365127	51365423	296	148.0	
80991	chr17	51371631	51373079	1448	724.0	
80992	chr17	51374182	51374588	406	203.0	
80993	chr17	51427201	51428370	1169	584.0	
80994	chr17	51435334	51436016	682	341.0	
80995	chr17	51461648	51461894	246	123.0	
80996	chr17	51764389	51764726	337	168.0	
80997	chr17	54900656	54900804	148	74.0	
80998	chr17	54967502	54969570	2068	1034.0	
80999	chr17	54993025	54993489	464	232.0	
81000	chr17	55072930	55073273	343	172.0	
81001	chr17	55090261	55090295	34	17.0	
81002	chr17	55237197	55239241	2044	1022.0	
81003	chr17	55263537	55266600	3063	1532.0	
81004	chr17	55294625	55294629	4	2.0	
81005	chr17	55295884	55296352	468	234.0	
81006	chr17	55348725	55349176	451	226.0	
81007	chr17	55356503	55357138	635	318.0	
81008	chr17	55394522	55395294	772	386.0	
81009	chr17	55414033	55414588	555	278.0	
81010	chr17	55419102	55422620	3518	1759.0	
81011	chr17	55437033	55437763	730	365.0	
81012	chr17	55444907	55445386	479	240.0	
81013	chr17	55496183	55496855	672	336.0	
81014	chr17	55513933	55514465	532	266.0	
81015	chr17	55521158	55521629	471	236.0	
81016	chr17	55526334	55526792	458	229.0	
81017	chr17	55576355	55578099	1744	872.0	
81018	chr17	55583991	55584480	489	244.0	
81019	chr17	55601771	55602201	430	215.0	
81020	chr17	55639949	55640492	543	272.0	
81021	chr17	55641768	55642132	364	182.0	
81022	chr17	55664204	55664715	511	256.0	
81023	chr17	55672508	55673494	986	493.0	
81024	chr17	55674038	55674589	551	276.0	
81025	chr17	55690084	55690582	498	249.0	
81026	chr17	55693192	55693705	513	256.0	
81027	chr17	55704437	55704761	324	162.0	
81028	chr17	55710615	55710777	162	81.0	
81029	chr17	55718129	55718525	396	198.0	
81030	chr17	55735770	55736171	401	200.0	
81031	chr17	55750512	55751809	1297	648.0	
81032	chr17	55763768	55764293	525	262.0	
81033	chr17	56290553	56290848	295	148.0	
81034	chr17	56304965	56305316	351	176.0	
81035	chr17	56310682	56311325	643	322.0	
81036	chr17	56313147	56313642	495	248.0	
81037	chr17	56592380	56596865	4485	2242.0	
81038	chr17	56597497	56597950	453	226.0	
81039	chr17	56598909	56599664	755	378.0	
81040	chr17	56602355	56603067	712	356.0	
81041	chr17	56653836	56654362	526	263.0	
81042	chr17	56678699	56679573	874	437.0	
81043	chr17	56681551	56682322	771	386.0	
81044	chr17	56715784	56716404	620	310.0	
81045	chr17	56737614	56738052	438	219.0	
81046	chr17	56779586	56780980	1394	697.0	
81047	chr17	56786806	56787680	874	437.0	
81048	chr17	56793788	56794353	565	282.0	
81049	chr17	56814099	56814424	325	162.0	
81050	chr17	56819411	56820119	708	354.0	
81051	chr17	56832461	56835523	3062	1531.0	
81052	chr17	56870175	56870491	316	158.0	
81053	chr17	56880085	56880620	535	268.0	
81054	chr17	56891729	56892342	613	306.0	
81055	chr17	56907759	56908928	1169	584.0	
81056	chr17	56910092	56910515	423	212.0	
81057	chr17	56912119	56915010	2891	1446.0	
81058	chr17	56915630	56916388	758	379.0	
81059	chr17	56918822	56919615	793	396.0	
81060	chr17	56939788	56940377	589	294.0	
81061	chr17	56960437	56961443	1006	503.0	
81062	chr17	56977112	56979287	2175	1088.0	
81063	chr17	56983215	56983864	649	324.0	
81064	chr17	56985269	56986234	965	482.0	
81065	chr17	57004881	57005636	755	378.0	
81066	chr17	57009943	57010463	520	260.0	
81067	chr17	57045588	57047267	1679	840.0	
81068	chr17	57082392	57082942	550	275.0	
81069	chr17	57084394	57086966	2572	1286.0	
81070	chr17	57092148	57092624	476	238.0	
81071	chr17	57102134	57102535	401	200.0	
81072	chr17	57113990	57114481	491	246.0	
81073	chr17	57130897	57131423	526	263.0	
81074	chr17	57243010	57243749	739	370.0	
81075	chr17	57253613	57253836	223	112.0	
81076	chr17	57254414	57259067	4653	2326.0	
81077	chr17	57281981	57282278	297	148.0	
81078	chr17	57284756	57285737	981	490.0	
81079	chr17	57338613	57338664	51	26.0	
81080	chr17	57357062	57357336	274	137.0	
81081	chr17	57408330	57408812	482	241.0	
81082	chr17	57440194	57441557	1363	682.0	
81083	chr17	57442959	57443635	676	338.0	
81084	chr17	57454903	57455875	972	486.0	
81085	chr17	57486984	57487338	354	177.0	
81086	chr17	57551240	57552693	1453	726.0	
81087	chr17	57554244	57554380	136	68.0	
81088	chr17	57561158	57561559	401	200.0	
81089	chr17	57577883	57578277	394	197.0	
81090	chr17	57597781	57598208	427	214.0	
81091	chr17	57599192	57600580	1388	694.0	
81092	chr17	57601187	57601813	626	313.0	
81093	chr17	57603639	57606258	2619	1310.0	
81094	chr17	57612507	57613135	628	314.0	
81095	chr17	57622764	57623287	523	262.0	
81096	chr17	57629294	57630062	768	384.0	
81097	chr17	57645973	57646569	596	298.0	
81098	chr17	57662601	57663489	888	444.0	
81099	chr17	57671776	57672881	1105	552.0	
81100	chr17	57697900	57699524	1624	812.0	
81101	chr17	57739918	57740290	372	186.0	
81102	chr17	57747497	57747963	466	233.0	
81103	chr17	57750285	57750504	219	110.0	
81104	chr17	57783157	57783838	681	340.0	
81105	chr17	57811114	57811611	497	248.0	
81106	chr17	57832340	57833749	1409	704.0	
81107	chr17	57849438	57850920	1482	741.0	
81108	chr17	57857834	57858352	518	259.0	
81109	chr17	57860693	57862154	1461	730.0	
81110	chr17	57867761	57869081	1320	660.0	
81111	chr17	57873257	57873328	71	36.0	
81112	chr17	57874322	57874897	575	288.0	
81113	chr17	57890282	57890456	174	87.0	
81114	chr17	57892237	57893698	1461	730.0	
81115	chr17	57899206	57900299	1093	546.0	
81116	chr17	57903007	57903873	866	433.0	
81117	chr17	57905417	57906153	736	368.0	
81118	chr17	57917094	57917535	441	220.0	
81119	chr17	57939517	57940295	778	389.0	
81120	chr17	57943231	57943616	385	192.0	
81121	chr17	57946391	57947521	1130	565.0	
81122	chr17	57948410	57950085	1675	838.0	
81123	chr17	57950784	57951473	689	344.0	
81124	chr17	57954576	57956948	2372	1186.0	
81125	chr17	57982321	57982976	655	328.0	
81126	chr17	57986718	57989287	2569	1284.0	
81127	chr17	57993424	57994175	751	376.0	
81128	chr17	57995148	57996079	931	466.0	
81129	chr17	57998038	57998341	303	152.0	
81130	chr17	57999125	58000108	983	492.0	
81131	chr17	58006136	58008436	2300	1150.0	
81132	chr17	58082554	58085797	3243	1622.0	
81133	chr17	58086729	58087271	542	271.0	
81134	chr17	58088283	58088653	370	185.0	
81135	chr17	58090214	58090454	240	120.0	
81136	chr17	58091123	58093764	2641	1320.0	
81137	chr17	58094443	58094659	216	108.0	
81138	chr17	58112931	58113525	594	297.0	
81139	chr17	58120191	58120600	409	204.0	
81140	chr17	58121871	58122355	484	242.0	
81141	chr17	58152665	58153634	969	484.0	
81142	chr17	58156613	58157916	1303	652.0	
81143	chr17	58170629	58170834	205	102.0	
81144	chr17	58172228	58172876	648	324.0	
81145	chr17	58199970	58200475	505	252.0	
81146	chr17	58217759	58220054	2295	1148.0	
81147	chr17	58232454	58234010	1556	778.0	
81148	chr17	58247770	58247941	171	86.0	
81149	chr17	58249165	58250270	1105	552.0	
81150	chr17	58273161	58273790	629	314.0	"enhancer	enhancer"
81151	chr17	58277070	58280123	3053	1526.0	"enhancer	region"
81152	chr17	58281680	58282177	497	248.0	"region	promoter	protein_binding_site	regulatory_region	promoter	protein_binding_site	enhancer	promoter"
81153	chr17	58287968	58288943	975	488.0	
81154	chr17	58291322	58291521	199	100.0	
81155	chr17	58302883	58304869	1986	993.0	
81156	chr17	58308239	58308906	667	334.0	
81157	chr17	58309531	58310475	944	472.0	
81158	chr17	58311186	58311190	4	2.0	
81159	chr17	58312116	58312219	103	52.0	
81160	chr17	58317112	58318360	1248	624.0	
81161	chr17	58319369	58320053	684	342.0	
81162	chr17	58322921	58341179	18258	9129.0	
81163	chr17	58341702	58342793	1091	546.0	
81164	chr17	58343483	58345458	1975	988.0	
81165	chr17	58351170	58353856	2686	1343.0	
81166	chr17	58368928	58369186	258	129.0	
81167	chr17	58369936	58370697	761	380.0	
81168	chr17	58375265	58375674	409	204.0	
81169	chr17	58376654	58377060	406	203.0	
81170	chr17	58382249	58382960	711	356.0	
81171	chr17	58384963	58385275	312	156.0	
81172	chr17	58387717	58388182	465	232.0	
81173	chr17	58417238	58418187	949	474.0	
81174	chr17	58447426	58447916	490	245.0	
81175	chr17	58487324	58488459	1135	568.0	
81176	chr17	58503848	58504241	393	196.0	
81177	chr17	58504892	58505474	582	291.0	
81178	chr17	58507033	58507541	508	254.0	
81179	chr17	58513381	58515218	1837	918.0	
81180	chr17	58517040	58519889	2849	1424.0	
81181	chr17	58520783	58521243	460	230.0	
81182	chr17	58526937	58527630	693	346.0	
81183	chr17	58531359	58532743	1384	692.0	
81184	chr17	58534331	58535497	1166	583.0	
81185	chr17	58556890	58557311	421	210.0	
81186	chr17	58568736	58569617	881	440.0	
81187	chr17	58577654	58578055	401	200.0	
81188	chr17	58587580	58588118	538	269.0	
81189	chr17	58605504	58605766	262	131.0	
81190	chr17	58614808	58615316	508	254.0	
81191	chr17	58615971	58616314	343	172.0	
81192	chr17	58621244	58621542	298	149.0	
81193	chr17	58626893	58627384	491	246.0	
81194	chr17	58630505	58632772	2267	1134.0	
81195	chr17	58657344	58660023	2679	1340.0	
81196	chr17	58666654	58667434	780	390.0	
81197	chr17	58692085	58693261	1176	588.0	
81198	chr17	58710990	58711175	185	92.0	
81199	chr17	58755573	58756074	501	250.0	
81200	chr17	58944856	58945385	529	264.0	
81201	chr17	58947846	58948225	379	190.0	
81202	chr17	58954332	58954694	362	181.0	
81203	chr17	58985453	58985653	200	100.0	
81204	chr17	58996973	58997439	466	233.0	
81205	chr17	59001078	59002070	992	496.0	
81206	chr17	59004622	59005308	686	343.0	
81207	chr17	59105899	59107644	1745	872.0	
81208	chr17	59154182	59156775	2593	1296.0	
81209	chr17	59160144	59160618	474	237.0	
81210	chr17	59165844	59166370	526	263.0	
81211	chr17	59167405	59168000	595	298.0	
81212	chr17	59170782	59171030	248	124.0	
81213	chr17	59209199	59210654	1455	728.0	
81214	chr17	59219962	59221456	1494	747.0	
81215	chr17	59276918	59278806	1888	944.0	
81216	chr17	59287492	59287848	356	178.0	
81217	chr17	59300840	59301462	622	311.0	
81218	chr17	59310883	59311599	716	358.0	
81219	chr17	59324253	59324512	259	130.0	
81220	chr17	59327941	59328281	340	170.0	
81221	chr17	59329308	59333461	4153	2076.0	
81222	chr17	59361974	59362848	874	437.0	
81223	chr17	59365235	59366471	1236	618.0	
81224	chr17	59370948	59370952	4	2.0	
81225	chr17	59372080	59374845	2765	1382.0	
81226	chr17	59415411	59415849	438	219.0	
81227	chr17	59433640	59433945	305	152.0	
81228	chr17	59435553	59435605	52	26.0	
81229	chr17	59437468	59438332	864	432.0	
81230	chr17	59440569	59441264	695	348.0	
81231	chr17	59456620	59456647	27	14.0	
81232	chr17	59514131	59516431	2300	1150.0	
81233	chr17	59521373	59521935	562	281.0	
81234	chr17	59533593	59534178	585	292.0	
81235	chr17	59543203	59543614	411	206.0	
81236	chr17	59561014	59561485	471	236.0	
81237	chr17	59564934	59566454	1520	760.0	
81238	chr17	59607809	59608167	358	179.0	
81239	chr17	59618317	59621384	3067	1534.0	
81240	chr17	59622388	59622984	596	298.0	
81241	chr17	59627640	59628259	619	310.0	
81242	chr17	59641864	59642576	712	356.0	
81243	chr17	59643401	59643799	398	199.0	
81244	chr17	59656547	59657093	546	273.0	
81245	chr17	59706406	59708905	2499	1250.0	
81246	chr17	59712819	59713285	466	233.0	
81247	chr17	59715408	59715468	60	30.0	
81248	chr17	59723444	59723811	367	184.0	
81249	chr17	59725614	59726141	527	264.0	
81250	chr17	59729271	59730418	1147	574.0	
81251	chr17	59746833	59747259	426	213.0	
81252	chr17	59753160	59754836	1676	838.0	"enhancer	sequence_feature"
81253	chr17	59760131	59760444	313	156.0	
81254	chr17	59769291	59769399	108	54.0	
81255	chr17	59769956	59770437	481	240.0	
81256	chr17	59779068	59779386	318	159.0	
81257	chr17	59782796	59784597	1801	900.0	
81258	chr17	59785459	59785493	34	17.0	
81259	chr17	59786090	59787629	1539	770.0	
81260	chr17	59790819	59791437	618	309.0	
81261	chr17	59804781	59805520	739	370.0	
81262	chr17	59825709	59826289	580	290.0	
81263	chr17	59827090	59829991	2901	1450.0	
81264	chr17	59836979	59841569	4590	2295.0	
81265	chr17	59842123	59849427	7304	3652.0	
81266	chr17	59852039	59852139	100	50.0	
81267	chr17	59853154	59853643	489	244.0	
81268	chr17	59856024	59856028	4	2.0	
81269	chr17	59859385	59859855	470	235.0	
81270	chr17	59876117	59876517	400	200.0	
81271	chr17	59892091	59894713	2622	1311.0	
81272	chr17	59898967	59899576	609	304.0	
81273	chr17	59914242	59914704	462	231.0	
81274	chr17	59963774	59965453	1679	840.0	
81275	chr17	60036926	60037713	787	394.0	
81276	chr17	60077854	60079505	1651	826.0	
81277	chr17	60086768	60087160	392	196.0	
81278	chr17	60089123	60089873	750	375.0	
81279	chr17	60090481	60090775	294	147.0	
81280	chr17	60091684	60093218	1534	767.0	
81281	chr17	60094644	60095254	610	305.0	
81282	chr17	60102423	60103227	804	402.0	
81283	chr17	60134659	60136055	1396	698.0	
81284	chr17	60139520	60140385	865	432.0	
81285	chr17	60141380	60143355	1975	988.0	
81286	chr17	60161829	60162563	734	367.0	
81287	chr17	60170400	60170960	560	280.0	
81288	chr17	60186949	60187329	380	190.0	
81289	chr17	60305024	60305661	637	318.0	
81290	chr17	60326153	60326412	259	130.0	
81291	chr17	60357605	60358016	411	206.0	
81292	chr17	60363731	60364101	370	185.0	
81293	chr17	60371800	60372550	750	375.0	
81294	chr17	60383932	60384406	474	237.0	
81295	chr17	60386126	60386171	45	22.0	
81296	chr17	60390155	60394592	4437	2218.0	
81297	chr17	60395602	60396083	481	240.0	
81298	chr17	60398063	60398999	936	468.0	
81299	chr17	60421112	60422635	1523	762.0	
81300	chr17	60435664	60436358	694	347.0	
81301	chr17	60437381	60437786	405	202.0	
81302	chr17	60525013	60526881	1868	934.0	
81303	chr17	60569739	60570202	463	232.0	
81304	chr17	60577041	60577916	875	438.0	
81305	chr17	60598256	60602661	4405	2202.0	
81306	chr17	60638642	60639208	566	283.0	
81307	chr17	60641753	60642154	401	200.0	
81308	chr17	60652325	60652858	533	266.0	
81309	chr17	60674787	60674788	1	0.0	
81310	chr17	60676906	60678504	1598	799.0	
81311	chr17	60694702	60695079	377	188.0	
81312	chr17	60720740	60721142	402	201.0	
81313	chr17	60864505	60864544	39	20.0	
81314	chr17	61130366	61130692	326	163.0	
81315	chr17	61139012	61139836	824	412.0	
81316	chr17	61218543	61218894	351	176.0	
81317	chr17	61221096	61223408	2312	1156.0	
81318	chr17	61234043	61234371	328	164.0	
81319	chr17	61245137	61245286	149	74.0	
81320	chr17	61250296	61251382	1086	543.0	
81321	chr17	61251953	61252868	915	458.0	
81322	chr17	61374025	61374339	314	157.0	
81323	chr17	61389891	61390326	435	218.0	
81324	chr17	61396751	61397117	366	183.0	
81325	chr17	61398501	61399015	514	257.0	promoter
81326	chr17	61399789	61401289	1500	750.0	"promoter	promoter	protein_binding_site	protein_binding_site	region"
81327	chr17	61401908	61402180	272	136.0	
81328	chr17	61402814	61405659	2845	1422.0	
81329	chr17	61408141	61408506	365	182.0	
81330	chr17	61409090	61413369	4279	2140.0	
81331	chr17	61416557	61417452	895	448.0	
81332	chr17	61467626	61468026	400	200.0	
81333	chr17	61635933	61636320	387	194.0	
81334	chr17	61806169	61806321	152	76.0	
81335	chr17	61816524	61816934	410	205.0	enhancer
81336	chr17	61837204	61837594	390	195.0	
81337	chr17	61862707	61864291	1584	792.0	
81338	chr17	61904080	61904965	885	442.0	
81339	chr17	61926911	61928636	1725	862.0	
81340	chr17	61970061	61970639	578	289.0	
81341	chr17	62042539	62042736	197	98.0	
81342	chr17	62062320	62062632	312	156.0	
81343	chr17	62063687	62066689	3002	1501.0	
81344	chr17	62098608	62099226	618	309.0	
81345	chr17	62109413	62109897	484	242.0	
81346	chr17	62170281	62171958	1677	838.0	
81347	chr17	62172717	62173064	347	174.0	
81348	chr17	62421323	62421834	511	256.0	
81349	chr17	62423349	62424642	1293	646.0	
81350	chr17	62452173	62452719	546	273.0	
81351	chr17	62453566	62454055	489	244.0	
81352	chr17	62470663	62471173	510	255.0	
81353	chr17	62477576	62480291	2715	1358.0	
81354	chr17	62484942	62485377	435	218.0	
81355	chr17	62553086	62553729	643	322.0	
81356	chr17	62611283	62612370	1087	544.0	
81357	chr17	62625201	62625615	414	207.0	
81358	chr17	62626685	62628706	2021	1010.0	
81359	chr17	62634836	62635124	288	144.0	
81360	chr17	62652053	62654151	2098	1049.0	
81361	chr17	62672263	62672708	445	222.0	
81362	chr17	62703365	62704843	1478	739.0	
81363	chr17	62720382	62720655	273	136.0	
81364	chr17	62724200	62725433	1233	616.0	
81365	chr17	62793084	62794707	1623	812.0	
81366	chr17	62808138	62808612	474	237.0	
81367	chr17	62827689	62827949	260	130.0	
81368	chr17	62882226	62883317	1091	546.0	
81369	chr17	62892741	62893479	738	369.0	
81370	chr17	62895438	62896420	982	491.0	
81371	chr17	62899168	62899821	653	326.0	
81372	chr17	62965121	62967258	2137	1068.0	
81373	chr17	62968311	62969110	799	400.0	
81374	chr17	62995251	62996038	787	394.0	
81375	chr17	63076195	63076359	164	82.0	
81376	chr17	63140205	63140806	601	300.0	
81377	chr17	63191522	63192111	589	294.0	
81378	chr17	63196957	63197340	383	192.0	
81379	chr17	63221962	63222303	341	170.0	
81380	chr17	63275316	63275757	441	220.0	
81381	chr17	63278974	63279208	234	117.0	
81382	chr17	63279784	63280108	324	162.0	
81383	chr17	63405634	63406100	466	233.0	
81384	chr17	63406645	63407193	548	274.0	
81385	chr17	63419980	63420464	484	242.0	
81386	chr17	63425329	63426026	697	348.0	
81387	chr17	63428299	63428413	114	57.0	
81388	chr17	63434665	63436161	1496	748.0	
81389	chr17	63438381	63438771	390	195.0	
81390	chr17	63439432	63440736	1304	652.0	
81391	chr17	63442530	63442818	288	144.0	
81392	chr17	63445209	63447704	2495	1248.0	
81393	chr17	63460718	63461985	1267	634.0	
81394	chr17	63476350	63477988	1638	819.0	
81395	chr17	63478780	63479336	556	278.0	
81396	chr17	63499240	63499512	272	136.0	
81397	chr17	63522832	63523614	782	391.0	
81398	chr17	63538139	63538549	410	205.0	
81399	chr17	63549446	63552306	2860	1430.0	
81400	chr17	63585577	63586013	436	218.0	
81401	chr17	63597182	63597662	480	240.0	
81402	chr17	63598165	63598818	653	326.0	
81403	chr17	63600409	63601614	1205	602.0	
81404	chr17	63610154	63610510	356	178.0	
81405	chr17	63611206	63612713	1507	754.0	
81406	chr17	63621361	63623573	2212	1106.0	
81407	chr17	63624239	63624919	680	340.0	
81408	chr17	63626836	63627207	371	186.0	
81409	chr17	63634064	63634551	487	244.0	
81410	chr17	63641415	63642478	1063	532.0	
81411	chr17	63644891	63645162	271	136.0	
81412	chr17	63646115	63646939	824	412.0	
81413	chr17	63649711	63650188	477	238.0	
81414	chr17	63654460	63654861	401	200.0	
81415	chr17	63665260	63666207	947	474.0	
81416	chr17	63675915	63675993	78	39.0	enhancer
81417	chr17	63692234	63703381	11147	5574.0	
81418	chr17	63705191	63707829	2638	1319.0	
81419	chr17	63710095	63710955	860	430.0	
81420	chr17	63740569	63743650	3081	1540.0	
81421	chr17	63751736	63752288	552	276.0	
81422	chr17	63753317	63753381	64	32.0	
81423	chr17	63761473	63761945	472	236.0	
81424	chr17	63770283	63770759	476	238.0	
81425	chr17	63772179	63775474	3295	1648.0	
81426	chr17	63819626	63820498	872	436.0	
81427	chr17	63824790	63824799	9	4.0	
81428	chr17	63826265	63828328	2063	1032.0	
81429	chr17	63830620	63831006	386	193.0	
81430	chr17	63831605	63831942	337	168.0	
81431	chr17	63834425	63835479	1054	527.0	
81432	chr17	63838608	63839810	1202	601.0	
81433	chr17	63840347	63844197	3850	1925.0	
81434	chr17	63848408	63849872	1464	732.0	
81435	chr17	63865987	63866589	602	301.0	
81436	chr17	63882173	63882662	489	244.0	
81437	chr17	63888920	63889598	678	339.0	
81438	chr17	63899671	63899719	48	24.0	
81439	chr17	63903708	63904147	439	220.0	
81440	chr17	63911402	63912084	682	341.0	recombination_feature
81441	chr17	63915785	63916185	400	200.0	recombination_feature
81442	chr17	63919109	63919781	672	336.0	"locus_control_region	promoter	recombination_feature"
81443	chr17	63922349	63922804	455	228.0	"locus_control_region	recombination_feature"
81444	chr17	63925537	63926069	532	266.0	locus_control_region
81445	chr17	63927513	63927832	319	160.0	locus_control_region
81446	chr17	63930864	63932929	2065	1032.0	locus_control_region
81447	chr17	63934926	63934968	42	21.0	"locus_control_region	enhancer	region	protein_binding_site	protein_binding_site"
81448	chr17	63945575	63947364	1789	894.0	"locus_control_region	region	region	enhancer	protein_binding_site	protein_binding_site"
81449	chr17	63950906	63951341	435	218.0	"locus_control_region	region	region	insulator	insulator"
81450	chr17	63954259	63955040	781	390.0	locus_control_region
81451	chr17	63961317	63962345	1028	514.0	
81452	chr17	63966760	63967294	534	267.0	
81453	chr17	63983376	63983564	188	94.0	
81454	chr17	63984755	63985960	1205	602.0	
81455	chr17	63989986	63991192	1206	603.0	
81456	chr17	63992700	63994225	1525	762.0	
81457	chr17	63997504	64000355	2851	1426.0	
81458	chr17	64001159	64002529	1370	685.0	
81459	chr17	64009407	64010049	642	321.0	
81460	chr17	64014606	64021724	7118	3559.0	
81461	chr17	64022262	64023065	803	402.0	
81462	chr17	64024184	64026403	2219	1110.0	
81463	chr17	64027319	64027769	450	225.0	
81464	chr17	64028834	64029322	488	244.0	
81465	chr17	64051030	64051821	791	396.0	
81466	chr17	64056229	64057091	862	431.0	
81467	chr17	64060263	64062080	1817	908.0	
81468	chr17	64062921	64064460	1539	770.0	
81469	chr17	64066477	64068089	1612	806.0	
81470	chr17	64073990	64076090	2100	1050.0	
81471	chr17	64077254	64077880	626	313.0	
81472	chr17	64081773	64082855	1082	541.0	
81473	chr17	64083632	64084436	804	402.0	
81474	chr17	64085776	64085879	103	52.0	
81475	chr17	64091130	64093455	2325	1162.0	
81476	chr17	64095661	64095806	145	72.0	
81477	chr17	64097184	64097532	348	174.0	
81478	chr17	64103343	64104361	1018	509.0	
81479	chr17	64106323	64109964	3641	1820.0	
81480	chr17	64112135	64112608	473	236.0	
81481	chr17	64114534	64116478	1944	972.0	
81482	chr17	64117702	64119083	1381	690.0	
81483	chr17	64120180	64121768	1588	794.0	
81484	chr17	64125371	64131768	6397	3198.0	
81485	chr17	64133343	64134056	713	356.0	
81486	chr17	64144984	64147745	2761	1380.0	
81487	chr17	64148719	64149034	315	158.0	
81488	chr17	64150600	64150609	9	4.0	
81489	chr17	64156266	64156525	259	130.0	
81490	chr17	64174577	64175623	1046	523.0	
81491	chr17	64180043	64181074	1031	516.0	
81492	chr17	64185111	64185274	163	82.0	
81493	chr17	64216735	64217101	366	183.0	
81494	chr17	64218004	64218659	655	328.0	
81495	chr17	64260806	64261162	356	178.0	
81496	chr17	64261739	64264142	2403	1202.0	
81497	chr17	64270597	64271389	792	396.0	
81498	chr17	64272936	64273407	471	236.0	
81499	chr17	64278579	64278721	142	71.0	
81500	chr17	64281897	64282439	542	271.0	
81501	chr17	64287488	64288038	550	275.0	
81502	chr17	64306812	64307321	509	254.0	
81503	chr17	64319177	64319238	61	30.0	
81504	chr17	64320369	64321701	1332	666.0	
81505	chr17	64326037	64327351	1314	657.0	
81506	chr17	64331309	64332661	1352	676.0	
81507	chr17	64475325	64476072	747	374.0	
81508	chr17	64479619	64480020	401	200.0	
81509	chr17	64481040	64481231	191	96.0	
81510	chr17	64484360	64484778	418	209.0	
81511	chr17	64489513	64489702	189	94.0	
81512	chr17	64490970	64491903	933	466.0	
81513	chr17	64492464	64508172	15708	7854.0	
81514	chr17	64572757	64573118	361	180.0	
81515	chr17	64599234	64600065	831	416.0	
81516	chr17	64602547	64602802	255	128.0	
81517	chr17	64613338	64613642	304	152.0	
81518	chr17	64628738	64628925	187	94.0	
81519	chr17	64634279	64634542	263	132.0	
81520	chr17	64649005	64649556	551	276.0	
81521	chr17	64657920	64658116	196	98.0	
81522	chr17	64658956	64659097	141	70.0	
81523	chr17	64660043	64663079	3036	1518.0	
81524	chr17	64694179	64694616	437	218.0	
81525	chr17	64706965	64707669	704	352.0	
81526	chr17	64708558	64709863	1305	652.0	
81527	chr17	64712406	64714334	1928	964.0	
81528	chr17	64736870	64737278	408	204.0	
81529	chr17	64741199	64741304	105	52.0	
81530	chr17	64774186	64774708	522	261.0	
81531	chr17	64776411	64783552	7141	3570.0	
81532	chr17	64792743	64793204	461	230.0	
81533	chr17	64808286	64809102	816	408.0	
81534	chr17	64833984	64834315	331	166.0	
81535	chr17	64835588	64838278	2690	1345.0	
81536	chr17	64840885	64841456	571	286.0	
81537	chr17	64846947	64848417	1470	735.0	
81538	chr17	64918642	64921046	2404	1202.0	
81539	chr17	64922855	64923626	771	386.0	
81540	chr17	64927343	64927978	635	318.0	
81541	chr17	64938798	64939642	844	422.0	
81542	chr17	64961525	64962628	1103	552.0	
81543	chr17	64965479	64966546	1067	534.0	
81544	chr17	64967758	64967982	224	112.0	
81545	chr17	64968561	64971109	2548	1274.0	
81546	chr17	64973780	64976706	2926	1463.0	
81547	chr17	64984537	64986962	2425	1212.0	
81548	chr17	64988909	64989525	616	308.0	
81549	chr17	64990874	64991386	512	256.0	
81550	chr17	65013724	65014491	767	384.0	
81551	chr17	65020160	65020764	604	302.0	
81552	chr17	65022866	65023502	636	318.0	
81553	chr17	65027098	65030285	3187	1594.0	
81554	chr17	65035759	65036086	327	164.0	
81555	chr17	65037506	65037513	7	4.0	
81556	chr17	65039077	65040148	1071	536.0	
81557	chr17	65040760	65042820	2060	1030.0	
81558	chr17	65047724	65049776	2052	1026.0	
81559	chr17	65054664	65057911	3247	1624.0	
81560	chr17	65060541	65061114	573	286.0	
81561	chr17	65065895	65066362	467	234.0	
81562	chr17	65099789	65101556	1767	884.0	
81563	chr17	65115942	65116100	158	79.0	
81564	chr17	65121969	65124053	2084	1042.0	
81565	chr17	65130906	65131240	334	167.0	
81566	chr17	65136668	65138108	1440	720.0	
81567	chr17	65154848	65155420	572	286.0	
81568	chr17	65164062	65164557	495	248.0	
81569	chr17	65173237	65174196	959	480.0	
81570	chr17	65179014	65180409	1395	698.0	
81571	chr17	65181209	65182661	1452	726.0	
81572	chr17	65198502	65199168	666	333.0	
81573	chr17	65202924	65203313	389	194.0	
81574	chr17	65228706	65229453	747	374.0	
81575	chr17	65231762	65232065	303	152.0	
81576	chr17	65294158	65294598	440	220.0	
81577	chr17	65495220	65495628	408	204.0	
81578	chr17	65523233	65524367	1134	567.0	
81579	chr17	65537785	65538933	1148	574.0	
81580	chr17	65547401	65547664	263	132.0	
81581	chr17	65555965	65557886	1921	960.0	
81582	chr17	65558603	65562375	3772	1886.0	
81583	chr17	65593039	65593386	347	174.0	
81584	chr17	65742009	65742016	7	4.0	
81585	chr17	65750550	65751079	529	264.0	
81586	chr17	66165571	66165903	332	166.0	
81587	chr17	66191410	66192953	1543	772.0	
81588	chr17	66194030	66194599	569	284.0	
81589	chr17	66200610	66201108	498	249.0	
81590	chr17	66201705	66202213	508	254.0	
81591	chr17	66246169	66246964	795	398.0	
81592	chr17	66254982	66256039	1057	528.0	
81593	chr17	66285963	66286300	337	168.0	
81594	chr17	66301658	66305093	3435	1718.0	
81595	chr17	66327996	66328660	664	332.0	
81596	chr17	66330963	66332015	1052	526.0	
81597	chr17	66374146	66374808	662	331.0	
81598	chr17	66399132	66399845	713	356.0	
81599	chr17	66406903	66406906	3	2.0	
81600	chr17	66420997	66421414	417	208.0	
81601	chr17	66426085	66426815	730	365.0	
81602	chr17	66429765	66429767	2	1.0	
81603	chr17	66431362	66432209	847	424.0	
81604	chr17	66433304	66433397	93	46.0	
81605	chr17	66438019	66438518	499	250.0	
81606	chr17	66441062	66441808	746	373.0	
81607	chr17	66451614	66451890	276	138.0	
81608	chr17	66452415	66452432	17	8.0	
81609	chr17	66459698	66460396	698	349.0	
81610	chr17	66461958	66462394	436	218.0	
81611	chr17	66466742	66467404	662	331.0	
81612	chr17	66468401	66469379	978	489.0	
81613	chr17	66478885	66479539	654	327.0	
81614	chr17	66481317	66481645	328	164.0	
81615	chr17	66493960	66494056	96	48.0	
81616	chr17	66542162	66542558	396	198.0	
81617	chr17	66548090	66548815	725	362.0	
81618	chr17	66567120	66567658	538	269.0	
81619	chr17	66633313	66633656	343	172.0	
81620	chr17	66667334	66667927	593	296.0	
81621	chr17	66673374	66674441	1067	534.0	
81622	chr17	66691551	66692090	539	270.0	
81623	chr17	66713405	66714058	653	326.0	
81624	chr17	66715689	66716135	446	223.0	
81625	chr17	66727995	66728318	323	162.0	
81626	chr17	66791230	66791683	453	226.0	
81627	chr17	66906621	66907048	427	214.0	
81628	chr17	67082006	67082528	522	261.0	
81629	chr17	67104639	67105741	1102	551.0	
81630	chr17	67127030	67127331	301	150.0	
81631	chr17	67138009	67138228	219	110.0	
81632	chr17	67164279	67165645	1366	683.0	
81633	chr17	67171276	67171915	639	320.0	
81634	chr17	67200726	67201063	337	168.0	
81635	chr17	67211700	67212083	383	192.0	
81636	chr17	67213010	67213406	396	198.0	
81637	chr17	67221006	67221554	548	274.0	
81638	chr17	67223967	67224332	365	182.0	
81639	chr17	67241762	67242163	401	200.0	
81640	chr17	67244270	67248798	4528	2264.0	
81641	chr17	67257353	67259464	2111	1056.0	
81642	chr17	67260024	67260984	960	480.0	
81643	chr17	67272573	67272900	327	164.0	
81644	chr17	67293251	67294351	1100	550.0	
81645	chr17	67312168	67312702	534	267.0	
81646	chr17	67353161	67354831	1670	835.0	
81647	chr17	67359825	67360550	725	362.0	
81648	chr17	67364935	67367184	2249	1124.0	
81649	chr17	67374308	67375256	948	474.0	
81650	chr17	67376528	67380318	3790	1895.0	
81651	chr17	67381334	67381912	578	289.0	
81652	chr17	67385256	67385478	222	111.0	
81653	chr17	67386937	67387512	575	288.0	
81654	chr17	67390052	67391281	1229	614.0	
81655	chr17	67398631	67399268	637	318.0	
81656	chr17	67400155	67400621	466	233.0	
81657	chr17	67401629	67403192	1563	782.0	
81658	chr17	67407651	67408189	538	269.0	
81659	chr17	67411330	67411881	551	276.0	
81660	chr17	67421396	67422803	1407	704.0	
81661	chr17	67431505	67432063	558	279.0	
81662	chr17	67433241	67436498	3257	1628.0	
81663	chr17	67440461	67442050	1589	794.0	
81664	chr17	67449678	67450738	1060	530.0	
81665	chr17	67452448	67453577	1129	564.0	
81666	chr17	67461899	67461907	8	4.0	
81667	chr17	67464632	67465071	439	220.0	
81668	chr17	67469088	67469844	756	378.0	
81669	chr17	67474662	67476058	1396	698.0	
81670	chr17	67477696	67479358	1662	831.0	
81671	chr17	67481840	67482241	401	200.0	
81672	chr17	67486671	67487574	903	452.0	
81673	chr17	67490883	67492856	1973	986.0	
81674	chr17	67504026	67504056	30	15.0	
81675	chr17	67509731	67510695	964	482.0	
81676	chr17	67520350	67521002	652	326.0	
81677	chr17	67546639	67546973	334	167.0	
81678	chr17	67569813	67570262	449	224.0	
81679	chr17	67574894	67574963	69	34.0	
81680	chr17	67594146	67594552	406	203.0	
81681	chr17	67602865	67603429	564	282.0	
81682	chr17	67628648	67628856	208	104.0	
81683	chr17	67629931	67630324	393	196.0	
81684	chr17	67650811	67651033	222	111.0	
81685	chr17	67689438	67689972	534	267.0	
81686	chr17	67717108	67718850	1742	871.0	
81687	chr17	67725227	67726010	783	392.0	
81688	chr17	67755537	67755552	15	8.0	
81689	chr17	67778989	67779413	424	212.0	
81690	chr17	67800335	67800962	627	314.0	
81691	chr17	67813068	67813717	649	324.0	
81692	chr17	67818046	67818555	509	254.0	
81693	chr17	67824336	67827170	2834	1417.0	
81694	chr17	67829256	67829756	500	250.0	
81695	chr17	67835428	67835722	294	147.0	
81696	chr17	67855469	67856275	806	403.0	
81697	chr17	67963154	67963670	516	258.0	
81698	chr17	67992510	67994436	1926	963.0	
81699	chr17	67995069	67996842	1773	886.0	
81700	chr17	68010908	68011591	683	342.0	
81701	chr17	68019331	68020882	1551	776.0	
81702	chr17	68035111	68036873	1762	881.0	
81703	chr17	68054628	68054847	219	110.0	
81704	chr17	68057486	68057978	492	246.0	
81705	chr17	68085607	68087904	2297	1148.0	
81706	chr17	68089883	68090328	445	222.0	
81707	chr17	68100059	68100109	50	25.0	
81708	chr17	68101089	68102938	1849	924.0	
81709	chr17	68168384	68169478	1094	547.0	
81710	chr17	68172297	68173025	728	364.0	
81711	chr17	68180093	68186032	5939	2970.0	
81712	chr17	68195689	68201732	6043	3022.0	
81713	chr17	68204677	68207242	2565	1282.0	
81714	chr17	68213442	68213875	433	216.0	
81715	chr17	68225044	68225512	468	234.0	
81716	chr17	68232776	68233169	393	196.0	
81717	chr17	68234519	68235993	1474	737.0	
81718	chr17	68236955	68239670	2715	1358.0	
81719	chr17	68246804	68250003	3199	1600.0	
81720	chr17	68253211	68254196	985	492.0	
81721	chr17	68255215	68256662	1447	724.0	
81722	chr17	68257912	68259938	2026	1013.0	
81723	chr17	68262784	68263794	1010	505.0	
81724	chr17	68273791	68274124	333	166.0	
81725	chr17	68288075	68293018	4943	2472.0	
81726	chr17	68296169	68297685	1516	758.0	
81727	chr17	68310150	68310609	459	230.0	
81728	chr17	68312180	68314005	1825	912.0	
81729	chr17	68314818	68315464	646	323.0	
81730	chr17	68318310	68319882	1572	786.0	
81731	chr17	68343950	68345365	1415	708.0	
81732	chr17	68346146	68347726	1580	790.0	
81733	chr17	68353011	68353555	544	272.0	
81734	chr17	68356090	68357364	1274	637.0	
81735	chr17	68377892	68379029	1137	568.0	
81736	chr17	68380996	68381608	612	306.0	
81737	chr17	68383788	68384361	573	286.0	
81738	chr17	68396821	68397505	684	342.0	
81739	chr17	68398798	68399459	661	330.0	
81740	chr17	68413455	68415319	1864	932.0	
81741	chr17	68431709	68432183	474	237.0	
81742	chr17	68435906	68438760	2854	1427.0	
81743	chr17	68440980	68441543	563	282.0	
81744	chr17	68455725	68458562	2837	1418.0	
81745	chr17	68460254	68461995	1741	870.0	
81746	chr17	68462603	68463645	1042	521.0	
81747	chr17	68465883	68466642	759	380.0	
81748	chr17	68485082	68485642	560	280.0	
81749	chr17	68487589	68488614	1025	512.0	
81750	chr17	68491182	68492134	952	476.0	
81751	chr17	68497816	68499311	1495	748.0	
81752	chr17	68509402	68510334	932	466.0	
81753	chr17	68511258	68514036	2778	1389.0	
81754	chr17	68514935	68515112	177	88.0	
81755	chr17	68517931	68518691	760	380.0	
81756	chr17	68519314	68519323	9	4.0	
81757	chr17	68539528	68540384	856	428.0	
81758	chr17	68566445	68566524	79	40.0	
81759	chr17	68580128	68580909	781	390.0	
81760	chr17	68591583	68591604	21	10.0	
81761	chr17	68600315	68602368	2053	1026.0	
81762	chr17	68602890	68603587	697	348.0	
81763	chr17	68613913	68614326	413	206.0	
81764	chr17	68697985	68699165	1180	590.0	
81765	chr17	68759333	68760321	988	494.0	
81766	chr17	68771823	68772469	646	323.0	
81767	chr17	68774514	68774831	317	158.0	
81768	chr17	68777413	68777718	305	152.0	
81769	chr17	68793992	68794214	222	111.0	
81770	chr17	68909092	68909560	468	234.0	
81771	chr17	68981348	68981750	402	201.0	
81772	chr17	69047431	69047995	564	282.0	
81773	chr17	69064003	69064865	862	431.0	
81774	chr17	69070795	69071122	327	164.0	
81775	chr17	69093297	69093703	406	203.0	
81776	chr17	69098706	69099019	313	156.0	
81777	chr17	69099539	69099812	273	136.0	
81778	chr17	69115710	69116478	768	384.0	
81779	chr17	69118390	69118603	213	106.0	
81780	chr17	69170390	69170701	311	156.0	
81781	chr17	69175677	69176375	698	349.0	
81782	chr17	69235363	69235886	523	262.0	
81783	chr17	69246833	69247110	277	138.0	
81784	chr17	69326280	69327999	1719	860.0	
81785	chr17	69394635	69395143	508	254.0	
81786	chr17	69414138	69415504	1366	683.0	
81787	chr17	69428129	69429096	967	484.0	
81788	chr17	69430585	69430935	350	175.0	
81789	chr17	69501955	69502597	642	321.0	
81790	chr17	69503705	69504124	419	210.0	
81791	chr17	69523281	69523582	301	150.0	
81792	chr17	69526037	69526334	297	148.0	
81793	chr17	69568982	69569706	724	362.0	
81794	chr17	69581280	69582002	722	361.0	
81795	chr17	69602934	69603368	434	217.0	
81796	chr17	69607241	69607495	254	127.0	
81797	chr17	69757991	69758102	111	56.0	
81798	chr17	69761932	69762034	102	51.0	
81799	chr17	70099253	70100260	1007	504.0	
81800	chr17	70119948	70120854	906	453.0	
81801	chr17	70123126	70123651	525	262.0	
81802	chr17	70137392	70137741	349	174.0	
81803	chr17	70168017	70170116	2099	1050.0	
81804	chr17	70202895	70202939	44	22.0	
81805	chr17	70205286	70206913	1627	814.0	
81806	chr17	70230971	70231120	149	74.0	
81807	chr17	70286398	70286820	422	211.0	
81808	chr17	70288447	70289055	608	304.0	
81809	chr17	70295243	70296136	893	446.0	
81810	chr17	70314387	70314975	588	294.0	
81811	chr17	70344396	70344764	368	184.0	
81812	chr17	70352924	70353158	234	117.0	
81813	chr17	70365073	70365611	538	269.0	
81814	chr17	70405403	70406101	698	349.0	
81815	chr17	70499093	70499541	448	224.0	
81816	chr17	70527172	70527901	729	364.0	
81817	chr17	70552417	70552753	336	168.0	
81818	chr17	70624261	70624635	374	187.0	
81819	chr17	71921585	71922362	777	388.0	
81820	chr17	72030234	72030783	549	274.0	
81821	chr17	72540243	72540725	482	241.0	
81822	chr17	72556960	72557341	381	190.0	
81823	chr17	72560197	72560626	429	214.0	
81824	chr17	72591677	72591876	199	100.0	
81825	chr17	72592497	72593072	575	288.0	
81826	chr17	72617853	72618587	734	367.0	
81827	chr17	72714399	72714737	338	169.0	
81828	chr17	72719341	72720336	995	498.0	
81829	chr17	72725443	72725905	462	231.0	
81830	chr17	72726812	72728149	1337	668.0	
81831	chr17	72976876	72977426	550	275.0	
81832	chr17	72977972	72978417	445	222.0	
81833	chr17	72986066	72986561	495	248.0	
81834	chr17	73061084	73061547	463	232.0	
81835	chr17	73072251	73072689	438	219.0	
81836	chr17	73091730	73093327	1597	798.0	
81837	chr17	73096809	73097683	874	437.0	
81838	chr17	73099514	73099818	304	152.0	
81839	chr17	73103419	73104373	954	477.0	
81840	chr17	73132145	73132644	499	250.0	
81841	chr17	73134171	73134724	553	276.0	
81842	chr17	73135728	73136177	449	224.0	
81843	chr17	73141335	73142007	672	336.0	
81844	chr17	73142668	73143605	937	468.0	
81845	chr17	73152214	73152812	598	299.0	
81846	chr17	73156135	73156650	515	258.0	
81847	chr17	73164358	73165205	847	424.0	
81848	chr17	73165991	73167257	1266	633.0	
81849	chr17	73171800	73172244	444	222.0	
81850	chr17	73184117	73184511	394	197.0	
81851	chr17	73191215	73194008	2793	1396.0	
81852	chr17	73203371	73204594	1223	612.0	
81853	chr17	73210366	73210737	371	186.0	
81854	chr17	73211550	73212213	663	332.0	
81855	chr17	73228650	73229141	491	246.0	
81856	chr17	73231355	73233556	2201	1100.0	
81857	chr17	73255606	73256100	494	247.0	
81858	chr17	73270972	73271460	488	244.0	
81859	chr17	73290612	73292232	1620	810.0	
81860	chr17	73304956	73305628	672	336.0	
81861	chr17	73308178	73308565	387	194.0	
81862	chr17	73310294	73313066	2772	1386.0	
81863	chr17	73313769	73313912	143	72.0	
81864	chr17	73325554	73325755	201	100.0	
81865	chr17	73333641	73333755	114	57.0	
81866	chr17	73339964	73340744	780	390.0	
81867	chr17	73369789	73370335	546	273.0	
81868	chr17	73401985	73402260	275	138.0	
81869	chr17	73429308	73429874	566	283.0	
81870	chr17	73430861	73431370	509	254.0	
81871	chr17	73482145	73482524	379	190.0	
81872	chr17	73546945	73547478	533	266.0	
81873	chr17	73551858	73552139	281	140.0	
81874	chr17	73561069	73561575	506	253.0	
81875	chr17	73567059	73567715	656	328.0	
81876	chr17	73591134	73592845	1711	856.0	
81877	chr17	73595834	73595856	22	11.0	
81878	chr17	73641963	73642169	206	103.0	
81879	chr17	73642834	73643931	1097	548.0	
81880	chr17	73644444	73645627	1183	592.0	
81881	chr17	73646955	73646984	29	14.0	
81882	chr17	73657491	73658127	636	318.0	
81883	chr17	73667092	73667809	717	358.0	
81884	chr17	73690600	73690992	392	196.0	
81885	chr17	73710060	73710590	530	265.0	
81886	chr17	73711214	73711464	250	125.0	
81887	chr17	73722145	73722692	547	274.0	
81888	chr17	73731637	73732211	574	287.0	
81889	chr17	73733457	73733969	512	256.0	
81890	chr17	73740074	73740802	728	364.0	
81891	chr17	73743627	73743906	279	140.0	
81892	chr17	73823791	73824027	236	118.0	
81893	chr17	73827824	73828217	393	196.0	
81894	chr17	73841775	73841778	3	2.0	
81895	chr17	73901892	73902417	525	262.0	
81896	chr17	73952501	73953238	737	368.0	
81897	chr17	73956536	73956970	434	217.0	
81898	chr17	73969754	73970419	665	332.0	
81899	chr17	73981010	73981474	464	232.0	
81900	chr17	73998625	73998979	354	177.0	
81901	chr17	74008431	74008447	16	8.0	
81902	chr17	74012415	74012783	368	184.0	
81903	chr17	74163609	74163807	198	99.0	
81904	chr17	74176650	74177097	447	224.0	
81905	chr17	74190103	74190607	504	252.0	
81906	chr17	74193206	74193951	745	372.0	
81907	chr17	74199373	74200236	863	432.0	
81908	chr17	74203061	74204510	1449	724.0	
81909	chr17	74206235	74206753	518	259.0	
81910	chr17	74208126	74208259	133	66.0	
81911	chr17	74209939	74214852	4913	2456.0	
81912	chr17	74215493	74215820	327	164.0	
81913	chr17	74217219	74217583	364	182.0	
81914	chr17	74234512	74235420	908	454.0	
81915	chr17	74239097	74239747	650	325.0	
81916	chr17	74241502	74241988	486	243.0	
81917	chr17	74271303	74271725	422	211.0	
81918	chr17	74273947	74275207	1260	630.0	
81919	chr17	74279836	74280895	1059	530.0	
81920	chr17	74282403	74283625	1222	611.0	
81921	chr17	74284891	74285057	166	83.0	
81922	chr17	74296507	74297015	508	254.0	
81923	chr17	74301068	74301620	552	276.0	
81924	chr17	74325348	74326811	1463	732.0	
81925	chr17	74329236	74329524	288	144.0	
81926	chr17	74353965	74354764	799	400.0	
81927	chr17	74356607	74357579	972	486.0	
81928	chr17	74361418	74361858	440	220.0	
81929	chr17	74368134	74369682	1548	774.0	
81930	chr17	74379164	74380474	1310	655.0	
81931	chr17	74391767	74392096	329	164.0	
81932	chr17	74430472	74432489	2017	1008.0	
81933	chr17	74437653	74438044	391	196.0	
81934	chr17	74442622	74443746	1124	562.0	
81935	chr17	74444326	74444510	184	92.0	
81936	chr17	74446726	74447214	488	244.0	
81937	chr17	74453672	74454812	1140	570.0	
81938	chr17	74457316	74458135	819	410.0	
81939	chr17	74462477	74465156	2679	1340.0	
81940	chr17	74465845	74468164	2319	1160.0	
81941	chr17	74471398	74471631	233	116.0	
81942	chr17	74473828	74475038	1210	605.0	
81943	chr17	74478245	74479504	1259	630.0	
81944	chr17	74491815	74492043	228	114.0	
81945	chr17	74493247	74493785	538	269.0	
81946	chr17	74512345	74513365	1020	510.0	
81947	chr17	74513896	74515284	1388	694.0	
81948	chr17	74517032	74517214	182	91.0	
81949	chr17	74519930	74522367	2437	1218.0	
81950	chr17	74524536	74525116	580	290.0	
81951	chr17	74527195	74527198	3	2.0	
81952	chr17	74528220	74529183	963	482.0	
81953	chr17	74531078	74533521	2443	1222.0	
81954	chr17	74545207	74546559	1352	676.0	
81955	chr17	74547708	74548122	414	207.0	
81956	chr17	74566077	74567832	1755	878.0	
81957	chr17	74569224	74570208	984	492.0	
81958	chr17	74571653	74572038	385	192.0	
81959	chr17	74579918	74580257	339	170.0	
81960	chr17	74592028	74592609	581	290.0	
81961	chr17	74595361	74595717	356	178.0	
81962	chr17	74597128	74597447	319	160.0	
81963	chr17	74598954	74600132	1178	589.0	
81964	chr17	74601960	74602396	436	218.0	
81965	chr17	74603110	74603464	354	177.0	
81966	chr17	74607233	74607859	626	313.0	
81967	chr17	74612495	74613384	889	444.0	
81968	chr17	74623315	74624346	1031	516.0	
81969	chr17	74631697	74633043	1346	673.0	
81970	chr17	74637261	74638294	1033	516.0	
81971	chr17	74639165	74640397	1232	616.0	
81972	chr17	74641370	74642356	986	493.0	
81973	chr17	74646211	74646691	480	240.0	
81974	chr17	74657227	74658046	819	410.0	
81975	chr17	74670916	74671851	935	468.0	
81976	chr17	74677791	74678234	443	222.0	
81977	chr17	74679860	74680152	292	146.0	
81978	chr17	74681836	74682975	1139	570.0	
81979	chr17	74686704	74687194	490	245.0	
81980	chr17	74688634	74689544	910	455.0	
81981	chr17	74690236	74691203	967	484.0	
81982	chr17	74697537	74697846	309	154.0	
81983	chr17	74702106	74702387	281	140.0	
81984	chr17	74711253	74711392	139	70.0	
81985	chr17	74712306	74713698	1392	696.0	
81986	chr17	74730289	74731480	1191	596.0	
81987	chr17	74732349	74734008	1659	830.0	
81988	chr17	74735429	74739686	4257	2128.0	
81989	chr17	74740193	74740586	393	196.0	
81990	chr17	74741557	74742799	1242	621.0	
81991	chr17	74744156	74745451	1295	648.0	
81992	chr17	74746650	74752603	5953	2976.0	
81993	chr17	74753152	74755755	2603	1302.0	
81994	chr17	74757223	74762251	5028	2514.0	
81995	chr17	74763841	74764546	705	352.0	
81996	chr17	74767323	74773745	6422	3211.0	
81997	chr17	74775554	74777356	1802	901.0	
81998	chr17	74777911	74781306	3395	1698.0	
81999	chr17	74785548	74787163	1615	808.0	
82000	chr17	74790136	74792073	1937	968.0	
82001	chr17	74808082	74809498	1416	708.0	
82002	chr17	74812268	74812661	393	196.0	
82003	chr17	74813634	74814030	396	198.0	
82004	chr17	74833840	74834537	697	348.0	
82005	chr17	74840864	74841735	871	436.0	
82006	chr17	74842489	74843490	1001	500.0	
82007	chr17	74852096	74853155	1059	530.0	
82008	chr17	74859486	74862702	3216	1608.0	
82009	chr17	74864606	74865534	928	464.0	
82010	chr17	74872263	74874379	2116	1058.0	
82011	chr17	74883316	74883746	430	215.0	
82012	chr17	74893407	74893861	454	227.0	
82013	chr17	74917326	74917864	538	269.0	
82014	chr17	74919649	74919749	100	50.0	
82015	chr17	74922961	74925036	2075	1038.0	
82016	chr17	74957818	74958388	570	285.0	
82017	chr17	74960409	74962306	1897	948.0	
82018	chr17	74971750	74973277	1527	764.0	
82019	chr17	74978875	74978961	86	43.0	
82020	chr17	74981552	74983139	1587	794.0	
82021	chr17	74984483	74984884	401	200.0	
82022	chr17	74985546	74986045	499	250.0	
82023	chr17	74986712	74988755	2043	1022.0	
82024	chr17	74991716	74992037	321	160.0	
82025	chr17	75006722	75007016	294	147.0	
82026	chr17	75011196	75011200	4	2.0	
82027	chr17	75012070	75014416	2346	1173.0	
82028	chr17	75025036	75025958	922	461.0	
82029	chr17	75031649	75037437	5788	2894.0	
82030	chr17	75046020	75048614	2594	1297.0	
82031	chr17	75059882	75060348	466	233.0	
82032	chr17	75067789	75068177	388	194.0	
82033	chr17	75069846	75069994	148	74.0	
82034	chr17	75075862	75076452	590	295.0	
82035	chr17	75077153	75078367	1214	607.0	
82036	chr17	75080967	75081277	310	155.0	
82037	chr17	75084154	75084377	223	112.0	
82038	chr17	75085615	75085967	352	176.0	
82039	chr17	75087208	75090080	2872	1436.0	
82040	chr17	75092774	75093175	401	200.0	
82041	chr17	75095903	75096711	808	404.0	
82042	chr17	75102156	75102813	657	328.0	
82043	chr17	75105749	75106217	468	234.0	
82044	chr17	75108814	75110906	2092	1046.0	
82045	chr17	75111729	75112238	509	254.0	
82046	chr17	75113665	75115606	1941	970.0	
82047	chr17	75120177	75120613	436	218.0	
82048	chr17	75124166	75124744	578	289.0	
82049	chr17	75125948	75126339	391	196.0	
82050	chr17	75130444	75132292	1848	924.0	
82051	chr17	75135484	75135832	348	174.0	
82052	chr17	75140844	75141456	612	306.0	
82053	chr17	75146554	75147049	495	248.0	
82054	chr17	75147765	75148537	772	386.0	
82055	chr17	75152837	75155409	2572	1286.0	
82056	chr17	75171607	75172563	956	478.0	
82057	chr17	75181173	75183748	2575	1288.0	
82058	chr17	75189215	75189598	383	192.0	
82059	chr17	75191612	75191727	115	58.0	
82060	chr17	75201507	75202368	861	430.0	
82061	chr17	75204739	75206272	1533	766.0	
82062	chr17	75228072	75229302	1230	615.0	
82063	chr17	75238564	75239453	889	444.0	
82064	chr17	75240292	75241070	778	389.0	
82065	chr17	75242018	75243414	1396	698.0	
82066	chr17	75244196	75244997	801	400.0	
82067	chr17	75249869	75250610	741	370.0	
82068	chr17	75251410	75252237	827	414.0	
82069	chr17	75260597	75262536	1939	970.0	
82070	chr17	75265720	75265945	225	112.0	
82071	chr17	75266958	75267359	401	200.0	
82072	chr17	75268736	75272834	4098	2049.0	
82073	chr17	75288531	75290796	2265	1132.0	
82074	chr17	75292684	75293419	735	368.0	
82075	chr17	75295029	75296490	1461	730.0	
82076	chr17	75297246	75298330	1084	542.0	
82077	chr17	75300945	75302338	1393	696.0	
82078	chr17	75308797	75309828	1031	516.0	
82079	chr17	75311874	75313018	1144	572.0	
82080	chr17	75313638	75314770	1132	566.0	
82081	chr17	75315685	75316662	977	488.0	
82082	chr17	75317710	75317969	259	130.0	
82083	chr17	75322824	75323936	1112	556.0	
82084	chr17	75325926	75326692	766	383.0	
82085	chr17	75338226	75339523	1297	648.0	
82086	chr17	75342073	75342256	183	92.0	
82087	chr17	75343095	75344203	1108	554.0	
82088	chr17	75344755	75347415	2660	1330.0	
82089	chr17	75348381	75348737	356	178.0	
82090	chr17	75352263	75352577	314	157.0	
82091	chr17	75371233	75372030	797	398.0	
82092	chr17	75393307	75394946	1639	820.0	
82093	chr17	75403731	75407016	3285	1642.0	
82094	chr17	75412354	75413216	862	431.0	
82095	chr17	75418397	75419005	608	304.0	
82096	chr17	75426040	75427028	988	494.0	
82097	chr17	75428724	75429309	585	292.0	
82098	chr17	75435973	75436352	379	190.0	
82099	chr17	75455989	75457585	1596	798.0	
82100	chr17	75459790	75460321	531	266.0	
82101	chr17	75487121	75488137	1016	508.0	
82102	chr17	75498145	75498413	268	134.0	
82103	chr17	75504043	75504734	691	346.0	
82104	chr17	75514697	75518930	4233	2116.0	
82105	chr17	75524349	75526966	2617	1308.0	
82106	chr17	75534773	75536038	1265	632.0	
82107	chr17	75566741	75567215	474	237.0	
82108	chr17	75570840	75571860	1020	510.0	
82109	chr17	75580993	75581747	754	377.0	
82110	chr17	75587539	75591433	3894	1947.0	
82111	chr17	75601124	75601782	658	329.0	
82112	chr17	75620002	75620347	345	172.0	
82113	chr17	75625042	75625119	77	38.0	
82114	chr17	75625853	75626297	444	222.0	
82115	chr17	75632643	75634269	1626	813.0	
82116	chr17	75642414	75642445	31	16.0	
82117	chr17	75645944	75646575	631	316.0	
82118	chr17	75652878	75653372	494	247.0	
82119	chr17	75663976	75664715	739	370.0	
82120	chr17	75666605	75668261	1656	828.0	
82121	chr17	75674627	75675475	848	424.0	
82122	chr17	75686194	75686762	568	284.0	
82123	chr17	75687902	75690023	2121	1060.0	
82124	chr17	75720663	75721841	1178	589.0	
82125	chr17	75737810	75738882	1072	536.0	
82126	chr17	75747559	75748446	887	444.0	
82127	chr17	75749588	75751340	1752	876.0	
82128	chr17	75752140	75756456	4316	2158.0	
82129	chr17	75759690	75759804	114	57.0	
82130	chr17	75764064	75766614	2550	1275.0	
82131	chr17	75767175	75780491	13316	6658.0	
82132	chr17	75782733	75786775	4042	2021.0	
82133	chr17	75821729	75822854	1125	562.0	
82134	chr17	75826805	75828624	1819	910.0	
82135	chr17	75830013	75830477	464	232.0	
82136	chr17	75831969	75833631	1662	831.0	
82137	chr17	75842964	75845824	2860	1430.0	
82138	chr17	75848234	75849047	813	406.0	
82139	chr17	75853916	75856733	2817	1408.0	
82140	chr17	75858554	75859320	766	383.0	
82141	chr17	75861063	75861896	833	416.0	
82142	chr17	75864189	75865449	1260	630.0	
82143	chr17	75872552	75873373	821	410.0	
82144	chr17	75875402	75879336	3934	1967.0	
82145	chr17	75881835	75882332	497	248.0	
82146	chr17	75895285	75897909	2624	1312.0	
82147	chr17	75904024	75906541	2517	1258.0	
82148	chr17	75927249	75927757	508	254.0	
82149	chr17	75940450	75941742	1292	646.0	
82150	chr17	75969908	75970571	663	332.0	
82151	chr17	75978330	75980523	2193	1096.0	
82152	chr17	75983560	75983985	425	212.0	
82153	chr17	75991945	75992277	332	166.0	
82154	chr17	75996676	75997835	1159	580.0	
82155	chr17	76000346	76000860	514	257.0	
82156	chr17	76005353	76006066	713	356.0	
82157	chr17	76013957	76014971	1014	507.0	
82158	chr17	76021409	76021813	404	202.0	
82159	chr17	76029079	76029967	888	444.0	
82160	chr17	76063917	76064303	386	193.0	
82161	chr17	76071681	76073291	1610	805.0	
82162	chr17	76074421	76077603	3182	1591.0	
82163	chr17	76079694	76080290	596	298.0	
82164	chr17	76091607	76091907	300	150.0	
82165	chr17	76102697	76104570	1873	936.0	
82166	chr17	76120991	76122406	1415	708.0	
82167	chr17	76123981	76124116	135	68.0	
82168	chr17	76135192	76135657	465	232.0	
82169	chr17	76139238	76142169	2931	1466.0	
82170	chr17	76142786	76143882	1096	548.0	
82171	chr17	76144880	76146692	1812	906.0	
82172	chr17	76151808	76152276	468	234.0	
82173	chr17	76179573	76180512	939	470.0	
82174	chr17	76181858	76182743	885	442.0	
82175	chr17	76191343	76192878	1535	768.0	
82176	chr17	76193601	76193997	396	198.0	
82177	chr17	76199144	76199955	811	406.0	
82178	chr17	76208149	76208365	216	108.0	
82179	chr17	76239571	76241512	1941	970.0	
82180	chr17	76246224	76247021	797	398.0	
82181	chr17	76251729	76252974	1245	622.0	
82182	chr17	76256438	76257206	768	384.0	
82183	chr17	76261670	76262290	620	310.0	
82184	chr17	76262841	76280114	17273	8636.0	
82185	chr17	76298902	76299567	665	332.0	
82186	chr17	76303058	76303733	675	338.0	
82187	chr17	76327392	76328273	881	440.0	
82188	chr17	76352910	76354741	1831	916.0	
82189	chr17	76381265	76386863	5598	2799.0	
82190	chr17	76389227	76389287	60	30.0	
82191	chr17	76397757	76398781	1024	512.0	
82192	chr17	76406068	76406851	783	392.0	
82193	chr17	76408464	76409031	567	284.0	
82194	chr17	76423684	76424085	401	200.0	
82195	chr17	76427740	76428183	443	222.0	
82196	chr17	76432737	76432847	110	55.0	
82197	chr17	76446417	76446879	462	231.0	
82198	chr17	76451583	76454093	2510	1255.0	
82199	chr17	76458658	76459077	419	210.0	
82200	chr17	76460504	76460958	454	227.0	
82201	chr17	76465726	76466705	979	490.0	
82202	chr17	76467952	76469570	1618	809.0	
82203	chr17	76473506	76474104	598	299.0	
82204	chr17	76480588	76486295	5707	2854.0	
82205	chr17	76488653	76489245	592	296.0	
82206	chr17	76490521	76495185	4664	2332.0	
82207	chr17	76496530	76496556	26	13.0	
82208	chr17	76498226	76502812	4586	2293.0	
82209	chr17	76505955	76507168	1213	606.0	
82210	chr17	76511335	76512336	1001	500.0	
82211	chr17	76514659	76516424	1765	882.0	
82212	chr17	76522848	76523806	958	479.0	
82213	chr17	76527357	76529278	1921	960.0	
82214	chr17	76530508	76530719	211	106.0	
82215	chr17	76537461	76538620	1159	580.0	
82216	chr17	76540485	76541315	830	415.0	
82217	chr17	76547120	76547823	703	352.0	
82218	chr17	76550812	76551450	638	319.0	
82219	chr17	76556717	76559131	2414	1207.0	
82220	chr17	76560729	76561887	1158	579.0	
82221	chr17	76565362	76565372	10	5.0	
82222	chr17	76567522	76568295	773	386.0	
82223	chr17	76568859	76569209	350	175.0	
82224	chr17	76579359	76579391	32	16.0	
82225	chr17	76584676	76587200	2524	1262.0	
82226	chr17	76597228	76598500	1272	636.0	
82227	chr17	76599568	76600300	732	366.0	
82228	chr17	76614262	76614507	245	122.0	
82229	chr17	76623810	76624332	522	261.0	
82230	chr17	76643628	76644026	398	199.0	
82231	chr17	76659431	76660556	1125	562.0	
82232	chr17	76670398	76672677	2279	1140.0	
82233	chr17	76678214	76679216	1002	501.0	
82234	chr17	76681151	76682587	1436	718.0	
82235	chr17	76700417	76701092	675	338.0	
82236	chr17	76709529	76711705	2176	1088.0	
82237	chr17	76712258	76712445	187	94.0	
82238	chr17	76713106	76716947	3841	1920.0	
82239	chr17	76717465	76720381	2916	1458.0	
82240	chr17	76720954	76722874	1920	960.0	
82241	chr17	76723378	76724240	862	431.0	
82242	chr17	76724800	76738820	14020	7010.0	
82243	chr17	76751970	76754137	2167	1084.0	
82244	chr17	76772686	76773736	1050	525.0	
82245	chr17	76791122	76791824	702	351.0	
82246	chr17	76816462	76816965	503	252.0	
82247	chr17	76839471	76840522	1051	526.0	
82248	chr17	76868073	76869041	968	484.0	
82249	chr17	76956989	76957185	196	98.0	
82250	chr17	76958030	76958582	552	276.0	
82251	chr17	76968744	76969874	1130	565.0	
82252	chr17	76982521	76983049	528	264.0	
82253	chr17	76997308	76999050	1742	871.0	
82254	chr17	77011183	77011535	352	176.0	
82255	chr17	77056202	77056668	466	233.0	
82256	chr17	77066730	77067166	436	218.0	
82257	chr17	77086155	77087104	949	474.0	
82258	chr17	77088046	77089514	1468	734.0	
82259	chr17	77096454	77096887	433	216.0	
82260	chr17	77098291	77100558	2267	1134.0	
82261	chr17	77106765	77107997	1232	616.0	
82262	chr17	77110062	77110407	345	172.0	
82263	chr17	77111936	77112337	401	200.0	
82264	chr17	77124120	77124703	583	292.0	
82265	chr17	77127497	77128551	1054	527.0	
82266	chr17	77137913	77138302	389	194.0	
82267	chr17	77139728	77142323	2595	1298.0	
82268	chr17	77145562	77146619	1057	528.0	
82269	chr17	77182186	77182651	465	232.0	
82270	chr17	77186197	77186427	230	115.0	
82271	chr17	77206598	77206916	318	159.0	
82272	chr17	77212351	77212879	528	264.0	
82273	chr17	77214704	77215061	357	178.0	
82274	chr17	77234023	77234046	23	12.0	
82275	chr17	77235271	77235944	673	336.0	
82276	chr17	77246613	77247788	1175	588.0	
82277	chr17	77266794	77267428	634	317.0	
82278	chr17	77274195	77274572	377	188.0	
82279	chr17	77277660	77278176	516	258.0	
82280	chr17	77279916	77282135	2219	1110.0	
82281	chr17	77285503	77286397	894	447.0	
82282	chr17	77308729	77309208	479	240.0	
82283	chr17	77315449	77315926	477	238.0	
82284	chr17	77318789	77321261	2472	1236.0	
82285	chr17	77322382	77324104	1722	861.0	
82286	chr17	77324812	77326734	1922	961.0	
82287	chr17	77331139	77333417	2278	1139.0	
82288	chr17	77341936	77343806	1870	935.0	
82289	chr17	77356031	77357330	1299	650.0	
82290	chr17	77363986	77364648	662	331.0	
82291	chr17	77366926	77367237	311	156.0	
82292	chr17	77372062	77377096	5034	2517.0	
82293	chr17	77377949	77377985	36	18.0	
82294	chr17	77382075	77383537	1462	731.0	
82295	chr17	77388288	77388421	133	66.0	
82296	chr17	77388963	77390694	1731	866.0	
82297	chr17	77391931	77392733	802	401.0	
82298	chr17	77399932	77401343	1411	706.0	
82299	chr17	77404445	77406725	2280	1140.0	
82300	chr17	77407571	77408127	556	278.0	
82301	chr17	77409280	77411637	2357	1178.0	
82302	chr17	77416159	77416272	113	56.0	
82303	chr17	77419737	77421963	2226	1113.0	
82304	chr17	77424831	77431226	6395	3198.0	
82305	chr17	77432268	77435910	3642	1821.0	
82306	chr17	77436615	77442545	5930	2965.0	
82307	chr17	77443128	77446950	3822	1911.0	
82308	chr17	77449322	77463453	14131	7066.0	
82309	chr17	77464895	77466700	1805	902.0	
82310	chr17	77471127	77473178	2051	1026.0	
82311	chr17	77474027	77475747	1720	860.0	
82312	chr17	77476323	77476856	533	266.0	
82313	chr17	77477396	77477879	483	242.0	
82314	chr17	77479388	77479500	112	56.0	
82315	chr17	77480990	77481207	217	108.0	
82316	chr17	77483994	77485728	1734	867.0	
82317	chr17	77489652	77489706	54	27.0	
82318	chr17	77491756	77495577	3821	1910.0	
82319	chr17	77499816	77500097	281	140.0	
82320	chr17	77501023	77501437	414	207.0	
82321	chr17	77502298	77502681	383	192.0	
82322	chr17	77504246	77504643	397	198.0	
82323	chr17	77506614	77507343	729	364.0	
82324	chr17	77542623	77543138	515	258.0	
82325	chr17	77546943	77547379	436	218.0	
82326	chr17	77548940	77549392	452	226.0	
82327	chr17	77571431	77572001	570	285.0	
82328	chr17	77579561	77580307	746	373.0	
82329	chr17	77609907	77611268	1361	680.0	
82330	chr17	77618084	77618536	452	226.0	
82331	chr17	77644939	77646242	1303	652.0	
82332	chr17	77666475	77667713	1238	619.0	
82333	chr17	77690572	77691005	433	216.0	
82334	chr17	77692469	77693067	598	299.0	
82335	chr17	77741175	77741490	315	158.0	
82336	chr17	77772342	77773180	838	419.0	
82337	chr17	77783675	77785093	1418	709.0	
82338	chr17	77834259	77834944	685	342.0	
82339	chr17	77836535	77837240	705	352.0	
82340	chr17	77842368	77844425	2057	1028.0	
82341	chr17	77846364	77847808	1444	722.0	
82342	chr17	77863663	77864149	486	243.0	
82343	chr17	77867386	77867888	502	251.0	
82344	chr17	77869170	77870363	1193	596.0	
82345	chr17	77871520	77872631	1111	556.0	
82346	chr17	77875756	77876398	642	321.0	
82347	chr17	77877021	77877428	407	204.0	
82348	chr17	77880764	77883486	2722	1361.0	
82349	chr17	77883988	77884715	727	364.0	
82350	chr17	77886125	77889241	3116	1558.0	
82351	chr17	77892419	77892768	349	174.0	
82352	chr17	77916591	77917579	988	494.0	
82353	chr17	77947027	77947732	705	352.0	
82354	chr17	77957088	77960588	3500	1750.0	
82355	chr17	77963397	77964125	728	364.0	
82356	chr17	78010948	78011093	145	72.0	
82357	chr17	78019401	78019737	336	168.0	
82358	chr17	78040612	78041508	896	448.0	
82359	chr17	78084915	78085376	461	230.0	
82360	chr17	78089540	78090051	511	256.0	
82361	chr17	78111293	78115531	4238	2119.0	
82362	chr17	78116067	78116679	612	306.0	
82363	chr17	78117206	78119235	2029	1014.0	
82364	chr17	78120567	78123151	2584	1292.0	
82365	chr17	78123944	78135092	11148	5574.0	
82366	chr17	78137172	78141264	4092	2046.0	
82367	chr17	78141777	78142164	387	194.0	
82368	chr17	78143976	78145130	1154	577.0	
82369	chr17	78147233	78148067	834	417.0	
82370	chr17	78153368	78153795	427	214.0	
82371	chr17	78154802	78155776	974	487.0	
82372	chr17	78159525	78159926	401	200.0	
82373	chr17	78167950	78170305	2355	1178.0	
82374	chr17	78171314	78175171	3857	1928.0	
82375	chr17	78176288	78177165	877	438.0	
82376	chr17	78179410	78180570	1160	580.0	
82377	chr17	78186254	78187780	1526	763.0	
82378	chr17	78198570	78199714	1144	572.0	
82379	chr17	78213581	78214843	1262	631.0	
82380	chr17	78226812	78227946	1134	567.0	
82381	chr17	78231932	78232256	324	162.0	
82382	chr17	78241490	78242829	1339	670.0	
82383	chr17	78250614	78255079	4465	2232.0	
82384	chr17	78256088	78256349	261	130.0	
82385	chr17	78257712	78259168	1456	728.0	
82386	chr17	78263010	78263727	717	358.0	
82387	chr17	78272420	78273225	805	402.0	
82388	chr17	78276158	78276863	705	352.0	
82389	chr17	78278321	78278666	345	172.0	
82390	chr17	78282436	78282584	148	74.0	
82391	chr17	78284053	78285653	1600	800.0	
82392	chr17	78289654	78290381	727	364.0	
82393	chr17	78293236	78293548	312	156.0	
82394	chr17	78301208	78301606	398	199.0	
82395	chr17	78305878	78306147	269	134.0	
82396	chr17	78313666	78314775	1109	554.0	
82397	chr17	78315468	78316193	725	362.0	
82398	chr17	78317068	78317901	833	416.0	
82399	chr17	78324043	78325623	1580	790.0	
82400	chr17	78329079	78330011	932	466.0	
82401	chr17	78331988	78333427	1439	720.0	
82402	chr17	78337110	78339299	2189	1094.0	
82403	chr17	78341365	78344384	3019	1510.0	
82404	chr17	78349805	78350558	753	376.0	
82405	chr17	78351320	78361595	10275	5138.0	
82406	chr17	78362359	78363211	852	426.0	
82407	chr17	78364734	78365399	665	332.0	
82408	chr17	78375386	78376258	872	436.0	
82409	chr17	78377250	78379530	2280	1140.0	
82410	chr17	78381224	78382624	1400	700.0	
82411	chr17	78383891	78385007	1116	558.0	
82412	chr17	78385804	78387020	1216	608.0	
82413	chr17	78388130	78389377	1247	624.0	
82414	chr17	78412306	78415343	3037	1518.0	
82415	chr17	78416009	78417620	1611	806.0	
82416	chr17	78421697	78422481	784	392.0	
82417	chr17	78425579	78425933	354	177.0	
82418	chr17	78433089	78433609	520	260.0	
82419	chr17	78437086	78437155	69	34.0	
82420	chr17	78437697	78439613	1916	958.0	
82421	chr17	78440751	78440989	238	119.0	
82422	chr17	78442147	78443566	1419	710.0	
82423	chr17	78445554	78446000	446	223.0	
82424	chr17	78448582	78448832	250	125.0	
82425	chr17	78451204	78451295	91	46.0	
82426	chr17	78474401	78475276	875	438.0	
82427	chr17	78484254	78485274	1020	510.0	
82428	chr17	78497022	78497547	525	262.0	
82429	chr17	78541508	78542434	926	463.0	
82430	chr17	78568425	78568834	409	204.0	
82431	chr17	78578525	78578733	208	104.0	
82432	chr17	78583143	78583537	394	197.0	
82433	chr17	78592004	78593237	1233	616.0	
82434	chr17	78597893	78598276	383	192.0	
82435	chr17	78604749	78605226	477	238.0	
82436	chr17	78613257	78614007	750	375.0	
82437	chr17	78631402	78632524	1122	561.0	
82438	chr17	78638025	78639897	1872	936.0	
82439	chr17	78645543	78646588	1045	522.0	
82440	chr17	78664939	78666998	2059	1030.0	
82441	chr17	78667907	78668159	252	126.0	
82442	chr17	78669232	78671472	2240	1120.0	
82443	chr17	78672221	78672225	4	2.0	
82444	chr17	78672820	78673586	766	383.0	
82445	chr17	78674496	78675137	641	320.0	
82446	chr17	78679038	78679043	5	2.0	
82447	chr17	78683585	78683825	240	120.0	
82448	chr17	78689088	78689630	542	271.0	
82449	chr17	78697753	78698015	262	131.0	
82450	chr17	78708402	78709738	1336	668.0	
82451	chr17	78710719	78710722	3	2.0	
82452	chr17	78712000	78712024	24	12.0	
82453	chr17	78714495	78720366	5871	2936.0	
82454	chr17	78722147	78726729	4582	2291.0	
82455	chr17	78727811	78728000	189	94.0	
82456	chr17	78729751	78731268	1517	758.0	
82457	chr17	78733660	78733806	146	73.0	
82458	chr17	78734491	78737792	3301	1650.0	
82459	chr17	78739259	78740225	966	483.0	
82460	chr17	78741655	78742705	1050	525.0	
82461	chr17	78744957	78749593	4636	2318.0	
82462	chr17	78750100	78750346	246	123.0	
82463	chr17	78750893	78754453	3560	1780.0	
82464	chr17	78755517	78755603	86	43.0	
82465	chr17	78756661	78760366	3705	1852.0	
82466	chr17	78761138	78761426	288	144.0	
82467	chr17	78766715	78767171	456	228.0	
82468	chr17	78769056	78769768	712	356.0	
82469	chr17	78771499	78773241	1742	871.0	
82470	chr17	78774189	78776574	2385	1192.0	
82471	chr17	78777828	78783282	5454	2727.0	
82472	chr17	78783934	78784224	290	145.0	
82473	chr17	78784813	78785810	997	498.0	
82474	chr17	78789155	78790383	1228	614.0	
82475	chr17	78792199	78792583	384	192.0	
82476	chr17	78793432	78793757	325	162.0	
82477	chr17	78794931	78795301	370	185.0	
82478	chr17	78798137	78799717	1580	790.0	
82479	chr17	78800249	78800901	652	326.0	
82480	chr17	78803200	78807676	4476	2238.0	
82481	chr17	78816659	78819893	3234	1617.0	
82482	chr17	78825659	78827838	2179	1090.0	
82483	chr17	78828448	78828861	413	206.0	
82484	chr17	78832438	78832655	217	108.0	
82485	chr17	78838707	78842044	3337	1668.0	
82486	chr17	78843043	78844777	1734	867.0	
82487	chr17	78861935	78862834	899	450.0	
82488	chr17	78865530	78867228	1698	849.0	
82489	chr17	78875706	78876395	689	344.0	
82490	chr17	78879517	78880406	889	444.0	
82491	chr17	78882389	78884321	1932	966.0	
82492	chr17	78888948	78891226	2278	1139.0	
82493	chr17	78892784	78893260	476	238.0	
82494	chr17	78910693	78911523	830	415.0	
82495	chr17	78912139	78912408	269	134.0	
82496	chr17	78913678	78914353	675	338.0	
82497	chr17	78915723	78916836	1113	556.0	
82498	chr17	78917956	78919128	1172	586.0	
82499	chr17	78922802	78926194	3392	1696.0	
82500	chr17	78933309	78934608	1299	650.0	
82501	chr17	78946798	78946817	19	10.0	
82502	chr17	78971167	78971891	724	362.0	
82503	chr17	78979718	78980440	722	361.0	
82504	chr17	78985741	78987402	1661	830.0	
82505	chr17	78993104	78993579	475	238.0	
82506	chr17	79005420	79006198	778	389.0	
82507	chr17	79008071	79010495	2424	1212.0	
82508	chr17	79019502	79019975	473	236.0	
82509	chr17	79023707	79024912	1205	602.0	
82510	chr17	79036504	79037014	510	255.0	
82511	chr17	79038792	79039188	396	198.0	
82512	chr17	79042283	79042781	498	249.0	
82513	chr17	79045622	79046303	681	340.0	
82514	chr17	79058636	79059224	588	294.0	
82515	chr17	79065082	79065498	416	208.0	
82516	chr17	79074113	79076286	2173	1086.0	
82517	chr17	79082391	79083649	1258	629.0	
82518	chr17	79086986	79088204	1218	609.0	
82519	chr17	79093273	79094109	836	418.0	
82520	chr17	79097351	79097692	341	170.0	
82521	chr17	79161309	79161566	257	128.0	
82522	chr17	79243136	79243178	42	21.0	
82523	chr17	79340258	79341443	1185	592.0	
82524	chr17	79391698	79392193	495	248.0	
82525	chr17	79393205	79393714	509	254.0	
82526	chr17	79400818	79401723	905	452.0	
82527	chr17	79708372	79709042	670	335.0	
82528	chr17	79728115	79729368	1253	626.0	
82529	chr17	79732666	79733728	1062	531.0	
82530	chr17	79736338	79736534	196	98.0	
82531	chr17	79741627	79742558	931	466.0	
82532	chr17	79745668	79748426	2758	1379.0	
82533	chr17	79752277	79752349	72	36.0	
82534	chr17	79776854	79780008	3154	1577.0	
82535	chr17	79781784	79781906	122	61.0	
82536	chr17	79789629	79792112	2483	1242.0	
82537	chr17	79796210	79801701	5491	2746.0	
82538	chr17	79802711	79806209	3498	1749.0	
82539	chr17	79807425	79815839	8414	4207.0	
82540	chr17	79817696	79817712	16	8.0	
82541	chr17	79821678	79821905	227	114.0	
82542	chr17	79824861	79825294	433	216.0	
82543	chr17	79826057	79826749	692	346.0	
82544	chr17	79827444	79827648	204	102.0	
82545	chr17	79828227	79846070	17843	8922.0	
82546	chr17	79852661	79853224	563	282.0	
82547	chr17	79867132	79867347	215	108.0	
82548	chr17	79874353	79874805	452	226.0	
82549	chr17	79916124	79916500	376	188.0	
82550	chr17	79924436	79924645	209	104.0	
82551	chr17	79927282	79927811	529	264.0	
82552	chr17	79933703	79934359	656	328.0	
82553	chr17	79936450	79938034	1584	792.0	
82554	chr17	79942667	79943307	640	320.0	
82555	chr17	79970562	79971063	501	250.0	
82556	chr17	79988277	79988436	159	80.0	
82557	chr17	79991208	79992635	1427	714.0	
82558	chr17	79993338	79994366	1028	514.0	
82559	chr17	79996291	79998092	1801	900.0	
82560	chr17	80005567	80006720	1153	576.0	
82561	chr17	80008156	80009009	853	426.0	
82562	chr17	80024380	80024536	156	78.0	
82563	chr17	80029421	80029607	186	93.0	
82564	chr17	80034903	80037470	2567	1284.0	
82565	chr17	80063854	80064571	717	358.0	
82566	chr17	80082567	80083140	573	286.0	
82567	chr17	80092190	80093497	1307	654.0	
82568	chr17	80100321	80102491	2170	1085.0	
82569	chr17	80121829	80140750	18921	9460.0	
82570	chr17	80141378	80148220	6842	3421.0	
82571	chr17	80152071	80152585	514	257.0	
82572	chr17	80195860	80196686	826	413.0	
82573	chr17	80206740	80207125	385	192.0	
82574	chr17	80212877	80213741	864	432.0	
82575	chr17	80219092	80221312	2220	1110.0	
82576	chr17	80222468	80222545	77	38.0	
82577	chr17	80252599	80253505	906	453.0	
82578	chr17	80254467	80255424	957	478.0	"sequence_feature	enhancer"
82579	chr17	80259431	80266261	6830	3415.0	
82580	chr17	80270802	80271302	500	250.0	
82581	chr17	80274452	80275266	814	407.0	
82582	chr17	80278438	80278454	16	8.0	
82583	chr17	80284491	80285114	623	312.0	
82584	chr17	80313376	80313638	262	131.0	
82585	chr17	80315731	80316196	465	232.0	
82586	chr17	80327267	80327950	683	342.0	
82587	chr17	80339169	80340123	954	477.0	
82588	chr17	80345833	80345858	25	12.0	
82589	chr17	80349366	80349427	61	30.0	
82590	chr17	80361469	80361890	421	210.0	
82591	chr17	80363285	80366087	2802	1401.0	
82592	chr17	80377826	80378140	314	157.0	
82593	chr17	80379042	80379694	652	326.0	
82594	chr17	80380357	80380891	534	267.0	
82595	chr17	80384297	80384549	252	126.0	
82596	chr17	80385090	80386146	1056	528.0	
82597	chr17	80395691	80398108	2417	1208.0	
82598	chr17	80413857	80416064	2207	1104.0	
82599	chr17	80424144	80424588	444	222.0	
82600	chr17	80426498	80427606	1108	554.0	
82601	chr17	80441060	80441467	407	204.0	
82602	chr17	80453946	80455718	1772	886.0	
82603	chr17	80457522	80458033	511	256.0	
82604	chr17	80471748	80472421	673	336.0	
82605	chr17	80474467	80478818	4351	2176.0	
82606	chr17	80544529	80545555	1026	513.0	
82607	chr17	80575251	80575824	573	286.0	
82608	chr17	80605344	80605965	621	310.0	
82609	chr17	80622109	80622306	197	98.0	
82610	chr17	80649650	80650414	764	382.0	
82611	chr17	80663609	80665807	2198	1099.0	
82612	chr17	80678645	80679560	915	458.0	
82613	chr17	80703070	80703554	484	242.0	
82614	chr17	80708613	80709115	502	251.0	
82615	chr17	80720593	80721683	1090	545.0	
82616	chr17	80731168	80731672	504	252.0	
82617	chr17	80737313	80739749	2436	1218.0	
82618	chr17	80743165	80743621	456	228.0	
82619	chr17	80750282	80750651	369	184.0	
82620	chr17	80758726	80759458	732	366.0	
82621	chr17	80760395	80761925	1530	765.0	
82622	chr17	80763471	80763837	366	183.0	
82623	chr17	80764781	80766023	1242	621.0	
82624	chr17	80773199	80773466	267	134.0	
82625	chr17	80774093	80775201	1108	554.0	
82626	chr17	80780083	80781579	1496	748.0	
82627	chr17	80782548	80783243	695	348.0	
82628	chr17	80789779	80790591	812	406.0	
82629	chr17	80791294	80791890	596	298.0	
82630	chr17	80811796	80811964	168	84.0	
82631	chr17	80819352	80820048	696	348.0	
82632	chr17	80832415	80833676	1261	630.0	
82633	chr17	80846438	80846579	141	70.0	
82634	chr17	80847238	80848270	1032	516.0	
82635	chr17	80855853	80857313	1460	730.0	
82636	chr17	80861733	80862236	503	252.0	
82637	chr17	80866144	80866648	504	252.0	
82638	chr17	80870315	80871858	1543	772.0	
82639	chr17	80873065	80873066	1	0.0	
82640	chr17	80873617	80874048	431	216.0	
82641	chr17	80876867	80877832	965	482.0	
82642	chr17	80889945	80893426	3481	1740.0	
82643	chr17	80895329	80895659	330	165.0	
82644	chr17	80899283	80900089	806	403.0	
82645	chr17	80900844	80901287	443	222.0	
82646	chr17	80910586	80910948	362	181.0	
82647	chr17	80911690	80912155	465	232.0	
82648	chr17	80929714	80929718	4	2.0	
82649	chr17	80935516	80936001	485	242.0	
82650	chr17	80938433	80938982	549	274.0	
82651	chr17	80940837	80941199	362	181.0	
82652	chr17	80966739	80966806	67	34.0	
82653	chr17	80969368	80970807	1439	720.0	
82654	chr17	80980720	80981867	1147	574.0	
82655	chr17	80986861	80987909	1048	524.0	
82656	chr17	80988696	80989761	1065	532.0	
82657	chr17	80991186	80992781	1595	798.0	
82658	chr17	81002364	81002654	290	145.0	
82659	chr17	81003605	81005095	1490	745.0	
82660	chr17	81009395	81009549	154	77.0	
82661	chr17	81017855	81018980	1125	562.0	
82662	chr17	81023389	81024255	866	433.0	
82663	chr17	81027982	81028318	336	168.0	
82664	chr17	81031249	81032485	1236	618.0	
82665	chr17	81033158	81041575	8417	4208.0	
82666	chr17	81042100	81053658	11558	5779.0	
82667	chr17	81054376	81077646	23270	11635.0	
82668	chr17	81078643	81084896	6253	3126.0	
82669	chr17	81085618	81085763	145	72.0	
82670	chr17	81086399	81087815	1416	708.0	
82671	chr17	81090346	81091552	1206	603.0	
82672	chr17	81094364	81096084	1720	860.0	
82673	chr17	81097109	81098274	1165	582.0	
82674	chr17	81101417	81102394	977	488.0	
82675	chr17	81119154	81120156	1002	501.0	
82676	chr17	81142606	81143241	635	318.0	
82677	chr17	81148916	81149729	813	406.0	
82678	chr17	81150283	81151563	1280	640.0	
82679	chr17	81152543	81152550	7	4.0	
82680	chr17	81153214	81153865	651	326.0	
82681	chr17	81154916	81155403	487	244.0	
82682	chr17	81159951	81161039	1088	544.0	
82683	chr17	81165919	81166456	537	268.0	
82684	chr17	81189766	81189961	195	98.0	
82685	chr17	81200678	81201230	552	276.0	
82686	chr17	81207593	81208079	486	243.0	
82687	chr17	81222208	81224221	2013	1006.0	
82688	chr17	81228177	81229110	933	466.0	
82689	chr17	81230497	81230822	325	162.0	
82690	chr17	81238179	81240392	2213	1106.0	
82691	chr17	81241277	81242282	1005	502.0	
82692	chr17	81244593	81244599	6	3.0	
82693	chr17	81251789	81252165	376	188.0	
82694	chr17	81253084	81253931	847	424.0	
82695	chr17	81254765	81255856	1091	546.0	
82696	chr17	81272665	81273119	454	227.0	
82697	chr17	81284960	81286339	1379	690.0	
82698	chr17	81287785	81288859	1074	537.0	
82699	chr17	81291476	81292183	707	354.0	
82700	chr17	81294428	81296578	2150	1075.0	
82701	chr17	81306981	81307480	499	250.0	
82702	chr17	81308825	81309896	1071	536.0	
82703	chr17	81322755	81324151	1396	698.0	
82704	chr17	81326085	81327674	1589	794.0	
82705	chr17	81329333	81330652	1319	660.0	
82706	chr17	81339558	81340006	448	224.0	
82707	chr17	81341656	81342025	369	184.0	
82708	chr17	81342659	81347689	5030	2515.0	
82709	chr17	81350109	81350695	586	293.0	
82710	chr17	81355140	81355283	143	72.0	
82711	chr17	81357543	81357919	376	188.0	
82712	chr17	81365027	81366340	1313	656.0	
82713	chr17	81372416	81372862	446	223.0	
82714	chr17	81373494	81373884	390	195.0	
82715	chr17	81382066	81382701	635	318.0	
82716	chr17	81386442	81387990	1548	774.0	
82717	chr17	81388510	81389103	593	296.0	
82718	chr17	81392102	81400943	8841	4420.0	
82719	chr17	81401652	81402308	656	328.0	
82720	chr17	81409164	81409716	552	276.0	
82721	chr17	81412517	81413483	966	483.0	
82722	chr17	81419112	81419505	393	196.0	
82723	chr17	81422726	81423706	980	490.0	
82724	chr17	81425660	81426023	363	182.0	
82725	chr17	81453726	81454115	389	194.0	
82726	chr17	81455271	81455803	532	266.0	
82727	chr17	81460809	81461345	536	268.0	
82728	chr17	81469644	81470079	435	218.0	
82729	chr17	81471929	81472444	515	258.0	
82730	chr17	81480983	81485073	4090	2045.0	
82731	chr17	81486068	81486554	486	243.0	
82732	chr17	81487403	81489347	1944	972.0	
82733	chr17	81490221	81490653	432	216.0	
82734	chr17	81491208	81491418	210	105.0	
82735	chr17	81502630	81502723	93	46.0	
82736	chr17	81506833	81516648	9815	4908.0	
82737	chr17	81517269	81520494	3225	1612.0	
82738	chr17	81523175	81523538	363	182.0	
82739	chr17	81533571	81534233	662	331.0	
82740	chr17	81536806	81538034	1228	614.0	
82741	chr17	81551295	81554381	3086	1543.0	
82742	chr17	81559003	81559811	808	404.0	
82743	chr17	81560663	81561594	931	466.0	
82744	chr17	81563906	81564619	713	356.0	
82745	chr17	81577177	81577905	728	364.0	
82746	chr17	81598010	81598923	913	456.0	
82747	chr17	81601423	81601975	552	276.0	
82748	chr17	81614467	81614639	172	86.0	
82749	chr17	81636225	81637554	1329	664.0	
82750	chr17	81652884	81653939	1055	528.0	
82751	chr17	81662676	81663738	1062	531.0	
82752	chr17	81665415	81667385	1970	985.0	
82753	chr17	81675836	81676309	473	236.0	
82754	chr17	81682815	81684736	1921	960.0	
82755	chr17	81701385	81704361	2976	1488.0	
82756	chr17	81707439	81707540	101	50.0	
82757	chr17	81710320	81713110	2790	1395.0	
82758	chr17	81722446	81722539	93	46.0	
82759	chr17	81733630	81734465	835	418.0	
82760	chr17	81735348	81736287	939	470.0	
82761	chr17	81740590	81741876	1286	643.0	
82762	chr17	81817777	81817785	8	4.0	
82763	chr17	81821671	81822145	474	237.0	
82764	chr17	81831421	81834128	2707	1354.0	
82765	chr17	81837291	81838400	1109	554.0	
82766	chr17	81840567	81841745	1178	589.0	
82767	chr17	81842695	81842922	227	114.0	
82768	chr17	81844197	81845454	1257	628.0	
82769	chr17	81854929	81856223	1294	647.0	
82770	chr17	81858229	81862275	4046	2023.0	
82771	chr17	81863290	81873091	9801	4900.0	
82772	chr17	81884271	81886513	2242	1121.0	
82773	chr17	81888988	81889111	123	62.0	
82774	chr17	81890536	81892548	2012	1006.0	
82775	chr17	81901852	81903117	1265	632.0	
82776	chr17	81910321	81912350	2029	1014.0	
82777	chr17	81912878	81912882	4	2.0	
82778	chr17	81916202	81916715	513	256.0	
82779	chr17	81917228	81918973	1745	872.0	
82780	chr17	81921071	81921692	621	310.0	
82781	chr17	81922783	81925240	2457	1228.0	
82782	chr17	81925801	81929442	3641	1820.0	
82783	chr17	81930704	81930962	258	129.0	
82784	chr17	81936058	81937883	1825	912.0	
82785	chr17	81959191	81962135	2944	1472.0	
82786	chr17	81963597	81963980	383	192.0	
82787	chr17	81966701	81968703	2002	1001.0	
82788	chr17	81976437	81978481	2044	1022.0	
82789	chr17	81981083	81981313	230	115.0	
82790	chr17	81983573	81984011	438	219.0	
82791	chr17	82019823	82024236	4413	2206.0	
82792	chr17	82030139	82032451	2312	1156.0	
82793	chr17	82036585	82038348	1763	882.0	
82794	chr17	82038977	82039258	281	140.0	
82795	chr17	82050955	82052654	1699	850.0	
82796	chr17	82064618	82066448	1830	915.0	
82797	chr17	82080698	82081783	1085	542.0	
82798	chr17	82082489	82082632	143	72.0	
82799	chr17	82083728	82085232	1504	752.0	
82800	chr17	82085822	82086186	364	182.0	
82801	chr17	82088806	82089795	989	494.0	
82802	chr17	82095520	82100005	4485	2242.0	
82803	chr17	82101230	82101548	318	159.0	
82804	chr17	82105655	82107850	2195	1098.0	
82805	chr17	82120209	82120663	454	227.0	
82806	chr17	82126319	82128398	2079	1040.0	
82807	chr17	82153603	82154630	1027	514.0	
82808	chr17	82170286	82171052	766	383.0	
82809	chr17	82193465	82194240	775	388.0	
82810	chr17	82200493	82201355	862	431.0	
82811	chr17	82205403	82206798	1395	698.0	
82812	chr17	82212133	82218229	6096	3048.0	
82813	chr17	82222664	82223340	676	338.0	
82814	chr17	82226136	82226248	112	56.0	
82815	chr17	82226850	82253625	26775	13388.0	
82816	chr17	82255350	82255920	570	285.0	
82817	chr17	82256961	82258037	1076	538.0	
82818	chr17	82258583	82258947	364	182.0	
82819	chr17	82263594	82263662	68	34.0	
82820	chr17	82264335	82264422	87	44.0	
82821	chr17	82267198	82270859	3661	1830.0	
82822	chr17	82272203	82274345	2142	1071.0	
82823	chr17	82279045	82280000	955	478.0	
82824	chr17	82281228	82281372	144	72.0	
82825	chr17	82281942	82282225	283	142.0	
82826	chr17	82283247	82283841	594	297.0	
82827	chr17	82287868	82288552	684	342.0	
82828	chr17	82291356	82294577	3221	1610.0	
82829	chr17	82296720	82300000	3280	1640.0	"sequence_feature	enhancer"
82830	chr17	82300529	82306481	5952	2976.0	
82831	chr17	82314461	82318218	3757	1878.0	
82832	chr17	82320965	82323107	2142	1071.0	
82833	chr17	82332629	82335694	3065	1532.0	
82834	chr17	82340354	82340476	122	61.0	
82835	chr17	82346695	82347088	393	196.0	
82836	chr17	82350446	82350912	466	233.0	
82837	chr17	82351453	82352442	989	494.0	
82838	chr17	82358984	82359314	330	165.0	
82839	chr17	82371260	82371308	48	24.0	
82840	chr17	82400258	82401318	1060	530.0	
82841	chr17	82414381	82415190	809	404.0	
82842	chr17	82417705	82420098	2393	1196.0	
82843	chr17	82424538	82424986	448	224.0	
82844	chr17	82429381	82429409	28	14.0	
82845	chr17	82433972	82434627	655	328.0	
82846	chr17	82440272	82441385	1113	556.0	
82847	chr17	82448785	82451416	2631	1316.0	
82848	chr17	82457072	82459663	2591	1296.0	
82849	chr17	82463570	82463992	422	211.0	
82850	chr17	82465203	82465805	602	301.0	
82851	chr17	82480828	82481192	364	182.0	
82852	chr17	82494047	82498338	4291	2146.0	
82853	chr17	82499140	82499473	333	166.0	
82854	chr17	82506433	82506760	327	164.0	
82855	chr17	82509268	82509449	181	90.0	
82856	chr17	82517462	82517655	193	96.0	
82857	chr17	82518771	82521178	2407	1204.0	
82858	chr17	82521964	82522359	395	198.0	
82859	chr17	82528722	82529239	517	258.0	
82860	chr17	82531007	82531328	321	160.0	
82861	chr17	82548503	82549356	853	426.0	
82862	chr17	82550883	82552323	1440	720.0	
82863	chr17	82554355	82554870	515	258.0	
82864	chr17	82582305	82582616	311	156.0	
82865	chr17	82583690	82584240	550	275.0	
82866	chr17	82587150	82587662	512	256.0	
82867	chr17	82590920	82594107	3187	1594.0	
82868	chr17	82603818	82604667	849	424.0	
82869	chr17	82623690	82624310	620	310.0	
82870	chr17	82627434	82628608	1174	587.0	
82871	chr17	82636846	82636962	116	58.0	
82872	chr17	82639554	82640865	1311	656.0	
82873	chr17	82646607	82650437	3830	1915.0	
82874	chr17	82654946	82655719	773	386.0	
82875	chr17	82668471	82669030	559	280.0	
82876	chr17	82697337	82699699	2362	1181.0	
82877	chr17	82707912	82709013	1101	550.0	
82878	chr17	82715848	82717952	2104	1052.0	
82879	chr17	82735063	82736164	1101	550.0	
82880	chr17	82750961	82753181	2220	1110.0	
82881	chr17	82767375	82767376	1	0.0	
82882	chr17	82770421	82770695	274	137.0	
82883	chr17	82774932	82775924	992	496.0	
82884	chr17	82776467	82776858	391	196.0	
82885	chr17	82781522	82783220	1698	849.0	
82886	chr17	82819002	82819389	387	194.0	
82887	chr17	82836946	82837176	230	115.0	
82888	chr17	82837973	82838846	873	436.0	
82889	chr17	82847852	82848605	753	376.0	
82890	chr17	82849444	82849735	291	146.0	
82891	chr17	82858586	82860684	2098	1049.0	
82892	chr17	82863476	82865228	1752	876.0	
82893	chr17	82870981	82871909	928	464.0	enhancer
82894	chr17	82872536	82873329	793	396.0	
82895	chr17	82876147	82876423	276	138.0	
82896	chr17	82878701	82878808	107	54.0	
82897	chr17	82881899	82883691	1792	896.0	
82898	chr17	82884484	82886481	1997	998.0	
82899	chr17	82892853	82894268	1415	708.0	
82900	chr17	82908031	82908261	230	115.0	
82901	chr17	82909230	82910244	1014	507.0	
82902	chr17	82911785	82912321	536	268.0	
82903	chr17	82915499	82915694	195	98.0	
82904	chr17	82917689	82918095	406	203.0	
82905	chr17	82962918	82963795	877	438.0	
82906	chr17	82978578	82979481	903	452.0	
82907	chr17	82985797	82986558	761	380.0	
82908	chr17	83046777	83047076	299	150.0	
82909	chr17	83048017	83049632	1615	808.0	
82910	chr17	83050744	83052648	1904	952.0	
82911	chr17	83053731	83054881	1150	575.0	
82912	chr17	83068897	83069485	588	294.0	
82913	chr17	83071870	83072560	690	345.0	
82914	chr17	83073468	83074134	666	333.0	
82915	chr17	83076932	83092401	15469	7734.0	
82916	chr17	83093006	83103310	10304	5152.0	
82917	chr17	83104188	83106335	2147	1074.0	
82918	chr17	83107160	83107670	510	255.0	
82919	chr17	83153081	83153775	694	347.0	
82920	chr17	83155227	83156158	931	466.0	
82921	chr17	83202851	83203892	1041	520.0	
82922	chr17	83204985	83206199	1214	607.0	
82923	chr18	10761	10783	22	11.0	
82924	chr18	11651	12678	1027	514.0	
82925	chr18	13463	13566	103	52.0	
82926	chr18	105676	106070	394	197.0	
82927	chr18	107460	108307	847	424.0	
82928	chr18	109007	112495	3488	1744.0	
82929	chr18	136382	136880	498	249.0	
82930	chr18	157869	159630	1761	880.0	
82931	chr18	267140	269251	2111	1056.0	
82932	chr18	275522	275896	374	187.0	
82933	chr18	322110	323737	1627	814.0	
82934	chr18	331931	332267	336	168.0	
82935	chr18	335983	336091	108	54.0	
82936	chr18	336703	337104	401	200.0	
82937	chr18	362016	362272	256	128.0	
82938	chr18	370885	370969	84	42.0	
82939	chr18	374740	374928	188	94.0	
82940	chr18	379519	380551	1032	516.0	
82941	chr18	393299	393486	187	94.0	
82942	chr18	400402	400929	527	264.0	
82943	chr18	405153	405466	313	156.0	
82944	chr18	447098	447645	547	274.0	
82945	chr18	452959	453351	392	196.0	
82946	chr18	463757	464733	976	488.0	
82947	chr18	469371	469777	406	203.0	
82948	chr18	471095	471513	418	209.0	
82949	chr18	484835	485148	313	156.0	
82950	chr18	495236	495320	84	42.0	
82951	chr18	496969	497367	398	199.0	
82952	chr18	499923	500936	1013	506.0	
82953	chr18	518907	519361	454	227.0	
82954	chr18	596119	597529	1410	705.0	
82955	chr18	614759	615718	959	480.0	
82956	chr18	616350	616756	406	203.0	
82957	chr18	623925	624374	449	224.0	
82958	chr18	650312	650788	476	238.0	
82959	chr18	657076	659054	1978	989.0	
82960	chr18	681940	682456	516	258.0	
82961	chr18	702895	703294	399	200.0	
82962	chr18	711207	713648	2441	1220.0	
82963	chr18	714217	714618	401	200.0	
82964	chr18	715668	716064	396	198.0	
82965	chr18	725692	726000	308	154.0	
82966	chr18	741771	742454	683	342.0	
82967	chr18	801119	801641	522	261.0	
82968	chr18	805179	806048	869	434.0	
82969	chr18	807751	808939	1188	594.0	
82970	chr18	810200	813990	3790	1895.0	
82971	chr18	814503	814982	479	240.0	
82972	chr18	829927	831425	1498	749.0	
82973	chr18	832246	832497	251	126.0	
82974	chr18	839106	839988	882	441.0	
82975	chr18	845160	845493	333	166.0	
82976	chr18	864749	865223	474	237.0	
82977	chr18	873737	874437	700	350.0	
82978	chr18	1578575	1578909	334	167.0	
82979	chr18	1648602	1649191	589	294.0	
82980	chr18	1664106	1664507	401	200.0	
82981	chr18	2104859	2105231	372	186.0	
82982	chr18	2337543	2337914	371	186.0	
82983	chr18	2448719	2449135	416	208.0	
82984	chr18	2516132	2516679	547	274.0	
82985	chr18	2541951	2542347	396	198.0	
82986	chr18	2547443	2547873	430	215.0	
82987	chr18	2570568	2572468	1900	950.0	
82988	chr18	2589389	2590506	1117	558.0	
82989	chr18	2597584	2598048	464	232.0	
82990	chr18	2605222	2606810	1588	794.0	
82991	chr18	2627811	2628286	475	238.0	
82992	chr18	2635931	2638684	2753	1376.0	
82993	chr18	2639915	2640187	272	136.0	
82994	chr18	2641230	2642231	1001	500.0	
82995	chr18	2646183	2647117	934	467.0	
82996	chr18	2653435	2658650	5215	2608.0	
82997	chr18	2659310	2659786	476	238.0	
82998	chr18	2662428	2663696	1268	634.0	
82999	chr18	2680329	2680682	353	176.0	
83000	chr18	2682020	2682624	604	302.0	
83001	chr18	2687559	2688088	529	264.0	
83002	chr18	2692202	2692345	143	72.0	
83003	chr18	2706749	2707148	399	200.0	
83004	chr18	2809421	2809848	427	214.0	
83005	chr18	2843025	2843638	613	306.0	
83006	chr18	2844874	2849131	4257	2128.0	
83007	chr18	2856456	2858285	1829	914.0	
83008	chr18	2858880	2859221	341	170.0	
83009	chr18	2875461	2875670	209	104.0	
83010	chr18	2881851	2882227	376	188.0	
83011	chr18	2882987	2883891	904	452.0	
83012	chr18	2889595	2890362	767	384.0	
83013	chr18	2898038	2898824	786	393.0	
83014	chr18	2905835	2909800	3965	1982.0	
83015	chr18	2911726	2911825	99	50.0	
83016	chr18	2913151	2913518	367	184.0	
83017	chr18	2917290	2917676	386	193.0	
83018	chr18	2932126	2932999	873	436.0	
83019	chr18	2955811	2956656	845	422.0	
83020	chr18	2957543	2962370	4827	2414.0	
83021	chr18	2962895	2963617	722	361.0	
83022	chr18	2964325	2964851	526	263.0	
83023	chr18	2965814	2966169	355	178.0	
83024	chr18	2967297	2973370	6073	3036.0	
83025	chr18	2978396	2981892	3496	1748.0	
83026	chr18	2982416	2983461	1045	522.0	
83027	chr18	2984730	2986219	1489	744.0	
83028	chr18	2994308	2995232	924	462.0	
83029	chr18	2996214	2996564	350	175.0	
83030	chr18	2998256	2999667	1411	706.0	
83031	chr18	3008551	3008828	277	138.0	
83032	chr18	3009516	3009708	192	96.0	
83033	chr18	3011456	3017382	5926	2963.0	
83034	chr18	3037323	3037855	532	266.0	
83035	chr18	3045296	3045762	466	233.0	
83036	chr18	3051921	3052746	825	412.0	
83037	chr18	3058249	3059736	1487	744.0	
83038	chr18	3060387	3063397	3010	1505.0	
83039	chr18	3066420	3066722	302	151.0	
83040	chr18	3067490	3068072	582	291.0	
83041	chr18	3074073	3074363	290	145.0	
83042	chr18	3097007	3097541	534	267.0	
83043	chr18	3129027	3129911	884	442.0	
83044	chr18	3151400	3151814	414	207.0	
83045	chr18	3161281	3161736	455	228.0	
83046	chr18	3177693	3178600	907	454.0	
83047	chr18	3179441	3179953	512	256.0	
83048	chr18	3213441	3213778	337	168.0	
83049	chr18	3230470	3230885	415	208.0	
83050	chr18	3245469	3249858	4389	2194.0	
83051	chr18	3250541	3250928	387	194.0	
83052	chr18	3255587	3256002	415	208.0	
83053	chr18	3260320	3264829	4509	2254.0	
83054	chr18	3265620	3267486	1866	933.0	
83055	chr18	3268318	3268509	191	96.0	
83056	chr18	3269122	3269691	569	284.0	
83057	chr18	3277622	3278043	421	210.0	
83058	chr18	3279039	3279804	765	382.0	
83059	chr18	3281344	3281907	563	282.0	
83060	chr18	3286199	3286240	41	20.0	
83061	chr18	3296750	3297911	1161	580.0	
83062	chr18	3305147	3305782	635	318.0	
83063	chr18	3322889	3323298	409	204.0	
83064	chr18	3323950	3324322	372	186.0	
83065	chr18	3340000	3340373	373	186.0	
83066	chr18	3380583	3380994	411	206.0	
83067	chr18	3401685	3402302	617	308.0	
83068	chr18	3405680	3406142	462	231.0	
83069	chr18	3411927	3412406	479	240.0	
83070	chr18	3424417	3424586	169	84.0	
83071	chr18	3441291	3441732	441	220.0	
83072	chr18	3446357	3455126	8769	4384.0	
83073	chr18	3458358	3459619	1261	630.0	
83074	chr18	3466889	3467290	401	200.0	
83075	chr18	3473246	3473520	274	137.0	
83076	chr18	3481775	3482210	435	218.0	
83077	chr18	3493512	3493917	405	202.0	
83078	chr18	3495675	3496076	401	200.0	
83079	chr18	3498939	3499896	957	478.0	
83080	chr18	3511761	3512575	814	407.0	
83081	chr18	3525768	3526579	811	406.0	
83082	chr18	3584858	3587310	2452	1226.0	
83083	chr18	3593065	3597451	4386	2193.0	
83084	chr18	3602378	3606697	4319	2160.0	
83085	chr18	3624782	3625254	472	236.0	
83086	chr18	3652871	3653176	305	152.0	
83087	chr18	3659574	3660162	588	294.0	
83088	chr18	3660678	3661721	1043	522.0	
83089	chr18	3664800	3665280	480	240.0	
83090	chr18	3665828	3666777	949	474.0	
83091	chr18	3679191	3679673	482	241.0	
83092	chr18	3690471	3690797	326	163.0	
83093	chr18	3699626	3700619	993	496.0	
83094	chr18	3703630	3704082	452	226.0	
83095	chr18	3706489	3706855	366	183.0	
83096	chr18	3710665	3711397	732	366.0	
83097	chr18	3722003	3722772	769	384.0	
83098	chr18	3725066	3725559	493	246.0	
83099	chr18	3726203	3726692	489	244.0	
83100	chr18	3747237	3748383	1146	573.0	
83101	chr18	3748992	3749398	406	203.0	
83102	chr18	3771071	3772021	950	475.0	
83103	chr18	3787249	3787807	558	279.0	
83104	chr18	3869874	3870228	354	177.0	
83105	chr18	3875955	3876377	422	211.0	
83106	chr18	3877637	3878812	1175	588.0	
83107	chr18	3995475	3995890	415	208.0	
83108	chr18	4060381	4060824	443	222.0	
83109	chr18	4068767	4068910	143	72.0	
83110	chr18	4106417	4106797	380	190.0	
83111	chr18	5057386	5059673	2287	1144.0	
83112	chr18	5073314	5073359	45	22.0	
83113	chr18	5158949	5159512	563	282.0	
83114	chr18	5167882	5168218	336	168.0	
83115	chr18	5175329	5175699	370	185.0	
83116	chr18	5196946	5197406	460	230.0	
83117	chr18	5236993	5239090	2097	1048.0	
83118	chr18	5293985	5297687	3702	1851.0	
83119	chr18	5309835	5310728	893	446.0	
83120	chr18	5417341	5417839	498	249.0	
83121	chr18	5418983	5419426	443	222.0	
83122	chr18	5424925	5425334	409	204.0	
83123	chr18	5440141	5440733	592	296.0	
83124	chr18	5444903	5445207	304	152.0	
83125	chr18	5455512	5457187	1675	838.0	
83126	chr18	5462151	5462682	531	266.0	
83127	chr18	5463227	5464874	1647	824.0	
83128	chr18	5466127	5467052	925	462.0	
83129	chr18	5475191	5475715	524	262.0	
83130	chr18	5514954	5516172	1218	609.0	
83131	chr18	5527653	5527972	319	160.0	
83132	chr18	5542596	5544350	1754	877.0	
83133	chr18	5546658	5547059	401	200.0	
83134	chr18	5574787	5575328	541	270.0	
83135	chr18	5583029	5583911	882	441.0	
83136	chr18	5628523	5628890	367	184.0	
83137	chr18	5629802	5630872	1070	535.0	
83138	chr18	5890480	5890980	500	250.0	
83139	chr18	6269989	6270272	283	142.0	
83140	chr18	6270884	6271175	291	146.0	
83141	chr18	6294354	6294837	483	242.0	
83142	chr18	6406258	6406879	621	310.0	
83143	chr18	6413666	6415420	1754	877.0	
83144	chr18	7273279	7274167	888	444.0	
83145	chr18	7452435	7452477	42	21.0	
83146	chr18	7566451	7568910	2459	1230.0	
83147	chr18	7573117	7573159	42	21.0	
83148	chr18	7946651	7947235	584	292.0	
83149	chr18	7950721	7951087	366	183.0	
83150	chr18	7957267	7957641	374	187.0	
83151	chr18	7958471	7958872	401	200.0	
83152	chr18	7964816	7965217	401	200.0	
83153	chr18	8052227	8052700	473	236.0	
83154	chr18	8367304	8367654	350	175.0	
83155	chr18	8478684	8479040	356	178.0	
83156	chr18	8529700	8529930	230	115.0	
83157	chr18	8601115	8602081	966	483.0	
83158	chr18	8603660	8604657	997	498.0	
83159	chr18	8607797	8611230	3433	1716.0	
83160	chr18	8615338	8615843	505	252.0	
83161	chr18	8623280	8624352	1072	536.0	
83162	chr18	8654470	8654718	248	124.0	
83163	chr18	8696056	8697203	1147	574.0	
83164	chr18	8703916	8707577	3661	1830.0	
83165	chr18	8742286	8742867	581	290.0	
83166	chr18	8744585	8745118	533	266.0	
83167	chr18	8745743	8745758	15	8.0	
83168	chr18	8755325	8756067	742	371.0	
83169	chr18	8763103	8763324	221	110.0	
83170	chr18	8786257	8787030	773	386.0	
83171	chr18	8912227	8912820	593	296.0	
83172	chr18	8966818	8967224	406	203.0	
83173	chr18	8988217	8988707	490	245.0	
83174	chr18	9017026	9017804	778	389.0	
83175	chr18	9062006	9062851	845	422.0	
83176	chr18	9066919	9067099	180	90.0	
83177	chr18	9069597	9070135	538	269.0	
83178	chr18	9073354	9074289	935	468.0	
83179	chr18	9082610	9084464	1854	927.0	
83180	chr18	9090902	9092504	1602	801.0	
83181	chr18	9095049	9095993	944	472.0	
83182	chr18	9101474	9104590	3116	1558.0	
83183	chr18	9107143	9107808	665	332.0	
83184	chr18	9113281	9114046	765	382.0	
83185	chr18	9116614	9119051	2437	1218.0	
83186	chr18	9120774	9121237	463	232.0	
83187	chr18	9135528	9138687	3159	1580.0	
83188	chr18	9139675	9140729	1054	527.0	
83189	chr18	9142137	9142219	82	41.0	
83190	chr18	9143476	9144212	736	368.0	
83191	chr18	9146461	9146541	80	40.0	
83192	chr18	9147470	9148432	962	481.0	
83193	chr18	9150127	9150492	365	182.0	
83194	chr18	9160055	9160395	340	170.0	
83195	chr18	9174009	9174820	811	406.0	
83196	chr18	9184873	9185538	665	332.0	
83197	chr18	9240316	9240616	300	150.0	
83198	chr18	9243114	9243298	184	92.0	
83199	chr18	9261050	9261181	131	66.0	
83200	chr18	9333555	9335555	2000	1000.0	
83201	chr18	9404372	9404968	596	298.0	
83202	chr18	9433195	9433968	773	386.0	
83203	chr18	9466838	9467157	319	160.0	
83204	chr18	9474424	9477026	2602	1301.0	
83205	chr18	9494622	9495218	596	298.0	
83206	chr18	9516375	9516900	525	262.0	
83207	chr18	9530734	9530839	105	52.0	
83208	chr18	9561763	9562142	379	190.0	
83209	chr18	9575432	9575979	547	274.0	
83210	chr18	9612117	9615612	3495	1748.0	
83211	chr18	9647953	9648359	406	203.0	
83212	chr18	9673063	9673991	928	464.0	
83213	chr18	9701831	9702875	1044	522.0	
83214	chr18	9707461	9709782	2321	1160.0	
83215	chr18	9710644	9713255	2611	1306.0	
83216	chr18	9715920	9716758	838	419.0	
83217	chr18	9734189	9734297	108	54.0	
83218	chr18	9735285	9735795	510	255.0	
83219	chr18	9739784	9741120	1336	668.0	
83220	chr18	9741716	9743937	2221	1110.0	
83221	chr18	9753830	9754389	559	280.0	
83222	chr18	9755536	9756311	775	388.0	
83223	chr18	9758198	9758886	688	344.0	
83224	chr18	9760556	9761027	471	236.0	
83225	chr18	9762415	9763029	614	307.0	
83226	chr18	9766008	9766415	407	204.0	
83227	chr18	9771025	9772484	1459	730.0	
83228	chr18	9774960	9775937	977	488.0	
83229	chr18	9779577	9779984	407	204.0	
83230	chr18	9782214	9783337	1123	562.0	
83231	chr18	9792521	9793324	803	402.0	
83232	chr18	9804268	9805051	783	392.0	
83233	chr18	9825374	9828733	3359	1680.0	
83234	chr18	9849337	9850299	962	481.0	
83235	chr18	9851394	9851918	524	262.0	
83236	chr18	9856040	9856516	476	238.0	
83237	chr18	9869820	9870295	475	238.0	
83238	chr18	9906567	9906791	224	112.0	
83239	chr18	9910588	9911158	570	285.0	
83240	chr18	9912278	9916649	4371	2186.0	
83241	chr18	9918048	9918130	82	41.0	
83242	chr18	9920438	9921179	741	370.0	
83243	chr18	9951281	9951619	338	169.0	
83244	chr18	9953012	9953278	266	133.0	
83245	chr18	9968407	9969679	1272	636.0	
83246	chr18	9971259	9971781	522	261.0	
83247	chr18	9989508	9989934	426	213.0	
83248	chr18	9990980	9991334	354	177.0	
83249	chr18	10005012	10005725	713	356.0	
83250	chr18	10006521	10006990	469	234.0	
83251	chr18	10016482	10016880	398	199.0	
83252	chr18	10020102	10020588	486	243.0	
83253	chr18	10024562	10024633	71	36.0	
83254	chr18	10032267	10033156	889	444.0	
83255	chr18	10045006	10045076	70	35.0	
83256	chr18	10057304	10058769	1465	732.0	
83257	chr18	10059987	10060205	218	109.0	
83258	chr18	10072602	10073208	606	303.0	
83259	chr18	10113613	10114189	576	288.0	
83260	chr18	10122966	10123609	643	322.0	
83261	chr18	10130486	10130985	499	250.0	
83262	chr18	10131854	10132231	377	188.0	
83263	chr18	10140560	10140925	365	182.0	
83264	chr18	10201598	10202078	480	240.0	
83265	chr18	10213439	10214025	586	293.0	
83266	chr18	10215462	10215835	373	186.0	
83267	chr18	10231212	10231621	409	204.0	
83268	chr18	10250671	10251053	382	191.0	
83269	chr18	10258840	10259198	358	179.0	
83270	chr18	10261229	10261796	567	284.0	
83271	chr18	10265523	10265736	213	106.0	
83272	chr18	10284907	10285682	775	388.0	
83273	chr18	10289893	10291228	1335	668.0	
83274	chr18	10298384	10298729	345	172.0	
83275	chr18	10315536	10315874	338	169.0	
83276	chr18	10354470	10354791	321	160.0	
83277	chr18	10367922	10368196	274	137.0	
83278	chr18	10400448	10401971	1523	762.0	
83279	chr18	10454307	10455441	1134	567.0	
83280	chr18	10475299	10475647	348	174.0	
83281	chr18	10482817	10483577	760	380.0	
83282	chr18	10490555	10491216	661	330.0	
83283	chr18	10499198	10499718	520	260.0	
83284	chr18	10515591	10515715	124	62.0	
83285	chr18	10518603	10519374	771	386.0	
83286	chr18	10520007	10520578	571	286.0	
83287	chr18	10524809	10527614	2805	1402.0	
83288	chr18	10528571	10528688	117	58.0	
83289	chr18	10559997	10560900	903	452.0	
83290	chr18	10591884	10592256	372	186.0	
83291	chr18	10593588	10594220	632	316.0	
83292	chr18	10604165	10604508	343	172.0	
83293	chr18	10629051	10629403	352	176.0	
83294	chr18	10744035	10744174	139	70.0	
83295	chr18	10787241	10787842	601	300.0	
83296	chr18	10791435	10792608	1173	586.0	
83297	chr18	11149402	11149884	482	241.0	
83298	chr18	11163668	11163974	306	153.0	
83299	chr18	11259497	11259751	254	127.0	
83300	chr18	11293903	11294165	262	131.0	
83301	chr18	11553324	11553753	429	214.0	
83302	chr18	11587842	11588190	348	174.0	
83303	chr18	11655369	11655622	253	126.0	
83304	chr18	11688937	11690312	1375	688.0	
83305	chr18	11732895	11733542	647	324.0	
83306	chr18	11751836	11752927	1091	546.0	
83307	chr18	11760732	11761196	464	232.0	
83308	chr18	11806946	11806953	7	4.0	
83309	chr18	11817834	11819206	1372	686.0	
83310	chr18	11828861	11829185	324	162.0	
83311	chr18	11848128	11848512	384	192.0	
83312	chr18	11849496	11855170	5674	2837.0	
83313	chr18	11855821	11856498	677	338.0	
83314	chr18	11857022	11858026	1004	502.0	
83315	chr18	11860013	11860585	572	286.0	
83316	chr18	11872566	11872857	291	146.0	
83317	chr18	11882745	11883646	901	450.0	
83318	chr18	11884705	11884786	81	40.0	
83319	chr18	11885421	11886010	589	294.0	
83320	chr18	11893726	11894350	624	312.0	
83321	chr18	11907862	11910105	2243	1122.0	
83322	chr18	11916874	11917462	588	294.0	
83323	chr18	11921913	11922321	408	204.0	
83324	chr18	11925103	11925446	343	172.0	
83325	chr18	11937777	11938483	706	353.0	
83326	chr18	11946973	11948190	1217	608.0	
83327	chr18	11979859	11982700	2841	1420.0	
83328	chr18	11987532	11988049	517	258.0	
83329	chr18	11994978	11996563	1585	792.0	
83330	chr18	12034519	12034869	350	175.0	
83331	chr18	12038249	12039450	1201	600.0	
83332	chr18	12050035	12050736	701	350.0	
83333	chr18	12053277	12053722	445	222.0	
83334	chr18	12237150	12237616	466	233.0	
83335	chr18	12271587	12272338	751	376.0	
83336	chr18	12307017	12309278	2261	1130.0	
83337	chr18	12315563	12315951	388	194.0	
83338	chr18	12317548	12318463	915	458.0	
83339	chr18	12327612	12328361	749	374.0	
83340	chr18	12376032	12378349	2317	1158.0	
83341	chr18	12391600	12392120	520	260.0	
83342	chr18	12394422	12394767	345	172.0	
83343	chr18	12407371	12408686	1315	658.0	
83344	chr18	12419707	12420750	1043	522.0	
83345	chr18	12595990	12596299	309	154.0	
83346	chr18	12596884	12597124	240	120.0	
83347	chr18	12606831	12607761	930	465.0	
83348	chr18	12656921	12660317	3396	1698.0	
83349	chr18	12679202	12679552	350	175.0	
83350	chr18	12701673	12704514	2841	1420.0	
83351	chr18	12726789	12727681	892	446.0	
83352	chr18	12744079	12744535	456	228.0	
83353	chr18	12774941	12776543	1602	801.0	
83354	chr18	12777151	12777710	559	280.0	
83355	chr18	12838023	12840970	2947	1474.0	
83356	chr18	12867485	12867844	359	180.0	
83357	chr18	12879748	12881226	1478	739.0	
83358	chr18	12882707	12886955	4248	2124.0	
83359	chr18	12890534	12890819	285	142.0	
83360	chr18	12893712	12894275	563	282.0	
83361	chr18	12896824	12897475	651	326.0	
83362	chr18	12903859	12904571	712	356.0	
83363	chr18	12910870	12911740	870	435.0	
83364	chr18	12920870	12921918	1048	524.0	
83365	chr18	12929650	12930107	457	228.0	
83366	chr18	12934242	12935066	824	412.0	
83367	chr18	12944838	12944989	151	76.0	
83368	chr18	12946722	12949179	2457	1228.0	
83369	chr18	12964853	12965244	391	196.0	
83370	chr18	12989969	12992318	2349	1174.0	
83371	chr18	13003368	13003835	467	234.0	
83372	chr18	13048248	13048644	396	198.0	
83373	chr18	13051882	13052438	556	278.0	
83374	chr18	13113101	13113256	155	78.0	
83375	chr18	13135915	13138946	3031	1516.0	
83376	chr18	13147181	13147517	336	168.0	
83377	chr18	13159408	13159947	539	270.0	
83378	chr18	13176885	13177232	347	174.0	
83379	chr18	13215845	13219236	3391	1696.0	
83380	chr18	13222050	13222948	898	449.0	
83381	chr18	13266448	13266879	431	216.0	
83382	chr18	13273768	13274346	578	289.0	
83383	chr18	13276536	13277030	494	247.0	
83384	chr18	13279189	13279556	367	184.0	
83385	chr18	13282297	13282871	574	287.0	
83386	chr18	13284673	13284919	246	123.0	
83387	chr18	13287367	13287778	411	206.0	
83388	chr18	13290951	13291342	391	196.0	
83389	chr18	13302835	13303204	369	184.0	
83390	chr18	13308447	13308706	259	130.0	
83391	chr18	13313386	13313657	271	136.0	
83392	chr18	13353316	13353821	505	252.0	
83393	chr18	13359187	13359653	466	233.0	
83394	chr18	13362654	13362959	305	152.0	
83395	chr18	13367073	13367203	130	65.0	
83396	chr18	13369639	13370089	450	225.0	
83397	chr18	13372031	13372362	331	166.0	
83398	chr18	13374862	13378536	3674	1837.0	
83399	chr18	13381006	13383556	2550	1275.0	
83400	chr18	13416229	13416542	313	156.0	
83401	chr18	13436582	13438655	2073	1036.0	
83402	chr18	13450772	13452419	1647	824.0	
83403	chr18	13455544	13456466	922	461.0	
83404	chr18	13464405	13466014	1609	804.0	
83405	chr18	13470619	13471214	595	298.0	
83406	chr18	13482311	13482774	463	232.0	
83407	chr18	13487317	13487645	328	164.0	
83408	chr18	13538973	13539549	576	288.0	
83409	chr18	13540794	13541146	352	176.0	
83410	chr18	13548099	13548376	277	138.0	
83411	chr18	13549203	13550036	833	416.0	
83412	chr18	13558007	13558608	601	300.0	
83413	chr18	13562322	13563869	1547	774.0	
83414	chr18	13566296	13569454	3158	1579.0	
83415	chr18	13576838	13578062	1224	612.0	
83416	chr18	13579777	13580353	576	288.0	
83417	chr18	13585613	13586644	1031	516.0	
83418	chr18	13608118	13609719	1601	800.0	
83419	chr18	13610617	13616440	5823	2912.0	
83420	chr18	13623350	13623897	547	274.0	
83421	chr18	13630024	13630593	569	284.0	
83422	chr18	13641439	13642256	817	408.0	
83423	chr18	13725520	13727829	2309	1154.0	
83424	chr18	13730581	13730841	260	130.0	
83425	chr18	13813234	13813690	456	228.0	
83426	chr18	13823796	13824546	750	375.0	
83427	chr18	14131727	14133032	1305	652.0	
83428	chr18	14139564	14140028	464	232.0	
83429	chr18	14174871	14175084	213	106.0	
83430	chr18	14178423	14179750	1327	664.0	
83431	chr18	14415781	14416148	367	184.0	
83432	chr18	14430853	14431684	831	416.0	
83433	chr18	14450153	14451070	917	458.0	
83434	chr18	14457996	14459009	1013	506.0	
83435	chr18	14612416	14612605	189	94.0	
83436	chr18	15407689	15408163	474	237.0	
83437	chr18	15409278	15410099	821	410.0	
83438	chr18	20930937	20940569	9632	4816.0	
83439	chr18	20971837	20972271	434	217.0	
83440	chr18	21004721	21005022	301	150.0	
83441	chr18	21054426	21054826	400	200.0	
83442	chr18	21099442	21099888	446	223.0	
83443	chr18	21101425	21101538	113	56.0	
83444	chr18	21105967	21106346	379	190.0	
83445	chr18	21110304	21112831	2527	1264.0	
83446	chr18	21117466	21118376	910	455.0	
83447	chr18	21134864	21135290	426	213.0	
83448	chr18	21163569	21164620	1051	526.0	
83449	chr18	21179537	21180036	499	250.0	
83450	chr18	21599029	21602900	3871	1936.0	
83451	chr18	21611587	21613130	1543	772.0	
83452	chr18	21682294	21683249	955	478.0	
83453	chr18	21684953	21686037	1084	542.0	
83454	chr18	21686559	21686919	360	180.0	
83455	chr18	21699200	21700127	927	464.0	
83456	chr18	21703095	21705474	2379	1190.0	
83457	chr18	21735471	21736109	638	319.0	
83458	chr18	21739952	21742377	2425	1212.0	
83459	chr18	21745180	21745848	668	334.0	
83460	chr18	21853019	21853408	389	194.0	
83461	chr18	21897743	21898095	352	176.0	
83462	chr18	21956003	21956456	453	226.0	
83463	chr18	21997554	21998024	470	235.0	
83464	chr18	22168261	22172156	3895	1948.0	
83465	chr18	22190723	22191202	479	240.0	
83466	chr18	22221393	22221804	411	206.0	
83467	chr18	22237972	22238648	676	338.0	
83468	chr18	22260204	22260864	660	330.0	
83469	chr18	22263273	22263544	271	136.0	
83470	chr18	22282063	22283401	1338	669.0	
83471	chr18	22285375	22285943	568	284.0	
83472	chr18	22296373	22296696	323	162.0	
83473	chr18	22301272	22302666	1394	697.0	
83474	chr18	22307516	22307959	443	222.0	
83475	chr18	22320790	22321093	303	152.0	
83476	chr18	22322317	22322792	475	238.0	
83477	chr18	22324104	22325178	1074	537.0	
83478	chr18	22332504	22332907	403	202.0	
83479	chr18	22337498	22337675	177	88.0	
83480	chr18	22342534	22347334	4800	2400.0	
83481	chr18	22348086	22349457	1371	686.0	
83482	chr18	22363878	22364240	362	181.0	
83483	chr18	22378699	22379029	330	165.0	
83484	chr18	22385791	22386053	262	131.0	
83485	chr18	22391442	22392186	744	372.0	
83486	chr18	22393261	22393549	288	144.0	
83487	chr18	22406129	22406419	290	145.0	
83488	chr18	22407979	22408460	481	240.0	
83489	chr18	22465906	22466827	921	460.0	
83490	chr18	22559452	22560301	849	424.0	
83491	chr18	22563070	22563545	475	238.0	
83492	chr18	22704348	22704660	312	156.0	
83493	chr18	22799011	22799453	442	221.0	
83494	chr18	22831579	22831650	71	36.0	
83495	chr18	22872962	22873515	553	276.0	
83496	chr18	22930028	22930620	592	296.0	
83497	chr18	22932666	22934459	1793	896.0	
83498	chr18	22939299	22940014	715	358.0	
83499	chr18	22953416	22953541	125	62.0	
83500	chr18	22975539	22975830	291	146.0	
83501	chr18	22983241	22983481	240	120.0	
83502	chr18	23020922	23021353	431	216.0	
83503	chr18	23049659	23050108	449	224.0	
83504	chr18	23054074	23054209	135	68.0	
83505	chr18	23068577	23072164	3587	1794.0	
83506	chr18	23077714	23079251	1537	768.0	
83507	chr18	23091232	23091826	594	297.0	
83508	chr18	23126338	23126739	401	200.0	
83509	chr18	23131654	23132158	504	252.0	
83510	chr18	23134240	23137197	2957	1478.0	
83511	chr18	23142981	23143843	862	431.0	
83512	chr18	23224307	23224831	524	262.0	
83513	chr18	23228237	23229138	901	450.0	
83514	chr18	23230761	23232809	2048	1024.0	
83515	chr18	23237303	23238421	1118	559.0	
83516	chr18	23243084	23244207	1123	562.0	
83517	chr18	23250844	23251868	1024	512.0	
83518	chr18	23257890	23258767	877	438.0	
83519	chr18	23259469	23260814	1345	672.0	
83520	chr18	23267039	23267407	368	184.0	
83521	chr18	23269138	23269451	313	156.0	
83522	chr18	23306772	23308476	1704	852.0	
83523	chr18	23317995	23318269	274	137.0	
83524	chr18	23358385	23359337	952	476.0	
83525	chr18	23397951	23398231	280	140.0	
83526	chr18	23411738	23412243	505	252.0	
83527	chr18	23416405	23416696	291	146.0	
83528	chr18	23422578	23423634	1056	528.0	
83529	chr18	23436888	23438873	1985	992.0	
83530	chr18	23452355	23454227	1872	936.0	
83531	chr18	23458797	23459383	586	293.0	
83532	chr18	23479728	23480383	655	328.0	
83533	chr18	23487831	23488819	988	494.0	
83534	chr18	23498533	23499939	1406	703.0	
83535	chr18	23502539	23505971	3432	1716.0	
83536	chr18	23512177	23513202	1025	512.0	
83537	chr18	23515541	23516561	1020	510.0	
83538	chr18	23523622	23524188	566	283.0	
83539	chr18	23528676	23530644	1968	984.0	
83540	chr18	23539319	23539616	297	148.0	
83541	chr18	23540251	23541720	1469	734.0	
83542	chr18	23546122	23546613	491	246.0	
83543	chr18	23563501	23564083	582	291.0	
83544	chr18	23570725	23571775	1050	525.0	
83545	chr18	23573413	23575297	1884	942.0	
83546	chr18	23578431	23579849	1418	709.0	
83547	chr18	23583439	23583649	210	105.0	
83548	chr18	23584596	23587786	3190	1595.0	
83549	chr18	23593665	23594166	501	250.0	
83550	chr18	23596177	23596725	548	274.0	
83551	chr18	23618694	23620017	1323	662.0	
83552	chr18	23622133	23622695	562	281.0	
83553	chr18	23661890	23663596	1706	853.0	
83554	chr18	23689018	23690218	1200	600.0	
83555	chr18	23703030	23703483	453	226.0	
83556	chr18	23810458	23810708	250	125.0	
83557	chr18	23812530	23812941	411	206.0	
83558	chr18	23816885	23817028	143	72.0	
83559	chr18	23828333	23829149	816	408.0	
83560	chr18	23837609	23837994	385	192.0	
83561	chr18	23852674	23852808	134	67.0	
83562	chr18	23853791	23854003	212	106.0	
83563	chr18	23859812	23860368	556	278.0	
83564	chr18	23862268	23863244	976	488.0	
83565	chr18	23864502	23865160	658	329.0	
83566	chr18	23867011	23867307	296	148.0	
83567	chr18	23870925	23871928	1003	502.0	
83568	chr18	23872664	23873168	504	252.0	
83569	chr18	23885651	23886282	631	316.0	
83570	chr18	23918367	23918918	551	276.0	
83571	chr18	23929454	23929958	504	252.0	
83572	chr18	23935865	23936153	288	144.0	
83573	chr18	23938300	23938734	434	217.0	
83574	chr18	23943117	23943431	314	157.0	
83575	chr18	23964249	23965144	895	448.0	
83576	chr18	23966944	23968137	1193	596.0	
83577	chr18	23970076	23971134	1058	529.0	
83578	chr18	23972238	23972818	580	290.0	
83579	chr18	23977815	23978485	670	335.0	
83580	chr18	23992191	23993323	1132	566.0	
83581	chr18	23994204	23994949	745	372.0	
83582	chr18	23999161	24002852	3691	1846.0	
83583	chr18	24004057	24004311	254	127.0	
83584	chr18	24009423	24013121	3698	1849.0	
83585	chr18	24013683	24017071	3388	1694.0	
83586	chr18	24018219	24020403	2184	1092.0	
83587	chr18	24021906	24021909	3	2.0	
83588	chr18	24023449	24023646	197	98.0	
83589	chr18	24027126	24027749	623	312.0	
83590	chr18	24039503	24040116	613	306.0	
83591	chr18	24054128	24054435	307	154.0	
83592	chr18	24055226	24055611	385	192.0	
83593	chr18	24076079	24076682	603	302.0	
83594	chr18	24080937	24081004	67	34.0	
83595	chr18	24118383	24119470	1087	544.0	
83596	chr18	24136865	24137467	602	301.0	
83597	chr18	24138289	24139831	1542	771.0	
83598	chr18	24176715	24177365	650	325.0	
83599	chr18	24187030	24187686	656	328.0	
83600	chr18	24271461	24272396	935	468.0	
83601	chr18	24274749	24275392	643	322.0	
83602	chr18	24359709	24360200	491	246.0	
83603	chr18	24386725	24386825	100	50.0	
83604	chr18	24395321	24395871	550	275.0	
83605	chr18	24396868	24398617	1749	874.0	
83606	chr18	24426200	24427616	1416	708.0	
83607	chr18	24443987	24444061	74	37.0	
83608	chr18	24465414	24465955	541	270.0	
83609	chr18	24487618	24489318	1700	850.0	
83610	chr18	24491844	24492335	491	246.0	
83611	chr18	24660037	24660682	645	322.0	
83612	chr18	24726688	24727040	352	176.0	
83613	chr18	24846303	24846431	128	64.0	
83614	chr18	24964148	24964745	597	298.0	
83615	chr18	25164451	25165677	1226	613.0	enhancer
83616	chr18	25225225	25225464	239	120.0	
83617	chr18	25230918	25231362	444	222.0	
83618	chr18	25239646	25239728	82	41.0	
83619	chr18	25298989	25299810	821	410.0	
83620	chr18	25349230	25352682	3452	1726.0	
83621	chr18	25518704	25519120	416	208.0	
83622	chr18	25544567	25545284	717	358.0	
83623	chr18	25557043	25557373	330	165.0	
83624	chr18	25725270	25725391	121	60.0	
83625	chr18	25921616	25921907	291	146.0	
83626	chr18	25953592	25954185	593	296.0	
83627	chr18	26089245	26091701	2456	1228.0	
83628	chr18	26092793	26092810	17	8.0	
83629	chr18	26103593	26103989	396	198.0	
83630	chr18	26133462	26134475	1013	506.0	
83631	chr18	26190356	26191046	690	345.0	
83632	chr18	26215193	26216473	1280	640.0	
83633	chr18	26225318	26228174	2856	1428.0	
83634	chr18	26255603	26256047	444	222.0	
83635	chr18	26383681	26384072	391	196.0	
83636	chr18	26458564	26458878	314	157.0	
83637	chr18	26547559	26550644	3085	1542.0	
83638	chr18	26621382	26621849	467	234.0	
83639	chr18	26642375	26643137	762	381.0	
83640	chr18	26649696	26650122	426	213.0	
83641	chr18	26655977	26657453	1476	738.0	
83642	chr18	26700516	26700530	14	7.0	
83643	chr18	26702168	26702410	242	121.0	
83644	chr18	26706797	26707599	802	401.0	
83645	chr18	26708758	26709258	500	250.0	
83646	chr18	26710413	26710942	529	264.0	
83647	chr18	26711678	26712207	529	264.0	
83648	chr18	26719807	26720352	545	272.0	
83649	chr18	26723901	26724645	744	372.0	
83650	chr18	26746319	26746678	359	180.0	
83651	chr18	26752174	26752845	671	336.0	
83652	chr18	28176860	28178323	1463	732.0	
83653	chr18	28781724	28782282	558	279.0	
83654	chr18	29096439	29096751	312	156.0	
83655	chr18	31100927	31102274	1347	674.0	
83656	chr18	31162707	31163524	817	408.0	
83657	chr18	31199433	31199608	175	88.0	
83658	chr18	31203099	31203861	762	381.0	
83659	chr18	31206026	31207408	1382	691.0	
83660	chr18	31497785	31498432	647	324.0	
83661	chr18	31500339	31500730	391	196.0	
83662	chr18	31555842	31556381	539	270.0	
83663	chr18	31574427	31574701	274	137.0	
83664	chr18	31625441	31625580	139	70.0	
83665	chr18	31633433	31634779	1346	673.0	
83666	chr18	31650138	31650149	11	6.0	
83667	chr18	31652375	31652693	318	159.0	
83668	chr18	31658283	31659676	1393	696.0	
83669	chr18	31677591	31678004	413	206.0	
83670	chr18	31681169	31681605	436	218.0	
83671	chr18	31683974	31686305	2331	1166.0	
83672	chr18	31722312	31722829	517	258.0	
83673	chr18	31724598	31724610	12	6.0	
83674	chr18	31736632	31737028	396	198.0	
83675	chr18	31741097	31741557	460	230.0	
83676	chr18	31791693	31792189	496	248.0	
83677	chr18	31819577	31820026	449	224.0	
83678	chr18	31941988	31944639	2651	1326.0	
83679	chr18	31956725	31957579	854	427.0	
83680	chr18	31977287	31977653	366	183.0	
83681	chr18	32017873	32020713	2840	1420.0	
83682	chr18	32022581	32022687	106	53.0	
83683	chr18	32025727	32025819	92	46.0	
83684	chr18	32026454	32026714	260	130.0	
83685	chr18	32029571	32029741	170	85.0	
83686	chr18	32034223	32034251	28	14.0	
83687	chr18	32036793	32037478	685	342.0	
83688	chr18	32040268	32041519	1251	626.0	
83689	chr18	32042294	32042971	677	338.0	
83690	chr18	32048387	32051217	2830	1415.0	
83691	chr18	32072293	32072763	470	235.0	
83692	chr18	32084845	32086307	1462	731.0	
83693	chr18	32086817	32087509	692	346.0	
83694	chr18	32091357	32095413	4056	2028.0	
83695	chr18	32096104	32098126	2022	1011.0	
83696	chr18	32099356	32099367	11	6.0	
83697	chr18	32157934	32158798	864	432.0	
83698	chr18	32258780	32258928	148	74.0	
83699	chr18	32469963	32471768	1805	902.0	
83700	chr18	32531226	32531563	337	168.0	
83701	chr18	32549271	32549636	365	182.0	
83702	chr18	32552403	32552846	443	222.0	
83703	chr18	32714535	32714945	410	205.0	
83704	chr18	32730454	32730930	476	238.0	
83705	chr18	32760295	32760876	581	290.0	
83706	chr18	32771414	32772161	747	374.0	
83707	chr18	32773112	32773219	107	54.0	
83708	chr18	32803483	32803965	482	241.0	
83709	chr18	32884509	32884969	460	230.0	
83710	chr18	32902601	32902966	365	182.0	
83711	chr18	32909846	32910158	312	156.0	
83712	chr18	32919770	32920195	425	212.0	
83713	chr18	33116422	33116784	362	181.0	
83714	chr18	33146003	33146496	493	246.0	
83715	chr18	33232052	33232372	320	160.0	
83716	chr18	34493077	34493553	476	238.0	
83717	chr18	34709043	34710496	1453	726.0	
83718	chr18	34787938	34788319	381	190.0	
83719	chr18	34860167	34861043	876	438.0	
83720	chr18	34976480	34979713	3233	1616.0	
83721	chr18	35005928	35006426	498	249.0	
83722	chr18	35026201	35027061	860	430.0	
83723	chr18	35029344	35031145	1801	900.0	
83724	chr18	35037998	35039901	1903	952.0	
83725	chr18	35040653	35047248	6595	3298.0	
83726	chr18	35048019	35048303	284	142.0	
83727	chr18	35049075	35051868	2793	1396.0	
83728	chr18	35055702	35055813	111	56.0	
83729	chr18	35059759	35060109	350	175.0	
83730	chr18	35067521	35067558	37	18.0	
83731	chr18	35071651	35072133	482	241.0	
83732	chr18	35074496	35074871	375	188.0	
83733	chr18	35076128	35076545	417	208.0	
83734	chr18	35091979	35092213	234	117.0	
83735	chr18	35106501	35107188	687	344.0	
83736	chr18	35122840	35123112	272	136.0	
83737	chr18	35132550	35132919	369	184.0	
83738	chr18	35143903	35144355	452	226.0	
83739	chr18	35153610	35154401	791	396.0	
83740	chr18	35155688	35156103	415	208.0	
83741	chr18	35158715	35159641	926	463.0	
83742	chr18	35174110	35174622	512	256.0	
83743	chr18	35227368	35227420	52	26.0	
83744	chr18	35230905	35231588	683	342.0	
83745	chr18	35240034	35241836	1802	901.0	
83746	chr18	35246980	35248295	1315	658.0	
83747	chr18	35265980	35269302	3322	1661.0	
83748	chr18	35289186	35291199	2013	1006.0	
83749	chr18	35343257	35346269	3012	1506.0	
83750	chr18	35354972	35355594	622	311.0	
83751	chr18	35376191	35377822	1631	816.0	
83752	chr18	35386461	35387466	1005	502.0	
83753	chr18	35390919	35391380	461	230.0	
83754	chr18	35407787	35408311	524	262.0	
83755	chr18	35410571	35410932	361	180.0	
83756	chr18	35412637	35412924	287	144.0	
83757	chr18	35415223	35416090	867	434.0	
83758	chr18	35443503	35443614	111	56.0	
83759	chr18	35464969	35465104	135	68.0	
83760	chr18	35467933	35467989	56	28.0	
83761	chr18	35477511	35477902	391	196.0	
83762	chr18	35478445	35478999	554	277.0	
83763	chr18	35491064	35491283	219	110.0	
83764	chr18	35494867	35495262	395	198.0	
83765	chr18	35496789	35498552	1763	882.0	
83766	chr18	35501946	35502650	704	352.0	
83767	chr18	35508173	35508340	167	84.0	
83768	chr18	35511533	35511908	375	188.0	
83769	chr18	35523670	35524712	1042	521.0	
83770	chr18	35525698	35527135	1437	718.0	
83771	chr18	35573541	35573979	438	219.0	
83772	chr18	35580624	35583697	3073	1536.0	
83773	chr18	35588971	35589416	445	222.0	
83774	chr18	35592052	35592759	707	354.0	
83775	chr18	35606004	35606404	400	200.0	
83776	chr18	35616420	35617567	1147	574.0	
83777	chr18	35694912	35695147	235	118.0	
83778	chr18	35756447	35756919	472	236.0	
83779	chr18	35770478	35770753	275	138.0	
83780	chr18	35808790	35810999	2209	1104.0	
83781	chr18	35811756	35812415	659	330.0	
83782	chr18	35822425	35822848	423	212.0	
83783	chr18	35835716	35836320	604	302.0	
83784	chr18	35912326	35912657	331	166.0	
83785	chr18	35949803	35950845	1042	521.0	
83786	chr18	35970129	35973856	3727	1864.0	
83787	chr18	35984943	35985275	332	166.0	
83788	chr18	36015557	36016003	446	223.0	
83789	chr18	36017614	36018122	508	254.0	
83790	chr18	36031488	36031820	332	166.0	
83791	chr18	36047838	36047843	5	2.0	
83792	chr18	36066607	36068121	1514	757.0	
83793	chr18	36075766	36076609	843	422.0	
83794	chr18	36083811	36083964	153	76.0	
83795	chr18	36095913	36096332	419	210.0	
83796	chr18	36128100	36131459	3359	1680.0	
83797	chr18	36149959	36150340	381	190.0	
83798	chr18	36179468	36180265	797	398.0	
83799	chr18	36186637	36188111	1474	737.0	
83800	chr18	36284639	36285097	458	229.0	
83801	chr18	36297416	36297718	302	151.0	
83802	chr18	36460966	36461148	182	91.0	
83803	chr18	36462188	36462631	443	222.0	
83804	chr18	36688113	36688394	281	140.0	
83805	chr18	36809486	36810023	537	268.0	
83806	chr18	36827693	36830303	2610	1305.0	
83807	chr18	38575722	38577361	1639	820.0	
83808	chr18	38611299	38611352	53	26.0	
83809	chr18	38940413	38941993	1580	790.0	
83810	chr18	39318073	39318345	272	136.0	
83811	chr18	41906509	41907054	545	272.0	
83812	chr18	41923457	41923964	507	254.0	
83813	chr18	41928522	41929016	494	247.0	
83814	chr18	41936802	41937217	415	208.0	
83815	chr18	41954479	41956032	1553	776.0	
83816	chr18	41977575	41977576	1	0.0	
83817	chr18	42028217	42028670	453	226.0	
83818	chr18	42048105	42048548	443	222.0	
83819	chr18	42053141	42053622	481	240.0	
83820	chr18	42113754	42114752	998	499.0	
83821	chr18	42298734	42299090	356	178.0	
83822	chr18	42654528	42654832	304	152.0	
83823	chr18	44502795	44503153	358	179.0	
83824	chr18	44507439	44508861	1422	711.0	
83825	chr18	44526914	44527363	449	224.0	
83826	chr18	44576080	44576423	343	172.0	
83827	chr18	44671795	44672133	338	169.0	
83828	chr18	44678828	44681615	2787	1394.0	
83829	chr18	44682592	44683353	761	380.0	
83830	chr18	44700484	44701136	652	326.0	
83831	chr18	44709794	44710191	397	198.0	
83832	chr18	44716850	44717057	207	104.0	
83833	chr18	44723299	44723748	449	224.0	
83834	chr18	44724250	44726343	2093	1046.0	
83835	chr18	44729418	44730331	913	456.0	
83836	chr18	44731519	44731931	412	206.0	
83837	chr18	44733296	44733992	696	348.0	
83838	chr18	44735330	44735371	41	20.0	
83839	chr18	44758984	44760513	1529	764.0	
83840	chr18	44766495	44766710	215	108.0	
83841	chr18	44771845	44772289	444	222.0	
83842	chr18	44786723	44787082	359	180.0	
83843	chr18	44798394	44798878	484	242.0	
83844	chr18	44800014	44800488	474	237.0	
83845	chr18	44805663	44806083	420	210.0	
83846	chr18	44838844	44839843	999	500.0	
83847	chr18	44842126	44842522	396	198.0	
83848	chr18	44887142	44887616	474	237.0	
83849	chr18	44895407	44895830	423	212.0	
83850	chr18	44979663	44980087	424	212.0	
83851	chr18	44987000	44987224	224	112.0	
83852	chr18	44991023	44991201	178	89.0	
83853	chr18	44996245	44996674	429	214.0	
83854	chr18	45059652	45060091	439	220.0	
83855	chr18	45066195	45067359	1164	582.0	
83856	chr18	45071898	45072326	428	214.0	
83857	chr18	45084929	45084949	20	10.0	
83858	chr18	45102857	45104275	1418	709.0	
83859	chr18	45106170	45106929	759	380.0	
83860	chr18	45161779	45162296	517	258.0	
83861	chr18	45165300	45165979	679	340.0	
83862	chr18	45169743	45169888	145	72.0	
83863	chr18	45212618	45213196	578	289.0	
83864	chr18	45232136	45232325	189	94.0	
83865	chr18	45334164	45334599	435	218.0	
83866	chr18	45373196	45373669	473	236.0	
83867	chr18	45384401	45384792	391	196.0	
83868	chr18	45454082	45454317	235	118.0	
83869	chr18	45455925	45456525	600	300.0	
83870	chr18	45551451	45551742	291	146.0	
83871	chr18	45620950	45621394	444	222.0	
83872	chr18	45628979	45629435	456	228.0	
83873	chr18	45656469	45656692	223	112.0	
83874	chr18	45657872	45658370	498	249.0	
83875	chr18	45664691	45667454	2763	1382.0	
83876	chr18	45669269	45669370	101	50.0	
83877	chr18	45669997	45671060	1063	532.0	
83878	chr18	45682855	45683637	782	391.0	
83879	chr18	45686355	45689347	2992	1496.0	
83880	chr18	45691165	45691739	574	287.0	
83881	chr18	45722809	45723337	528	264.0	
83882	chr18	45774177	45775867	1690	845.0	
83883	chr18	45785120	45785625	505	252.0	
83884	chr18	45807188	45807556	368	184.0	
83885	chr18	45820130	45820507	377	188.0	
83886	chr18	45826794	45829467	2673	1336.0	
83887	chr18	45837394	45839860	2466	1233.0	
83888	chr18	45849771	45850341	570	285.0	
83889	chr18	45874357	45875347	990	495.0	
83890	chr18	45879862	45880578	716	358.0	
83891	chr18	45889662	45890073	411	206.0	
83892	chr18	45890608	45891051	443	222.0	
83893	chr18	45910338	45910844	506	253.0	
83894	chr18	45920406	45920743	337	168.0	
83895	chr18	45937962	45939455	1493	746.0	
83896	chr18	45951364	45951736	372	186.0	
83897	chr18	45962233	45963604	1371	686.0	
83898	chr18	45966399	45968053	1654	827.0	
83899	chr18	45973810	45974866	1056	528.0	
83900	chr18	45978340	45978463	123	62.0	
83901	chr18	45997559	45998688	1129	564.0	
83902	chr18	46008830	46010186	1356	678.0	
83903	chr18	46010712	46011120	408	204.0	
83904	chr18	46013375	46013886	511	256.0	
83905	chr18	46020639	46020672	33	16.0	
83906	chr18	46027726	46028725	999	500.0	
83907	chr18	46031832	46032090	258	129.0	
83908	chr18	46040616	46041063	447	224.0	
83909	chr18	46042744	46043213	469	234.0	
83910	chr18	46051944	46052432	488	244.0	
83911	chr18	46055081	46056368	1287	644.0	
83912	chr18	46070398	46072770	2372	1186.0	
83913	chr18	46073350	46074385	1035	518.0	
83914	chr18	46096665	46098972	2307	1154.0	
83915	chr18	46103700	46105142	1442	721.0	
83916	chr18	46148677	46149772	1095	548.0	
83917	chr18	46155645	46156980	1335	668.0	
83918	chr18	46167738	46168539	801	400.0	
83919	chr18	46172913	46175417	2504	1252.0	
83920	chr18	46176326	46176357	31	16.0	
83921	chr18	46193519	46193736	217	108.0	
83922	chr18	46204901	46205192	291	146.0	
83923	chr18	46211628	46212311	683	342.0	
83924	chr18	46213287	46213745	458	229.0	
83925	chr18	46222615	46223399	784	392.0	
83926	chr18	46224307	46224340	33	16.0	
83927	chr18	46225001	46225116	115	58.0	
83928	chr18	46249802	46251414	1612	806.0	
83929	chr18	46264327	46264588	261	130.0	
83930	chr18	46281101	46281773	672	336.0	
83931	chr18	46290991	46291681	690	345.0	
83932	chr18	46294227	46294736	509	254.0	
83933	chr18	46315196	46315602	406	203.0	
83934	chr18	46324110	46325057	947	474.0	
83935	chr18	46333062	46336748	3686	1843.0	
83936	chr18	46338917	46339115	198	99.0	
83937	chr18	46341943	46342460	517	258.0	
83938	chr18	46343565	46344575	1010	505.0	
83939	chr18	46346254	46346464	210	105.0	
83940	chr18	46397158	46398486	1328	664.0	
83941	chr18	46481031	46481468	437	218.0	
83942	chr18	46536391	46536949	558	279.0	
83943	chr18	46546406	46546483	77	38.0	
83944	chr18	46601233	46601826	593	296.0	
83945	chr18	46623044	46624437	1393	696.0	
83946	chr18	46658050	46658712	662	331.0	
83947	chr18	46672329	46672778	449	224.0	
83948	chr18	46754174	46754587	413	206.0	
83949	chr18	46916350	46918479	2129	1064.0	
83950	chr18	46920105	46920316	211	106.0	
83951	chr18	46946422	46947451	1029	514.0	
83952	chr18	47100221	47100617	396	198.0	
83953	chr18	47149488	47151911	2423	1212.0	
83954	chr18	47175330	47176810	1480	740.0	
83955	chr18	47205012	47205265	253	126.0	
83956	chr18	47748844	47749744	900	450.0	
83957	chr18	47754499	47754952	453	226.0	
83958	chr18	47756329	47756815	486	243.0	
83959	chr18	47758065	47758094	29	14.0	
83960	chr18	47772576	47773057	481	240.0	
83961	chr18	47901483	47902339	856	428.0	
83962	chr18	47911739	47912753	1014	507.0	
83963	chr18	47928449	47928926	477	238.0	
83964	chr18	47929631	47933111	3480	1740.0	
83965	chr18	47953342	47954140	798	399.0	
83966	chr18	47970609	47971659	1050	525.0	
83967	chr18	47985595	47987521	1926	963.0	
83968	chr18	47999827	48000397	570	285.0	
83969	chr18	48003739	48004295	556	278.0	
83970	chr18	48007747	48008873	1126	563.0	
83971	chr18	48022537	48023079	542	271.0	
83972	chr18	48161123	48162437	1314	657.0	
83973	chr18	48167018	48167469	451	226.0	
83974	chr18	48222141	48222521	380	190.0	
83975	chr18	48225579	48225850	271	136.0	
83976	chr18	48228374	48228561	187	94.0	
83977	chr18	48230476	48230998	522	261.0	
83978	chr18	48300393	48300794	401	200.0	
83979	chr18	48408912	48410956	2044	1022.0	
83980	chr18	48412329	48412760	431	216.0	
83981	chr18	48445408	48445950	542	271.0	
83982	chr18	48446517	48447059	542	271.0	
83983	chr18	48455860	48456619	759	380.0	
83984	chr18	48459455	48459839	384	192.0	
83985	chr18	48475839	48476246	407	204.0	
83986	chr18	48532050	48532147	97	48.0	
83987	chr18	48538553	48541725	3172	1586.0	
83988	chr18	48545642	48546073	431	216.0	
83989	chr18	48662091	48662590	499	250.0	
83990	chr18	48664194	48664709	515	258.0	
83991	chr18	48673990	48674369	379	190.0	
83992	chr18	48674970	48677237	2267	1134.0	
83993	chr18	48698705	48699087	382	191.0	
83994	chr18	48711937	48712290	353	176.0	
83995	chr18	48715535	48716646	1111	556.0	
83996	chr18	48743064	48743490	426	213.0	
83997	chr18	48744720	48745053	333	166.0	
83998	chr18	48776965	48777847	882	441.0	
83999	chr18	48781174	48782235	1061	530.0	
84000	chr18	48784643	48786145	1502	751.0	
84001	chr18	48790793	48791746	953	476.0	
84002	chr18	48797763	48798312	549	274.0	
84003	chr18	48806483	48807374	891	446.0	
84004	chr18	48813482	48816005	2523	1262.0	
84005	chr18	48820830	48821399	569	284.0	
84006	chr18	48832459	48835865	3406	1703.0	
84007	chr18	48837286	48837713	427	214.0	
84008	chr18	48838765	48839610	845	422.0	
84009	chr18	48841197	48843541	2344	1172.0	
84010	chr18	48851033	48851908	875	438.0	
84011	chr18	48855930	48856360	430	215.0	
84012	chr18	48868210	48869972	1762	881.0	
84013	chr18	48873259	48873763	504	252.0	
84014	chr18	48875997	48876030	33	16.0	
84015	chr18	48896458	48897869	1411	706.0	
84016	chr18	48901883	48902571	688	344.0	
84017	chr18	48909813	48910054	241	120.0	
84018	chr18	48913096	48914051	955	478.0	
84019	chr18	48916009	48916244	235	118.0	
84020	chr18	48917270	48918187	917	458.0	
84021	chr18	48919001	48919527	526	263.0	
84022	chr18	48921788	48925275	3487	1744.0	
84023	chr18	48926069	48930695	4626	2313.0	
84024	chr18	48931629	48936374	4745	2372.0	
84025	chr18	48937065	48942025	4960	2480.0	
84026	chr18	48942585	48946639	4054	2027.0	
84027	chr18	48947343	48953526	6183	3092.0	
84028	chr18	48954495	48954585	90	45.0	
84029	chr18	48955480	48956436	956	478.0	
84030	chr18	48963233	48963701	468	234.0	
84031	chr18	48970441	48970550	109	54.0	
84032	chr18	48975242	48976750	1508	754.0	
84033	chr18	48979656	48980641	985	492.0	
84034	chr18	48982191	48982592	401	200.0	
84035	chr18	48983327	48984196	869	434.0	
84036	chr18	48990665	48990983	318	159.0	
84037	chr18	48992035	48993337	1302	651.0	
84038	chr18	48996854	48998542	1688	844.0	
84039	chr18	49015970	49016381	411	206.0	
84040	chr18	49021771	49022243	472	236.0	
84041	chr18	49023428	49023832	404	202.0	
84042	chr18	49025593	49025596	3	2.0	
84043	chr18	49031408	49032311	903	452.0	
84044	chr18	49041867	49042349	482	241.0	
84045	chr18	49052822	49053836	1014	507.0	
84046	chr18	49055467	49056431	964	482.0	
84047	chr18	49061646	49061993	347	174.0	
84048	chr18	49168902	49169430	528	264.0	
84049	chr18	49170989	49171531	542	271.0	
84050	chr18	49227491	49228699	1208	604.0	
84051	chr18	49249436	49250007	571	286.0	
84052	chr18	49398811	49399508	697	348.0	
84053	chr18	49401561	49401845	284	142.0	
84054	chr18	49415421	49415768	347	174.0	
84055	chr18	49447768	49448248	480	240.0	
84056	chr18	49459384	49461431	2047	1024.0	
84057	chr18	49476346	49477479	1133	566.0	
84058	chr18	49486111	49489025	2914	1457.0	
84059	chr18	49489923	49490637	714	357.0	
84060	chr18	49491314	49493139	1825	912.0	
84061	chr18	49510600	49511105	505	252.0	
84062	chr18	49560747	49562297	1550	775.0	
84063	chr18	49751713	49752155	442	221.0	
84064	chr18	49786094	49786720	626	313.0	
84065	chr18	49788519	49788979	460	230.0	
84066	chr18	49812529	49814918	2389	1194.0	
84067	chr18	49819486	49821031	1545	772.0	
84068	chr18	49858678	49859152	474	237.0	
84069	chr18	49861774	49861819	45	22.0	
84070	chr18	49898472	49898824	352	176.0	
84071	chr18	49950149	49950311	162	81.0	
84072	chr18	50009763	50010207	444	222.0	
84073	chr18	50194850	50195561	711	356.0	
84074	chr18	50218751	50219204	453	226.0	
84075	chr18	50265784	50267192	1408	704.0	
84076	chr18	50267964	50268911	947	474.0	
84077	chr18	50280731	50282795	2064	1032.0	
84078	chr18	50283417	50284799	1382	691.0	
84079	chr18	50285381	50285393	12	6.0	
84080	chr18	50286364	50288563	2199	1100.0	
84081	chr18	50297614	50298802	1188	594.0	
84082	chr18	50307217	50309050	1833	916.0	
84083	chr18	50334539	50334995	456	228.0	
84084	chr18	50338128	50338542	414	207.0	
84085	chr18	50356092	50357703	1611	806.0	
84086	chr18	50374311	50375651	1340	670.0	
84087	chr18	50805669	50806757	1088	544.0	
84088	chr18	50814521	50814529	8	4.0	
84089	chr18	50817001	50817040	39	20.0	
84090	chr18	50819418	50821298	1880	940.0	
84091	chr18	50830500	50831281	781	390.0	
84092	chr18	50836471	50836916	445	222.0	
84093	chr18	50849633	50849836	203	102.0	
84094	chr18	50850687	50850972	285	142.0	
84095	chr18	50853754	50855223	1469	734.0	
84096	chr18	50862142	50863018	876	438.0	
84097	chr18	50877792	50880577	2785	1392.0	
84098	chr18	50883257	50884052	795	398.0	
84099	chr18	50944238	50944680	442	221.0	
84100	chr18	50967357	50968868	1511	756.0	
84101	chr18	50973406	50973674	268	134.0	
84102	chr18	51009071	51009597	526	263.0	
84103	chr18	51028164	51028572	408	204.0	
84104	chr18	51029335	51031413	2078	1039.0	
84105	chr18	51035015	51035244	229	114.0	
84106	chr18	51038081	51038431	350	175.0	
84107	chr18	51039138	51039667	529	264.0	
84108	chr18	51045063	51045128	65	32.0	
84109	chr18	51050754	51051720	966	483.0	
84110	chr18	51053759	51054258	499	250.0	
84111	chr18	51074398	51075043	645	322.0	
84112	chr18	51107050	51107723	673	336.0	
84113	chr18	51110165	51110760	595	298.0	
84114	chr18	51151205	51152719	1514	757.0	
84115	chr18	51153422	51154662	1240	620.0	
84116	chr18	51162546	51162963	417	208.0	
84117	chr18	51168388	51169677	1289	644.0	
84118	chr18	51171953	51172169	216	108.0	
84119	chr18	51184104	51184255	151	76.0	
84120	chr18	51188041	51188532	491	246.0	
84121	chr18	51191005	51191902	897	448.0	
84122	chr18	51194217	51199542	5325	2662.0	
84123	chr18	51211251	51212257	1006	503.0	
84124	chr18	51214591	51215038	447	224.0	
84125	chr18	51251566	51252062	496	248.0	
84126	chr18	51266633	51267169	536	268.0	
84127	chr18	51384491	51384619	128	64.0	
84128	chr18	52792648	52792994	346	173.0	
84129	chr18	53589587	53589952	365	182.0	
84130	chr18	54086332	54086851	519	260.0	
84131	chr18	54119611	54119866	255	128.0	
84132	chr18	54209776	54210142	366	183.0	
84133	chr18	54222715	54225389	2674	1337.0	
84134	chr18	54239909	54241599	1690	845.0	
84135	chr18	54247009	54247457	448	224.0	
84136	chr18	54250596	54251212	616	308.0	
84137	chr18	54260601	54261209	608	304.0	
84138	chr18	54261794	54262567	773	386.0	
84139	chr18	54263949	54264256	307	154.0	
84140	chr18	54266543	54266679	136	68.0	
84141	chr18	54267817	54267927	110	55.0	
84142	chr18	54268442	54270770	2328	1164.0	
84143	chr18	54284942	54285525	583	292.0	
84144	chr18	54357054	54358986	1932	966.0	
84145	chr18	54388703	54389154	451	226.0	
84146	chr18	54392514	54393026	512	256.0	
84147	chr18	54717661	54718582	921	460.0	
84148	chr18	54806037	54806316	279	140.0	
84149	chr18	54812920	54813292	372	186.0	
84150	chr18	54828079	54829411	1332	666.0	
84151	chr18	54946048	54946929	881	440.0	
84152	chr18	54959291	54959538	247	124.0	
84153	chr18	54968852	54969221	369	184.0	
84154	chr18	54983063	54983471	408	204.0	
84155	chr18	55069496	55069979	483	242.0	
84156	chr18	55233953	55235068	1115	558.0	
84157	chr18	55248528	55248908	380	190.0	
84158	chr18	55266023	55266316	293	146.0	
84159	chr18	55268004	55268975	971	486.0	
84160	chr18	55321089	55322912	1823	912.0	
84161	chr18	55328290	55328750	460	230.0	
84162	chr18	55337753	55338353	600	300.0	
84163	chr18	55376459	55376822	363	182.0	
84164	chr18	55415246	55415712	466	233.0	
84165	chr18	55420486	55420940	454	227.0	
84166	chr18	55423530	55423963	433	216.0	enhancer
84167	chr18	55457141	55457298	157	78.0	
84168	chr18	55465275	55465704	429	214.0	
84169	chr18	55477276	55478157	881	440.0	
84170	chr18	55506107	55506415	308	154.0	
84171	chr18	55510028	55511303	1275	638.0	
84172	chr18	55576056	55576302	246	123.0	
84173	chr18	55587337	55590446	3109	1554.0	
84174	chr18	55778595	55781151	2556	1278.0	
84175	chr18	55988775	55988785	10	5.0	
84176	chr18	56089625	56090026	401	200.0	
84177	chr18	56235028	56236005	977	488.0	
84178	chr18	56248563	56249079	516	258.0	
84179	chr18	56257149	56258666	1517	758.0	
84180	chr18	56294781	56294842	61	30.0	
84181	chr18	56402908	56403158	250	125.0	
84182	chr18	56443837	56444646	809	404.0	
84183	chr18	56468202	56468874	672	336.0	
84184	chr18	56568919	56569849	930	465.0	
84185	chr18	56576037	56576443	406	203.0	
84186	chr18	56637343	56639524	2181	1090.0	
84187	chr18	56645407	56645818	411	206.0	
84188	chr18	56647034	56647295	261	130.0	
84189	chr18	56650682	56653469	2787	1394.0	
84190	chr18	56655282	56655806	524	262.0	
84191	chr18	56709367	56709858	491	246.0	
84192	chr18	56756945	56757440	495	248.0	
84193	chr18	56824196	56824467	271	136.0	
84194	chr18	56825246	56825704	458	229.0	
84195	chr18	56851770	56852142	372	186.0	
84196	chr18	56869151	56869635	484	242.0	
84197	chr18	57004696	57005058	362	181.0	
84198	chr18	57008003	57008410	407	204.0	
84199	chr18	57017083	57017826	743	372.0	
84200	chr18	57077673	57078243	570	285.0	
84201	chr18	57084664	57085279	615	308.0	
84202	chr18	57398218	57398654	436	218.0	
84203	chr18	57427601	57428154	553	276.0	
84204	chr18	57434940	57435586	646	323.0	
84205	chr18	57437859	57438174	315	158.0	
84206	chr18	57523112	57523847	735	368.0	
84207	chr18	57544918	57545744	826	413.0	
84208	chr18	57555190	57555494	304	152.0	
84209	chr18	57557847	57558291	444	222.0	
84210	chr18	57561791	57562231	440	220.0	
84211	chr18	57580991	57581909	918	459.0	
84212	chr18	57585776	57587399	1623	812.0	
84213	chr18	57618878	57619374	496	248.0	
84214	chr18	57621033	57622826	1793	896.0	
84215	chr18	57629597	57631443	1846	923.0	
84216	chr18	57649447	57650435	988	494.0	
84217	chr18	57665742	57667466	1724	862.0	
84218	chr18	57729159	57729685	526	263.0	
84219	chr18	57737594	57738136	542	271.0	
84220	chr18	57748670	57749178	508	254.0	
84221	chr18	57771158	57771641	483	242.0	
84222	chr18	57780864	57781350	486	243.0	
84223	chr18	57803014	57803439	425	212.0	
84224	chr18	57833397	57834041	644	322.0	
84225	chr18	57837770	57838407	637	318.0	
84226	chr18	57881799	57882230	431	216.0	
84227	chr18	58015003	58015471	468	234.0	
84228	chr18	58038110	58038399	289	144.0	
84229	chr18	58042822	58046162	3340	1670.0	
84230	chr18	58051845	58052115	270	135.0	
84231	chr18	58087799	58088714	915	458.0	
84232	chr18	58091153	58091750	597	298.0	
84233	chr18	58121851	58122351	500	250.0	
84234	chr18	58135730	58136204	474	237.0	
84235	chr18	58180734	58181128	394	197.0	
84236	chr18	58195164	58195721	557	278.0	
84237	chr18	58213416	58213916	500	250.0	
84238	chr18	58303389	58303658	269	134.0	
84239	chr18	58310373	58310953	580	290.0	
84240	chr18	58314089	58314819	730	365.0	
84241	chr18	58317004	58317414	410	205.0	
84242	chr18	58321888	58322452	564	282.0	
84243	chr18	58348443	58348943	500	250.0	
84244	chr18	58361952	58362752	800	400.0	
84245	chr18	58400066	58400076	10	5.0	
84246	chr18	58438220	58439358	1138	569.0	
84247	chr18	58493726	58494264	538	269.0	
84248	chr18	58501050	58501384	334	167.0	
84249	chr18	58502512	58502917	405	202.0	
84250	chr18	58505131	58505553	422	211.0	
84251	chr18	58520983	58521299	316	158.0	
84252	chr18	58525629	58526333	704	352.0	
84253	chr18	58529677	58530251	574	287.0	
84254	chr18	58534862	58537118	2256	1128.0	
84255	chr18	58538682	58539028	346	173.0	
84256	chr18	58541182	58543082	1900	950.0	
84257	chr18	58544959	58545318	359	180.0	
84258	chr18	58552009	58552425	416	208.0	
84259	chr18	58557127	58557475	348	174.0	
84260	chr18	58564961	58565490	529	264.0	
84261	chr18	58605384	58605722	338	169.0	
84262	chr18	58609231	58609876	645	322.0	
84263	chr18	58615110	58616405	1295	648.0	
84264	chr18	58629314	58629710	396	198.0	
84265	chr18	58638173	58638929	756	378.0	
84266	chr18	58649995	58650777	782	391.0	
84267	chr18	58657312	58659015	1703	852.0	
84268	chr18	58668894	58669408	514	257.0	
84269	chr18	58669926	58672604	2678	1339.0	
84270	chr18	58682551	58682868	317	158.0	
84271	chr18	58687255	58688658	1403	702.0	
84272	chr18	58691283	58691564	281	140.0	
84273	chr18	58692567	58693329	762	381.0	
84274	chr18	58697192	58697517	325	162.0	
84275	chr18	58714233	58714675	442	221.0	
84276	chr18	58715539	58716495	956	478.0	
84277	chr18	58721843	58722152	309	154.0	
84278	chr18	58754429	58755566	1137	568.0	
84279	chr18	58761614	58762015	401	200.0	
84280	chr18	58764017	58764857	840	420.0	
84281	chr18	58768214	58769022	808	404.0	
84282	chr18	58781491	58782150	659	330.0	
84283	chr18	58792202	58792424	222	111.0	
84284	chr18	58800587	58800964	377	188.0	
84285	chr18	58819063	58819516	453	226.0	
84286	chr18	58847532	58847869	337	168.0	
84287	chr18	58862743	58865134	2391	1196.0	
84288	chr18	58887258	58888082	824	412.0	
84289	chr18	58896207	58896650	443	222.0	
84290	chr18	58937213	58937733	520	260.0	
84291	chr18	58946204	58946597	393	196.0	
84292	chr18	58963702	58964585	883	442.0	
84293	chr18	58970859	58971294	435	218.0	
84294	chr18	58975377	58975601	224	112.0	
84295	chr18	59057142	59057607	465	232.0	
84296	chr18	59070352	59070865	513	256.0	
84297	chr18	59084081	59084606	525	262.0	
84298	chr18	59138914	59140880	1966	983.0	
84299	chr18	59265430	59265799	369	184.0	
84300	chr18	59269060	59269425	365	182.0	
84301	chr18	59308395	59309149	754	377.0	
84302	chr18	59356628	59360146	3518	1759.0	
84303	chr18	59389725	59390018	293	146.0	
84304	chr18	59402350	59402929	579	290.0	
84305	chr18	59837452	59837987	535	268.0	
84306	chr18	59847179	59847513	334	167.0	
84307	chr18	59862198	59862586	388	194.0	
84308	chr18	59876139	59876519	380	190.0	
84309	chr18	59877311	59877943	632	316.0	
84310	chr18	59881766	59882808	1042	521.0	
84311	chr18	59885514	59886654	1140	570.0	
84312	chr18	59898784	59901491	2707	1354.0	
84313	chr18	59902024	59903035	1011	506.0	
84314	chr18	59904106	59907672	3566	1783.0	
84315	chr18	59911276	59912211	935	468.0	
84316	chr18	59917248	59918887	1639	820.0	
84317	chr18	59921278	59921924	646	323.0	
84318	chr18	59927219	59927723	504	252.0	
84319	chr18	59953539	59954014	475	238.0	
84320	chr18	59988099	59988500	401	200.0	
84321	chr18	60568287	60568416	129	64.0	
84322	chr18	60656440	60657030	590	295.0	
84323	chr18	61088793	61089034	241	120.0	
84324	chr18	61360653	61361125	472	236.0	
84325	chr18	61551540	61551855	315	158.0	
84326	chr18	61554121	61554971	850	425.0	
84327	chr18	61579372	61579526	154	77.0	
84328	chr18	61581742	61582285	543	272.0	
84329	chr18	61589013	61589488	475	238.0	
84330	chr18	61635806	61636203	397	198.0	
84331	chr18	61732783	61733958	1175	588.0	
84332	chr18	61738413	61739196	783	392.0	
84333	chr18	61764383	61764759	376	188.0	
84334	chr18	61833358	61833791	433	216.0	
84335	chr18	61892592	61895092	2500	1250.0	
84336	chr18	61901324	61901817	493	246.0	
84337	chr18	61942110	61942492	382	191.0	
84338	chr18	61949039	61949263	224	112.0	
84339	chr18	61952100	61952625	525	262.0	
84340	chr18	61972328	61973381	1053	526.0	
84341	chr18	61975552	61976435	883	442.0	
84342	chr18	61980299	61980847	548	274.0	
84343	chr18	61982469	61982896	427	214.0	
84344	chr18	61992801	61993445	644	322.0	
84345	chr18	62088196	62088493	297	148.0	
84346	chr18	62131299	62131722	423	212.0	
84347	chr18	62183348	62184018	670	335.0	
84348	chr18	62186122	62188670	2548	1274.0	
84349	chr18	62208973	62209560	587	294.0	
84350	chr18	62249464	62249903	439	220.0	
84351	chr18	62258659	62258995	336	168.0	
84352	chr18	62280809	62281210	401	200.0	
84353	chr18	62281754	62281999	245	122.0	
84354	chr18	62288496	62289065	569	284.0	
84355	chr18	62296445	62296852	407	204.0	
84356	chr18	62324042	62326472	2430	1215.0	
84357	chr18	62329643	62329951	308	154.0	
84358	chr18	62331547	62332992	1445	722.0	
84359	chr18	62339229	62339552	323	162.0	
84360	chr18	62399168	62399750	582	291.0	
84361	chr18	62420213	62421480	1267	634.0	
84362	chr18	62423074	62423516	442	221.0	
84363	chr18	62425410	62426192	782	391.0	
84364	chr18	62436549	62437754	1205	602.0	
84365	chr18	62450536	62451494	958	479.0	
84366	chr18	62452132	62452767	635	318.0	
84367	chr18	62453810	62454286	476	238.0	
84368	chr18	62460762	62461381	619	310.0	
84369	chr18	62464293	62464550	257	128.0	
84370	chr18	62479524	62479909	385	192.0	
84371	chr18	62499125	62499771	646	323.0	
84372	chr18	62505607	62507130	1523	762.0	
84373	chr18	62521641	62527411	5770	2885.0	
84374	chr18	62554110	62554444	334	167.0	
84375	chr18	62566278	62566554	276	138.0	
84376	chr18	62577051	62577451	400	200.0	
84377	chr18	62583394	62585150	1756	878.0	
84378	chr18	62586105	62586611	506	253.0	
84379	chr18	62638370	62638780	410	205.0	
84380	chr18	62702292	62702689	397	198.0	
84381	chr18	62714410	62717990	3580	1790.0	
84382	chr18	62723916	62724031	115	58.0	
84383	chr18	62744306	62744408	102	51.0	
84384	chr18	62782031	62782351	320	160.0	
84385	chr18	62784551	62785032	481	240.0	
84386	chr18	62797354	62797703	349	174.0	
84387	chr18	62807423	62808601	1178	589.0	
84388	chr18	62815274	62815888	614	307.0	
84389	chr18	62828936	62829124	188	94.0	
84390	chr18	62869409	62870130	721	360.0	
84391	chr18	62928356	62928780	424	212.0	
84392	chr18	62939376	62940122	746	373.0	
84393	chr18	62950559	62951125	566	283.0	
84394	chr18	62957811	62958317	506	253.0	
84395	chr18	62979224	62979678	454	227.0	
84396	chr18	62982447	62983095	648	324.0	
84397	chr18	63016176	63016719	543	272.0	
84398	chr18	63041060	63041536	476	238.0	
84399	chr18	63050612	63051409	797	398.0	
84400	chr18	63073510	63073878	368	184.0	
84401	chr18	63074826	63075563	737	368.0	
84402	chr18	63078287	63079633	1346	673.0	
84403	chr18	63097965	63099133	1168	584.0	
84404	chr18	63100120	63100223	103	52.0	
84405	chr18	63105911	63106931	1020	510.0	
84406	chr18	63130931	63132008	1077	538.0	
84407	chr18	63137677	63139341	1664	832.0	
84408	chr18	63141678	63143428	1750	875.0	
84409	chr18	63152105	63152915	810	405.0	
84410	chr18	63154488	63159314	4826	2413.0	
84411	chr18	63160093	63163132	3039	1520.0	
84412	chr18	63187126	63187304	178	89.0	
84413	chr18	63192525	63193261	736	368.0	
84414	chr18	63197098	63198336	1238	619.0	
84415	chr18	63199395	63201017	1622	811.0	
84416	chr18	63205799	63207709	1910	955.0	
84417	chr18	63212875	63214392	1517	758.0	
84418	chr18	63216314	63217459	1145	572.0	
84419	chr18	63224129	63225064	935	468.0	
84420	chr18	63230022	63230316	294	147.0	
84421	chr18	63232886	63233247	361	180.0	
84422	chr18	63234619	63235299	680	340.0	
84423	chr18	63235939	63237373	1434	717.0	
84424	chr18	63245672	63245958	286	143.0	
84425	chr18	63249388	63250375	987	494.0	
84426	chr18	63253089	63254458	1369	684.0	
84427	chr18	63255420	63255740	320	160.0	
84428	chr18	63266833	63268400	1567	784.0	
84429	chr18	63271706	63272429	723	362.0	
84430	chr18	63285358	63285793	435	218.0	
84431	chr18	63286928	63287328	400	200.0	
84432	chr18	63290674	63291411	737	368.0	
84433	chr18	63292624	63293651	1027	514.0	
84434	chr18	63298680	63299280	600	300.0	
84435	chr18	63299875	63300674	799	400.0	
84436	chr18	63301316	63302470	1154	577.0	
84437	chr18	63303047	63304048	1001	500.0	
84438	chr18	63309410	63309850	440	220.0	
84439	chr18	63311552	63312256	704	352.0	
84440	chr18	63312765	63313321	556	278.0	
84441	chr18	63314569	63316261	1692	846.0	
84442	chr18	63316763	63323651	6888	3444.0	
84443	chr18	63339850	63340311	461	230.0	
84444	chr18	63342167	63342621	454	227.0	
84445	chr18	63363877	63364438	561	280.0	
84446	chr18	63365808	63368288	2480	1240.0	
84447	chr18	63375896	63376843	947	474.0	
84448	chr18	63399802	63400320	518	259.0	
84449	chr18	63421326	63423496	2170	1085.0	
84450	chr18	63439172	63439709	537	268.0	
84451	chr18	63440725	63441413	688	344.0	
84452	chr18	63444417	63445341	924	462.0	
84453	chr18	63506089	63506469	380	190.0	
84454	chr18	63511340	63511645	305	152.0	
84455	chr18	63518377	63518866	489	244.0	
84456	chr18	63553086	63553514	428	214.0	
84457	chr18	63578411	63578737	326	163.0	
84458	chr18	63579639	63579984	345	172.0	
84459	chr18	63584789	63585154	365	182.0	
84460	chr18	63590283	63590763	480	240.0	
84461	chr18	63788414	63788924	510	255.0	
84462	chr18	63831031	63831531	500	250.0	
84463	chr18	63848138	63848544	406	203.0	
84464	chr18	63849992	63850421	429	214.0	
84465	chr18	63859743	63860434	691	346.0	
84466	chr18	63869273	63870258	985	492.0	
84467	chr18	63887419	63887722	303	152.0	
84468	chr18	63889526	63890104	578	289.0	
84469	chr18	63890899	63891292	393	196.0	
84470	chr18	63892495	63892947	452	226.0	
84471	chr18	63894438	63894502	64	32.0	
84472	chr18	63909005	63909126	121	60.0	
84473	chr18	63917875	63918237	362	181.0	
84474	chr18	63922193	63922404	211	106.0	
84475	chr18	63928388	63928723	335	168.0	
84476	chr18	63930719	63931202	483	242.0	
84477	chr18	63935964	63937352	1388	694.0	
84478	chr18	63937894	63938257	363	182.0	
84479	chr18	63948955	63949654	699	350.0	
84480	chr18	63963557	63964092	535	268.0	
84481	chr18	63969635	63972083	2448	1224.0	
84482	chr18	63975027	63976088	1061	530.0	
84483	chr18	63979315	63979846	531	266.0	
84484	chr18	63980975	63981537	562	281.0	
84485	chr18	63994713	63995233	520	260.0	
84486	chr18	64713268	64713720	452	226.0	
84487	chr18	66639229	66639629	400	200.0	
84488	chr18	66640460	66640864	404	202.0	
84489	chr18	67200272	67200591	319	160.0	
84490	chr18	67217514	67217989	475	238.0	
84491	chr18	67241269	67241634	365	182.0	
84492	chr18	67265585	67266094	509	254.0	
84493	chr18	67302078	67302308	230	115.0	
84494	chr18	67417849	67418573	724	362.0	
84495	chr18	67451238	67451361	123	62.0	
84496	chr18	67513237	67513593	356	178.0	
84497	chr18	67515536	67517788	2252	1126.0	
84498	chr18	68660371	68660771	400	200.0	
84499	chr18	68665672	68666010	338	169.0	
84500	chr18	68713947	68715814	1867	934.0	
84501	chr18	68721459	68723312	1853	926.0	
84502	chr18	68728059	68728757	698	349.0	
84503	chr18	68735700	68736144	444	222.0	
84504	chr18	68838320	68838339	19	10.0	
84505	chr18	68840790	68841193	403	202.0	
84506	chr18	69469329	69469829	500	250.0	
84507	chr18	69636915	69637226	311	156.0	
84508	chr18	69723451	69723788	337	168.0	
84509	chr18	69876491	69876892	401	200.0	
84510	chr18	69885664	69886453	789	394.0	
84511	chr18	69895098	69898993	3895	1948.0	
84512	chr18	69910556	69910557	1	0.0	
84513	chr18	69934899	69936622	1723	862.0	
84514	chr18	69943149	69943333	184	92.0	
84515	chr18	69945160	69949611	4451	2226.0	
84516	chr18	69954433	69954485	52	26.0	
84517	chr18	69955036	69957985	2949	1474.0	
84518	chr18	69958530	69960128	1598	799.0	
84519	chr18	69967990	69968568	578	289.0	
84520	chr18	70086552	70086877	325	162.0	
84521	chr18	70135576	70136012	436	218.0	
84522	chr18	70151760	70152111	351	176.0	
84523	chr18	70195816	70196255	439	220.0	
84524	chr18	70205040	70206768	1728	864.0	
84525	chr18	70228499	70228900	401	200.0	
84526	chr18	70284844	70285756	912	456.0	
84527	chr18	70288446	70289935	1489	744.0	
84528	chr18	70292631	70292952	321	160.0	
84529	chr18	70420076	70420666	590	295.0	
84530	chr18	70421879	70422738	859	430.0	
84531	chr18	70429043	70430367	1324	662.0	
84532	chr18	70433783	70434323	540	270.0	
84533	chr18	70454676	70455116	440	220.0	
84534	chr18	70464725	70465151	426	213.0	
84535	chr18	70489710	70490752	1042	521.0	
84536	chr18	70491696	70492169	473	236.0	
84537	chr18	70499239	70499520	281	140.0	
84538	chr18	70598793	70599439	646	323.0	
84539	chr18	70621663	70622174	511	256.0	
84540	chr18	70658930	70659454	524	262.0	
84541	chr18	70672202	70673142	940	470.0	
84542	chr18	70683312	70683607	295	148.0	
84543	chr18	70781789	70782301	512	256.0	
84544	chr18	72869892	72870060	168	84.0	
84545	chr18	73073752	73074115	363	182.0	
84546	chr18	74012443	74013007	564	282.0	
84547	chr18	74014088	74014346	258	129.0	
84548	chr18	74040730	74041130	400	200.0	
84549	chr18	74063125	74063429	304	152.0	
84550	chr18	74069158	74069625	467	234.0	
84551	chr18	74082388	74083465	1077	538.0	
84552	chr18	74147029	74149262	2233	1116.0	
84553	chr18	74163286	74163669	383	192.0	
84554	chr18	74196032	74196807	775	388.0	
84555	chr18	74204455	74204540	85	42.0	
84556	chr18	74234523	74235072	549	274.0	
84557	chr18	74249097	74249692	595	298.0	
84558	chr18	74251585	74252013	428	214.0	
84559	chr18	74264342	74264664	322	161.0	
84560	chr18	74290916	74292964	2048	1024.0	
84561	chr18	74310361	74310887	526	263.0	
84562	chr18	74320163	74320337	174	87.0	
84563	chr18	74334316	74334978	662	331.0	
84564	chr18	74342422	74342828	406	203.0	
84565	chr18	74351326	74351732	406	203.0	
84566	chr18	74353150	74353635	485	242.0	
84567	chr18	74356924	74357392	468	234.0	
84568	chr18	74373249	74374453	1204	602.0	
84569	chr18	74378021	74378816	795	398.0	
84570	chr18	74389061	74389492	431	216.0	
84571	chr18	74390704	74391105	401	200.0	
84572	chr18	74396629	74397256	627	314.0	
84573	chr18	74399430	74399522	92	46.0	
84574	chr18	74456968	74457480	512	256.0	
84575	chr18	74478849	74480074	1225	612.0	
84576	chr18	74481211	74481409	198	99.0	
84577	chr18	74484919	74485305	386	193.0	
84578	chr18	74493544	74497238	3694	1847.0	
84579	chr18	74497774	74501331	3557	1778.0	
84580	chr18	74506700	74506927	227	114.0	
84581	chr18	74524056	74524741	685	342.0	
84582	chr18	74541008	74541248	240	120.0	
84583	chr18	74551865	74552396	531	266.0	
84584	chr18	74567796	74568403	607	304.0	
84585	chr18	74588805	74590255	1450	725.0	
84586	chr18	74590819	74591233	414	207.0	
84587	chr18	74595288	74595856	568	284.0	
84588	chr18	74596731	74599216	2485	1242.0	
84589	chr18	74623449	74623809	360	180.0	
84590	chr18	74631322	74632638	1316	658.0	
84591	chr18	74652585	74652726	141	70.0	
84592	chr18	74896375	74896795	420	210.0	
84593	chr18	74901393	74901779	386	193.0	
84594	chr18	74942288	74942726	438	219.0	
84595	chr18	74951121	74951444	323	162.0	
84596	chr18	74983129	74983883	754	377.0	
84597	chr18	74990385	74991154	769	384.0	
84598	chr18	74994424	74996473	2049	1024.0	
84599	chr18	75029582	75029800	218	109.0	
84600	chr18	75066881	75067425	544	272.0	
84601	chr18	75070521	75071829	1308	654.0	
84602	chr18	75161449	75162181	732	366.0	
84603	chr18	75173008	75173494	486	243.0	
84604	chr18	75203955	75205483	1528	764.0	
84605	chr18	75206970	75212863	5893	2946.0	
84606	chr18	75216110	75217267	1157	578.0	
84607	chr18	75226816	75227027	211	106.0	
84608	chr18	75229411	75229856	445	222.0	
84609	chr18	75240526	75240898	372	186.0	
84610	chr18	75244307	75244742	435	218.0	
84611	chr18	75245808	75250593	4785	2392.0	
84612	chr18	75307527	75307917	390	195.0	
84613	chr18	75477896	75478312	416	208.0	
84614	chr18	75479000	75479438	438	219.0	
84615	chr18	76131643	76132224	581	290.0	
84616	chr18	76134633	76134993	360	180.0	
84617	chr18	76349018	76349514	496	248.0	
84618	chr18	76374656	76375305	649	324.0	
84619	chr18	76376831	76377143	312	156.0	
84620	chr18	76380854	76380970	116	58.0	
84621	chr18	76391719	76392053	334	167.0	
84622	chr18	76395395	76396118	723	362.0	
84623	chr18	76398647	76399492	845	422.0	
84624	chr18	76402390	76402962	572	286.0	
84625	chr18	76405964	76406441	477	238.0	
84626	chr18	76411028	76411430	402	201.0	
84627	chr18	76415184	76415587	403	202.0	
84628	chr18	76448177	76449076	899	450.0	
84629	chr18	76450694	76451804	1110	555.0	
84630	chr18	76452305	76452700	395	198.0	
84631	chr18	76466557	76469147	2590	1295.0	
84632	chr18	76472854	76473910	1056	528.0	
84633	chr18	76475717	76476244	527	264.0	
84634	chr18	76476924	76477648	724	362.0	
84635	chr18	76479343	76480233	890	445.0	
84636	chr18	76486572	76486958	386	193.0	
84637	chr18	76487884	76488071	187	94.0	
84638	chr18	76490445	76496725	6280	3140.0	
84639	chr18	76499634	76500521	887	444.0	
84640	chr18	76502474	76502946	472	236.0	
84641	chr18	76503555	76503947	392	196.0	
84642	chr18	76505633	76505967	334	167.0	
84643	chr18	76507978	76508379	401	200.0	
84644	chr18	76518536	76519005	469	234.0	
84645	chr18	76525241	76525726	485	242.0	
84646	chr18	76528596	76529475	879	440.0	
84647	chr18	76545026	76546539	1513	756.0	
84648	chr18	76553765	76554552	787	394.0	
84649	chr18	76564076	76564600	524	262.0	
84650	chr18	76565148	76566250	1102	551.0	
84651	chr18	76568687	76569132	445	222.0	
84652	chr18	76573232	76574117	885	442.0	
84653	chr18	76578521	76579140	619	310.0	
84654	chr18	76589278	76589705	427	214.0	
84655	chr18	76619352	76620726	1374	687.0	
84656	chr18	76658655	76658912	257	128.0	
84657	chr18	76686666	76687360	694	347.0	
84658	chr18	76709544	76710205	661	330.0	
84659	chr18	76720688	76722212	1524	762.0	
84660	chr18	76723801	76724252	451	226.0	
84661	chr18	76740387	76740740	353	176.0	
84662	chr18	76787517	76788304	787	394.0	
84663	chr18	76801723	76802611	888	444.0	
84664	chr18	76803647	76804215	568	284.0	
84665	chr18	76811603	76811970	367	184.0	
84666	chr18	76821341	76824175	2834	1417.0	
84667	chr18	76874679	76875690	1011	506.0	
84668	chr18	76922041	76922562	521	260.0	
84669	chr18	76948532	76948749	217	108.0	
84670	chr18	76963907	76964306	399	200.0	
84671	chr18	76965597	76966194	597	298.0	
84672	chr18	76980969	76981569	600	300.0	
84673	chr18	76983022	76983935	913	456.0	
84674	chr18	76987967	76988410	443	222.0	
84675	chr18	76990973	76991354	381	190.0	
84676	chr18	77000364	77000885	521	260.0	
84677	chr18	77004493	77005588	1095	548.0	
84678	chr18	77006263	77007395	1132	566.0	
84679	chr18	77013606	77014149	543	272.0	
84680	chr18	77015188	77015563	375	188.0	
84681	chr18	77023151	77023542	391	196.0	
84682	chr18	77032444	77032755	311	156.0	
84683	chr18	77052452	77057598	5146	2573.0	
84684	chr18	77059513	77060095	582	291.0	
84685	chr18	77061238	77063893	2655	1328.0	
84686	chr18	77064793	77066309	1516	758.0	
84687	chr18	77066860	77070423	3563	1782.0	
84688	chr18	77071465	77072439	974	487.0	
84689	chr18	77073410	77074520	1110	555.0	
84690	chr18	77080117	77081911	1794	897.0	
84691	chr18	77084202	77084608	406	203.0	
84692	chr18	77095271	77095856	585	292.0	
84693	chr18	77097878	77103084	5206	2603.0	
84694	chr18	77105040	77109678	4638	2319.0	
84695	chr18	77111451	77112907	1456	728.0	
84696	chr18	77114110	77115705	1595	798.0	
84697	chr18	77118557	77119824	1267	634.0	
84698	chr18	77123294	77125317	2023	1012.0	
84699	chr18	77127727	77134581	6854	3427.0	
84700	chr18	77140250	77142092	1842	921.0	
84701	chr18	77146816	77148001	1185	592.0	
84702	chr18	77151945	77152173	228	114.0	
84703	chr18	77160498	77161810	1312	656.0	
84704	chr18	77178519	77179000	481	240.0	
84705	chr18	77207380	77207896	516	258.0	
84706	chr18	77208577	77209587	1010	505.0	
84707	chr18	77211807	77212241	434	217.0	
84708	chr18	77220771	77221106	335	168.0	
84709	chr18	77249175	77249923	748	374.0	
84710	chr18	77621838	77622660	822	411.0	
84711	chr18	77645187	77645778	591	296.0	
84712	chr18	77650750	77651205	455	228.0	
84713	chr18	77899847	77900620	773	386.0	
84714	chr18	78539634	78540237	603	302.0	
84715	chr18	78625945	78626211	266	133.0	
84716	chr18	78632109	78632607	498	249.0	
84717	chr18	78640657	78640941	284	142.0	
84718	chr18	78641718	78643500	1782	891.0	
84719	chr18	78647066	78647306	240	120.0	
84720	chr18	78875461	78875643	182	91.0	
84721	chr18	79010942	79011680	738	369.0	
84722	chr18	79047868	79048203	335	168.0	
84723	chr18	79067349	79070282	2933	1466.0	
84724	chr18	79070939	79071914	975	488.0	
84725	chr18	79139163	79139643	480	240.0	
84726	chr18	79156613	79157637	1024	512.0	
84727	chr18	79191983	79192330	347	174.0	
84728	chr18	79200522	79200947	425	212.0	
84729	chr18	79218868	79219147	279	140.0	
84730	chr18	79245435	79247007	1572	786.0	
84731	chr18	79318199	79318487	288	144.0	
84732	chr18	79326297	79327656	1359	680.0	
84733	chr18	79374740	79375237	497	248.0	
84734	chr18	79378721	79379644	923	462.0	
84735	chr18	79380452	79381427	975	488.0	
84736	chr18	79383567	79383568	1	0.0	
84737	chr18	79391132	79391312	180	90.0	
84738	chr18	79392212	79408228	16016	8008.0	
84739	chr18	79410342	79411218	876	438.0	
84740	chr18	79412460	79412602	142	71.0	
84741	chr18	79416257	79416670	413	206.0	
84742	chr18	79418257	79419103	846	423.0	
84743	chr18	79420816	79422862	2046	1023.0	
84744	chr18	79423385	79424135	750	375.0	
84745	chr18	79426260	79426994	734	367.0	
84746	chr18	79427655	79428032	377	188.0	
84747	chr18	79429953	79430346	393	196.0	
84748	chr18	79432546	79432565	19	10.0	
84749	chr18	79435956	79436344	388	194.0	
84750	chr18	79438910	79439542	632	316.0	
84751	chr18	79440815	79441156	341	170.0	
84752	chr18	79460320	79460967	647	324.0	
84753	chr18	79465306	79467161	1855	928.0	
84754	chr18	79496103	79496434	331	166.0	
84755	chr18	79497220	79497873	653	326.0	
84756	chr18	79506045	79508371	2326	1163.0	
84757	chr18	79508987	79509536	549	274.0	
84758	chr18	79516339	79517816	1477	738.0	
84759	chr18	79520159	79525068	4909	2454.0	
84760	chr18	79528655	79529245	590	295.0	
84761	chr18	79575149	79575368	219	110.0	
84762	chr18	79584744	79584745	1	0.0	
84763	chr18	79624527	79625750	1223	612.0	
84764	chr18	79631825	79632074	249	124.0	
84765	chr18	79642666	79644526	1860	930.0	
84766	chr18	79678548	79685685	7137	3568.0	
84767	chr18	79788119	79788376	257	128.0	
84768	chr18	79791332	79793393	2061	1030.0	
84769	chr18	79794833	79795219	386	193.0	
84770	chr18	79797910	79797912	2	1.0	
84771	chr18	79819738	79820604	866	433.0	
84772	chr18	79823215	79823579	364	182.0	
84773	chr18	79825850	79826295	445	222.0	
84774	chr18	79856650	79856973	323	162.0	
84775	chr18	79912593	79913307	714	357.0	
84776	chr18	79913979	79914973	994	497.0	
84777	chr18	79943913	79945625	1712	856.0	
84778	chr18	79947299	79947732	433	216.0	
84779	chr18	79949515	79953204	3689	1844.0	
84780	chr18	79960166	79960628	462	231.0	
84781	chr18	79962793	79965973	3180	1590.0	
84782	chr18	79971566	79971975	409	204.0	
84783	chr18	79982485	79983259	774	387.0	
84784	chr18	79983811	79984363	552	276.0	
84785	chr18	79987628	79989454	1826	913.0	
84786	chr18	80032839	80035062	2223	1112.0	
84787	chr18	80105052	80106105	1053	526.0	
84788	chr18	80106666	80110763	4097	2048.0	
84789	chr18	80127031	80127145	114	57.0	
84790	chr18	80147038	80149037	1999	1000.0	
84791	chr18	80154231	80154720	489	244.0	
84792	chr18	80157685	80158161	476	238.0	
84793	chr18	80159572	80160262	690	345.0	
84794	chr18	80171210	80172538	1328	664.0	
84795	chr18	80175049	80176194	1145	572.0	
84796	chr18	80246581	80248085	1504	752.0	
84797	chr18	80253886	80254309	423	212.0	
84798	chr18	80257585	80258242	657	328.0	
84799	chr19	246731	247513	782	391.0	
84800	chr19	266910	267798	888	444.0	
84801	chr19	290000	291373	1373	686.0	"enhancer	sequence_feature"
84802	chr19	294865	295521	656	328.0	
84803	chr19	296406	296880	474	237.0	
84804	chr19	342602	345795	3193	1596.0	
84805	chr19	382709	382897	188	94.0	
84806	chr19	408989	409423	434	217.0	
84807	chr19	459767	461209	1442	721.0	
84808	chr19	480093	480575	482	241.0	
84809	chr19	488232	489896	1664	832.0	
84810	chr19	491458	492475	1017	508.0	
84811	chr19	495395	496124	729	364.0	
84812	chr19	497575	498425	850	425.0	
84813	chr19	502708	503213	505	252.0	
84814	chr19	506247	508496	2249	1124.0	
84815	chr19	510232	512412	2180	1090.0	
84816	chr19	518449	519420	971	486.0	
84817	chr19	530607	533784	3177	1588.0	
84818	chr19	535071	535889	818	409.0	
84819	chr19	537071	537126	55	28.0	
84820	chr19	542261	545583	3322	1661.0	
84821	chr19	547509	547767	258	129.0	
84822	chr19	550018	550377	359	180.0	
84823	chr19	555653	556835	1182	591.0	
84824	chr19	566266	568084	1818	909.0	
84825	chr19	569786	573967	4181	2090.0	
84826	chr19	574919	575570	651	326.0	
84827	chr19	576847	577085	238	119.0	
84828	chr19	583459	586233	2774	1387.0	
84829	chr19	587986	591861	3875	1938.0	
84830	chr19	603900	604847	947	474.0	
84831	chr19	608874	612010	3136	1568.0	
84832	chr19	615711	616189	478	239.0	
84833	chr19	632448	634419	1971	986.0	
84834	chr19	638955	640809	1854	927.0	
84835	chr19	641555	642094	539	270.0	
84836	chr19	642925	643648	723	362.0	
84837	chr19	658167	664055	5888	2944.0	
84838	chr19	664649	665599	950	475.0	
84839	chr19	667530	668060	530	265.0	
84840	chr19	671967	672403	436	218.0	
84841	chr19	675547	676930	1383	692.0	
84842	chr19	677482	677963	481	240.0	
84843	chr19	679484	681920	2436	1218.0	
84844	chr19	693151	693483	332	166.0	
84845	chr19	694784	695380	596	298.0	
84846	chr19	697210	697361	151	76.0	
84847	chr19	699101	700353	1252	626.0	
84848	chr19	703098	704782	1684	842.0	
84849	chr19	708599	709052	453	226.0	
84850	chr19	719296	719408	112	56.0	
84851	chr19	733849	734632	783	392.0	
84852	chr19	737706	738212	506	253.0	
84853	chr19	741543	741910	367	184.0	
84854	chr19	751717	752002	285	142.0	
84855	chr19	752919	753656	737	368.0	
84856	chr19	756458	756480	22	11.0	
84857	chr19	770019	771650	1631	816.0	
84858	chr19	789131	789860	729	364.0	
84859	chr19	795140	795259	119	60.0	
84860	chr19	796427	809102	12675	6338.0	
84861	chr19	809752	817512	7760	3880.0	
84862	chr19	820137	820418	281	140.0	
84863	chr19	821306	822759	1453	726.0	
84864	chr19	823583	824034	451	226.0	
84865	chr19	824805	825297	492	246.0	
84866	chr19	826212	826631	419	210.0	
84867	chr19	827480	828228	748	374.0	
84868	chr19	836467	836727	260	130.0	
84869	chr19	839143	839526	383	192.0	
84870	chr19	840499	841181	682	341.0	
84871	chr19	843225	844821	1596	798.0	
84872	chr19	850395	851106	711	356.0	
84873	chr19	852034	853095	1061	530.0	
84874	chr19	856946	857467	521	260.0	
84875	chr19	859091	864514	5423	2712.0	
84876	chr19	871735	874060	2325	1162.0	
84877	chr19	875479	876040	561	280.0	
84878	chr19	888923	889376	453	226.0	
84879	chr19	892216	894171	1955	978.0	
84880	chr19	897784	897824	40	20.0	
84881	chr19	898556	899116	560	280.0	
84882	chr19	900025	901004	979	490.0	
84883	chr19	905523	907910	2387	1194.0	
84884	chr19	908500	910183	1683	842.0	
84885	chr19	911560	913952	2392	1196.0	
84886	chr19	915030	915512	482	241.0	
84887	chr19	916901	922297	5396	2698.0	
84888	chr19	924453	929172	4719	2360.0	
84889	chr19	932578	933620	1042	521.0	
84890	chr19	934825	935455	630	315.0	
84891	chr19	937230	937873	643	322.0	
84892	chr19	940346	941663	1317	658.0	
84893	chr19	947318	948438	1120	560.0	
84894	chr19	952905	953514	609	304.0	
84895	chr19	982430	985124	2694	1347.0	
84896	chr19	991290	992130	840	420.0	
84897	chr19	995104	995283	179	90.0	
84898	chr19	995948	997218	1270	635.0	
84899	chr19	998151	999255	1104	552.0	
84900	chr19	999956	1002303	2347	1174.0	
84901	chr19	1009239	1009429	190	95.0	
84902	chr19	1012005	1012438	433	216.0	
84903	chr19	1016514	1022509	5995	2998.0	
84904	chr19	1025901	1029007	3106	1553.0	
84905	chr19	1029993	1031744	1751	876.0	
84906	chr19	1035698	1036290	592	296.0	
84907	chr19	1037394	1041840	4446	2223.0	
84908	chr19	1045085	1045667	582	291.0	
84909	chr19	1046851	1047598	747	374.0	
84910	chr19	1052569	1053146	577	288.0	
84911	chr19	1057061	1057644	583	292.0	
84912	chr19	1062452	1070439	7987	3994.0	
84913	chr19	1071902	1072080	178	89.0	
84914	chr19	1073075	1083274	10199	5100.0	
84915	chr19	1084164	1092312	8148	4074.0	
84916	chr19	1093351	1096434	3083	1542.0	
84917	chr19	1097749	1098539	790	395.0	
84918	chr19	1099424	1100066	642	321.0	
84919	chr19	1101097	1111603	10506	5253.0	
84920	chr19	1112132	1114520	2388	1194.0	
84921	chr19	1122892	1123648	756	378.0	
84922	chr19	1130484	1134368	3884	1942.0	
84923	chr19	1136224	1136596	372	186.0	
84924	chr19	1140719	1140973	254	127.0	
84925	chr19	1154748	1155887	1139	570.0	
84926	chr19	1163094	1163579	485	242.0	
84927	chr19	1164469	1165489	1020	510.0	
84928	chr19	1168820	1169388	568	284.0	
84929	chr19	1171516	1175693	4177	2088.0	"enhancer	sequence_feature"
84930	chr19	1176397	1177886	1489	744.0	
84931	chr19	1180178	1181125	947	474.0	
84932	chr19	1189404	1189862	458	229.0	
84933	chr19	1192074	1193182	1108	554.0	
84934	chr19	1194170	1195131	961	480.0	
84935	chr19	1203444	1203794	350	175.0	
84936	chr19	1204978	1208592	3614	1807.0	
84937	chr19	1213544	1214669	1125	562.0	
84938	chr19	1218113	1218257	144	72.0	
84939	chr19	1221493	1221873	380	190.0	
84940	chr19	1223091	1223497	406	203.0	
84941	chr19	1232476	1232990	514	257.0	
84942	chr19	1235837	1242527	6690	3345.0	
84943	chr19	1243975	1246892	2917	1458.0	
84944	chr19	1247611	1277599	29988	14994.0	
84945	chr19	1278652	1280344	1692	846.0	
84946	chr19	1281687	1283235	1548	774.0	
84947	chr19	1284745	1286387	1642	821.0	
84948	chr19	1295625	1296192	567	284.0	
84949	chr19	1315677	1316050	373	186.0	
84950	chr19	1325136	1325633	497	248.0	
84951	chr19	1344650	1345410	760	380.0	
84952	chr19	1354120	1356021	1901	950.0	
84953	chr19	1363403	1364539	1136	568.0	
84954	chr19	1367365	1367733	368	184.0	
84955	chr19	1371947	1372400	453	226.0	
84956	chr19	1382738	1384822	2084	1042.0	
84957	chr19	1396635	1396680	45	22.0	
84958	chr19	1400628	1402058	1430	715.0	
84959	chr19	1402584	1403156	572	286.0	
84960	chr19	1406548	1413132	6584	3292.0	
84961	chr19	1414987	1416149	1162	581.0	
84962	chr19	1437663	1441230	3567	1784.0	
84963	chr19	1443812	1447606	3794	1897.0	
84964	chr19	1449083	1450936	1853	926.0	
84965	chr19	1453519	1454328	809	404.0	
84966	chr19	1455013	1456572	1559	780.0	
84967	chr19	1459398	1459958	560	280.0	
84968	chr19	1465597	1466160	563	282.0	
84969	chr19	1468199	1472011	3812	1906.0	
84970	chr19	1478448	1479949	1501	750.0	
84971	chr19	1488346	1488730	384	192.0	
84972	chr19	1489431	1491919	2488	1244.0	
84973	chr19	1503202	1503974	772	386.0	
84974	chr19	1507425	1508747	1322	661.0	
84975	chr19	1512176	1514420	2244	1122.0	
84976	chr19	1545942	1546794	852	426.0	
84977	chr19	1560410	1560743	333	166.0	
84978	chr19	1566808	1569070	2262	1131.0	
84979	chr19	1569624	1569855	231	116.0	
84980	chr19	1590664	1593602	2938	1469.0	
84981	chr19	1604698	1606696	1998	999.0	
84982	chr19	1608420	1609701	1281	640.0	
84983	chr19	1618173	1618578	405	202.0	
84984	chr19	1624370	1624895	525	262.0	
84985	chr19	1648566	1649365	799	400.0	
84986	chr19	1650360	1653665	3305	1652.0	
84987	chr19	1655460	1655694	234	117.0	
84988	chr19	1661093	1661645	552	276.0	
84989	chr19	1668315	1669555	1240	620.0	
84990	chr19	1671677	1672758	1081	540.0	
84991	chr19	1690763	1691169	406	203.0	
84992	chr19	1725444	1726036	592	296.0	
84993	chr19	1747344	1748524	1180	590.0	
84994	chr19	1749724	1749946	222	111.0	
84995	chr19	1767210	1767890	680	340.0	
84996	chr19	1788802	1789245	443	222.0	
84997	chr19	1790739	1791171	432	216.0	
84998	chr19	1795709	1796382	673	336.0	
84999	chr19	1810762	1813785	3023	1512.0	
85000	chr19	1814773	1814988	215	108.0	
85001	chr19	1825863	1829230	3367	1684.0	
85002	chr19	1833467	1834207	740	370.0	
85003	chr19	1835870	1836078	208	104.0	
85004	chr19	1836976	1838736	1760	880.0	
85005	chr19	1839391	1840515	1124	562.0	
85006	chr19	1843822	1846531	2709	1354.0	
85007	chr19	1847226	1865798	18572	9286.0	
85008	chr19	1873138	1873626	488	244.0	
85009	chr19	1874499	1877134	2635	1318.0	
85010	chr19	1880261	1886303	6042	3021.0	
85011	chr19	1887216	1887518	302	151.0	
85012	chr19	1894855	1899100	4245	2122.0	
85013	chr19	1901061	1902476	1415	708.0	
85014	chr19	1903316	1906259	2943	1472.0	
85015	chr19	1908881	1910074	1193	596.0	
85016	chr19	1917240	1917493	253	126.0	
85017	chr19	1923154	1923876	722	361.0	
85018	chr19	1927600	1928113	513	256.0	
85019	chr19	1928839	1930661	1822	911.0	
85020	chr19	1933120	1933693	573	286.0	
85021	chr19	1935329	1935928	599	300.0	
85022	chr19	1937705	1946354	8649	4324.0	
85023	chr19	1947613	1949507	1894	947.0	
85024	chr19	1954661	1954981	320	160.0	
85025	chr19	1956155	1956378	223	112.0	
85026	chr19	1957512	1958033	521	260.0	
85027	chr19	1961567	1961590	23	12.0	
85028	chr19	1966883	1967745	862	431.0	
85029	chr19	1971439	1971655	216	108.0	
85030	chr19	1986507	1986566	59	30.0	
85031	chr19	1992763	1993175	412	206.0	
85032	chr19	1999048	1999403	355	178.0	
85033	chr19	2010278	2010506	228	114.0	
85034	chr19	2011288	2011665	377	188.0	
85035	chr19	2012925	2020236	7311	3656.0	
85036	chr19	2021687	2022066	379	190.0	
85037	chr19	2025785	2027743	1958	979.0	
85038	chr19	2028525	2029104	579	290.0	
85039	chr19	2030302	2030512	210	105.0	
85040	chr19	2031072	2053069	21997	10998.0	
85041	chr19	2054093	2058820	4727	2364.0	
85042	chr19	2059853	2062592	2739	1370.0	
85043	chr19	2068802	2072255	3453	1726.0	
85044	chr19	2073060	2073438	378	189.0	
85045	chr19	2073971	2093332	19361	9680.0	
85046	chr19	2093898	2098098	4200	2100.0	
85047	chr19	2098822	2099111	289	144.0	
85048	chr19	2112228	2113153	925	462.0	
85049	chr19	2145761	2146039	278	139.0	
85050	chr19	2148358	2152556	4198	2099.0	
85051	chr19	2155678	2156606	928	464.0	
85052	chr19	2162577	2166049	3472	1736.0	
85053	chr19	2167262	2169676	2414	1207.0	
85054	chr19	2171013	2171894	881	440.0	
85055	chr19	2187604	2188488	884	442.0	
85056	chr19	2208613	2208734	121	60.0	
85057	chr19	2215169	2215878	709	354.0	
85058	chr19	2223796	2224489	693	346.0	
85059	chr19	2227309	2227987	678	339.0	
85060	chr19	2234969	2237721	2752	1376.0	
85061	chr19	2239148	2240612	1464	732.0	
85062	chr19	2249190	2254105	4915	2458.0	"promoter	promoter	promoter	promoter	protein_binding_site	protein_binding_site	protein_binding_site	protein_binding_site	protein_binding_site	protein_binding_site	promoter	protein_binding_site"
85063	chr19	2256229	2256693	464	232.0	
85064	chr19	2257701	2258591	890	445.0	
85065	chr19	2260241	2260765	524	262.0	
85066	chr19	2261716	2262204	488	244.0	
85067	chr19	2264213	2265003	790	395.0	
85068	chr19	2266280	2267216	936	468.0	
85069	chr19	2268846	2281075	12229	6114.0	
85070	chr19	2281608	2283644	2036	1018.0	
85071	chr19	2284734	2291699	6965	3482.0	
85072	chr19	2293965	2294838	873	436.0	
85073	chr19	2295428	2295431	3	2.0	
85074	chr19	2295990	2296261	271	136.0	
85075	chr19	2297202	2297383	181	90.0	
85076	chr19	2298738	2299330	592	296.0	
85077	chr19	2300688	2300795	107	54.0	
85078	chr19	2301502	2301509	7	4.0	
85079	chr19	2302178	2303957	1779	890.0	
85080	chr19	2305017	2305612	595	298.0	
85081	chr19	2306363	2306729	366	183.0	
85082	chr19	2307469	2309425	1956	978.0	
85083	chr19	2315565	2316636	1071	536.0	
85084	chr19	2324542	2325669	1127	564.0	
85085	chr19	2327355	2329603	2248	1124.0	
85086	chr19	2330694	2331057	363	182.0	
85087	chr19	2332025	2333741	1716	858.0	
85088	chr19	2335198	2336033	835	418.0	
85089	chr19	2383122	2383586	464	232.0	
85090	chr19	2384947	2385465	518	259.0	
85091	chr19	2391210	2391756	546	273.0	
85092	chr19	2393990	2395184	1194	597.0	
85093	chr19	2423353	2423703	350	175.0	
85094	chr19	2426491	2428736	2245	1122.0	"region	region	origin_of_replication	origin_of_replication	protein_binding_site	region	protein_binding_site	protein_binding_site	protein_binding_site	protein_binding_site	protein_binding_site	protein_binding_site	sequence_feature	sequence_feature	protein_binding_site	sequence_feature	sequence_feature	sequence_feature	sequence_feature	sequence_feature"
85095	chr19	2446272	2446849	577	288.0	
85096	chr19	2454932	2457647	2715	1358.0	
85097	chr19	2461613	2462653	1040	520.0	
85098	chr19	2474386	2482681	8295	4148.0	
85099	chr19	2483625	2483709	84	42.0	
85100	chr19	2486069	2486595	526	263.0	
85101	chr19	2487729	2489700	1971	986.0	
85102	chr19	2491174	2491769	595	298.0	
85103	chr19	2494046	2496093	2047	1024.0	
85104	chr19	2503333	2504261	928	464.0	
85105	chr19	2507069	2507681	612	306.0	
85106	chr19	2542294	2544063	1769	884.0	
85107	chr19	2546232	2547158	926	463.0	
85108	chr19	2549480	2550415	935	468.0	
85109	chr19	2552619	2553550	931	466.0	
85110	chr19	2561663	2562724	1061	530.0	
85111	chr19	2567582	2568113	531	266.0	
85112	chr19	2579118	2579843	725	362.0	
85113	chr19	2598668	2600085	1417	708.0	
85114	chr19	2607558	2608960	1402	701.0	
85115	chr19	2610654	2611804	1150	575.0	
85116	chr19	2613542	2615027	1485	742.0	
85117	chr19	2616597	2617483	886	443.0	
85118	chr19	2618210	2623303	5093	2546.0	
85119	chr19	2624460	2625927	1467	734.0	
85120	chr19	2627063	2628045	982	491.0	
85121	chr19	2629423	2630432	1009	504.0	
85122	chr19	2631094	2632001	907	454.0	
85123	chr19	2636535	2637616	1081	540.0	
85124	chr19	2648229	2648936	707	354.0	
85125	chr19	2652647	2652755	108	54.0	
85126	chr19	2663795	2664694	899	450.0	
85127	chr19	2677894	2678705	811	406.0	
85128	chr19	2680683	2682158	1475	738.0	
85129	chr19	2695260	2695752	492	246.0	
85130	chr19	2696612	2696787	175	88.0	
85131	chr19	2698689	2699402	713	356.0	
85132	chr19	2701425	2703329	1904	952.0	
85133	chr19	2710211	2711571	1360	680.0	
85134	chr19	2722877	2723426	549	274.0	
85135	chr19	2739053	2740663	1610	805.0	
85136	chr19	2748966	2749657	691	346.0	
85137	chr19	2769937	2770457	520	260.0	
85138	chr19	2775108	2776391	1283	642.0	
85139	chr19	2782483	2783989	1506	753.0	
85140	chr19	2784731	2786518	1787	894.0	
85141	chr19	2819479	2820742	1263	632.0	
85142	chr19	2840450	2842906	2456	1228.0	
85143	chr19	2856448	2857183	735	368.0	
85144	chr19	2872103	2872511	408	204.0	
85145	chr19	2887314	2887811	497	248.0	
85146	chr19	2888639	2889327	688	344.0	
85147	chr19	2900126	2901570	1444	722.0	
85148	chr19	2944379	2945934	1555	778.0	
85149	chr19	2949699	2951461	1762	881.0	
85150	chr19	2956389	2956855	466	233.0	
85151	chr19	2961741	2962772	1031	516.0	
85152	chr19	2974692	2974730	38	19.0	
85153	chr19	2975538	2975632	94	47.0	
85154	chr19	2976707	2978110	1403	702.0	
85155	chr19	2983419	2984081	662	331.0	
85156	chr19	3006179	3006534	355	178.0	
85157	chr19	3024757	3025358	601	300.0	
85158	chr19	3028126	3029774	1648	824.0	
85159	chr19	3034694	3037074	2380	1190.0	
85160	chr19	3046443	3048186	1743	872.0	
85161	chr19	3052650	3053225	575	288.0	
85162	chr19	3059917	3063479	3562	1781.0	
85163	chr19	3065552	3066080	528	264.0	
85164	chr19	3070438	3070927	489	244.0	
85165	chr19	3075746	3076692	946	473.0	
85166	chr19	3092466	3092849	383	192.0	
85167	chr19	3093801	3096538	2737	1368.0	
85168	chr19	3098749	3099472	723	362.0	
85169	chr19	3103551	3104768	1217	608.0	
85170	chr19	3108460	3109300	840	420.0	
85171	chr19	3125102	3126538	1436	718.0	
85172	chr19	3131179	3131578	399	200.0	
85173	chr19	3132654	3134100	1446	723.0	
85174	chr19	3135750	3137020	1270	635.0	
85175	chr19	3140593	3142880	2287	1144.0	
85176	chr19	3145806	3147046	1240	620.0	
85177	chr19	3154872	3155770	898	449.0	
85178	chr19	3162419	3163915	1496	748.0	
85179	chr19	3165050	3166293	1243	622.0	
85180	chr19	3169349	3170024	675	338.0	
85181	chr19	3172302	3172916	614	307.0	
85182	chr19	3175694	3177650	1956	978.0	
85183	chr19	3178167	3181360	3193	1596.0	
85184	chr19	3183158	3183230	72	36.0	
85185	chr19	3183777	3186909	3132	1566.0	
85186	chr19	3188771	3189288	517	258.0	
85187	chr19	3193713	3194214	501	250.0	
85188	chr19	3196958	3197008	50	25.0	
85189	chr19	3210454	3211275	821	410.0	
85190	chr19	3224171	3225046	875	438.0	
85191	chr19	3228557	3228903	346	173.0	
85192	chr19	3244028	3244414	386	193.0	
85193	chr19	3250680	3251122	442	221.0	
85194	chr19	3270899	3271354	455	228.0	
85195	chr19	3274920	3277269	2349	1174.0	
85196	chr19	3284433	3286282	1849	924.0	
85197	chr19	3304831	3305412	581	290.0	
85198	chr19	3306676	3306974	298	149.0	
85199	chr19	3308108	3308468	360	180.0	
85200	chr19	3324314	3324848	534	267.0	
85201	chr19	3326710	3327395	685	342.0	
85202	chr19	3338372	3339252	880	440.0	
85203	chr19	3343538	3344641	1103	552.0	
85204	chr19	3357100	3362498	5398	2699.0	
85205	chr19	3365519	3368382	2863	1432.0	
85206	chr19	3369038	3369953	915	458.0	
85207	chr19	3384874	3385136	262	131.0	
85208	chr19	3428511	3430168	1657	828.0	
85209	chr19	3434394	3435904	1510	755.0	
85210	chr19	3440020	3440554	534	267.0	
85211	chr19	3450929	3451331	402	201.0	
85212	chr19	3459498	3459956	458	229.0	
85213	chr19	3471951	3472409	458	229.0	
85214	chr19	3472991	3473417	426	213.0	
85215	chr19	3478279	3480284	2005	1002.0	
85216	chr19	3484748	3485477	729	364.0	
85217	chr19	3494631	3494968	337	168.0	
85218	chr19	3500024	3501557	1533	766.0	
85219	chr19	3504736	3507934	3198	1599.0	
85220	chr19	3508645	3509200	555	278.0	
85221	chr19	3516673	3517342	669	334.0	
85222	chr19	3536665	3539298	2633	1316.0	
85223	chr19	3544679	3545875	1196	598.0	
85224	chr19	3547360	3550188	2828	1414.0	
85225	chr19	3552567	3553517	950	475.0	
85226	chr19	3554057	3555150	1093	546.0	
85227	chr19	3555719	3558696	2977	1488.0	
85228	chr19	3571977	3574640	2663	1332.0	
85229	chr19	3576737	3577170	433	216.0	
85230	chr19	3585388	3586488	1100	550.0	
85231	chr19	3604633	3607499	2866	1433.0	
85232	chr19	3609003	3609007	4	2.0	
85233	chr19	3617442	3618972	1530	765.0	
85234	chr19	3626040	3627737	1697	848.0	
85235	chr19	3665587	3666462	875	438.0	
85236	chr19	3670613	3672651	2038	1019.0	
85237	chr19	3677339	3677380	41	20.0	
85238	chr19	3687433	3688661	1228	614.0	
85239	chr19	3692432	3693098	666	333.0	
85240	chr19	3698233	3701222	2989	1494.0	
85241	chr19	3705796	3706543	747	374.0	
85242	chr19	3710218	3710847	629	314.0	
85243	chr19	3719008	3719471	463	232.0	
85244	chr19	3721110	3722970	1860	930.0	
85245	chr19	3760650	3763679	3029	1514.0	
85246	chr19	3766698	3766873	175	88.0	
85247	chr19	3783539	3786815	3276	1638.0	
85248	chr19	3788695	3789877	1182	591.0	
85249	chr19	3798038	3798771	733	366.0	
85250	chr19	3801189	3802132	943	472.0	
85251	chr19	3806694	3807203	509	254.0	
85252	chr19	3810131	3811120	989	494.0	
85253	chr19	3812002	3814622	2620	1310.0	
85254	chr19	3818412	3818872	460	230.0	
85255	chr19	3821560	3822568	1008	504.0	
85256	chr19	3828418	3828803	385	192.0	
85257	chr19	3849078	3849518	440	220.0	
85258	chr19	3852644	3853099	455	228.0	
85259	chr19	3857634	3857948	314	157.0	
85260	chr19	3868911	3869331	420	210.0	
85261	chr19	3876914	3877302	388	194.0	
85262	chr19	3950497	3951879	1382	691.0	
85263	chr19	3969812	3973054	3242	1621.0	
85264	chr19	3975161	3988555	13394	6697.0	
85265	chr19	3989699	3990859	1160	580.0	
85266	chr19	4006843	4008678	1835	918.0	
85267	chr19	4014768	4015526	758	379.0	
85268	chr19	4019608	4019619	11	6.0	
85269	chr19	4034274	4035307	1033	516.0	
85270	chr19	4036947	4037194	247	124.0	
85271	chr19	4040426	4040747	321	160.0	
85272	chr19	4042540	4042970	430	215.0	
85273	chr19	4049516	4049602	86	43.0	
85274	chr19	4050405	4050645	240	120.0	
85275	chr19	4051369	4053567	2198	1099.0	
85276	chr19	4057503	4069970	12467	6234.0	
85277	chr19	4075300	4075729	429	214.0	
85278	chr19	4077648	4078963	1315	658.0	
85279	chr19	4081400	4082053	653	326.0	
85280	chr19	4083922	4085027	1105	552.0	
85281	chr19	4088528	4091259	2731	1366.0	
85282	chr19	4104014	4105669	1655	828.0	
85283	chr19	4108328	4109763	1435	718.0	
85284	chr19	4114846	4115961	1115	558.0	
85285	chr19	4122955	4124739	1784	892.0	
85286	chr19	4139486	4140769	1283	642.0	
85287	chr19	4153220	4153832	612	306.0	
85288	chr19	4172740	4173653	913	456.0	
85289	chr19	4179947	4183237	3290	1645.0	
85290	chr19	4183982	4184274	292	146.0	
85291	chr19	4186182	4186853	671	336.0	
85292	chr19	4204523	4205059	536	268.0	
85293	chr19	4214731	4215079	348	174.0	
85294	chr19	4229096	4229594	498	249.0	
85295	chr19	4233298	4233777	479	240.0	
85296	chr19	4246351	4248134	1783	892.0	
85297	chr19	4260668	4260955	287	144.0	
85298	chr19	4264518	4265290	772	386.0	
85299	chr19	4266978	4268112	1134	567.0	
85300	chr19	4279476	4279858	382	191.0	
85301	chr19	4301884	4303098	1214	607.0	
85302	chr19	4303756	4304974	1218	609.0	
85303	chr19	4310823	4310983	160	80.0	
85304	chr19	4319409	4319705	296	148.0	
85305	chr19	4326701	4329729	3028	1514.0	
85306	chr19	4337942	4339006	1064	532.0	
85307	chr19	4342137	4344703	2566	1283.0	
85308	chr19	4352538	4353203	665	332.0	
85309	chr19	4362628	4363533	905	452.0	
85310	chr19	4367778	4370934	3156	1578.0	
85311	chr19	4374009	4375095	1086	543.0	
85312	chr19	4375641	4376140	499	250.0	
85313	chr19	4379224	4381539	2315	1158.0	
85314	chr19	4390077	4390737	660	330.0	
85315	chr19	4399015	4403533	4518	2259.0	
85316	chr19	4420484	4420731	247	124.0	
85317	chr19	4430567	4432487	1920	960.0	
85318	chr19	4456032	4458390	2358	1179.0	
85319	chr19	4470795	4472707	1912	956.0	
85320	chr19	4474518	4474974	456	228.0	
85321	chr19	4504994	4505158	164	82.0	
85322	chr19	4523254	4523696	442	221.0	
85323	chr19	4525048	4525552	504	252.0	
85324	chr19	4531626	4532036	410	205.0	
85325	chr19	4534789	4535574	785	392.0	
85326	chr19	4539535	4543969	4434	2217.0	
85327	chr19	4547413	4547856	443	222.0	
85328	chr19	4556581	4557041	460	230.0	
85329	chr19	4558274	4558729	455	228.0	
85330	chr19	4559347	4560114	767	384.0	
85331	chr19	4561919	4562663	744	372.0	
85332	chr19	4563388	4564298	910	455.0	
85333	chr19	4567479	4568369	890	445.0	
85334	chr19	4568880	4569373	493	246.0	
85335	chr19	4575609	4576445	836	418.0	
85336	chr19	4581711	4581945	234	117.0	
85337	chr19	4584159	4584471	312	156.0	
85338	chr19	4589588	4589970	382	191.0	
85339	chr19	4593377	4594036	659	330.0	
85340	chr19	4597531	4598773	1242	621.0	
85341	chr19	4610024	4610495	471	236.0	
85342	chr19	4611987	4612311	324	162.0	
85343	chr19	4632965	4634979	2014	1007.0	
85344	chr19	4635808	4637741	1933	966.0	
85345	chr19	4638513	4640590	2077	1038.0	
85346	chr19	4666854	4667144	290	145.0	
85347	chr19	4669442	4671258	1816	908.0	
85348	chr19	4677116	4677507	391	196.0	
85349	chr19	4678838	4679408	570	285.0	
85350	chr19	4691313	4691771	458	229.0	
85351	chr19	4709246	4710018	772	386.0	
85352	chr19	4722740	4725377	2637	1318.0	
85353	chr19	4730625	4731162	537	268.0	
85354	chr19	4732515	4733190	675	338.0	
85355	chr19	4754192	4754544	352	176.0	
85356	chr19	4759416	4760382	966	483.0	
85357	chr19	4769202	4770015	813	406.0	
85358	chr19	4790607	4792686	2079	1040.0	
85359	chr19	4803795	4804358	563	282.0	
85360	chr19	4807122	4808751	1629	814.0	
85361	chr19	4809385	4810361	976	488.0	
85362	chr19	4811295	4813542	2247	1124.0	
85363	chr19	4815335	4816410	1075	538.0	
85364	chr19	4828976	4832367	3391	1696.0	
85365	chr19	4837407	4837992	585	292.0	
85366	chr19	4840609	4841749	1140	570.0	
85367	chr19	4851526	4852213	687	344.0	
85368	chr19	4866434	4868655	2221	1110.0	
85369	chr19	4869905	4870623	718	359.0	
85370	chr19	4872331	4873191	860	430.0	
85371	chr19	4878620	4878656	36	18.0	
85372	chr19	4900858	4901313	455	228.0	
85373	chr19	4909170	4912992	3822	1911.0	
85374	chr19	4913803	4917286	3483	1742.0	
85375	chr19	4922611	4922875	264	132.0	
85376	chr19	4950641	4951991	1350	675.0	
85377	chr19	4959375	4959494	119	60.0	
85378	chr19	4967910	4971713	3803	1902.0	
85379	chr19	4974765	4975257	492	246.0	
85380	chr19	4975977	4976984	1007	504.0	
85381	chr19	4978789	4979687	898	449.0	
85382	chr19	5001576	5001695	119	60.0	
85383	chr19	5029650	5030123	473	236.0	
85384	chr19	5030877	5032053	1176	588.0	
85385	chr19	5038898	5039082	184	92.0	
85386	chr19	5048049	5048741	692	346.0	
85387	chr19	5074111	5075928	1817	908.0	
85388	chr19	5077594	5078789	1195	598.0	
85389	chr19	5086168	5086768	600	300.0	
85390	chr19	5125770	5126114	344	172.0	
85391	chr19	5126689	5128471	1782	891.0	
85392	chr19	5128997	5132504	3507	1754.0	
85393	chr19	5135091	5135146	55	28.0	
85394	chr19	5135922	5136311	389	194.0	
85395	chr19	5138528	5140013	1485	742.0	
85396	chr19	5143369	5143839	470	235.0	
85397	chr19	5154068	5154563	495	248.0	
85398	chr19	5170366	5170815	449	224.0	
85399	chr19	5176822	5177188	366	183.0	
85400	chr19	5287695	5287719	24	12.0	
85401	chr19	5292584	5294051	1467	734.0	
85402	chr19	5313320	5313704	384	192.0	
85403	chr19	5322056	5322499	443	222.0	
85404	chr19	5336326	5336503	177	88.0	
85405	chr19	5338981	5339063	82	41.0	
85406	chr19	5339967	5341261	1294	647.0	
85407	chr19	5404076	5404388	312	156.0	
85408	chr19	5577993	5578864	871	436.0	
85409	chr19	5585478	5586830	1352	676.0	
85410	chr19	5587467	5587898	431	216.0	
85411	chr19	5589970	5590455	485	242.0	
85412	chr19	5593677	5594135	458	229.0	
85413	chr19	5594698	5595248	550	275.0	
85414	chr19	5602473	5602804	331	166.0	
85415	chr19	5606382	5606420	38	19.0	
85416	chr19	5607617	5608233	616	308.0	
85417	chr19	5619104	5619281	177	88.0	
85418	chr19	5620592	5625401	4809	2404.0	
85419	chr19	5627308	5629439	2131	1066.0	
85420	chr19	5679565	5681624	2059	1030.0	
85421	chr19	5685887	5687733	1846	923.0	
85422	chr19	5689200	5699287	10087	5044.0	
85423	chr19	5712137	5712140	3	2.0	
85424	chr19	5718466	5721337	2871	1436.0	
85425	chr19	5788245	5788430	185	92.0	
85426	chr19	5789941	5791806	1865	932.0	
85427	chr19	5794100	5794501	401	200.0	
85428	chr19	5802169	5802686	517	258.0	
85429	chr19	5803541	5806489	2948	1474.0	
85430	chr19	5826367	5829619	3252	1626.0	
85431	chr19	5830352	5830529	177	88.0	
85432	chr19	5864860	5864926	66	33.0	
85433	chr19	5865815	5866130	315	158.0	
85434	chr19	5884472	5884738	266	133.0	
85435	chr19	5892510	5892884	374	187.0	
85436	chr19	5903011	5905532	2521	1260.0	
85437	chr19	5947082	5948045	963	482.0	
85438	chr19	5948719	5949169	450	225.0	
85439	chr19	5949793	5950388	595	298.0	
85440	chr19	5951179	5952041	862	431.0	
85441	chr19	5952937	5954386	1449	724.0	
85442	chr19	5961470	5962922	1452	726.0	
85443	chr19	5965256	5965405	149	74.0	
85444	chr19	5967707	5968678	971	486.0	
85445	chr19	5974760	5975293	533	266.0	
85446	chr19	5977247	5979101	1854	927.0	
85447	chr19	5982970	5983547	577	288.0	
85448	chr19	5987098	5988120	1022	511.0	
85449	chr19	6022207	6022761	554	277.0	
85450	chr19	6048693	6049422	729	364.0	
85451	chr19	6056634	6058127	1493	746.0	
85452	chr19	6059849	6061370	1521	760.0	
85453	chr19	6062042	6064704	2662	1331.0	
85454	chr19	6065400	6067897	2497	1248.0	
85455	chr19	6068932	6069914	982	491.0	
85456	chr19	6070451	6071117	666	333.0	
85457	chr19	6076961	6077530	569	284.0	
85458	chr19	6086888	6088536	1648	824.0	
85459	chr19	6100042	6100959	917	458.0	
85460	chr19	6102024	6102104	80	40.0	
85461	chr19	6104699	6105364	665	332.0	
85462	chr19	6108397	6111840	3443	1722.0	
85463	chr19	6125447	6126816	1369	684.0	
85464	chr19	6160977	6161925	948	474.0	
85465	chr19	6165890	6166438	548	274.0	
85466	chr19	6198915	6200149	1234	617.0	
85467	chr19	6218384	6219093	709	354.0	
85468	chr19	6233952	6234622	670	335.0	
85469	chr19	6243762	6244448	686	343.0	
85470	chr19	6260821	6261291	470	235.0	
85471	chr19	6273410	6274471	1061	530.0	
85472	chr19	6277701	6280720	3019	1510.0	
85473	chr19	6299738	6300182	444	222.0	
85474	chr19	6360980	6363143	2163	1082.0	
85475	chr19	6372032	6374585	2553	1276.0	
85476	chr19	6376499	6376773	274	137.0	
85477	chr19	6392410	6394418	2008	1004.0	
85478	chr19	6412334	6412851	517	258.0	
85479	chr19	6423303	6426628	3325	1662.0	
85480	chr19	6429460	6429798	338	169.0	
85481	chr19	6458657	6461184	2527	1264.0	
85482	chr19	6463902	6464706	804	402.0	
85483	chr19	6476021	6476715	694	347.0	
85484	chr19	6479604	6479803	199	100.0	
85485	chr19	6480746	6482698	1952	976.0	
85486	chr19	6489329	6490180	851	426.0	
85487	chr19	6498423	6499205	782	391.0	
85488	chr19	6501588	6502798	1210	605.0	
85489	chr19	6504575	6505233	658	329.0	
85490	chr19	6515643	6518899	3256	1628.0	
85491	chr19	6521639	6523091	1452	726.0	
85492	chr19	6527726	6529422	1696	848.0	
85493	chr19	6530265	6533502	3237	1618.0	
85494	chr19	6534365	6537020	2655	1328.0	
85495	chr19	6537934	6538635	701	350.0	
85496	chr19	6539491	6539801	310	155.0	
85497	chr19	6540976	6541537	561	280.0	
85498	chr19	6543802	6544267	465	232.0	
85499	chr19	6551673	6552557	884	442.0	
85500	chr19	6556565	6556652	87	44.0	
85501	chr19	6572113	6572755	642	321.0	
85502	chr19	6577392	6578364	972	486.0	
85503	chr19	6586959	6588973	2014	1007.0	
85504	chr19	6590131	6591510	1379	690.0	
85505	chr19	6592279	6593212	933	466.0	
85506	chr19	6601440	6602036	596	298.0	
85507	chr19	6603768	6604453	685	342.0	
85508	chr19	6613718	6614161	443	222.0	
85509	chr19	6631806	6632456	650	325.0	
85510	chr19	6633139	6633643	504	252.0	
85511	chr19	6641573	6642375	802	401.0	
85512	chr19	6654191	6655536	1345	672.0	
85513	chr19	6661472	6662346	874	437.0	
85514	chr19	6663348	6664333	985	492.0	
85515	chr19	6667028	6667787	759	380.0	
85516	chr19	6668481	6670710	2229	1114.0	
85517	chr19	6674557	6675627	1070	535.0	
85518	chr19	6677787	6678510	723	362.0	
85519	chr19	6686293	6686707	414	207.0	
85520	chr19	6710549	6710963	414	207.0	
85521	chr19	6718545	6719336	791	396.0	
85522	chr19	6720451	6721282	831	416.0	
85523	chr19	6721847	6722085	238	119.0	
85524	chr19	6723398	6724190	792	396.0	
85525	chr19	6728184	6728924	740	370.0	
85526	chr19	6730500	6730775	275	138.0	
85527	chr19	6733404	6733686	282	141.0	
85528	chr19	6736027	6741639	5612	2806.0	
85529	chr19	6753069	6754299	1230	615.0	
85530	chr19	6760997	6761441	444	222.0	
85531	chr19	6765939	6769839	3900	1950.0	
85532	chr19	6771875	6775500	3625	1812.0	
85533	chr19	6778402	6778811	409	204.0	
85534	chr19	6797512	6798010	498	249.0	
85535	chr19	6799614	6803606	3992	1996.0	
85536	chr19	6806575	6806890	315	158.0	
85537	chr19	6811832	6812300	468	234.0	
85538	chr19	6813807	6814536	729	364.0	
85539	chr19	6828793	6829625	832	416.0	
85540	chr19	6831010	6831505	495	248.0	
85541	chr19	6861714	6864196	2482	1241.0	
85542	chr19	6868203	6868840	637	318.0	
85543	chr19	6876629	6877215	586	293.0	
85544	chr19	6886254	6887929	1675	838.0	
85545	chr19	6890126	6891286	1160	580.0	
85546	chr19	6891919	6892410	491	246.0	
85547	chr19	6926020	6926489	469	234.0	
85548	chr19	6945732	6946138	406	203.0	
85549	chr19	6958840	6959194	354	177.0	
85550	chr19	6963224	6964331	1107	554.0	
85551	chr19	6967884	6968336	452	226.0	
85552	chr19	6969923	6970883	960	480.0	
85553	chr19	6987817	6988230	413	206.0	
85554	chr19	6997650	6998807	1157	578.0	
85555	chr19	6999913	7001117	1204	602.0	
85556	chr19	7004329	7004736	407	204.0	
85557	chr19	7009128	7009527	399	200.0	
85558	chr19	7013710	7014133	423	212.0	
85559	chr19	7063444	7064278	834	417.0	
85560	chr19	7068617	7070305	1688	844.0	
85561	chr19	7098478	7100016	1538	769.0	
85562	chr19	7101833	7102915	1082	541.0	
85563	chr19	7104914	7104989	75	38.0	
85564	chr19	7149068	7149553	485	242.0	
85565	chr19	7159003	7159973	970	485.0	
85566	chr19	7179150	7179515	365	182.0	
85567	chr19	7182910	7183902	992	496.0	
85568	chr19	7185807	7186929	1122	561.0	
85569	chr19	7188715	7189036	321	160.0	
85570	chr19	7192127	7193018	891	446.0	
85571	chr19	7196781	7198890	2109	1054.0	
85572	chr19	7207941	7208423	482	241.0	
85573	chr19	7239520	7239902	382	191.0	
85574	chr19	7242857	7243369	512	256.0	
85575	chr19	7268033	7268898	865	432.0	
85576	chr19	7272825	7273297	472	236.0	
85577	chr19	7293364	7295227	1863	932.0	
85578	chr19	7337185	7338451	1266	633.0	
85579	chr19	7340840	7341558	718	359.0	
85580	chr19	7344805	7347143	2338	1169.0	
85581	chr19	7348387	7350996	2609	1304.0	
85582	chr19	7354149	7354966	817	408.0	
85583	chr19	7367038	7367319	281	140.0	
85584	chr19	7380445	7381016	571	286.0	
85585	chr19	7384372	7385154	782	391.0	
85586	chr19	7387420	7387978	558	279.0	
85587	chr19	7393277	7395899	2622	1311.0	
85588	chr19	7398571	7399097	526	263.0	
85589	chr19	7426958	7427313	355	178.0	
85590	chr19	7428544	7428944	400	200.0	
85591	chr19	7449404	7449956	552	276.0	
85592	chr19	7471199	7473586	2387	1194.0	
85593	chr19	7475082	7484165	9083	4542.0	
85594	chr19	7485122	7485131	9	4.0	
85595	chr19	7486192	7486210	18	9.0	
85596	chr19	7488388	7489654	1266	633.0	
85597	chr19	7490957	7493107	2150	1075.0	
85598	chr19	7494612	7494828	216	108.0	
85599	chr19	7497280	7497646	366	183.0	
85600	chr19	7500871	7501534	663	332.0	
85601	chr19	7505356	7507137	1781	890.0	
85602	chr19	7507643	7508391	748	374.0	
85603	chr19	7515675	7516614	939	470.0	
85604	chr19	7521857	7523583	1726	863.0	
85605	chr19	7527461	7527999	538	269.0	
85606	chr19	7533469	7537106	3637	1818.0	
85607	chr19	7543317	7546297	2980	1490.0	
85608	chr19	7550990	7551722	732	366.0	
85609	chr19	7555312	7555545	233	116.0	
85610	chr19	7568317	7568895	578	289.0	
85611	chr19	7575414	7575852	438	219.0	
85612	chr19	7595353	7596854	1501	750.0	
85613	chr19	7605377	7606076	699	350.0	
85614	chr19	7628809	7630713	1904	952.0	
85615	chr19	7636544	7638189	1645	822.0	
85616	chr19	7639277	7639530	253	126.0	
85617	chr19	7643576	7644046	470	235.0	
85618	chr19	7645082	7646369	1287	644.0	
85619	chr19	7651765	7653272	1507	754.0	
85620	chr19	7655241	7656200	959	480.0	
85621	chr19	7656734	7658870	2136	1068.0	
85622	chr19	7661819	7661898	79	40.0	
85623	chr19	7669070	7669252	182	91.0	
85624	chr19	7670008	7670882	874	437.0	
85625	chr19	7673984	7674908	924	462.0	
85626	chr19	7676207	7682438	6231	3116.0	
85627	chr19	7689341	7689522	181	90.0	
85628	chr19	7690568	7693322	2754	1377.0	
85629	chr19	7694493	7694933	440	220.0	
85630	chr19	7699249	7699795	546	273.0	
85631	chr19	7701543	7702580	1037	518.0	
85632	chr19	7705132	7707373	2241	1120.0	
85633	chr19	7714359	7715275	916	458.0	
85634	chr19	7718671	7719161	490	245.0	
85635	chr19	7729091	7730771	1680	840.0	
85636	chr19	7734083	7734810	727	364.0	
85637	chr19	7740581	7740771	190	95.0	
85638	chr19	7747346	7747871	525	262.0	
85639	chr19	7748811	7749165	354	177.0	
85640	chr19	7751068	7751727	659	330.0	
85641	chr19	7772294	7773307	1013	506.0	
85642	chr19	7778048	7778489	441	220.0	
85643	chr19	7783914	7784613	699	350.0	
85644	chr19	7788247	7789939	1692	846.0	
85645	chr19	7799491	7800483	992	496.0	
85646	chr19	7807321	7808181	860	430.0	
85647	chr19	7815139	7815834	695	348.0	
85648	chr19	7828843	7830796	1953	976.0	
85649	chr19	7852987	7853841	854	427.0	
85650	chr19	7861760	7864054	2294	1147.0	
85651	chr19	7865086	7865953	867	434.0	
85652	chr19	7868234	7872873	4639	2320.0	
85653	chr19	7873757	7875043	1286	643.0	
85654	chr19	7888288	7888681	393	196.0	
85655	chr19	7902796	7905092	2296	1148.0	
85656	chr19	7915773	7918549	2776	1388.0	
85657	chr19	7919605	7921818	2213	1106.0	
85658	chr19	7924918	7926806	1888	944.0	
85659	chr19	7929021	7929935	914	457.0	
85660	chr19	7942916	7944830	1914	957.0	
85661	chr19	7970769	7971165	396	198.0	
85662	chr19	8001778	8003020	1242	621.0	
85663	chr19	8004399	8006434	2035	1018.0	
85664	chr19	8017777	8018243	466	233.0	
85665	chr19	8050116	8051317	1201	600.0	
85666	chr19	8051954	8052580	626	313.0	
85667	chr19	8073017	8073175	158	79.0	
85668	chr19	8158404	8158915	511	256.0	
85669	chr19	8180767	8181367	600	300.0	
85670	chr19	8191941	8192002	61	30.0	
85671	chr19	8193124	8195867	2743	1372.0	
85672	chr19	8196492	8196925	433	216.0	
85673	chr19	8208466	8210746	2280	1140.0	
85674	chr19	8240211	8240886	675	338.0	
85675	chr19	8242145	8242666	521	260.0	
85676	chr19	8252808	8253605	797	398.0	
85677	chr19	8261017	8261273	256	128.0	
85678	chr19	8268387	8269860	1473	736.0	
85679	chr19	8306485	8306724	239	120.0	
85680	chr19	8307447	8308995	1548	774.0	
85681	chr19	8320450	8322320	1870	935.0	
85682	chr19	8324494	8325067	573	286.0	
85683	chr19	8334744	8335995	1251	626.0	
85684	chr19	8340484	8340885	401	200.0	
85685	chr19	8342289	8343843	1554	777.0	
85686	chr19	8353587	8354523	936	468.0	
85687	chr19	8361929	8362811	882	441.0	
85688	chr19	8363456	8364597	1141	570.0	
85689	chr19	8384532	8385009	477	238.0	
85690	chr19	8389426	8392357	2931	1466.0	
85691	chr19	8396188	8397122	934	467.0	
85692	chr19	8412618	8413996	1378	689.0	
85693	chr19	8423153	8424391	1238	619.0	
85694	chr19	8444173	8446537	2364	1182.0	
85695	chr19	8447296	8447686	390	195.0	
85696	chr19	8449910	8450193	283	142.0	
85697	chr19	8451636	8452197	561	280.0	
85698	chr19	8473633	8474518	885	442.0	
85699	chr19	8480694	8481472	778	389.0	
85700	chr19	8484128	8485039	911	456.0	
85701	chr19	8486931	8488397	1466	733.0	
85702	chr19	8494005	8494698	693	346.0	
85703	chr19	8499891	8500822	931	466.0	
85704	chr19	8501545	8506925	5380	2690.0	
85705	chr19	8512032	8516509	4477	2238.0	
85706	chr19	8517373	8520203	2830	1415.0	
85707	chr19	8521459	8521563	104	52.0	
85708	chr19	8525291	8526589	1298	649.0	
85709	chr19	8540464	8541325	861	430.0	
85710	chr19	8557491	8558066	575	288.0	
85711	chr19	8564348	8565356	1008	504.0	
85712	chr19	8567530	8572382	4852	2426.0	
85713	chr19	8573059	8574449	1390	695.0	
85714	chr19	8575124	8579491	4367	2184.0	
85715	chr19	8580256	8581446	1190	595.0	
85716	chr19	8582381	8582633	252	126.0	
85717	chr19	8585835	8586362	527	264.0	
85718	chr19	8591584	8593287	1703	852.0	
85719	chr19	8609019	8613293	4274	2137.0	
85720	chr19	8615286	8616203	917	458.0	
85721	chr19	8637971	8638759	788	394.0	
85722	chr19	8639906	8641056	1150	575.0	
85723	chr19	8641991	8642950	959	480.0	
85724	chr19	8646216	8646913	697	348.0	
85725	chr19	8647494	8648635	1141	570.0	
85726	chr19	8650014	8650543	529	264.0	
85727	chr19	8654516	8655774	1258	629.0	
85728	chr19	8663816	8664734	918	459.0	
85729	chr19	8665987	8666182	195	98.0	
85730	chr19	8670781	8671739	958	479.0	
85731	chr19	8681602	8682030	428	214.0	
85732	chr19	8694200	8694893	693	346.0	
85733	chr19	8702154	8702839	685	342.0	
85734	chr19	8831554	8833577	2023	1012.0	
85735	chr19	9079776	9080177	401	200.0	
85736	chr19	9131019	9131372	353	176.0	
85737	chr19	9136219	9137117	898	449.0	
85738	chr19	9139748	9141048	1300	650.0	
85739	chr19	9205459	9206081	622	311.0	
85740	chr19	9283521	9284035	514	257.0	
85741	chr19	9308997	9310597	1600	800.0	
85742	chr19	9312002	9312657	655	328.0	
85743	chr19	9323357	9324931	1574	787.0	
85744	chr19	9406818	9407377	559	280.0	
85745	chr19	9431362	9431907	545	272.0	
85746	chr19	9434824	9436315	1491	746.0	
85747	chr19	9538029	9539181	1152	576.0	
85748	chr19	9583163	9585076	1913	956.0	
85749	chr19	9586605	9587267	662	331.0	
85750	chr19	9620602	9622185	1583	792.0	
85751	chr19	9625577	9626294	717	358.0	
85752	chr19	9674341	9675739	1398	699.0	
85753	chr19	9709372	9709516	144	72.0	
85754	chr19	9721816	9722147	331	166.0	
85755	chr19	9767837	9769430	1593	796.0	
85756	chr19	9784560	9786663	2103	1052.0	
85757	chr19	9790061	9790613	552	276.0	
85758	chr19	9791367	9793853	2486	1243.0	
85759	chr19	9795504	9796944	1440	720.0	
85760	chr19	9808714	9809532	818	409.0	
85761	chr19	9818078	9820333	2255	1128.0	
85762	chr19	9826887	9828773	1886	943.0	
85763	chr19	9834376	9836038	1662	831.0	
85764	chr19	9847264	9847435	171	86.0	
85765	chr19	9848032	9848517	485	242.0	
85766	chr19	9857786	9858680	894	447.0	
85767	chr19	9862755	9864066	1311	656.0	
85768	chr19	9865994	9866829	835	418.0	
85769	chr19	9913411	9915185	1774	887.0	
85770	chr19	9927329	9927922	593	296.0	
85771	chr19	9930621	9931399	778	389.0	
85772	chr19	9933889	9936776	2887	1444.0	
85773	chr19	10000173	10000696	523	262.0	
85774	chr19	10006158	10006771	613	306.0	
85775	chr19	10009141	10010427	1286	643.0	
85776	chr19	10027470	10028174	704	352.0	
85777	chr19	10074133	10074647	514	257.0	
85778	chr19	10085369	10087417	2048	1024.0	
85779	chr19	10091970	10092237	267	134.0	
85780	chr19	10093634	10093635	1	0.0	
85781	chr19	10095472	10096975	1503	752.0	
85782	chr19	10098916	10099444	528	264.0	
85783	chr19	10101553	10103404	1851	926.0	
85784	chr19	10104111	10107266	3155	1578.0	
85785	chr19	10111011	10114767	3756	1878.0	
85786	chr19	10115890	10116635	745	372.0	
85787	chr19	10119110	10120454	1344	672.0	
85788	chr19	10126104	10126825	721	360.0	
85789	chr19	10142482	10144069	1587	794.0	
85790	chr19	10193898	10195717	1819	910.0	
85791	chr19	10197686	10199280	1594	797.0	
85792	chr19	10209265	10209789	524	262.0	
85793	chr19	10219612	10220200	588	294.0	
85794	chr19	10222457	10222925	468	234.0	
85795	chr19	10228403	10232107	3704	1852.0	
85796	chr19	10235600	10237133	1533	766.0	
85797	chr19	10239198	10239611	413	206.0	
85798	chr19	10249838	10252898	3060	1530.0	
85799	chr19	10258713	10259631	918	459.0	
85800	chr19	10268954	10275675	6721	3360.0	
85801	chr19	10276643	10281591	4948	2474.0	
85802	chr19	10282442	10282493	51	26.0	
85803	chr19	10283189	10296405	13216	6608.0	
85804	chr19	10299675	10300392	717	358.0	
85805	chr19	10305321	10305982	661	330.0	
85806	chr19	10315240	10316916	1676	838.0	
85807	chr19	10331899	10335263	3364	1682.0	
85808	chr19	10338872	10340310	1438	719.0	
85809	chr19	10345766	10347352	1586	793.0	
85810	chr19	10353773	10354178	405	202.0	
85811	chr19	10372652	10374148	1496	748.0	
85812	chr19	10374937	10375350	413	206.0	
85813	chr19	10379790	10381597	1807	904.0	
85814	chr19	10382991	10383381	390	195.0	
85815	chr19	10386207	10386415	208	104.0	
85816	chr19	10388609	10391822	3213	1606.0	
85817	chr19	10393100	10407497	14397	7198.0	
85818	chr19	10408206	10409577	1371	686.0	
85819	chr19	10410391	10411099	708	354.0	
85820	chr19	10412141	10412932	791	396.0	
85821	chr19	10415558	10433737	18179	9090.0	
85822	chr19	10436139	10436923	784	392.0	
85823	chr19	10447056	10447132	76	38.0	
85824	chr19	10460582	10461977	1395	698.0	
85825	chr19	10471909	10472304	395	198.0	
85826	chr19	10478621	10479706	1085	542.0	
85827	chr19	10483385	10483996	611	306.0	
85828	chr19	10492066	10492507	441	220.0	
85829	chr19	10498312	10498950	638	319.0	
85830	chr19	10501772	10504029	2257	1128.0	
85831	chr19	10505198	10506228	1030	515.0	
85832	chr19	10508687	10509098	411	206.0	
85833	chr19	10510137	10510841	704	352.0	
85834	chr19	10512121	10512139	18	9.0	
85835	chr19	10513806	10519647	5841	2920.0	
85836	chr19	10520567	10521313	746	373.0	
85837	chr19	10522958	10523826	868	434.0	
85838	chr19	10538204	10539413	1209	604.0	
85839	chr19	10541367	10541918	551	276.0	
85840	chr19	10543168	10545296	2128	1064.0	
85841	chr19	10551484	10554770	3286	1643.0	
85842	chr19	10565024	10569877	4853	2426.0	
85843	chr19	10572028	10572965	937	468.0	
85844	chr19	10580743	10581661	918	459.0	
85845	chr19	10591918	10592246	328	164.0	
85846	chr19	10593706	10594625	919	460.0	
85847	chr19	10595460	10597383	1923	962.0	
85848	chr19	10601904	10605175	3271	1636.0	
85849	chr19	10615360	10616644	1284	642.0	
85850	chr19	10624539	10624993	454	227.0	
85851	chr19	10635460	10636027	567	284.0	
85852	chr19	10638061	10638218	157	78.0	
85853	chr19	10639604	10640338	734	367.0	
85854	chr19	10643532	10645579	2047	1024.0	
85855	chr19	10648257	10648671	414	207.0	
85856	chr19	10651248	10657946	6698	3349.0	
85857	chr19	10658776	10659648	872	436.0	
85858	chr19	10660501	10660534	33	16.0	
85859	chr19	10661697	10663331	1634	817.0	
85860	chr19	10667886	10668305	419	210.0	
85861	chr19	10672494	10672943	449	224.0	
85862	chr19	10690172	10691912	1740	870.0	
85863	chr19	10695243	10696425	1182	591.0	
85864	chr19	10699544	10700190	646	323.0	
85865	chr19	10700844	10702457	1613	806.0	
85866	chr19	10713241	10713613	372	186.0	
85867	chr19	10716911	10720010	3099	1550.0	
85868	chr19	10729388	10730118	730	365.0	
85869	chr19	10730665	10732294	1629	814.0	
85870	chr19	10739142	10739796	654	327.0	
85871	chr19	10742354	10742833	479	240.0	
85872	chr19	10747610	10748020	410	205.0	
85873	chr19	10748908	10749251	343	172.0	
85874	chr19	10750928	10751686	758	379.0	
85875	chr19	10753152	10753249	97	48.0	
85876	chr19	10754726	10755740	1014	507.0	
85877	chr19	10759007	10760757	1750	875.0	
85878	chr19	10762640	10763141	501	250.0	
85879	chr19	10769810	10770444	634	317.0	
85880	chr19	10777235	10777689	454	227.0	
85881	chr19	10780165	10781111	946	473.0	
85882	chr19	10782900	10783207	307	154.0	
85883	chr19	10783951	10784790	839	420.0	
85884	chr19	10787269	10788000	731	366.0	
85885	chr19	10796878	10798442	1564	782.0	
85886	chr19	10799401	10799867	466	233.0	
85887	chr19	10805300	10806107	807	404.0	
85888	chr19	10808958	10810770	1812	906.0	
85889	chr19	10812623	10813976	1353	676.0	
85890	chr19	10814686	10815840	1154	577.0	
85891	chr19	10820190	10820607	417	208.0	
85892	chr19	10829127	10829839	712	356.0	
85893	chr19	10831583	10832043	460	230.0	
85894	chr19	10832626	10833951	1325	662.0	
85895	chr19	10834992	10837201	2209	1104.0	
85896	chr19	10848089	10848868	779	390.0	
85897	chr19	10856122	10856538	416	208.0	
85898	chr19	10858228	10858698	470	235.0	
85899	chr19	10860874	10861631	757	378.0	
85900	chr19	10863393	10865028	1635	818.0	
85901	chr19	10867383	10868406	1023	512.0	
85902	chr19	10870360	10873085	2725	1362.0	
85903	chr19	10876425	10877106	681	340.0	
85904	chr19	10878956	10879623	667	334.0	
85905	chr19	10897167	10897361	194	97.0	
85906	chr19	10927546	10929599	2053	1026.0	
85907	chr19	10936545	10937226	681	340.0	
85908	chr19	10941942	10942487	545	272.0	
85909	chr19	10959944	10962376	2432	1216.0	
85910	chr19	10962899	10964081	1182	591.0	
85911	chr19	10968725	10968842	117	58.0	
85912	chr19	10979888	10980477	589	294.0	
85913	chr19	11035428	11036549	1121	560.0	
85914	chr19	11048748	11049961	1213	606.0	
85915	chr19	11069601	11070037	436	218.0	
85916	chr19	11074194	11075082	888	444.0	
85917	chr19	11084810	11085378	568	284.0	
85918	chr19	11088931	11096871	7940	3970.0	
85919	chr19	11118258	11118378	120	60.0	
85920	chr19	11126016	11126676	660	330.0	
85921	chr19	11130742	11131399	657	328.0	
85922	chr19	11137471	11138895	1424	712.0	
85923	chr19	11143258	11143700	442	221.0	enhancer
85924	chr19	11155216	11156602	1386	693.0	
85925	chr19	11179962	11180346	384	192.0	
85926	chr19	11191307	11191747	440	220.0	
85927	chr19	11195282	11195447	165	82.0	
85928	chr19	11196777	11198253	1476	738.0	
85929	chr19	11203589	11204249	660	330.0	
85930	chr19	11208133	11208620	487	244.0	
85931	chr19	11243186	11243934	748	374.0	
85932	chr19	11261840	11262766	926	463.0	
85933	chr19	11279549	11280541	992	496.0	
85934	chr19	11288360	11288717	357	178.0	
85935	chr19	11292094	11292393	299	150.0	
85936	chr19	11293444	11294391	947	474.0	
85937	chr19	11296158	11297283	1125	562.0	
85938	chr19	11317611	11319975	2364	1182.0	
85939	chr19	11320614	11322731	2117	1058.0	
85940	chr19	11323625	11325157	1532	766.0	
85941	chr19	11337060	11340164	3104	1552.0	
85942	chr19	11344414	11347286	2872	1436.0	
85943	chr19	11354743	11356401	1658	829.0	
85944	chr19	11361573	11361780	207	104.0	
85945	chr19	11373612	11377596	3984	1992.0	
85946	chr19	11378206	11378683	477	238.0	
85947	chr19	11380092	11384608	4516	2258.0	
85948	chr19	11387115	11387617	502	251.0	
85949	chr19	11406261	11407224	963	482.0	
85950	chr19	11418416	11419358	942	471.0	
85951	chr19	11420365	11423092	2727	1364.0	
85952	chr19	11423786	11423892	106	53.0	
85953	chr19	11434533	11436354	1821	910.0	
85954	chr19	11437887	11438423	536	268.0	
85955	chr19	11446669	11447159	490	245.0	
85956	chr19	11460228	11460516	288	144.0	
85957	chr19	11478242	11483362	5120	2560.0	
85958	chr19	11496298	11496935	637	318.0	
85959	chr19	11504603	11506714	2111	1056.0	
85960	chr19	11528413	11529793	1380	690.0	
85961	chr19	11530418	11530850	432	216.0	
85962	chr19	11534420	11536614	2194	1097.0	
85963	chr19	11554252	11554390	138	69.0	
85964	chr19	11558496	11561138	2642	1321.0	
85965	chr19	11564873	11564924	51	26.0	
85966	chr19	11567625	11568841	1216	608.0	
85967	chr19	11577917	11579294	1377	688.0	
85968	chr19	11580906	11582317	1411	706.0	
85969	chr19	11583735	11584430	695	348.0	
85970	chr19	11587377	11588425	1048	524.0	
85971	chr19	11596731	11598296	1565	782.0	
85972	chr19	11624516	11625202	686	343.0	
85973	chr19	11639265	11640399	1134	567.0	
85974	chr19	11673815	11673852	37	18.0	
85975	chr19	11693891	11695515	1624	812.0	
85976	chr19	11700247	11700516	269	134.0	
85977	chr19	11736744	11737204	460	230.0	
85978	chr19	11737855	11739644	1789	894.0	
85979	chr19	11766451	11768182	1731	866.0	
85980	chr19	11797327	11799228	1901	950.0	
85981	chr19	11812100	11812553	453	226.0	
85982	chr19	11813551	11815048	1497	748.0	
85983	chr19	11848196	11849643	1447	724.0	
85984	chr19	11879874	11880268	394	197.0	
85985	chr19	11881088	11881656	568	284.0	
85986	chr19	11887173	11888715	1542	771.0	
85987	chr19	11923368	11926114	2746	1373.0	
85988	chr19	11963684	11965986	2302	1151.0	
85989	chr19	11971049	11971432	383	192.0	
85990	chr19	11984930	11985346	416	208.0	
85991	chr19	11987010	11989315	2305	1152.0	
85992	chr19	12035090	12036366	1276	638.0	
85993	chr19	12052067	12053333	1266	633.0	
85994	chr19	12056314	12056735	421	210.0	
85995	chr19	12059212	12060085	873	436.0	
85996	chr19	12064243	12065498	1255	628.0	
85997	chr19	12090789	12092980	2191	1096.0	
85998	chr19	12137487	12137954	467	234.0	
85999	chr19	12139602	12141769	2167	1084.0	
86000	chr19	12155730	12157107	1377	688.0	
86001	chr19	12159364	12159767	403	202.0	
86002	chr19	12162488	12164221	1733	866.0	
86003	chr19	12194634	12195568	934	467.0	
86004	chr19	12202265	12202695	430	215.0	
86005	chr19	12289011	12289984	973	486.0	
86006	chr19	12293431	12295557	2126	1063.0	
86007	chr19	12331103	12334338	3235	1618.0	
86008	chr19	12346892	12347293	401	200.0	
86009	chr19	12364515	12366245	1730	865.0	
86010	chr19	12399995	12401823	1828	914.0	
86011	chr19	12439850	12441783	1933	966.0	
86012	chr19	12482688	12482808	120	60.0	
86013	chr19	12484090	12485522	1432	716.0	
86014	chr19	12494767	12496102	1335	668.0	
86015	chr19	12550708	12552513	1805	902.0	
86016	chr19	12563949	12564642	693	346.0	
86017	chr19	12574009	12574493	484	242.0	
86018	chr19	12603688	12604264	576	288.0	
86019	chr19	12607570	12608073	503	252.0	
86020	chr19	12610145	12611751	1606	803.0	
86021	chr19	12612570	12614718	2148	1074.0	
86022	chr19	12616069	12616754	685	342.0	
86023	chr19	12620460	12620851	391	196.0	
86024	chr19	12635511	12635952	441	220.0	
86025	chr19	12639727	12640764	1037	518.0	
86026	chr19	12646613	12646767	154	77.0	
86027	chr19	12647404	12648185	781	390.0	
86028	chr19	12657053	12657409	356	178.0	
86029	chr19	12664382	12667389	3007	1504.0	
86030	chr19	12668094	12670502	2408	1204.0	
86031	chr19	12671781	12672608	827	414.0	
86032	chr19	12676074	12677247	1173	586.0	
86033	chr19	12680772	12682511	1739	870.0	
86034	chr19	12695896	12697391	1495	748.0	
86035	chr19	12716830	12717364	534	267.0	
86036	chr19	12720750	12724435	3685	1842.0	
86037	chr19	12730031	12730484	453	226.0	
86038	chr19	12733286	12735423	2137	1068.0	
86039	chr19	12736583	12738081	1498	749.0	
86040	chr19	12757360	12758299	939	470.0	
86041	chr19	12760367	12761158	791	396.0	
86042	chr19	12765759	12766647	888	444.0	
86043	chr19	12769532	12770140	608	304.0	
86044	chr19	12774723	12776211	1488	744.0	
86045	chr19	12777212	12780539	3327	1664.0	
86046	chr19	12781376	12804422	23046	11523.0	
86047	chr19	12805160	12807324	2164	1082.0	
86048	chr19	12825442	12825924	482	241.0	
86049	chr19	12828694	12828757	63	32.0	
86050	chr19	12830518	12830883	365	182.0	
86051	chr19	12832244	12836757	4513	2256.0	
86052	chr19	12837863	12839529	1666	833.0	
86053	chr19	12840400	12841538	1138	569.0	
86054	chr19	12847022	12848209	1187	594.0	
86055	chr19	12867101	12868181	1080	540.0	
86056	chr19	12872344	12873473	1129	564.0	
86057	chr19	12880630	12882434	1804	902.0	
86058	chr19	12883268	12884132	864	432.0	
86059	chr19	12884719	12886412	1693	846.0	
86060	chr19	12890169	12892087	1918	959.0	
86061	chr19	12913550	12914710	1160	580.0	
86062	chr19	12918719	12920312	1593	796.0	
86063	chr19	12932697	12934408	1711	856.0	
86064	chr19	12936689	12943821	7132	3566.0	
86065	chr19	12944400	12946872	2472	1236.0	
86066	chr19	12949759	12950267	508	254.0	
86067	chr19	12952723	12953278	555	278.0	
86068	chr19	12953847	12954891	1044	522.0	
86069	chr19	12955912	12957861	1949	974.0	
86070	chr19	12964723	12965988	1265	632.0	
86071	chr19	12977601	12978478	877	438.0	
86072	chr19	12983176	12986001	2825	1412.0	
86073	chr19	12994694	12996620	1926	963.0	
86074	chr19	12997362	12997433	71	36.0	
86075	chr19	13012688	13014531	1843	922.0	
86076	chr19	13022597	13023697	1100	550.0	
86077	chr19	13024722	13024725	3	2.0	
86078	chr19	13033997	13034508	511	256.0	
86079	chr19	13043954	13045119	1165	582.0	
86080	chr19	13051670	13052080	410	205.0	
86081	chr19	13060524	13061833	1309	654.0	
86082	chr19	13089192	13089593	401	200.0	
86083	chr19	13093492	13101357	7865	3932.0	
86084	chr19	13102205	13105815	3610	1805.0	
86085	chr19	13116112	13119401	3289	1644.0	
86086	chr19	13121933	13122835	902	451.0	
86087	chr19	13132442	13132963	521	260.0	
86088	chr19	13147003	13160997	13994	6997.0	
86089	chr19	13161852	13165889	4037	2018.0	
86090	chr19	13166759	13169146	2387	1194.0	
86091	chr19	13169949	13170407	458	229.0	
86092	chr19	13172017	13173295	1278	639.0	
86093	chr19	13181703	13182547	844	422.0	
86094	chr19	13194354	13195103	749	374.0	
86095	chr19	13195643	13196128	485	242.0	
86096	chr19	13207620	13209585	1965	982.0	"sequence_feature	repeat_region"
86097	chr19	13212634	13213284	650	325.0	
86098	chr19	13215453	13216394	941	470.0	
86099	chr19	13234320	13235042	722	361.0	
86100	chr19	13241745	13241762	17	8.0	
86101	chr19	13261019	13261522	503	252.0	
86102	chr19	13262349	13262818	469	234.0	
86103	chr19	13276973	13278393	1420	710.0	
86104	chr19	13396540	13396967	427	214.0	
86105	chr19	13430966	13431390	424	212.0	
86106	chr19	13441914	13442188	274	137.0	
86107	chr19	13589148	13589695	547	274.0	
86108	chr19	13597588	13598080	492	246.0	
86109	chr19	13672555	13672956	401	200.0	
86110	chr19	13689086	13689494	408	204.0	
86111	chr19	13721475	13721642	167	84.0	
86112	chr19	13729810	13732350	2540	1270.0	
86113	chr19	13747231	13748975	1744	872.0	
86114	chr19	13763995	13765967	1972	986.0	
86115	chr19	13773980	13775459	1479	740.0	
86116	chr19	13784854	13785601	747	374.0	
86117	chr19	13787408	13790957	3549	1774.0	
86118	chr19	13794190	13797408	3218	1609.0	
86119	chr19	13804854	13805071	217	108.0	
86120	chr19	13817287	13818490	1203	602.0	
86121	chr19	13823787	13823837	50	25.0	
86122	chr19	13825182	13851903	26721	13360.0	
86123	chr19	13859631	13859891	260	130.0	
86124	chr19	13860938	13866501	5563	2782.0	
86125	chr19	13872361	13873479	1118	559.0	
86126	chr19	13879122	13883061	3939	1970.0	
86127	chr19	13885902	13888048	2146	1073.0	
86128	chr19	13903097	13903599	502	251.0	
86129	chr19	13905532	13906998	1466	733.0	
86130	chr19	13921057	13921903	846	423.0	
86131	chr19	13951591	13953602	2011	1006.0	
86132	chr19	13959867	13960334	467	234.0	
86133	chr19	13973994	13974493	499	250.0	
86134	chr19	13978069	13979693	1624	812.0	
86135	chr19	13983112	13988027	4915	2458.0	
86136	chr19	13993539	13993825	286	143.0	
86137	chr19	14001014	14001409	395	198.0	
86138	chr19	14002208	14007537	5329	2664.0	
86139	chr19	14008311	14008674	363	182.0	
86140	chr19	14015430	14016009	579	290.0	
86141	chr19	14017707	14018226	519	260.0	
86142	chr19	14019023	14019552	529	264.0	
86143	chr19	14023456	14024008	552	276.0	
86144	chr19	14025544	14026626	1082	541.0	
86145	chr19	14030433	14033072	2639	1320.0	
86146	chr19	14041449	14041794	345	172.0	
86147	chr19	14042628	14043466	838	419.0	
86148	chr19	14047375	14047377	2	1.0	
86149	chr19	14048283	14049152	869	434.0	
86150	chr19	14057234	14058049	815	408.0	
86151	chr19	14058692	14059357	665	332.0	
86152	chr19	14071790	14075702	3912	1956.0	
86153	chr19	14076793	14076803	10	5.0	
86154	chr19	14078361	14078873	512	256.0	
86155	chr19	14080163	14082393	2230	1115.0	
86156	chr19	14089250	14092559	3309	1654.0	
86157	chr19	14112496	14113295	799	400.0	
86158	chr19	14113832	14115407	1575	788.0	
86159	chr19	14116495	14120174	3679	1840.0	
86160	chr19	14127070	14128697	1627	814.0	
86161	chr19	14135851	14138091	2240	1120.0	
86162	chr19	14139867	14140403	536	268.0	
86163	chr19	14147983	14150742	2759	1380.0	
86164	chr19	14165808	14168398	2590	1295.0	
86165	chr19	14195795	14196640	845	422.0	
86166	chr19	14200113	14200651	538	269.0	
86167	chr19	14203024	14203684	660	330.0	
86168	chr19	14204891	14208114	3223	1612.0	
86169	chr19	14209434	14209781	347	174.0	
86170	chr19	14216830	14218267	1437	718.0	
86171	chr19	14219645	14219947	302	151.0	
86172	chr19	14221261	14221920	659	330.0	
86173	chr19	14237475	14238073	598	299.0	
86174	chr19	14248516	14249810	1294	647.0	
86175	chr19	14274461	14275430	969	484.0	
86176	chr19	14283622	14284186	564	282.0	
86177	chr19	14288713	14289219	506	253.0	
86178	chr19	14293391	14293850	459	230.0	
86179	chr19	14295029	14295356	327	164.0	
86180	chr19	14309422	14310427	1005	502.0	
86181	chr19	14318934	14319231	297	148.0	
86182	chr19	14333566	14334894	1328	664.0	
86183	chr19	14337442	14337905	463	232.0	
86184	chr19	14348201	14349761	1560	780.0	
86185	chr19	14353197	14354783	1586	793.0	
86186	chr19	14355406	14356769	1363	682.0	
86187	chr19	14361626	14362436	810	405.0	
86188	chr19	14362958	14364855	1897	948.0	
86189	chr19	14366269	14373549	7280	3640.0	
86190	chr19	14374306	14376901	2595	1298.0	
86191	chr19	14377851	14378411	560	280.0	
86192	chr19	14379640	14420235	40595	20298.0	
86193	chr19	14423786	14423822	36	18.0	
86194	chr19	14431631	14435617	3986	1993.0	
86195	chr19	14438232	14438570	338	169.0	
86196	chr19	14439776	14440838	1062	531.0	
86197	chr19	14441677	14441796	119	60.0	
86198	chr19	14450284	14450961	677	338.0	
86199	chr19	14459385	14460242	857	428.0	
86200	chr19	14462574	14462735	161	80.0	
86201	chr19	14471875	14477455	5580	2790.0	
86202	chr19	14479626	14480766	1140	570.0	
86203	chr19	14486148	14486845	697	348.0	
86204	chr19	14494716	14498059	3343	1672.0	
86205	chr19	14502431	14502856	425	212.0	
86206	chr19	14505165	14519299	14134	7067.0	
86207	chr19	14519910	14520378	468	234.0	
86208	chr19	14521716	14523756	2040	1020.0	
86209	chr19	14528511	14530823	2312	1156.0	
86210	chr19	14532358	14532473	115	58.0	
86211	chr19	14536774	14537645	871	436.0	
86212	chr19	14551134	14551983	849	424.0	
86213	chr19	14555906	14557198	1292	646.0	
86214	chr19	14561460	14562414	954	477.0	
86215	chr19	14564187	14565115	928	464.0	
86216	chr19	14566337	14567261	924	462.0	
86217	chr19	14571354	14572646	1292	646.0	
86218	chr19	14574087	14574870	783	392.0	
86219	chr19	14577459	14578234	775	388.0	
86220	chr19	14582762	14583366	604	302.0	
86221	chr19	14585256	14585449	193	96.0	
86222	chr19	14591401	14591708	307	154.0	
86223	chr19	14603925	14604469	544	272.0	
86224	chr19	14605411	14605642	231	116.0	
86225	chr19	14613432	14614813	1381	690.0	
86226	chr19	14616358	14616963	605	302.0	
86227	chr19	14632237	14632737	500	250.0	
86228	chr19	14655802	14656065	263	132.0	
86229	chr19	14661223	14662007	784	392.0	
86230	chr19	14668027	14668590	563	282.0	
86231	chr19	14671985	14673117	1132	566.0	
86232	chr19	14674031	14675362	1331	666.0	
86233	chr19	14676069	14677167	1098	549.0	
86234	chr19	14683245	14683959	714	357.0	
86235	chr19	14686413	14686859	446	223.0	
86236	chr19	14689158	14690696	1538	769.0	
86237	chr19	14763892	14764056	164	82.0	
86238	chr19	14766549	14766880	331	166.0	
86239	chr19	14775691	14777381	1690	845.0	
86240	chr19	14783585	14783958	373	186.0	
86241	chr19	14784585	14787630	3045	1522.0	
86242	chr19	14795303	14795699	396	198.0	
86243	chr19	14822105	14822144	39	20.0	
86244	chr19	14888421	14889243	822	411.0	
86245	chr19	14943446	14944073	627	314.0	
86246	chr19	15091771	15092542	771	386.0	
86247	chr19	15101471	15101884	413	206.0	
86248	chr19	15107610	15107882	272	136.0	
86249	chr19	15124428	15126263	1835	918.0	
86250	chr19	15129851	15130316	465	232.0	
86251	chr19	15150350	15150848	498	249.0	
86252	chr19	15153966	15154393	427	214.0	
86253	chr19	15177191	15178116	925	462.0	
86254	chr19	15187604	15187617	13	6.0	
86255	chr19	15195268	15195887	619	310.0	
86256	chr19	15197223	15198025	802	401.0	
86257	chr19	15200308	15200472	164	82.0	
86258	chr19	15200978	15201146	168	84.0	
86259	chr19	15210062	15210965	903	452.0	
86260	chr19	15222828	15224275	1447	724.0	
86261	chr19	15231237	15234151	2914	1457.0	
86262	chr19	15238411	15238413	2	1.0	
86263	chr19	15252458	15252763	305	152.0	
86264	chr19	15263987	15265212	1225	612.0	
86265	chr19	15279549	15279984	435	218.0	
86266	chr19	15280784	15281476	692	346.0	
86267	chr19	15286010	15287082	1072	536.0	
86268	chr19	15287632	15287845	213	106.0	
86269	chr19	15288454	15289118	664	332.0	
86270	chr19	15289724	15290068	344	172.0	
86271	chr19	15292826	15293666	840	420.0	
86272	chr19	15296703	15299587	2884	1442.0	
86273	chr19	15302145	15302544	399	200.0	
86274	chr19	15303783	15304214	431	216.0	
86275	chr19	15309933	15310334	401	200.0	
86276	chr19	15311761	15312111	350	175.0	
86277	chr19	15316378	15318991	2613	1306.0	
86278	chr19	15321685	15322420	735	368.0	
86279	chr19	15323166	15324302	1136	568.0	
86280	chr19	15324816	15325315	499	250.0	
86281	chr19	15326583	15327318	735	368.0	
86282	chr19	15330699	15334486	3787	1894.0	
86283	chr19	15348853	15349416	563	282.0	
86284	chr19	15360002	15360450	448	224.0	
86285	chr19	15377727	15380925	3198	1599.0	
86286	chr19	15417481	15419810	2329	1164.0	
86287	chr19	15431922	15433788	1866	933.0	
86288	chr19	15449016	15452766	3750	1875.0	
86289	chr19	15463451	15465349	1898	949.0	
86290	chr19	15466698	15467695	997	498.0	
86291	chr19	15468983	15470364	1381	690.0	
86292	chr19	15479586	15480016	430	215.0	
86293	chr19	15508261	15508951	690	345.0	
86294	chr19	15514457	15515418	961	480.0	
86295	chr19	15532884	15533687	803	402.0	
86296	chr19	15550784	15552103	1319	660.0	
86297	chr19	15555077	15557061	1984	992.0	
86298	chr19	15584539	15585143	604	302.0	
86299	chr19	15587553	15588449	896	448.0	
86300	chr19	15629196	15629780	584	292.0	
86301	chr19	15631735	15632178	443	222.0	
86302	chr19	15633052	15633550	498	249.0	
86303	chr19	15640544	15640967	423	212.0	
86304	chr19	15641901	15642386	485	242.0	
86305	chr19	15666889	15667292	403	202.0	
86306	chr19	15702554	15703015	461	230.0	
86307	chr19	15812040	15812496	456	228.0	
86308	chr19	15820656	15821132	476	238.0	
86309	chr19	15835741	15837915	2174	1087.0	
86310	chr19	15843434	15845012	1578	789.0	
86311	chr19	15868973	15869475	502	251.0	
86312	chr19	15871597	15871916	319	160.0	
86313	chr19	15986770	15987094	324	162.0	
86314	chr19	16001560	16002972	1412	706.0	
86315	chr19	16025644	16026063	419	210.0	
86316	chr19	16041272	16042136	864	432.0	
86317	chr19	16051382	16052021	639	320.0	
86318	chr19	16061972	16063482	1510	755.0	
86319	chr19	16066485	16067030	545	272.0	
86320	chr19	16069840	16071449	1609	804.0	
86321	chr19	16073838	16074610	772	386.0	
86322	chr19	16075315	16080754	5439	2720.0	
86323	chr19	16083189	16083862	673	336.0	
86324	chr19	16085914	16087119	1205	602.0	
86325	chr19	16092459	16092472	13	6.0	
86326	chr19	16094986	16095472	486	243.0	
86327	chr19	16104700	16105287	587	294.0	
86328	chr19	16106120	16106603	483	242.0	
86329	chr19	16110679	16113208	2529	1264.0	
86330	chr19	16117734	16120138	2404	1202.0	
86331	chr19	16135377	16135763	386	193.0	
86332	chr19	16136542	16137102	560	280.0	
86333	chr19	16139364	16140265	901	450.0	
86334	chr19	16140960	16146607	5647	2824.0	
86335	chr19	16148732	16150248	1516	758.0	
86336	chr19	16153974	16153986	12	6.0	
86337	chr19	16158862	16159376	514	257.0	
86338	chr19	16168361	16169212	851	426.0	
86339	chr19	16182315	16183327	1012	506.0	
86340	chr19	16184782	16186355	1573	786.0	
86341	chr19	16197185	16198706	1521	760.0	
86342	chr19	16199953	16200454	501	250.0	
86343	chr19	16216677	16217522	845	422.0	
86344	chr19	16218601	16219151	550	275.0	
86345	chr19	16236802	16237258	456	228.0	
86346	chr19	16238347	16238950	603	302.0	
86347	chr19	16247273	16248267	994	497.0	
86348	chr19	16252489	16253136	647	324.0	
86349	chr19	16254072	16254320	248	124.0	
86350	chr19	16256578	16257482	904	452.0	
86351	chr19	16258379	16260432	2053	1026.0	
86352	chr19	16262027	16263921	1894	947.0	
86353	chr19	16266372	16267198	826	413.0	
86354	chr19	16268677	16269076	399	200.0	
86355	chr19	16279043	16279691	648	324.0	
86356	chr19	16283062	16286543	3481	1740.0	
86357	chr19	16293485	16293978	493	246.0	
86358	chr19	16305042	16305320	278	139.0	
86359	chr19	16312987	16313447	460	230.0	
86360	chr19	16315643	16316975	1332	666.0	
86361	chr19	16319445	16320134	689	344.0	
86362	chr19	16321872	16336129	14257	7128.0	
86363	chr19	16336824	16339683	2859	1430.0	
86364	chr19	16341742	16343719	1977	988.0	
86365	chr19	16351429	16351795	366	183.0	
86366	chr19	16352410	16352492	82	41.0	
86367	chr19	16355138	16355749	611	306.0	
86368	chr19	16359114	16359465	351	176.0	
86369	chr19	16365499	16372975	7476	3738.0	
86370	chr19	16374021	16374760	739	370.0	
86371	chr19	16376580	16377081	501	250.0	
86372	chr19	16382347	16384063	1716	858.0	
86373	chr19	16386412	16387069	657	328.0	
86374	chr19	16399202	16399951	749	374.0	
86375	chr19	16416898	16418312	1414	707.0	
86376	chr19	16420166	16420202	36	18.0	
86377	chr19	16429283	16429318	35	18.0	
86378	chr19	16435486	16435966	480	240.0	
86379	chr19	16441623	16442004	381	190.0	
86380	chr19	16443680	16444530	850	425.0	
86381	chr19	16445060	16447442	2382	1191.0	
86382	chr19	16449228	16450533	1305	652.0	
86383	chr19	16457041	16458019	978	489.0	
86384	chr19	16471013	16472887	1874	937.0	
86385	chr19	16495630	16497016	1386	693.0	
86386	chr19	16528090	16528504	414	207.0	
86387	chr19	16541637	16543531	1894	947.0	
86388	chr19	16565887	16566879	992	496.0	
86389	chr19	16570984	16574202	3218	1609.0	
86390	chr19	16576047	16576200	153	76.0	
86391	chr19	16576769	16577266	497	248.0	
86392	chr19	16581265	16581608	343	172.0	
86393	chr19	16583521	16589323	5802	2901.0	
86394	chr19	16590019	16590358	339	170.0	
86395	chr19	16593896	16595844	1948	974.0	
86396	chr19	16599709	16600461	752	376.0	
86397	chr19	16605419	16605843	424	212.0	
86398	chr19	16607961	16608675	714	357.0	
86399	chr19	16612249	16613024	775	388.0	
86400	chr19	16614984	16617381	2397	1198.0	
86401	chr19	16619564	16619778	214	107.0	
86402	chr19	16626668	16629704	3036	1518.0	
86403	chr19	16654176	16654489	313	156.0	
86404	chr19	16659334	16662683	3349	1674.0	
86405	chr19	16664042	16664089	47	24.0	
86406	chr19	16667114	16667522	408	204.0	
86407	chr19	16677079	16677464	385	192.0	
86408	chr19	16712345	16712597	252	126.0	
86409	chr19	16714696	16715149	453	226.0	
86410	chr19	16719002	16719989	987	494.0	
86411	chr19	16762079	16762393	314	157.0	
86412	chr19	16771493	16771991	498	249.0	
86413	chr19	16778739	16779279	540	270.0	
86414	chr19	16788519	16788750	231	116.0	
86415	chr19	16802247	16802818	571	286.0	
86416	chr19	16825218	16825591	373	186.0	
86417	chr19	16828629	16830121	1492	746.0	
86418	chr19	16833930	16834271	341	170.0	
86419	chr19	16836026	16836669	643	322.0	
86420	chr19	16847465	16847933	468	234.0	
86421	chr19	16863128	16863407	279	140.0	
86422	chr19	16888558	16889170	612	306.0	
86423	chr19	16893549	16893947	398	199.0	
86424	chr19	16895884	16898190	2306	1153.0	
86425	chr19	16899468	16900337	869	434.0	
86426	chr19	16954096	16955433	1337	668.0	
86427	chr19	16958928	16959403	475	238.0	
86428	chr19	16969082	16969594	512	256.0	
86429	chr19	17001271	17002759	1488	744.0	
86430	chr19	17009550	17010013	463	232.0	
86431	chr19	17020880	17021257	377	188.0	
86432	chr19	17021760	17022739	979	490.0	
86433	chr19	17025919	17026794	875	438.0	
86434	chr19	17035952	17036640	688	344.0	
86435	chr19	17052478	17052839	361	180.0	
86436	chr19	17064891	17065491	600	300.0	
86437	chr19	17066981	17067900	919	460.0	
86438	chr19	17074093	17077283	3190	1595.0	
86439	chr19	17078007	17078641	634	317.0	
86440	chr19	17079164	17080585	1421	710.0	
86441	chr19	17089749	17092447	2698	1349.0	
86442	chr19	17095598	17095758	160	80.0	
86443	chr19	17103176	17103526	350	175.0	
86444	chr19	17105518	17106040	522	261.0	
86445	chr19	17107502	17108658	1156	578.0	
86446	chr19	17109570	17110860	1290	645.0	
86447	chr19	17112613	17113848	1235	618.0	
86448	chr19	17124825	17126905	2080	1040.0	
86449	chr19	17133325	17133700	375	188.0	
86450	chr19	17135182	17136062	880	440.0	
86451	chr19	17138352	17139033	681	340.0	
86452	chr19	17156866	17157633	767	384.0	
86453	chr19	17160886	17161367	481	240.0	
86454	chr19	17170714	17171090	376	188.0	
86455	chr19	17183145	17185038	1893	946.0	
86456	chr19	17202187	17202583	396	198.0	
86457	chr19	17205085	17206190	1105	552.0	
86458	chr19	17209323	17210290	967	484.0	
86459	chr19	17212924	17213904	980	490.0	
86460	chr19	17214560	17216479	1919	960.0	
86461	chr19	17220096	17221036	940	470.0	
86462	chr19	17224148	17224307	159	80.0	
86463	chr19	17225485	17228085	2600	1300.0	
86464	chr19	17234606	17236674	2068	1034.0	
86465	chr19	17242981	17243613	632	316.0	
86466	chr19	17244712	17247294	2582	1291.0	
86467	chr19	17260543	17261469	926	463.0	
86468	chr19	17266444	17268046	1602	801.0	
86469	chr19	17281275	17283253	1978	989.0	
86470	chr19	17289482	17289972	490	245.0	
86471	chr19	17291950	17293382	1432	716.0	
86472	chr19	17293952	17294432	480	240.0	
86473	chr19	17302381	17304079	1698	849.0	
86474	chr19	17304665	17306635	1970	985.0	
86475	chr19	17308892	17310572	1680	840.0	
86476	chr19	17317285	17317847	562	281.0	
86477	chr19	17323695	17324349	654	327.0	
86478	chr19	17327379	17329478	2099	1050.0	
86479	chr19	17332459	17333074	615	308.0	
86480	chr19	17333663	17335439	1776	888.0	
86481	chr19	17336408	17338360	1952	976.0	
86482	chr19	17345952	17346649	697	348.0	
86483	chr19	17369863	17370696	833	416.0	
86484	chr19	17379190	17379566	376	188.0	
86485	chr19	17382593	17383255	662	331.0	
86486	chr19	17385759	17386476	717	358.0	
86487	chr19	17390235	17392303	2068	1034.0	
86488	chr19	17394874	17395628	754	377.0	
86489	chr19	17402997	17407853	4856	2428.0	
86490	chr19	17419270	17421070	1800	900.0	
86491	chr19	17424858	17425375	517	258.0	
86492	chr19	17441142	17441755	613	306.0	
86493	chr19	17447898	17449062	1164	582.0	
86494	chr19	17453333	17453886	553	276.0	
86495	chr19	17465972	17466698	726	363.0	
86496	chr19	17467870	17467952	82	41.0	
86497	chr19	17468766	17471625	2859	1430.0	
86498	chr19	17472349	17473539	1190	595.0	
86499	chr19	17475616	17476298	682	341.0	
86500	chr19	17480864	17481856	992	496.0	
86501	chr19	17488317	17490864	2547	1274.0	
86502	chr19	17496011	17496921	910	455.0	
86503	chr19	17499549	17500356	807	404.0	
86504	chr19	17507884	17508202	318	159.0	
86505	chr19	17510746	17512981	2235	1118.0	
86506	chr19	17522846	17524008	1162	581.0	
86507	chr19	17526915	17527467	552	276.0	
86508	chr19	17538730	17541365	2635	1318.0	
86509	chr19	17554938	17556768	1830	915.0	
86510	chr19	17557400	17557948	548	274.0	
86511	chr19	17559905	17560728	823	412.0	
86512	chr19	17561264	17561721	457	228.0	
86513	chr19	17573894	17574597	703	352.0	
86514	chr19	17576750	17576981	231	116.0	
86515	chr19	17579612	17580393	781	390.0	
86516	chr19	17603325	17603495	170	85.0	
86517	chr19	17605502	17607068	1566	783.0	
86518	chr19	17610365	17610819	454	227.0	
86519	chr19	17617195	17617222	27	14.0	
86520	chr19	17622307	17622780	473	236.0	
86521	chr19	17671874	17672275	401	200.0	
86522	chr19	17679979	17680732	753	376.0	
86523	chr19	17681539	17681940	401	200.0	
86524	chr19	17686855	17686961	106	53.0	
86525	chr19	17688066	17688792	726	363.0	
86526	chr19	17703681	17704316	635	318.0	
86527	chr19	17717120	17717925	805	402.0	
86528	chr19	17718849	17722368	3519	1760.0	
86529	chr19	17725747	17726100	353	176.0	
86530	chr19	17739163	17739641	478	239.0	
86531	chr19	17743853	17744425	572	286.0	
86532	chr19	17747086	17748679	1593	796.0	
86533	chr19	17749817	17752312	2495	1248.0	
86534	chr19	17753140	17753152	12	6.0	
86535	chr19	17754548	17756349	1801	900.0	
86536	chr19	17762418	17762934	516	258.0	
86537	chr19	17764997	17765752	755	378.0	
86538	chr19	17766531	17767050	519	260.0	
86539	chr19	17775312	17775738	426	213.0	
86540	chr19	17776253	17777053	800	400.0	
86541	chr19	17777957	17780272	2315	1158.0	
86542	chr19	17784116	17784969	853	426.0	
86543	chr19	17791654	17791739	85	42.0	
86544	chr19	17794539	17795376	837	418.0	
86545	chr19	17803166	17803874	708	354.0	
86546	chr19	17808114	17808251	137	68.0	
86547	chr19	17827671	17828081	410	205.0	
86548	chr19	17830644	17831416	772	386.0	
86549	chr19	17834585	17834647	62	31.0	
86550	chr19	17841992	17842446	454	227.0	
86551	chr19	17845960	17849144	3184	1592.0	
86552	chr19	17849982	17851266	1284	642.0	
86553	chr19	17855188	17856073	885	442.0	
86554	chr19	17859034	17861014	1980	990.0	
86555	chr19	17861889	17864637	2748	1374.0	
86556	chr19	17865400	17866533	1133	566.0	
86557	chr19	17870273	17870599	326	163.0	
86558	chr19	17871621	17874737	3116	1558.0	
86559	chr19	17884755	17884757	2	1.0	
86560	chr19	17932015	17933777	1762	881.0	
86561	chr19	17938009	17938866	857	428.0	
86562	chr19	17946047	17953246	7199	3600.0	
86563	chr19	17966876	17967301	425	212.0	
86564	chr19	17969962	17970343	381	190.0	
86565	chr19	17979553	17979848	295	148.0	
86566	chr19	17996555	17999110	2555	1278.0	
86567	chr19	17999708	18003685	3977	1988.0	
86568	chr19	18006486	18010914	4428	2214.0	
86569	chr19	18013428	18014789	1361	680.0	
86570	chr19	18016340	18016553	213	106.0	
86571	chr19	18017117	18017934	817	408.0	
86572	chr19	18021033	18022924	1891	946.0	
86573	chr19	18023443	18024592	1149	574.0	
86574	chr19	18031282	18031842	560	280.0	
86575	chr19	18034961	18035499	538	269.0	
86576	chr19	18044621	18045849	1228	614.0	
86577	chr19	18049406	18049676	270	135.0	
86578	chr19	18057995	18059109	1114	557.0	
86579	chr19	18063343	18063785	442	221.0	
86580	chr19	18086483	18087692	1209	604.0	
86581	chr19	18088342	18092130	3788	1894.0	
86582	chr19	18093413	18093909	496	248.0	
86583	chr19	18096753	18099985	3232	1616.0	
86584	chr19	18103848	18105100	1252	626.0	
86585	chr19	18107518	18110946	3428	1714.0	
86586	chr19	18112702	18113572	870	435.0	
86587	chr19	18117224	18120502	3278	1639.0	
86588	chr19	18126061	18126502	441	220.0	
86589	chr19	18127958	18128577	619	310.0	
86590	chr19	18137729	18137995	266	133.0	
86591	chr19	18148746	18150003	1257	628.0	
86592	chr19	18151434	18154532	3098	1549.0	
86593	chr19	18156925	18157560	635	318.0	
86594	chr19	18160755	18162104	1349	674.0	
86595	chr19	18167916	18174862	6946	3473.0	
86596	chr19	18175558	18175739	181	90.0	
86597	chr19	18176831	18177268	437	218.0	
86598	chr19	18178630	18178778	148	74.0	
86599	chr19	18179404	18181970	2566	1283.0	
86600	chr19	18182534	18183466	932	466.0	
86601	chr19	18184093	18187584	3491	1746.0	
86602	chr19	18191467	18195335	3868	1934.0	
86603	chr19	18202657	18205577	2920	1460.0	
86604	chr19	18208116	18208780	664	332.0	
86605	chr19	18220808	18221261	453	226.0	
86606	chr19	18223733	18226563	2830	1415.0	
86607	chr19	18231123	18231673	550	275.0	
86608	chr19	18232771	18233924	1153	576.0	
86609	chr19	18239367	18239722	355	178.0	
86610	chr19	18240773	18240966	193	96.0	
86611	chr19	18242842	18242848	6	3.0	
86612	chr19	18244187	18244543	356	178.0	
86613	chr19	18245215	18287204	41989	20994.0	
86614	chr19	18287801	18288302	501	250.0	
86615	chr19	18288859	18295417	6558	3279.0	
86616	chr19	18300992	18301468	476	238.0	
86617	chr19	18303056	18308243	5187	2594.0	
86618	chr19	18315953	18316319	366	183.0	
86619	chr19	18317103	18319978	2875	1438.0	
86620	chr19	18320840	18324101	3261	1630.0	
86621	chr19	18328037	18329216	1179	590.0	
86622	chr19	18337150	18337693	543	272.0	
86623	chr19	18339672	18341822	2150	1075.0	
86624	chr19	18349533	18349921	388	194.0	
86625	chr19	18364830	18365477	647	324.0	
86626	chr19	18365980	18366523	543	272.0	
86627	chr19	18373818	18374983	1165	582.0	
86628	chr19	18379903	18380825	922	461.0	
86629	chr19	18386014	18386451	437	218.0	
86630	chr19	18387750	18389158	1408	704.0	
86631	chr19	18392165	18394323	2158	1079.0	
86632	chr19	18397053	18398195	1142	571.0	
86633	chr19	18401453	18403168	1715	858.0	
86634	chr19	18407877	18408624	747	374.0	
86635	chr19	18410347	18411231	884	442.0	
86636	chr19	18414249	18423522	9273	4636.0	
86637	chr19	18425157	18430493	5336	2668.0	
86638	chr19	18431951	18442654	10703	5352.0	
86639	chr19	18450655	18452048	1393	696.0	
86640	chr19	18461486	18462486	1000	500.0	
86641	chr19	18463097	18463448	351	176.0	
86642	chr19	18466938	18467421	483	242.0	
86643	chr19	18468665	18468822	157	78.0	
86644	chr19	18469335	18470709	1374	687.0	
86645	chr19	18473993	18480687	6694	3347.0	
86646	chr19	18483327	18484025	698	349.0	
86647	chr19	18484946	18487144	2198	1099.0	
86648	chr19	18487942	18489152	1210	605.0	
86649	chr19	18490573	18491219	646	323.0	
86650	chr19	18493468	18497389	3921	1960.0	
86651	chr19	18498285	18499549	1264	632.0	
86652	chr19	18500237	18510618	10381	5190.0	
86653	chr19	18512976	18513493	517	258.0	
86654	chr19	18514377	18516934	2557	1278.0	
86655	chr19	18517910	18518298	388	194.0	
86656	chr19	18519018	18523258	4240	2120.0	
86657	chr19	18524197	18524199	2	1.0	
86658	chr19	18525902	18526361	459	230.0	
86659	chr19	18542533	18544834	2301	1150.0	
86660	chr19	18557125	18559866	2741	1370.0	
86661	chr19	18570947	18573250	2303	1152.0	
86662	chr19	18586264	18586720	456	228.0	
86663	chr19	18587789	18590864	3075	1538.0	
86664	chr19	18593712	18595072	1360	680.0	
86665	chr19	18596616	18597202	586	293.0	
86666	chr19	18603315	18604031	716	358.0	
86667	chr19	18605455	18605851	396	198.0	
86668	chr19	18606593	18607926	1333	666.0	
86669	chr19	18610479	18613759	3280	1640.0	
86670	chr19	18635734	18638745	3011	1506.0	
86671	chr19	18644288	18645046	758	379.0	
86672	chr19	18649180	18650180	1000	500.0	
86673	chr19	18659061	18659733	672	336.0	
86674	chr19	18664182	18664273	91	46.0	
86675	chr19	18677783	18678519	736	368.0	
86676	chr19	18682884	18684485	1601	800.0	
86677	chr19	18699716	18701774	2058	1029.0	
86678	chr19	18782241	18782957	716	358.0	
86679	chr19	18784993	18786664	1671	836.0	
86680	chr19	18787565	18791333	3768	1884.0	
86681	chr19	18809438	18809879	441	220.0	
86682	chr19	18831235	18834484	3249	1624.0	
86683	chr19	18842908	18844301	1393	696.0	
86684	chr19	18846762	18847661	899	450.0	
86685	chr19	18848507	18849519	1012	506.0	
86686	chr19	18861186	18861691	505	252.0	
86687	chr19	18863818	18864221	403	202.0	
86688	chr19	18866093	18867124	1031	516.0	
86689	chr19	18870317	18871168	851	426.0	
86690	chr19	18879416	18880429	1013	506.0	
86691	chr19	18894934	18896412	1478	739.0	
86692	chr19	18897223	18897608	385	192.0	
86693	chr19	18898362	18898385	23	12.0	
86694	chr19	18915612	18916102	490	245.0	
86695	chr19	18918437	18920297	1860	930.0	
86696	chr19	18931917	18933109	1192	596.0	
86697	chr19	18939916	18941881	1965	982.0	
86698	chr19	18967258	18968223	965	482.0	
86699	chr19	18969147	18969998	851	426.0	
86700	chr19	18972210	18973094	884	442.0	
86701	chr19	18975006	18975393	387	194.0	
86702	chr19	18985165	18985706	541	270.0	
86703	chr19	18986494	18987207	713	356.0	
86704	chr19	18995701	18996192	491	246.0	
86705	chr19	19010488	19010996	508	254.0	
86706	chr19	19026750	19026867	117	58.0	
86707	chr19	19031909	19034837	2928	1464.0	
86708	chr19	19039722	19040452	730	365.0	
86709	chr19	19053568	19054338	770	385.0	
86710	chr19	19062985	19065703	2718	1359.0	
86711	chr19	19068902	19069539	637	318.0	
86712	chr19	19110279	19110767	488	244.0	
86713	chr19	19115954	19116386	432	216.0	
86714	chr19	19134531	19135168	637	318.0	
86715	chr19	19137716	19140376	2660	1330.0	
86716	chr19	19145754	19146767	1013	506.0	
86717	chr19	19160352	19160957	605	302.0	
86718	chr19	19169810	19170949	1139	570.0	
86719	chr19	19174783	19175509	726	363.0	
86720	chr19	19185843	19186865	1022	511.0	
86721	chr19	19191477	19193568	2091	1046.0	
86722	chr19	19202511	19204111	1600	800.0	
86723	chr19	19224779	19225744	965	482.0	
86724	chr19	19261256	19261715	459	230.0	
86725	chr19	19319743	19322236	2493	1246.0	
86726	chr19	19329039	19329678	639	320.0	
86727	chr19	19360783	19361822	1039	520.0	
86728	chr19	19364499	19365565	1066	533.0	
86729	chr19	19366530	19367461	931	466.0	
86730	chr19	19372663	19373732	1069	534.0	
86731	chr19	19376109	19376438	329	164.0	
86732	chr19	19377695	19378193	498	249.0	
86733	chr19	19381243	19381592	349	174.0	
86734	chr19	19384859	19387538	2679	1340.0	
86735	chr19	19388463	19389833	1370	685.0	
86736	chr19	19391928	19392325	397	198.0	
86737	chr19	19394568	19395431	863	432.0	
86738	chr19	19402973	19403838	865	432.0	
86739	chr19	19404843	19407956	3113	1556.0	
86740	chr19	19409242	19411831	2589	1294.0	
86741	chr19	19418070	19421846	3776	1888.0	
86742	chr19	19427021	19427051	30	15.0	
86743	chr19	19427903	19428647	744	372.0	
86744	chr19	19443966	19446506	2540	1270.0	
86745	chr19	19447233	19448167	934	467.0	
86746	chr19	19451178	19453211	2033	1016.0	
86747	chr19	19457727	19462805	5078	2539.0	
86748	chr19	19463730	19464185	455	228.0	
86749	chr19	19470544	19471044	500	250.0	
86750	chr19	19474077	19474768	691	346.0	
86751	chr19	19475849	19476545	696	348.0	
86752	chr19	19485149	19485915	766	383.0	
86753	chr19	19486734	19486745	11	6.0	
86754	chr19	19487692	19488087	395	198.0	
86755	chr19	19488661	19491175	2514	1257.0	
86756	chr19	19508162	19508422	260	130.0	
86757	chr19	19510194	19510558	364	182.0	
86758	chr19	19514412	19514743	331	166.0	
86759	chr19	19515384	19516963	1579	790.0	
86760	chr19	19531922	19533021	1099	550.0	
86761	chr19	19537116	19541803	4687	2344.0	
86762	chr19	19542407	19542969	562	281.0	
86763	chr19	19552739	19553127	388	194.0	
86764	chr19	19554281	19554813	532	266.0	
86765	chr19	19562987	19563474	487	244.0	
86766	chr19	19589632	19591930	2298	1149.0	
86767	chr19	19595006	19595829	823	412.0	
86768	chr19	19597297	19599639	2342	1171.0	
86769	chr19	19600880	19601415	535	268.0	
86770	chr19	19601990	19603432	1442	721.0	
86771	chr19	19605825	19606642	817	408.0	
86772	chr19	19614889	19616040	1151	576.0	
86773	chr19	19617772	19620025	2253	1126.0	
86774	chr19	19623939	19624147	208	104.0	
86775	chr19	19627258	19630363	3105	1552.0	
86776	chr19	19635030	19635131	101	50.0	
86777	chr19	19641713	19644482	2769	1384.0	
86778	chr19	19661382	19664778	3396	1698.0	enhancer
86779	chr19	19667537	19670325	2788	1394.0	
86780	chr19	19689674	19690204	530	265.0	
86781	chr19	19732301	19733873	1572	786.0	
86782	chr19	19775753	19777280	1527	764.0	
86783	chr19	19817078	19818059	981	490.0	
86784	chr19	19820749	19822503	1754	877.0	
86785	chr19	19860673	19861544	871	436.0	
86786	chr19	19865270	19867635	2365	1182.0	
86787	chr19	19900124	19902113	1989	994.0	
86788	chr19	19930476	19930538	62	31.0	
86789	chr19	19958963	19959609	646	323.0	
86790	chr19	19997709	19998043	334	167.0	
86791	chr19	20038581	20039879	1298	649.0	
86792	chr19	20051590	20052976	1386	693.0	
86793	chr19	20077591	20079119	1528	764.0	
86794	chr19	20166796	20167999	1203	602.0	
86795	chr19	20237616	20238887	1271	636.0	
86796	chr19	20244145	20245002	857	428.0	
86797	chr19	20247085	20247276	191	96.0	
86798	chr19	20423244	20425317	2073	1036.0	
86799	chr19	20564764	20566205	1441	720.0	
86800	chr19	20660796	20662002	1206	603.0	
86801	chr19	20775878	20777198	1320	660.0	
86802	chr19	20922832	20924234	1402	701.0	
86803	chr19	20999515	21000567	1052	526.0	
86804	chr19	21019966	21021668	1702	851.0	
86805	chr19	21028383	21028914	531	266.0	
86806	chr19	21081794	21082845	1051	526.0	
86807	chr19	21141620	21142697	1077	538.0	
86808	chr19	21202845	21203277	432	216.0	
86809	chr19	21308683	21309140	457	228.0	
86810	chr19	21314535	21315192	657	328.0	
86811	chr19	21327404	21329942	2538	1269.0	
86812	chr19	21358511	21359965	1454	727.0	
86813	chr19	21396678	21397961	1283	642.0	
86814	chr19	21463471	21464208	737	368.0	
86815	chr19	21474242	21475429	1187	594.0	
86816	chr19	21482692	21484316	1624	812.0	
86817	chr19	21492855	21493757	902	451.0	
86818	chr19	21505193	21507118	1925	962.0	
86819	chr19	21568614	21570016	1402	701.0	
86820	chr19	21584446	21585480	1034	517.0	
86821	chr19	21586162	21587467	1305	652.0	
86822	chr19	21593615	21595226	1611	806.0	
86823	chr19	21604281	21605408	1127	564.0	
86824	chr19	21677892	21678534	642	321.0	
86825	chr19	21698209	21698648	439	220.0	
86826	chr19	21766573	21767990	1417	708.0	
86827	chr19	21835286	21836864	1578	789.0	
86828	chr19	21851308	21852767	1459	730.0	
86829	chr19	22010421	22011251	830	415.0	
86830	chr19	22051957	22053537	1580	790.0	
86831	chr19	22633709	22634971	1262	631.0	
86832	chr19	22783965	22784411	446	223.0	
86833	chr19	22996292	22996649	357	178.0	
86834	chr19	23116687	23117455	768	384.0	
86835	chr19	23249222	23250813	1591	796.0	
86836	chr19	23272686	23274925	2239	1120.0	
86837	chr19	23283837	23284372	535	268.0	
86838	chr19	23286510	23286809	299	150.0	
86839	chr19	23378935	23379765	830	415.0	
86840	chr19	23394252	23395898	1646	823.0	
86841	chr19	23415837	23416074	237	118.0	
86842	chr19	23686236	23687618	1382	691.0	
86843	chr19	23758057	23759475	1418	709.0	
86844	chr19	23760374	23760573	199	100.0	
86845	chr19	23762289	23764109	1820	910.0	
86846	chr19	23773904	23775142	1238	619.0	
86847	chr19	23782186	23782341	155	78.0	
86848	chr19	23787003	23787599	596	298.0	
86849	chr19	23788435	23788685	250	125.0	
86850	chr19	23799174	23799932	758	379.0	
86851	chr19	23801990	23802636	646	323.0	
86852	chr19	23817536	23817894	358	179.0	
86853	chr19	23824122	23824270	148	74.0	
86854	chr19	23914253	23915502	1249	624.0	
86855	chr19	23986703	23986877	174	87.0	
86856	chr19	23992253	23992752	499	250.0	
86857	chr19	24032692	24034577	1885	942.0	
86858	chr19	24035444	24035854	410	205.0	
86859	chr19	24086777	24088095	1318	659.0	
86860	chr19	24291929	24292045	116	58.0	
86861	chr19	24343175	24343612	437	218.0	
86862	chr19	27240874	27248951	8077	4038.0	
86863	chr19	27265696	27266049	353	176.0	
86864	chr19	27379195	27379589	394	197.0	
86865	chr19	27775170	27775176	6	3.0	
86866	chr19	27775990	27776387	397	198.0	
86867	chr19	27779922	27780401	479	240.0	
86868	chr19	27792905	27795094	2189	1094.0	
86869	chr19	28435835	28436405	570	285.0	
86870	chr19	28465761	28466521	760	380.0	
86871	chr19	28468710	28469528	818	409.0	
86872	chr19	28472400	28473290	890	445.0	
86873	chr19	28475545	28475892	347	174.0	
86874	chr19	28481067	28481595	528	264.0	
86875	chr19	28485272	28485673	401	200.0	
86876	chr19	28499379	28499435	56	28.0	
86877	chr19	28500953	28502364	1411	706.0	
86878	chr19	28504104	28504549	445	222.0	
86879	chr19	28632326	28632817	491	246.0	
86880	chr19	28633479	28634137	658	329.0	
86881	chr19	28727473	28727949	476	238.0	
86882	chr19	28736946	28737320	374	187.0	
86883	chr19	29211755	29213922	2167	1084.0	
86884	chr19	29260508	29260872	364	182.0	
86885	chr19	29262946	29263837	891	446.0	
86886	chr19	29276883	29277632	749	374.0	
86887	chr19	29302512	29302944	432	216.0	
86888	chr19	29528289	29528776	487	244.0	
86889	chr19	29587407	29588091	684	342.0	
86890	chr19	29605280	29606945	1665	832.0	
86891	chr19	29610014	29611284	1270	635.0	
86892	chr19	29620926	29622874	1948	974.0	
86893	chr19	29623555	29624665	1110	555.0	
86894	chr19	29645882	29646203	321	160.0	
86895	chr19	29651658	29651669	11	6.0	
86896	chr19	29661190	29661237	47	24.0	
86897	chr19	29664418	29669760	5342	2671.0	
86898	chr19	29671123	29673986	2863	1432.0	
86899	chr19	29676134	29677452	1318	659.0	
86900	chr19	29679915	29681346	1431	716.0	
86901	chr19	29690572	29691415	843	422.0	
86902	chr19	29694409	29695218	809	404.0	
86903	chr19	29696007	29697474	1467	734.0	
86904	chr19	29698114	29698125	11	6.0	
86905	chr19	29704905	29705278	373	186.0	
86906	chr19	29712396	29717210	4814	2407.0	
86907	chr19	29724015	29724656	641	320.0	
86908	chr19	29730380	29731042	662	331.0	
86909	chr19	29759973	29760671	698	349.0	
86910	chr19	29810296	29813271	2975	1488.0	
86911	chr19	29815199	29815629	430	215.0	
86912	chr19	29830866	29832027	1161	580.0	
86913	chr19	29837288	29838047	759	380.0	
86914	chr19	29841706	29842072	366	183.0	
86915	chr19	29842760	29846126	3366	1683.0	
86916	chr19	29857982	29858567	585	292.0	
86917	chr19	29872087	29874082	1995	998.0	
86918	chr19	29941675	29943214	1539	770.0	
86919	chr19	30006192	30006631	439	220.0	
86920	chr19	30683036	30683104	68	34.0	
86921	chr19	30719513	30719744	231	116.0	
86922	chr19	30784806	30785774	968	484.0	
86923	chr19	30790030	30790470	440	220.0	
86924	chr19	30800347	30800453	106	53.0	
86925	chr19	30864320	30864735	415	208.0	
86926	chr19	30877387	30878349	962	481.0	
86927	chr19	30882687	30882934	247	124.0	
86928	chr19	31054529	31054781	252	126.0	
86929	chr19	31089688	31090040	352	176.0	
86930	chr19	31213674	31214778	1104	552.0	
86931	chr19	31220482	31221020	538	269.0	
86932	chr19	31226253	31226483	230	115.0	
86933	chr19	31252587	31252791	204	102.0	
86934	chr19	31256350	31256982	632	316.0	
86935	chr19	31275171	31275248	77	38.0	
86936	chr19	31285900	31286073	173	86.0	
86937	chr19	31304871	31305615	744	372.0	
86938	chr19	31312079	31312498	419	210.0	
86939	chr19	31316249	31317062	813	406.0	
86940	chr19	31328802	31329187	385	192.0	
86941	chr19	31330947	31331736	789	394.0	
86942	chr19	31338068	31338445	377	188.0	
86943	chr19	31339255	31341049	1794	897.0	
86944	chr19	31348357	31355508	7151	3576.0	
86945	chr19	31356865	31357516	651	326.0	
86946	chr19	31372284	31372574	290	145.0	
86947	chr19	32201673	32201982	309	154.0	
86948	chr19	32224544	32225009	465	232.0	
86949	chr19	32340209	32340730	521	260.0	
86950	chr19	32344986	32346627	1641	820.0	
86951	chr19	32351920	32352354	434	217.0	
86952	chr19	32404660	32406699	2039	1020.0	
86953	chr19	32421595	32422511	916	458.0	
86954	chr19	32498517	32499182	665	332.0	
86955	chr19	32519093	32519321	228	114.0	
86956	chr19	32570175	32570685	510	255.0	
86957	chr19	32572710	32573299	589	294.0	
86958	chr19	32580328	32582237	1909	954.0	
86959	chr19	32599613	32600104	491	246.0	
86960	chr19	32642688	32643395	707	354.0	
86961	chr19	32662214	32662490	276	138.0	
86962	chr19	32672574	32672888	314	157.0	
86963	chr19	32674188	32677025	2837	1418.0	
86964	chr19	32690267	32690333	66	33.0	
86965	chr19	32691311	32694391	3080	1540.0	
86966	chr19	32695412	32695969	557	278.0	
86967	chr19	32696606	32697183	577	288.0	
86968	chr19	32745442	32747346	1904	952.0	
86969	chr19	32793992	32794951	959	480.0	
86970	chr19	32971351	32972842	1491	746.0	
86971	chr19	32976130	32976655	525	262.0	
86972	chr19	32977257	32977659	402	201.0	
86973	chr19	33037359	33037620	261	130.0	
86974	chr19	33064332	33065320	988	494.0	
86975	chr19	33080604	33081848	1244	622.0	
86976	chr19	33119099	33119407	308	154.0	
86977	chr19	33125809	33126478	669	334.0	
86978	chr19	33134670	33135156	486	243.0	
86979	chr19	33143648	33144491	843	422.0	
86980	chr19	33160163	33161078	915	458.0	
86981	chr19	33175780	33178243	2463	1232.0	
86982	chr19	33184154	33184680	526	263.0	
86983	chr19	33186308	33187453	1145	572.0	
86984	chr19	33188872	33189147	275	138.0	
86985	chr19	33194005	33196281	2276	1138.0	
86986	chr19	33225593	33227279	1686	843.0	
86987	chr19	33231494	33231882	388	194.0	
86988	chr19	33235160	33236043	883	442.0	
86989	chr19	33239580	33239922	342	171.0	
86990	chr19	33241032	33242191	1159	580.0	
86991	chr19	33245990	33246300	310	155.0	
86992	chr19	33248506	33249775	1269	634.0	
86993	chr19	33252954	33253263	309	154.0	
86994	chr19	33254430	33254776	346	173.0	
86995	chr19	33259424	33259947	523	262.0	
86996	chr19	33260523	33261957	1434	717.0	
86997	chr19	33267229	33269085	1856	928.0	
86998	chr19	33273783	33274727	944	472.0	
86999	chr19	33277990	33278883	893	446.0	
87000	chr19	33280429	33281004	575	288.0	
87001	chr19	33285461	33285676	215	108.0	
87002	chr19	33286813	33288319	1506	753.0	
87003	chr19	33292482	33294057	1575	788.0	
87004	chr19	33296148	33296667	519	260.0	
87005	chr19	33297997	33299237	1240	620.0	
87006	chr19	33300075	33304260	4185	2092.0	
87007	chr19	33329801	33331071	1270	635.0	
87008	chr19	33331953	33332754	801	400.0	
87009	chr19	33371903	33374851	2948	1474.0	
87010	chr19	33393993	33394859	866	433.0	
87011	chr19	33404525	33404777	252	126.0	
87012	chr19	33406569	33407438	869	434.0	
87013	chr19	33416153	33416800	647	324.0	
87014	chr19	33430201	33431082	881	440.0	
87015	chr19	33520820	33522553	1733	866.0	
87016	chr19	33771513	33771997	484	242.0	
87017	chr19	33777755	33778697	942	471.0	
87018	chr19	33795154	33798362	3208	1604.0	
87019	chr19	33816521	33817130	609	304.0	
87020	chr19	33819302	33821342	2040	1020.0	
87021	chr19	34041913	34042347	434	217.0	
87022	chr19	34096555	34096589	34	17.0	
87023	chr19	34121021	34121439	418	209.0	
87024	chr19	34134032	34135202	1170	585.0	
87025	chr19	34145680	34146174	494	247.0	
87026	chr19	34165378	34165635	257	128.0	
87027	chr19	34171428	34173916	2488	1244.0	
87028	chr19	34178114	34178596	482	241.0	
87029	chr19	34181073	34181542	469	234.0	
87030	chr19	34184897	34185702	805	402.0	
87031	chr19	34188506	34188709	203	102.0	
87032	chr19	34217865	34218998	1133	566.0	
87033	chr19	34220423	34220904	481	240.0	
87034	chr19	34232696	34232919	223	112.0	
87035	chr19	34253634	34255595	1961	980.0	
87036	chr19	34259868	34259985	117	58.0	
87037	chr19	34269478	34270880	1402	701.0	
87038	chr19	34308915	34309469	554	277.0	
87039	chr19	34310462	34310740	278	139.0	
87040	chr19	34317373	34317943	570	285.0	
87041	chr19	34336603	34337298	695	348.0	
87042	chr19	34345798	34346324	526	263.0	
87043	chr19	34349762	34351656	1894	947.0	
87044	chr19	34358617	34360601	1984	992.0	
87045	chr19	34364477	34367140	2663	1332.0	
87046	chr19	34391357	34392258	901	450.0	
87047	chr19	34403847	34405105	1258	629.0	
87048	chr19	34427712	34429425	1713	856.0	
87049	chr19	34430492	34431241	749	374.0	
87050	chr19	34475013	34475480	467	234.0	
87051	chr19	34499975	34500683	708	354.0	
87052	chr19	34501408	34502022	614	307.0	
87053	chr19	34639459	34639915	456	228.0	
87054	chr19	34662904	34663392	488	244.0	
87055	chr19	34667257	34667817	560	280.0	
87056	chr19	34676645	34678495	1850	925.0	
87057	chr19	34712613	34713124	511	256.0	
87058	chr19	34732737	34735008	2271	1136.0	
87059	chr19	34772394	34773705	1311	656.0	
87060	chr19	34859961	34860701	740	370.0	
87061	chr19	34888224	34888573	349	174.0	
87062	chr19	34926593	34927430	837	418.0	
87063	chr19	34962398	34964731	2333	1166.0	
87064	chr19	34972919	34975177	2258	1129.0	
87065	chr19	34975908	34976285	377	188.0	
87066	chr19	34985460	34985924	464	232.0	
87067	chr19	34989000	34989086	86	43.0	
87068	chr19	34990473	34990820	347	174.0	
87069	chr19	34996598	34998311	1713	856.0	
87070	chr19	34998945	35003999	5054	2527.0	
87071	chr19	35010870	35015169	4299	2150.0	
87072	chr19	35017485	35017808	323	162.0	
87073	chr19	35023387	35023900	513	256.0	
87074	chr19	35027911	35028429	518	259.0	
87075	chr19	35029770	35031406	1636	818.0	
87076	chr19	35038960	35039542	582	291.0	
87077	chr19	35040113	35041570	1457	728.0	
87078	chr19	35044277	35044773	496	248.0	
87079	chr19	35045633	35046204	571	286.0	
87080	chr19	35066734	35067600	866	433.0	
87081	chr19	35076791	35076949	158	79.0	
87082	chr19	35085847	35086394	547	274.0	
87083	chr19	35090411	35090933	522	261.0	
87084	chr19	35114481	35115208	727	364.0	
87085	chr19	35120495	35120908	413	206.0	
87086	chr19	35124111	35125225	1114	557.0	
87087	chr19	35135182	35136004	822	411.0	
87088	chr19	35137395	35137609	214	107.0	
87089	chr19	35138879	35139601	722	361.0	
87090	chr19	35140632	35145442	4810	2405.0	
87091	chr19	35146937	35147486	549	274.0	
87092	chr19	35152020	35152382	362	181.0	
87093	chr19	35153456	35156161	2705	1352.0	
87094	chr19	35167149	35167823	674	337.0	
87095	chr19	35171721	35172143	422	211.0	
87096	chr19	35175558	35176223	665	332.0	
87097	chr19	35204904	35208274	3370	1685.0	
87098	chr19	35209820	35209937	117	58.0	
87099	chr19	35210535	35214896	4361	2180.0	
87100	chr19	35215885	35218017	2132	1066.0	
87101	chr19	35223122	35223470	348	174.0	
87102	chr19	35225175	35225638	463	232.0	
87103	chr19	35236583	35236916	333	166.0	
87104	chr19	35240118	35240952	834	417.0	
87105	chr19	35247460	35250261	2801	1400.0	
87106	chr19	35264110	35270262	6152	3076.0	
87107	chr19	35272257	35272837	580	290.0	
87108	chr19	35281513	35282760	1247	624.0	
87109	chr19	35284734	35284775	41	20.0	
87110	chr19	35295622	35296343	721	360.0	
87111	chr19	35299894	35300063	169	84.0	
87112	chr19	35317478	35317868	390	195.0	
87113	chr19	35318589	35320918	2329	1164.0	
87114	chr19	35321512	35321576	64	32.0	
87115	chr19	35323987	35324777	790	395.0	
87116	chr19	35328726	35329477	751	376.0	
87117	chr19	35330373	35330939	566	283.0	
87118	chr19	35333075	35333183	108	54.0	
87119	chr19	35337466	35337467	1	0.0	
87120	chr19	35346333	35348226	1893	946.0	
87121	chr19	35352462	35353888	1426	713.0	
87122	chr19	35357965	35358756	791	396.0	
87123	chr19	35374903	35375354	451	226.0	
87124	chr19	35418047	35418408	361	180.0	
87125	chr19	35420234	35420876	642	321.0	
87126	chr19	35430531	35431607	1076	538.0	
87127	chr19	35433141	35433304	163	82.0	
87128	chr19	35436107	35437272	1165	582.0	
87129	chr19	35441960	35442594	634	317.0	
87130	chr19	35445693	35449718	4025	2012.0	
87131	chr19	35451232	35452112	880	440.0	
87132	chr19	35458805	35459604	799	400.0	
87133	chr19	35460508	35461082	574	287.0	
87134	chr19	35462215	35463445	1230	615.0	
87135	chr19	35468517	35469190	673	336.0	
87136	chr19	35484738	35485059	321	160.0	
87137	chr19	35495097	35495946	849	424.0	
87138	chr19	35509174	35510977	1803	902.0	
87139	chr19	35533606	35534558	952	476.0	
87140	chr19	35544386	35546750	2364	1182.0	
87141	chr19	35549085	35549642	557	278.0	
87142	chr19	35557507	35558606	1099	550.0	
87143	chr19	35585916	35586150	234	117.0	
87144	chr19	35592270	35592636	366	183.0	
87145	chr19	35596428	35596806	378	189.0	
87146	chr19	35609532	35610656	1124	562.0	
87147	chr19	35612128	35613517	1389	694.0	
87148	chr19	35628089	35629782	1693	846.0	
87149	chr19	35641386	35642119	733	366.0	
87150	chr19	35642818	35645895	3077	1538.0	
87151	chr19	35647692	35649121	1429	714.0	
87152	chr19	35673081	35673957	876	438.0	
87153	chr19	35693452	35694462	1010	505.0	
87154	chr19	35701896	35703291	1395	698.0	
87155	chr19	35710762	35711713	951	476.0	
87156	chr19	35712523	35714427	1904	952.0	
87157	chr19	35715185	35719209	4024	2012.0	
87158	chr19	35737446	35737835	389	194.0	
87159	chr19	35739929	35743007	3078	1539.0	
87160	chr19	35744271	35746238	1967	984.0	
87161	chr19	35747855	35749193	1338	669.0	
87162	chr19	35755312	35759001	3689	1844.0	
87163	chr19	35774735	35776290	1555	778.0	
87164	chr19	35819956	35820364	408	204.0	
87165	chr19	35828856	35829057	201	100.0	
87166	chr19	35845417	35846057	640	320.0	
87167	chr19	35856405	35857408	1003	502.0	
87168	chr19	35868088	35870409	2321	1160.0	
87169	chr19	35879279	35880458	1179	590.0	
87170	chr19	35881718	35882764	1046	523.0	
87171	chr19	35883684	35892166	8482	4241.0	
87172	chr19	35892859	35905742	12883	6442.0	
87173	chr19	35906957	35910137	3180	1590.0	
87174	chr19	35913515	35913939	424	212.0	
87175	chr19	35915174	35915848	674	337.0	
87176	chr19	35928402	35929000	598	299.0	
87177	chr19	35929673	35932349	2676	1338.0	
87178	chr19	35935781	35937843	2062	1031.0	
87179	chr19	35946953	35948167	1214	607.0	
87180	chr19	35952842	35953859	1017	508.0	
87181	chr19	35958760	35960081	1321	660.0	
87182	chr19	35963560	35963900	340	170.0	
87183	chr19	35977397	35977869	472	236.0	
87184	chr19	35986780	35987752	972	486.0	
87185	chr19	35993885	35996091	2206	1103.0	
87186	chr19	35998963	35999449	486	243.0	
87187	chr19	36009069	36009928	859	430.0	
87188	chr19	36013465	36015133	1668	834.0	
87189	chr19	36032630	36033130	500	250.0	
87190	chr19	36053478	36055742	2264	1132.0	
87191	chr19	36060415	36060834	419	210.0	
87192	chr19	36113990	36116552	2562	1281.0	
87193	chr19	36127254	36128779	1525	762.0	
87194	chr19	36131097	36131901	804	402.0	
87195	chr19	36132434	36132994	560	280.0	
87196	chr19	36136896	36137259	363	182.0	
87197	chr19	36139245	36141871	2626	1313.0	
87198	chr19	36152393	36152749	356	178.0	
87199	chr19	36170479	36171155	676	338.0	
87200	chr19	36213626	36215919	2293	1146.0	
87201	chr19	36331286	36332364	1078	539.0	
87202	chr19	36378491	36379858	1367	684.0	
87203	chr19	36401404	36401837	433	216.0	
87204	chr19	36417849	36419189	1340	670.0	
87205	chr19	36488402	36490605	2203	1102.0	
87206	chr19	36492816	36493527	711	356.0	
87207	chr19	36527723	36529609	1886	943.0	
87208	chr19	36572366	36574202	1836	918.0	
87209	chr19	36604334	36606350	2016	1008.0	
87210	chr19	36665883	36667722	1839	920.0	
87211	chr19	36686730	36688351	1621	810.0	
87212	chr19	36771391	36773570	2179	1090.0	
87213	chr19	36791690	36792131	441	220.0	
87214	chr19	36796662	36798099	1437	718.0	
87215	chr19	36837336	36839071	1735	868.0	
87216	chr19	36848992	36851814	2822	1411.0	
87217	chr19	36915550	36917119	1569	784.0	
87218	chr19	36972604	36974152	1548	774.0	
87219	chr19	37007518	37008200	682	341.0	
87220	chr19	37077604	37079197	1593	796.0	
87221	chr19	37172191	37173308	1117	558.0	
87222	chr19	37209943	37211247	1304	652.0	
87223	chr19	37217374	37219088	1714	857.0	
87224	chr19	37228000	37228398	398	199.0	
87225	chr19	37251503	37252138	635	318.0	
87226	chr19	37293627	37293667	40	20.0	
87227	chr19	37303976	37304623	647	324.0	
87228	chr19	37309820	37310249	429	214.0	
87229	chr19	37312342	37313580	1238	619.0	
87230	chr19	37316827	37318466	1639	820.0	
87231	chr19	37334041	37335285	1244	622.0	
87232	chr19	37370292	37371864	1572	786.0	
87233	chr19	37466375	37468008	1633	816.0	
87234	chr19	37468542	37470137	1595	798.0	
87235	chr19	37505770	37507493	1723	862.0	
87236	chr19	37551051	37552122	1071	536.0	
87237	chr19	37593654	37595747	2093	1046.0	
87238	chr19	37654332	37656578	2246	1123.0	
87239	chr19	37691762	37692674	912	456.0	
87240	chr19	37718994	37720226	1232	616.0	
87241	chr19	37778636	37780200	1564	782.0	
87242	chr19	37817043	37817995	952	476.0	
87243	chr19	37898583	37899114	531	266.0	
87244	chr19	37902489	37903267	778	389.0	
87245	chr19	37906136	37908359	2223	1112.0	
87246	chr19	37914918	37915257	339	170.0	
87247	chr19	37923030	37923413	383	192.0	
87248	chr19	37928365	37928965	600	300.0	
87249	chr19	37931973	37933369	1396	698.0	
87250	chr19	37978824	37979279	455	228.0	
87251	chr19	37986466	37986687	221	110.0	
87252	chr19	38003276	38005162	1886	943.0	
87253	chr19	38006196	38006866	670	335.0	
87254	chr19	38009813	38010120	307	154.0	
87255	chr19	38033306	38035091	1785	892.0	
87256	chr19	38046100	38049951	3851	1926.0	
87257	chr19	38059955	38060179	224	112.0	
87258	chr19	38080081	38080251	170	85.0	
87259	chr19	38095481	38096112	631	316.0	
87260	chr19	38134595	38134950	355	178.0	
87261	chr19	38142419	38142832	413	206.0	
87262	chr19	38213708	38214936	1228	614.0	
87263	chr19	38223819	38224907	1088	544.0	
87264	chr19	38226127	38226794	667	334.0	
87265	chr19	38229288	38230166	878	439.0	
87266	chr19	38233626	38234412	786	393.0	
87267	chr19	38243574	38244458	884	442.0	
87268	chr19	38256203	38256879	676	338.0	
87269	chr19	38263547	38265861	2314	1157.0	
87270	chr19	38284425	38284846	421	210.0	
87271	chr19	38287468	38288227	759	380.0	
87272	chr19	38308592	38308794	202	101.0	
87273	chr19	38312703	38313136	433	216.0	
87274	chr19	38315132	38317690	2558	1279.0	
87275	chr19	38319398	38320694	1296	648.0	
87276	chr19	38321527	38321626	99	50.0	
87277	chr19	38323318	38323718	400	200.0	
87278	chr19	38335356	38337706	2350	1175.0	
87279	chr19	38343982	38343994	12	6.0	
87280	chr19	38358515	38358711	196	98.0	
87281	chr19	38361282	38363004	1722	861.0	
87282	chr19	38373963	38375718	1755	878.0	
87283	chr19	38384300	38390452	6152	3076.0	
87284	chr19	38394257	38396281	2024	1012.0	
87285	chr19	38402427	38404015	1588	794.0	
87286	chr19	38417272	38418652	1380	690.0	
87287	chr19	38425528	38426555	1027	514.0	
87288	chr19	38427306	38427550	244	122.0	
87289	chr19	38433386	38433924	538	269.0	
87290	chr19	38441706	38441957	251	126.0	
87291	chr19	38506659	38507777	1118	559.0	
87292	chr19	38514960	38515724	764	382.0	
87293	chr19	38527790	38528033	243	122.0	
87294	chr19	38538652	38539488	836	418.0	
87295	chr19	38543844	38545036	1192	596.0	
87296	chr19	38545590	38545991	401	200.0	
87297	chr19	38547346	38547885	539	270.0	
87298	chr19	38551550	38551690	140	70.0	
87299	chr19	38556772	38557767	995	498.0	
87300	chr19	38559361	38559966	605	302.0	
87301	chr19	38564958	38566057	1099	550.0	
87302	chr19	38579257	38579733	476	238.0	
87303	chr19	38583474	38584143	669	334.0	
87304	chr19	38616292	38619938	3646	1823.0	
87305	chr19	38634366	38635200	834	417.0	
87306	chr19	38636592	38637800	1208	604.0	
87307	chr19	38646871	38653399	6528	3264.0	
87308	chr19	38655191	38658220	3029	1514.0	
87309	chr19	38659299	38659787	488	244.0	
87310	chr19	38663956	38665265	1309	654.0	
87311	chr19	38666953	38668223	1270	635.0	
87312	chr19	38669360	38670301	941	470.0	
87313	chr19	38674353	38676855	2502	1251.0	
87314	chr19	38679569	38680319	750	375.0	
87315	chr19	38680833	38681888	1055	528.0	
87316	chr19	38682545	38684919	2374	1187.0	
87317	chr19	38685703	38687092	1389	694.0	
87318	chr19	38688655	38689283	628	314.0	
87319	chr19	38691164	38691654	490	245.0	
87320	chr19	38693191	38695741	2550	1275.0	
87321	chr19	38726209	38727293	1084	542.0	
87322	chr19	38728372	38728432	60	30.0	
87323	chr19	38729270	38730170	900	450.0	
87324	chr19	38730803	38737835	7032	3516.0	
87325	chr19	38739803	38740339	536	268.0	
87326	chr19	38759587	38759799	212	106.0	
87327	chr19	38769354	38770574	1220	610.0	
87328	chr19	38792226	38793062	836	418.0	
87329	chr19	38829117	38829580	463	232.0	
87330	chr19	38830863	38832622	1759	880.0	
87331	chr19	38834820	38834828	8	4.0	
87332	chr19	38835371	38836176	805	402.0	
87333	chr19	38836764	38837421	657	328.0	
87334	chr19	38838171	38838282	111	56.0	
87335	chr19	38840157	38840811	654	327.0	
87336	chr19	38841506	38844272	2766	1383.0	
87337	chr19	38846379	38846387	8	4.0	
87338	chr19	38847148	38853300	6152	3076.0	
87339	chr19	38857080	38858430	1350	675.0	
87340	chr19	38864212	38866098	1886	943.0	
87341	chr19	38868691	38871174	2483	1242.0	
87342	chr19	38877452	38879215	1763	882.0	
87343	chr19	38887282	38888110	828	414.0	
87344	chr19	38888949	38889254	305	152.0	
87345	chr19	38895027	38895075	48	24.0	
87346	chr19	38898158	38900742	2584	1292.0	
87347	chr19	38908887	38909523	636	318.0	
87348	chr19	38912955	38913255	300	150.0	
87349	chr19	38924204	38925120	916	458.0	
87350	chr19	38926672	38927106	434	217.0	
87351	chr19	38928151	38928993	842	421.0	
87352	chr19	38929800	38931678	1878	939.0	
87353	chr19	38932733	38933242	509	254.0	
87354	chr19	38945353	38945554	201	100.0	
87355	chr19	38949534	38950296	762	381.0	
87356	chr19	38952565	38952960	395	198.0	
87357	chr19	38962106	38962646	540	270.0	
87358	chr19	39031105	39032606	1501	750.0	
87359	chr19	39052210	39052701	491	246.0	
87360	chr19	39073255	39074425	1170	585.0	
87361	chr19	39083468	39084570	1102	551.0	
87362	chr19	39110184	39110839	655	328.0	
87363	chr19	39121817	39122689	872	436.0	
87364	chr19	39125176	39128569	3393	1696.0	
87365	chr19	39133419	39133724	305	152.0	
87366	chr19	39142816	39142990	174	87.0	
87367	chr19	39187183	39187664	481	240.0	
87368	chr19	39195900	39196169	269	134.0	
87369	chr19	39197088	39197434	346	173.0	
87370	chr19	39212273	39212792	519	260.0	
87371	chr19	39236573	39237004	431	216.0	
87372	chr19	39237731	39238242	511	256.0	
87373	chr19	39246941	39247987	1046	523.0	
87374	chr19	39258348	39258739	391	196.0	
87375	chr19	39264802	39265193	391	196.0	
87376	chr19	39297681	39299926	2245	1122.0	
87377	chr19	39320116	39322091	1975	988.0	
87378	chr19	39326013	39326605	592	296.0	
87379	chr19	39327837	39328674	837	418.0	
87380	chr19	39333880	39334084	204	102.0	
87381	chr19	39334987	39336715	1728	864.0	
87382	chr19	39337572	39338523	951	476.0	
87383	chr19	39340298	39343323	3025	1512.0	
87384	chr19	39346009	39346379	370	185.0	
87385	chr19	39351413	39351979	566	283.0	
87386	chr19	39363869	39364353	484	242.0	
87387	chr19	39382169	39386464	4295	2148.0	
87388	chr19	39387039	39387312	273	136.0	
87389	chr19	39389386	39392288	2902	1451.0	
87390	chr19	39393441	39394422	981	490.0	
87391	chr19	39394925	39395315	390	195.0	
87392	chr19	39396020	39436789	40769	20384.0	
87393	chr19	39437868	39437885	17	8.0	
87394	chr19	39440000	39440935	935	468.0	
87395	chr19	39444613	39446411	1798	899.0	
87396	chr19	39446915	39447684	769	384.0	
87397	chr19	39448220	39449702	1482	741.0	
87398	chr19	39450410	39450725	315	158.0	
87399	chr19	39472390	39474846	2456	1228.0	
87400	chr19	39475603	39476252	649	324.0	
87401	chr19	39479901	39481695	1794	897.0	
87402	chr19	39497761	39499558	1797	898.0	
87403	chr19	39502491	39503430	939	470.0	
87404	chr19	39506861	39507865	1004	502.0	
87405	chr19	39514705	39516639	1934	967.0	
87406	chr19	39524349	39524957	608	304.0	
87407	chr19	39532132	39533554	1422	711.0	
87408	chr19	39539158	39540736	1578	789.0	
87409	chr19	39544969	39545283	314	157.0	
87410	chr19	39551344	39552818	1474	737.0	
87411	chr19	39557629	39559137	1508	754.0	
87412	chr19	39671928	39672416	488	244.0	
87413	chr19	39679170	39679809	639	320.0	
87414	chr19	39765455	39765842	387	194.0	
87415	chr19	39766680	39767075	395	198.0	
87416	chr19	39792744	39793668	924	462.0	
87417	chr19	39823924	39825336	1412	706.0	
87418	chr19	39828175	39829100	925	462.0	
87419	chr19	39832176	39834860	2684	1342.0	
87420	chr19	39842171	39842790	619	310.0	
87421	chr19	39843861	39847248	3387	1694.0	
87422	chr19	39881459	39882074	615	308.0	
87423	chr19	39936979	39937597	618	309.0	
87424	chr19	39941060	39942556	1496	748.0	
87425	chr19	39943947	39945075	1128	564.0	
87426	chr19	39946720	39946816	96	48.0	
87427	chr19	39953058	39954213	1155	578.0	
87428	chr19	39959519	39959680	161	80.0	
87429	chr19	39969395	39972357	2962	1481.0	
87430	chr19	39996215	39997956	1741	870.0	
87431	chr19	40055501	40056748	1247	624.0	
87432	chr19	40081386	40081807	421	210.0	
87433	chr19	40089995	40091562	1567	784.0	
87434	chr19	40139561	40140399	838	419.0	
87435	chr19	40143470	40145398	1928	964.0	
87436	chr19	40147358	40148106	748	374.0	
87437	chr19	40155743	40156074	331	166.0	
87438	chr19	40157052	40157466	414	207.0	
87439	chr19	40162729	40164270	1541	770.0	
87440	chr19	40165462	40165987	525	262.0	
87441	chr19	40190220	40192697	2477	1238.0	
87442	chr19	40217169	40218661	1492	746.0	
87443	chr19	40221638	40223678	2040	1020.0	
87444	chr19	40226458	40226691	233	116.0	
87445	chr19	40233830	40234270	440	220.0	
87446	chr19	40274462	40275051	589	294.0	
87447	chr19	40280109	40280786	677	338.0	
87448	chr19	40283164	40283166	2	1.0	
87449	chr19	40283917	40286256	2339	1170.0	
87450	chr19	40305268	40305755	487	244.0	
87451	chr19	40314863	40315014	151	76.0	
87452	chr19	40347236	40349545	2309	1154.0	
87453	chr19	40358609	40359330	721	360.0	
87454	chr19	40360610	40361697	1087	544.0	
87455	chr19	40363004	40364129	1125	562.0	
87456	chr19	40365524	40367243	1719	860.0	
87457	chr19	40398498	40399386	888	444.0	
87458	chr19	40403224	40405509	2285	1142.0	
87459	chr19	40406471	40406538	67	34.0	
87460	chr19	40407928	40408487	559	280.0	
87461	chr19	40411429	40411707	278	139.0	
87462	chr19	40413352	40413921	569	284.0	
87463	chr19	40415648	40416151	503	252.0	
87464	chr19	40416843	40417853	1010	505.0	
87465	chr19	40419039	40423638	4599	2300.0	
87466	chr19	40424580	40426747	2167	1084.0	
87467	chr19	40433311	40434670	1359	680.0	
87468	chr19	40435184	40435638	454	227.0	
87469	chr19	40442447	40445392	2945	1472.0	
87470	chr19	40461403	40462472	1069	534.0	
87471	chr19	40463391	40467700	4309	2154.0	
87472	chr19	40487837	40488353	516	258.0	
87473	chr19	40489141	40489542	401	200.0	
87474	chr19	40523196	40523716	520	260.0	
87475	chr19	40528777	40531026	2249	1124.0	
87476	chr19	40541138	40541646	508	254.0	
87477	chr19	40549082	40549706	624	312.0	
87478	chr19	40567460	40568115	655	328.0	
87479	chr19	40569836	40571497	1661	830.0	
87480	chr19	40575924	40577596	1672	836.0	
87481	chr19	40578414	40578981	567	284.0	
87482	chr19	40579752	40580621	869	434.0	
87483	chr19	40585372	40586432	1060	530.0	
87484	chr19	40592067	40592667	600	300.0	
87485	chr19	40594269	40594871	602	301.0	
87486	chr19	40596727	40606653	9926	4963.0	
87487	chr19	40609259	40615553	6294	3147.0	
87488	chr19	40634198	40635270	1072	536.0	
87489	chr19	40662476	40664276	1800	900.0	
87490	chr19	40673342	40673819	477	238.0	
87491	chr19	40687089	40688257	1168	584.0	
87492	chr19	40689010	40691903	2893	1446.0	
87493	chr19	40714111	40719475	5364	2682.0	
87494	chr19	40720243	40721016	773	386.0	
87495	chr19	40742053	40742275	222	111.0	
87496	chr19	40744484	40744807	323	162.0	
87497	chr19	40748315	40749258	943	472.0	
87498	chr19	40749801	40753504	3703	1852.0	
87499	chr19	40754062	40755416	1354	677.0	
87500	chr19	40756345	40757154	809	404.0	
87501	chr19	40765573	40765999	426	213.0	
87502	chr19	40771078	40771588	510	255.0	
87503	chr19	40776781	40779298	2517	1258.0	
87504	chr19	40792265	40792878	613	306.0	
87505	chr19	40797835	40808221	10386	5193.0	
87506	chr19	40810461	40812745	2284	1142.0	
87507	chr19	40818342	40820161	1819	910.0	
87508	chr19	40822822	40824127	1305	652.0	
87509	chr19	40826512	40827467	955	478.0	
87510	chr19	40833389	40833642	253	126.0	
87511	chr19	40843281	40844780	1499	750.0	
87512	chr19	40848492	40849228	736	368.0	
87513	chr19	40875193	40876829	1636	818.0	
87514	chr19	40899974	40900253	279	140.0	
87515	chr19	40908227	40908667	440	220.0	
87516	chr19	40969901	40971094	1193	596.0	
87517	chr19	40974518	40974995	477	238.0	
87518	chr19	41065071	41065288	217	108.0	
87519	chr19	41120438	41121650	1212	606.0	
87520	chr19	41126646	41128407	1761	880.0	
87521	chr19	41135103	41136286	1183	592.0	
87522	chr19	41144321	41144872	551	276.0	
87523	chr19	41175643	41176832	1189	594.0	
87524	chr19	41183387	41183750	363	182.0	
87525	chr19	41192717	41194630	1913	956.0	
87526	chr19	41195984	41196751	767	384.0	
87527	chr19	41204174	41204891	717	358.0	
87528	chr19	41218757	41218933	176	88.0	
87529	chr19	41225894	41226845	951	476.0	
87530	chr19	41233514	41234344	830	415.0	
87531	chr19	41261450	41267194	5744	2872.0	
87532	chr19	41296353	41298940	2587	1294.0	
87533	chr19	41299612	41300252	640	320.0	
87534	chr19	41301804	41304705	2901	1450.0	
87535	chr19	41305796	41311901	6105	3052.0	
87536	chr19	41313209	41313733	524	262.0	
87537	chr19	41315494	41317385	1891	946.0	
87538	chr19	41318227	41333175	14948	7474.0	
87539	chr19	41334113	41340333	6220	3110.0	
87540	chr19	41341077	41358591	17514	8757.0	
87541	chr19	41362363	41365123	2760	1380.0	
87542	chr19	41366093	41366424	331	166.0	
87543	chr19	41367732	41368246	514	257.0	
87544	chr19	41376184	41377419	1235	618.0	
87545	chr19	41378269	41378839	570	285.0	
87546	chr19	41379644	41380489	845	422.0	
87547	chr19	41396752	41398442	1690	845.0	
87548	chr19	41407248	41407872	624	312.0	
87549	chr19	41409249	41410502	1253	626.0	
87550	chr19	41420074	41421165	1091	546.0	
87551	chr19	41424807	41425515	708	354.0	
87552	chr19	41426566	41428798	2232	1116.0	
87553	chr19	41431370	41431856	486	243.0	enhancer
87554	chr19	41439326	41440502	1176	588.0	
87555	chr19	41449056	41449961	905	452.0	
87556	chr19	41457240	41457631	391	196.0	
87557	chr19	41463381	41464274	893	446.0	
87558	chr19	41516252	41517321	1069	534.0	
87559	chr19	41521071	41522708	1637	818.0	
87560	chr19	41526007	41526356	349	174.0	
87561	chr19	41529314	41532257	2943	1472.0	
87562	chr19	41534923	41535628	705	352.0	
87563	chr19	41537744	41538223	479	240.0	
87564	chr19	41541948	41542773	825	412.0	
87565	chr19	41545477	41547128	1651	826.0	
87566	chr19	41548737	41553400	4663	2332.0	
87567	chr19	41554797	41556180	1383	692.0	
87568	chr19	41559722	41560238	516	258.0	
87569	chr19	41562989	41565582	2593	1296.0	
87570	chr19	41570328	41571255	927	464.0	
87571	chr19	41575661	41576892	1231	616.0	
87572	chr19	41595075	41595762	687	344.0	
87573	chr19	41597503	41598138	635	318.0	
87574	chr19	41612441	41612942	501	250.0	
87575	chr19	41616909	41617219	310	155.0	
87576	chr19	41621560	41622153	593	296.0	
87577	chr19	41626802	41627618	816	408.0	
87578	chr19	41637393	41638002	609	304.0	
87579	chr19	41638589	41639187	598	299.0	
87580	chr19	41641652	41642330	678	339.0	
87581	chr19	41656693	41657649	956	478.0	
87582	chr19	41691354	41691761	407	204.0	
87583	chr19	41706579	41707332	753	376.0	
87584	chr19	41744758	41745221	463	232.0	
87585	chr19	41745772	41747012	1240	620.0	
87586	chr19	41753147	41754371	1224	612.0	
87587	chr19	41774431	41775181	750	375.0	
87588	chr19	41784555	41786190	1635	818.0	
87589	chr19	41793063	41793517	454	227.0	
87590	chr19	41794923	41795581	658	329.0	
87591	chr19	41796328	41796763	435	218.0	
87592	chr19	41801549	41803125	1576	788.0	
87593	chr19	41804264	41804781	517	258.0	
87594	chr19	41808877	41809464	587	294.0	
87595	chr19	41810703	41811538	835	418.0	
87596	chr19	41821040	41821546	506	253.0	
87597	chr19	41835908	41836392	484	242.0	
87598	chr19	41859102	41861401	2299	1150.0	
87599	chr19	41863204	41863628	424	212.0	
87600	chr19	41868359	41868372	13	6.0	
87601	chr19	41870266	41873771	3505	1752.0	
87602	chr19	41874938	41878417	3479	1740.0	
87603	chr19	41881855	41885313	3458	1729.0	
87604	chr19	41886366	41890293	3927	1964.0	
87605	chr19	41893909	41894350	441	220.0	
87606	chr19	41895969	41896373	404	202.0	
87607	chr19	41905209	41905333	124	62.0	
87608	chr19	41906991	41907189	198	99.0	
87609	chr19	41907918	41916971	9053	4526.0	
87610	chr19	41917762	41918934	1172	586.0	
87611	chr19	41919818	41922576	2758	1379.0	
87612	chr19	41927549	41931626	4077	2038.0	
87613	chr19	41933784	41937329	3545	1772.0	
87614	chr19	41938064	41938317	253	126.0	
87615	chr19	41939703	41941959	2256	1128.0	
87616	chr19	41943655	41946188	2533	1266.0	
87617	chr19	41947144	41947411	267	134.0	
87618	chr19	41951399	41952272	873	436.0	
87619	chr19	41957398	41960111	2713	1356.0	
87620	chr19	41966840	41967550	710	355.0	
87621	chr19	41993421	41995085	1664	832.0	
87622	chr19	41996910	41997712	802	401.0	
87623	chr19	41998435	41999205	770	385.0	
87624	chr19	42034639	42035234	595	298.0	
87625	chr19	42068779	42070389	1610	805.0	
87626	chr19	42075001	42077170	2169	1084.0	
87627	chr19	42077959	42078186	227	114.0	
87628	chr19	42079472	42080406	934	467.0	
87629	chr19	42081505	42081985	480	240.0	
87630	chr19	42090535	42091216	681	340.0	
87631	chr19	42092307	42092814	507	254.0	
87632	chr19	42108301	42109331	1030	515.0	
87633	chr19	42113992	42114694	702	351.0	
87634	chr19	42120938	42123654	2716	1358.0	
87635	chr19	42129060	42134066	5006	2503.0	
87636	chr19	42136123	42136144	21	10.0	
87637	chr19	42140092	42140565	473	236.0	
87638	chr19	42145714	42146164	450	225.0	
87639	chr19	42154605	42155431	826	413.0	
87640	chr19	42160047	42160303	256	128.0	
87641	chr19	42175926	42177654	1728	864.0	
87642	chr19	42179231	42179666	435	218.0	
87643	chr19	42182179	42182643	464	232.0	
87644	chr19	42184117	42185961	1844	922.0	
87645	chr19	42191289	42192289	1000	500.0	
87646	chr19	42195155	42195659	504	252.0	
87647	chr19	42196525	42204280	7755	3878.0	
87648	chr19	42207494	42208644	1150	575.0	
87649	chr19	42212803	42213453	650	325.0	
87650	chr19	42214554	42214596	42	21.0	
87651	chr19	42215200	42218666	3466	1733.0	
87652	chr19	42219530	42221033	1503	752.0	
87653	chr19	42238755	42239337	582	291.0	
87654	chr19	42239938	42239995	57	28.0	
87655	chr19	42241800	42256511	14711	7356.0	
87656	chr19	42267638	42271386	3748	1874.0	
87657	chr19	42276265	42276671	406	203.0	
87658	chr19	42279150	42286990	7840	3920.0	
87659	chr19	42288395	42288800	405	202.0	
87660	chr19	42290631	42291391	760	380.0	
87661	chr19	42292267	42292575	308	154.0	
87662	chr19	42293565	42294659	1094	547.0	
87663	chr19	42295601	42296698	1097	548.0	
87664	chr19	42301454	42303430	1976	988.0	
87665	chr19	42313041	42314085	1044	522.0	
87666	chr19	42316501	42317249	748	374.0	
87667	chr19	42323701	42326704	3003	1502.0	
87668	chr19	42347039	42347565	526	263.0	
87669	chr19	42352332	42352929	597	298.0	
87670	chr19	42363603	42364054	451	226.0	
87671	chr19	42365110	42365609	499	250.0	
87672	chr19	42370574	42371019	445	222.0	
87673	chr19	42386756	42387753	997	498.0	
87674	chr19	42396102	42397975	1873	936.0	
87675	chr19	42401068	42402625	1557	778.0	
87676	chr19	42419908	42420559	651	326.0	
87677	chr19	42422481	42424657	2176	1088.0	
87678	chr19	42433568	42434086	518	259.0	
87679	chr19	42438239	42439019	780	390.0	
87680	chr19	42440232	42441487	1255	628.0	
87681	chr19	42449776	42451087	1311	656.0	
87682	chr19	42455665	42455969	304	152.0	
87683	chr19	42465687	42466250	563	282.0	
87684	chr19	42480817	42480931	114	57.0	
87685	chr19	42497338	42497832	494	247.0	
87686	chr19	42528264	42529861	1597	798.0	
87687	chr19	42553203	42554009	806	403.0	
87688	chr19	42555303	42556099	796	398.0	
87689	chr19	42563306	42563763	457	228.0	
87690	chr19	42566868	42568518	1650	825.0	
87691	chr19	42596446	42596943	497	248.0	
87692	chr19	42606948	42606992	44	22.0	
87693	chr19	43432794	43433352	558	279.0	
87694	chr19	43438839	43439999	1160	580.0	
87695	chr19	43444907	43445289	382	191.0	
87696	chr19	43446936	43447666	730	365.0	
87697	chr19	43450530	43450905	375	188.0	
87698	chr19	43456044	43456141	97	48.0	
87699	chr19	43462685	43464911	2226	1113.0	
87700	chr19	43465432	43465942	510	255.0	
87701	chr19	43467730	43472310	4580	2290.0	
87702	chr19	43473688	43476075	2387	1194.0	
87703	chr19	43487432	43487877	445	222.0	
87704	chr19	43503107	43505433	2326	1163.0	
87705	chr19	43518649	43519915	1266	633.0	
87706	chr19	43524870	43527735	2865	1432.0	
87707	chr19	43531912	43535917	4005	2002.0	
87708	chr19	43555079	43555686	607	304.0	
87709	chr19	43560633	43560980	347	174.0	
87710	chr19	43561917	43563936	2019	1010.0	
87711	chr19	43574671	43576376	1705	852.0	
87712	chr19	43580042	43580943	901	450.0	
87713	chr19	43584011	43584657	646	323.0	
87714	chr19	43589726	43590033	307	154.0	
87715	chr19	43593047	43593221	174	87.0	
87716	chr19	43594330	43597303	2973	1486.0	
87717	chr19	43618776	43620670	1894	947.0	
87718	chr19	43624791	43625409	618	309.0	
87719	chr19	43626246	43626308	62	31.0	
87720	chr19	43638513	43640860	2347	1174.0	
87721	chr19	43641484	43641786	302	151.0	
87722	chr19	43644093	43648276	4183	2092.0	
87723	chr19	43648863	43649426	563	282.0	
87724	chr19	43649927	43650564	637	318.0	
87725	chr19	43652051	43663283	11232	5616.0	
87726	chr19	43663806	43666557	2751	1376.0	
87727	chr19	43667539	43670853	3314	1657.0	
87728	chr19	43671621	43671907	286	143.0	
87729	chr19	43674024	43675886	1862	931.0	
87730	chr19	43681751	43682243	492	246.0	
87731	chr19	43683231	43683632	401	200.0	
87732	chr19	43684234	43684691	457	228.0	
87733	chr19	43688292	43688764	472	236.0	
87734	chr19	43690919	43691235	316	158.0	
87735	chr19	43692347	43693981	1634	817.0	
87736	chr19	43696099	43696777	678	339.0	
87737	chr19	43699479	43701935	2456	1228.0	
87738	chr19	43723662	43723719	57	28.0	
87739	chr19	43725398	43725902	504	252.0	
87740	chr19	43726806	43727207	401	200.0	
87741	chr19	43732006	43732651	645	322.0	
87742	chr19	43738653	43739295	642	321.0	
87743	chr19	43744734	43745880	1146	573.0	
87744	chr19	43753001	43756565	3564	1782.0	
87745	chr19	43757258	43757622	364	182.0	
87746	chr19	43763530	43763819	289	144.0	
87747	chr19	43764917	43767068	2151	1076.0	
87748	chr19	43768162	43769076	914	457.0	
87749	chr19	43774338	43774873	535	268.0	
87750	chr19	43777042	43783341	6299	3150.0	
87751	chr19	43784103	43785782	1679	840.0	
87752	chr19	43789053	43789268	215	108.0	
87753	chr19	43798533	43799252	719	360.0	
87754	chr19	43809749	43810236	487	244.0	
87755	chr19	43820340	43820957	617	308.0	
87756	chr19	43826712	43827978	1266	633.0	
87757	chr19	43901371	43902321	950	475.0	
87758	chr19	43934726	43935949	1223	612.0	
87759	chr19	43950779	43951686	907	454.0	
87760	chr19	43983698	43984984	1286	643.0	
87761	chr19	44002229	44004064	1835	918.0	
87762	chr19	44006005	44006416	411	206.0	
87763	chr19	44024863	44025852	989	494.0	
87764	chr19	44051076	44052391	1315	658.0	
87765	chr19	44071482	44073062	1580	790.0	
87766	chr19	44093797	44095653	1856	928.0	
87767	chr19	44112767	44114246	1479	740.0	
87768	chr19	44141089	44142196	1107	554.0	
87769	chr19	44164340	44165981	1641	820.0	
87770	chr19	44207018	44208052	1034	517.0	
87771	chr19	44211948	44213344	1396	698.0	
87772	chr19	44259664	44260199	535	268.0	
87773	chr19	44304537	44305361	824	412.0	
87774	chr19	44401176	44401923	747	374.0	
87775	chr19	44448093	44448802	709	354.0	
87776	chr19	44499675	44501130	1455	728.0	
87777	chr19	44552339	44552665	326	163.0	
87778	chr19	44570842	44571276	434	217.0	
87779	chr19	44576973	44577302	329	164.0	
87780	chr19	44587896	44588808	912	456.0	
87781	chr19	44607009	44607441	432	216.0	
87782	chr19	44610550	44610845	295	148.0	
87783	chr19	44622996	44623555	559	280.0	
87784	chr19	44635933	44636539	606	303.0	
87785	chr19	44643600	44644555	955	478.0	
87786	chr19	44648894	44649301	407	204.0	
87787	chr19	44654162	44654886	724	362.0	
87788	chr19	44657133	44657688	555	278.0	
87789	chr19	44677764	44677800	36	18.0	
87790	chr19	44682824	44683166	342	171.0	
87791	chr19	44684939	44686444	1505	752.0	
87792	chr19	44687884	44688306	422	211.0	
87793	chr19	44689093	44689773	680	340.0	
87794	chr19	44691572	44692728	1156	578.0	
87795	chr19	44694196	44694599	403	202.0	
87796	chr19	44718776	44719071	295	148.0	
87797	chr19	44721419	44722973	1554	777.0	
87798	chr19	44723569	44724554	985	492.0	
87799	chr19	44732593	44732994	401	200.0	
87800	chr19	44736549	44737703	1154	577.0	
87801	chr19	44738578	44739489	911	456.0	
87802	chr19	44740281	44740654	373	186.0	
87803	chr19	44741342	44755458	14116	7058.0	
87804	chr19	44756924	44757617	693	346.0	
87805	chr19	44758805	44758859	54	27.0	
87806	chr19	44760507	44761516	1009	504.0	
87807	chr19	44762081	44762553	472	236.0	
87808	chr19	44763895	44764678	783	392.0	
87809	chr19	44765239	44766196	957	478.0	
87810	chr19	44767695	44768508	813	406.0	
87811	chr19	44769932	44771306	1374	687.0	
87812	chr19	44784290	44784984	694	347.0	
87813	chr19	44800216	44800913	697	348.0	
87814	chr19	44808782	44809231	449	224.0	
87815	chr19	44844379	44848641	4262	2131.0	
87816	chr19	44849264	44849966	702	351.0	
87817	chr19	44856359	44856693	334	167.0	
87818	chr19	44868675	44870544	1869	934.0	
87819	chr19	44889892	44891954	2062	1031.0	
87820	chr19	44903343	44904325	982	491.0	
87821	chr19	44905621	44906814	1193	596.0	
87822	chr19	44911132	44911608	476	238.0	
87823	chr19	44914511	44915663	1152	576.0	promoter
87824	chr19	44925257	44925855	598	299.0	
87825	chr19	44926659	44927650	991	496.0	
87826	chr19	44943707	44944255	548	274.0	
87827	chr19	44951333	44952004	671	336.0	
87828	chr19	44954193	44956463	2270	1135.0	
87829	chr19	44957543	44957545	2	1.0	
87830	chr19	44961334	44961771	437	218.0	
87831	chr19	44987406	44987665	259	130.0	
87832	chr19	44989098	44989786	688	344.0	
87833	chr19	44991968	44992309	341	170.0	
87834	chr19	44994377	44994553	176	88.0	
87835	chr19	44999532	45002941	3409	1704.0	
87836	chr19	45006723	45007324	601	300.0	
87837	chr19	45008568	45009073	505	252.0	
87838	chr19	45016051	45017435	1384	692.0	
87839	chr19	45038561	45040949	2388	1194.0	
87840	chr19	45047180	45047939	759	380.0	
87841	chr19	45051845	45052709	864	432.0	
87842	chr19	45059070	45060051	981	490.0	
87843	chr19	45069067	45069479	412	206.0	
87844	chr19	45071163	45071218	55	28.0	
87845	chr19	45071772	45071960	188	94.0	
87846	chr19	45072489	45072865	376	188.0	
87847	chr19	45074307	45076983	2676	1338.0	
87848	chr19	45078747	45080655	1908	954.0	
87849	chr19	45087280	45088128	848	424.0	
87850	chr19	45091150	45093876	2726	1363.0	
87851	chr19	45103004	45103970	966	483.0	
87852	chr19	45104872	45105052	180	90.0	
87853	chr19	45115698	45116310	612	306.0	
87854	chr19	45117089	45117745	656	328.0	
87855	chr19	45118619	45119098	479	240.0	
87856	chr19	45125935	45126517	582	291.0	
87857	chr19	45137425	45137557	132	66.0	
87858	chr19	45152126	45154235	2109	1054.0	
87859	chr19	45164154	45165318	1164	582.0	
87860	chr19	45171154	45172702	1548	774.0	
87861	chr19	45175737	45176057	320	160.0	
87862	chr19	45177471	45179969	2498	1249.0	
87863	chr19	45180965	45181299	334	167.0	
87864	chr19	45184637	45185380	743	372.0	
87865	chr19	45187289	45187978	689	344.0	
87866	chr19	45248517	45249598	1081	540.0	
87867	chr19	45250572	45252514	1942	971.0	
87868	chr19	45253414	45254355	941	470.0	
87869	chr19	45280582	45280793	211	106.0	
87870	chr19	45283392	45284299	907	454.0	
87871	chr19	45296219	45296792	573	286.0	
87872	chr19	45308042	45308473	431	216.0	
87873	chr19	45311558	45312137	579	290.0	
87874	chr19	45326009	45326609	600	300.0	
87875	chr19	45338409	45339096	687	344.0	
87876	chr19	45340467	45341302	835	418.0	
87877	chr19	45369930	45371322	1392	696.0	
87878	chr19	45385751	45385771	20	10.0	
87879	chr19	45398055	45398940	885	442.0	
87880	chr19	45402267	45402958	691	346.0	
87881	chr19	45403814	45407245	3431	1716.0	
87882	chr19	45409502	45409912	410	205.0	
87883	chr19	45418754	45420088	1334	667.0	
87884	chr19	45423044	45424969	1925	962.0	
87885	chr19	45427245	45429377	2132	1066.0	
87886	chr19	45430891	45431555	664	332.0	
87887	chr19	45439091	45441597	2506	1253.0	
87888	chr19	45442273	45445372	3099	1550.0	
87889	chr19	45446105	45457358	11253	5626.0	
87890	chr19	45458115	45458183	68	34.0	
87891	chr19	45459677	45461399	1722	861.0	
87892	chr19	45462170	45462724	554	277.0	
87893	chr19	45463419	45463423	4	2.0	
87894	chr19	45464164	45465776	1612	806.0	
87895	chr19	45466331	45491639	25308	12654.0	
87896	chr19	45492391	45495170	2779	1390.0	
87897	chr19	45495706	45499988	4282	2141.0	
87898	chr19	45501644	45502771	1127	564.0	
87899	chr19	45505518	45510479	4961	2480.0	
87900	chr19	45511926	45512575	649	324.0	
87901	chr19	45513118	45516925	3807	1904.0	
87902	chr19	45518522	45519156	634	317.0	
87903	chr19	45520960	45521377	417	208.0	
87904	chr19	45522164	45524515	2351	1176.0	
87905	chr19	45525865	45529808	3943	1972.0	
87906	chr19	45543785	45544275	490	245.0	
87907	chr19	45558251	45559034	783	392.0	
87908	chr19	45562638	45563227	589	294.0	
87909	chr19	45564168	45564467	299	150.0	
87910	chr19	45569811	45570343	532	266.0	
87911	chr19	45583643	45585793	2150	1075.0	
87912	chr19	45590884	45591382	498	249.0	
87913	chr19	45592385	45592775	390	195.0	
87914	chr19	45598186	45600197	2011	1006.0	
87915	chr19	45601830	45602291	461	230.0	
87916	chr19	45607108	45607861	753	376.0	
87917	chr19	45614115	45614848	733	366.0	
87918	chr19	45615840	45616539	699	350.0	
87919	chr19	45632505	45632920	415	208.0	
87920	chr19	45638797	45639850	1053	526.0	
87921	chr19	45640882	45643930	3048	1524.0	
87922	chr19	45644870	45646591	1721	860.0	
87923	chr19	45667440	45671539	4099	2050.0	
87924	chr19	45675967	45678341	2374	1187.0	
87925	chr19	45681070	45682313	1243	622.0	
87926	chr19	45691400	45693948	2548	1274.0	
87927	chr19	45706688	45707490	802	401.0	
87928	chr19	45716364	45718401	2037	1018.0	
87929	chr19	45729729	45731468	1739	870.0	
87930	chr19	45739476	45740163	687	344.0	
87931	chr19	45767862	45771315	3453	1726.0	"origin_of_replication	protein_binding_site	sequence_feature	repeat_region	repeat_region	protein_binding_site"
87932	chr19	45778928	45780477	1549	774.0	
87933	chr19	45781003	45781400	397	198.0	
87934	chr19	45790571	45793558	2987	1494.0	
87935	chr19	45794109	45794178	69	34.0	
87936	chr19	45798800	45799636	836	418.0	
87937	chr19	45806459	45806864	405	202.0	
87938	chr19	45809772	45809955	183	92.0	
87939	chr19	45815172	45816202	1030	515.0	
87940	chr19	45816832	45818168	1336	668.0	
87941	chr19	45862136	45864812	2676	1338.0	
87942	chr19	45876213	45877155	942	471.0	
87943	chr19	45882767	45884138	1371	686.0	
87944	chr19	45885176	45887475	2299	1150.0	
87945	chr19	45893331	45893829	498	249.0	
87946	chr19	45901281	45903730	2449	1224.0	
87947	chr19	45922501	45922717	216	108.0	
87948	chr19	45927441	45928344	903	452.0	
87949	chr19	45952550	45953486	936	468.0	
87950	chr19	45971754	45972610	856	428.0	
87951	chr19	45973314	45974971	1657	828.0	
87952	chr19	45994655	45996080	1425	712.0	
87953	chr19	45999556	46001379	1823	912.0	
87954	chr19	46009498	46010189	691	346.0	
87955	chr19	46014934	46017417	2483	1242.0	
87956	chr19	46023140	46023342	202	101.0	
87957	chr19	46028820	46029325	505	252.0	
87958	chr19	46077587	46077895	308	154.0	
87959	chr19	46082454	46082571	117	58.0	
87960	chr19	46181262	46181841	579	290.0	
87961	chr19	46184866	46185518	652	326.0	
87962	chr19	46189407	46189825	418	209.0	
87963	chr19	46191985	46193587	1602	801.0	
87964	chr19	46257143	46257167	24	12.0	
87965	chr19	46262734	46263387	653	326.0	
87966	chr19	46265169	46265718	549	274.0	
87967	chr19	46269130	46269422	292	146.0	
87968	chr19	46280754	46281118	364	182.0	
87969	chr19	46346060	46347935	1875	938.0	
87970	chr19	46349625	46351896	2271	1136.0	
87971	chr19	46361894	46362295	401	200.0	
87972	chr19	46395288	46396205	917	458.0	
87973	chr19	46402187	46402661	474	237.0	
87974	chr19	46403854	46404762	908	454.0	
87975	chr19	46426853	46426941	88	44.0	
87976	chr19	46428542	46429367	825	412.0	
87977	chr19	46478411	46478690	279	140.0	
87978	chr19	46487756	46488303	547	274.0	
87979	chr19	46489405	46490688	1283	642.0	
87980	chr19	46493066	46494122	1056	528.0	
87981	chr19	46495674	46496150	476	238.0	
87982	chr19	46513354	46513904	550	275.0	
87983	chr19	46515753	46516249	496	248.0	
87984	chr19	46522862	46523385	523	262.0	
87985	chr19	46529291	46531178	1887	944.0	
87986	chr19	46537275	46537945	670	335.0	
87987	chr19	46542367	46543254	887	444.0	
87988	chr19	46546487	46547303	816	408.0	
87989	chr19	46551064	46551562	498	249.0	
87990	chr19	46574517	46574852	335	168.0	
87991	chr19	46575963	46576080	117	58.0	
87992	chr19	46577003	46577357	354	177.0	
87993	chr19	46599974	46603719	3745	1872.0	
87994	chr19	46611003	46612872	1869	934.0	
87995	chr19	46613879	46614743	864	432.0	
87996	chr19	46616590	46620433	3843	1922.0	
87997	chr19	46622045	46622191	146	73.0	
87998	chr19	46624802	46625698	896	448.0	
87999	chr19	46626462	46626960	498	249.0	
88000	chr19	46633468	46640322	6854	3427.0	
88001	chr19	46647987	46648862	875	438.0	
88002	chr19	46659173	46662747	3574	1787.0	
88003	chr19	46678010	46678705	695	348.0	
88004	chr19	46697303	46697975	672	336.0	
88005	chr19	46704222	46705277	1055	528.0	
88006	chr19	46710687	46711064	377	188.0	
88007	chr19	46713405	46719752	6347	3174.0	
88008	chr19	46723117	46723446	329	164.0	
88009	chr19	46728515	46729359	844	422.0	
88010	chr19	46730883	46732058	1175	588.0	
88011	chr19	46733171	46734355	1184	592.0	
88012	chr19	46743158	46743240	82	41.0	
88013	chr19	46744324	46744326	2	1.0	
88014	chr19	46745038	46748934	3896	1948.0	
88015	chr19	46750068	46750504	436	218.0	
88016	chr19	46753569	46754246	677	338.0	
88017	chr19	46755039	46755540	501	250.0	
88018	chr19	46757096	46757922	826	413.0	
88019	chr19	46766453	46767318	865	432.0	
88020	chr19	46772227	46775359	3132	1566.0	
88021	chr19	46777416	46779737	2321	1160.0	
88022	chr19	46783892	46789389	5497	2748.0	
88023	chr19	46791865	46792474	609	304.0	
88024	chr19	46819876	46820347	471	236.0	
88025	chr19	46821249	46822548	1299	650.0	
88026	chr19	46824135	46825791	1656	828.0	
88027	chr19	46830020	46830285	265	132.0	
88028	chr19	46840267	46841126	859	430.0	
88029	chr19	46845892	46846760	868	434.0	
88030	chr19	46849141	46851661	2520	1260.0	
88031	chr19	46855634	46857173	1539	770.0	
88032	chr19	46859665	46863360	3695	1848.0	
88033	chr19	46913763	46914161	398	199.0	
88034	chr19	46924890	46925201	311	156.0	
88035	chr19	46935198	46935744	546	273.0	
88036	chr19	46936462	46937112	650	325.0	
88037	chr19	46950583	46951075	492	246.0	
88038	chr19	46954476	46956274	1798	899.0	
88039	chr19	46967402	46968148	746	373.0	
88040	chr19	46976836	46977352	516	258.0	
88041	chr19	46978274	46979102	828	414.0	
88042	chr19	46980846	46981958	1112	556.0	
88043	chr19	46984494	46984928	434	217.0	
88044	chr19	46990908	46991746	838	419.0	
88045	chr19	47003456	47003854	398	199.0	
88046	chr19	47012732	47013595	863	432.0	
88047	chr19	47019339	47021768	2429	1214.0	
88048	chr19	47023331	47023570	239	120.0	
88049	chr19	47032096	47032814	718	359.0	
88050	chr19	47035115	47036699	1584	792.0	
88051	chr19	47047351	47049358	2007	1004.0	
88052	chr19	47075121	47075833	712	356.0	
88053	chr19	47079244	47079950	706	353.0	
88054	chr19	47093813	47096037	2224	1112.0	
88055	chr19	47106915	47108299	1384	692.0	
88056	chr19	47109379	47114573	5194	2597.0	
88057	chr19	47124980	47125824	844	422.0	
88058	chr19	47130193	47131846	1653	826.0	
88059	chr19	47145659	47146465	806	403.0	
88060	chr19	47149271	47150001	730	365.0	
88061	chr19	47156820	47159671	2851	1426.0	
88062	chr19	47176516	47177222	706	353.0	
88063	chr19	47182323	47182844	521	260.0	
88064	chr19	47186323	47188058	1735	868.0	
88065	chr19	47190121	47190545	424	212.0	
88066	chr19	47210472	47211329	857	428.0	
88067	chr19	47225376	47233189	7813	3906.0	
88068	chr19	47239114	47244972	5858	2929.0	
88069	chr19	47247151	47247993	842	421.0	
88070	chr19	47253613	47254178	565	282.0	
88071	chr19	47255000	47258174	3174	1587.0	
88072	chr19	47262084	47262915	831	416.0	
88073	chr19	47271150	47275653	4503	2252.0	
88074	chr19	47280154	47280640	486	243.0	
88075	chr19	47284070	47284787	717	358.0	
88076	chr19	47288279	47288849	570	285.0	
88077	chr19	47289491	47289543	52	26.0	
88078	chr19	47293878	47294341	463	232.0	
88079	chr19	47295926	47296731	805	402.0	
88080	chr19	47300149	47300284	135	68.0	
88081	chr19	47302085	47302770	685	342.0	
88082	chr19	47305221	47305795	574	287.0	
88083	chr19	47308554	47311603	3049	1524.0	
88084	chr19	47313202	47314313	1111	556.0	
88085	chr19	47314998	47315984	986	493.0	
88086	chr19	47321996	47322591	595	298.0	
88087	chr19	47323893	47324956	1063	532.0	
88088	chr19	47330442	47331436	994	497.0	
88089	chr19	47335551	47337489	1938	969.0	
88090	chr19	47348562	47350293	1731	866.0	
88091	chr19	47351512	47352304	792	396.0	
88092	chr19	47363586	47364409	823	412.0	
88093	chr19	47369616	47370736	1120	560.0	
88094	chr19	47371283	47371651	368	184.0	
88095	chr19	47376449	47376962	513	256.0	
88096	chr19	47381731	47382474	743	372.0	
88097	chr19	47383225	47383962	737	368.0	
88098	chr19	47388560	47390391	1831	916.0	
88099	chr19	47391203	47392023	820	410.0	
88100	chr19	47407173	47407437	264	132.0	
88101	chr19	47417042	47419691	2649	1324.0	
88102	chr19	47420386	47422099	1713	856.0	
88103	chr19	47427027	47428928	1901	950.0	
88104	chr19	47429727	47430601	874	437.0	
88105	chr19	47435188	47435705	517	258.0	
88106	chr19	47436435	47437249	814	407.0	
88107	chr19	47444272	47444914	642	321.0	
88108	chr19	47445722	47448125	2403	1202.0	
88109	chr19	47471299	47472444	1145	572.0	
88110	chr19	47480071	47480407	336	168.0	
88111	chr19	47483386	47485559	2173	1086.0	
88112	chr19	47486389	47487951	1562	781.0	
88113	chr19	47489316	47490282	966	483.0	
88114	chr19	47490850	47494068	3218	1609.0	
88115	chr19	47495340	47498507	3167	1584.0	
88116	chr19	47499408	47499424	16	8.0	
88117	chr19	47505155	47508676	3521	1760.0	
88118	chr19	47509515	47510445	930	465.0	
88119	chr19	47511052	47516241	5189	2594.0	
88120	chr19	47518006	47518626	620	310.0	
88121	chr19	47522005	47522292	287	144.0	
88122	chr19	47539648	47540446	798	399.0	
88123	chr19	47541399	47542364	965	482.0	
88124	chr19	47545217	47545324	107	54.0	
88125	chr19	47572782	47573951	1169	584.0	
88126	chr19	47577583	47578112	529	264.0	
88127	chr19	47595789	47596408	619	310.0	
88128	chr19	47598774	47599163	389	194.0	
88129	chr19	47599792	47601321	1529	764.0	
88130	chr19	47604420	47604454	34	17.0	
88131	chr19	47607745	47610946	3201	1600.0	
88132	chr19	47637588	47637613	25	12.0	
88133	chr19	47663769	47664661	892	446.0	
88134	chr19	47697837	47698706	869	434.0	
88135	chr19	47699283	47699765	482	241.0	
88136	chr19	47707186	47707749	563	282.0	
88137	chr19	47713081	47713746	665	332.0	
88138	chr19	47723152	47723970	818	409.0	
88139	chr19	47726508	47726858	350	175.0	
88140	chr19	47729859	47730560	701	350.0	
88141	chr19	47743005	47744333	1328	664.0	
88142	chr19	47744905	47746197	1292	646.0	
88143	chr19	47752788	47753125	337	168.0	
88144	chr19	47758049	47758758	709	354.0	
88145	chr19	47765842	47766299	457	228.0	
88146	chr19	47777900	47779595	1695	848.0	
88147	chr19	47788716	47789196	480	240.0	
88148	chr19	47790309	47790945	636	318.0	
88149	chr19	47813664	47814138	474	237.0	
88150	chr19	47863398	47863811	413	206.0	
88151	chr19	47868824	47869316	492	246.0	
88152	chr19	47941221	47941569	348	174.0	
88153	chr19	47963089	47963589	500	250.0	
88154	chr19	48103068	48103505	437	218.0	
88155	chr19	48107260	48107977	717	358.0	
88156	chr19	48110266	48111419	1153	576.0	
88157	chr19	48117743	48118144	401	200.0	
88158	chr19	48152391	48152957	566	283.0	
88159	chr19	48162273	48162672	399	200.0	
88160	chr19	48169113	48171355	2242	1121.0	
88161	chr19	48190262	48190915	653	326.0	
88162	chr19	48194342	48194651	309	154.0	
88163	chr19	48203332	48204813	1481	740.0	
88164	chr19	48206407	48206922	515	258.0	
88165	chr19	48241123	48241220	97	48.0	
88166	chr19	48244206	48244801	595	298.0	
88167	chr19	48249325	48250191	866	433.0	
88168	chr19	48255354	48256253	899	450.0	
88169	chr19	48258242	48258754	512	256.0	
88170	chr19	48259471	48260590	1119	560.0	
88171	chr19	48266782	48267483	701	350.0	
88172	chr19	48270844	48272146	1302	651.0	
88173	chr19	48290777	48291680	903	452.0	
88174	chr19	48314325	48314807	482	241.0	
88175	chr19	48319752	48323800	4048	2024.0	
88176	chr19	48324801	48326736	1935	968.0	
88177	chr19	48329095	48331099	2004	1002.0	
88178	chr19	48332110	48334555	2445	1222.0	
88179	chr19	48351182	48351863	681	340.0	
88180	chr19	48362728	48365060	2332	1166.0	
88181	chr19	48390292	48392130	1838	919.0	
88182	chr19	48393220	48395915	2695	1348.0	
88183	chr19	48397735	48400852	3117	1558.0	
88184	chr19	48403170	48404114	944	472.0	
88185	chr19	48414315	48416106	1791	896.0	
88186	chr19	48418696	48419832	1136	568.0	
88187	chr19	48424672	48425191	519	260.0	
88188	chr19	48443009	48446693	3684	1842.0	
88189	chr19	48468329	48470310	1981	990.0	
88190	chr19	48470828	48470949	121	60.0	
88191	chr19	48477001	48478623	1622	811.0	
88192	chr19	48479255	48481525	2270	1135.0	
88193	chr19	48489518	48494372	4854	2427.0	
88194	chr19	48495419	48495862	443	222.0	
88195	chr19	48501138	48503006	1868	934.0	
88196	chr19	48506036	48506815	779	390.0	
88197	chr19	48510256	48514409	4153	2076.0	
88198	chr19	48558111	48558567	456	228.0	
88199	chr19	48574584	48575261	677	338.0	
88200	chr19	48583673	48584725	1052	526.0	
88201	chr19	48588653	48589579	926	463.0	
88202	chr19	48596900	48597585	685	342.0	
88203	chr19	48608639	48609407	768	384.0	
88204	chr19	48613578	48617013	3435	1718.0	
88205	chr19	48617681	48620417	2736	1368.0	
88206	chr19	48622115	48623055	940	470.0	
88207	chr19	48623569	48625385	1816	908.0	
88208	chr19	48627097	48627749	652	326.0	
88209	chr19	48628494	48631337	2843	1422.0	
88210	chr19	48632788	48633143	355	178.0	
88211	chr19	48634109	48639364	5255	2628.0	
88212	chr19	48644364	48647382	3018	1509.0	
88213	chr19	48648996	48649918	922	461.0	
88214	chr19	48652535	48653101	566	283.0	
88215	chr19	48659723	48661807	2084	1042.0	
88216	chr19	48675103	48675834	731	366.0	
88217	chr19	48684533	48684872	339	170.0	
88218	chr19	48696352	48696985	633	316.0	
88219	chr19	48713035	48715096	2061	1030.0	
88220	chr19	48720169	48721553	1384	692.0	
88221	chr19	48724599	48727212	2613	1306.0	
88222	chr19	48737478	48740148	2670	1335.0	
88223	chr19	48741423	48741918	495	248.0	
88224	chr19	48744937	48745812	875	438.0	
88225	chr19	48746627	48747550	923	462.0	
88226	chr19	48751893	48753360	1467	734.0	
88227	chr19	48760810	48760900	90	45.0	
88228	chr19	48780652	48781347	695	348.0	
88229	chr19	48782204	48782874	670	335.0	
88230	chr19	48787908	48788576	668	334.0	
88231	chr19	48794982	48796212	1230	615.0	
88232	chr19	48806540	48807089	549	274.0	
88233	chr19	48810078	48813027	2949	1474.0	
88234	chr19	48815965	48816323	358	179.0	
88235	chr19	48835443	48837624	2181	1090.0	
88236	chr19	48838627	48839281	654	327.0	
88237	chr19	48842624	48843141	517	258.0	
88238	chr19	48858369	48860492	2123	1062.0	
88239	chr19	48868098	48869606	1508	754.0	
88240	chr19	48871843	48888316	16473	8236.0	
88241	chr19	48891412	48892124	712	356.0	
88242	chr19	48895696	48897527	1831	916.0	
88243	chr19	48899621	48901500	1879	940.0	
88244	chr19	48907604	48908036	432	216.0	
88245	chr19	48913058	48913754	696	348.0	
88246	chr19	48918733	48919148	415	208.0	
88247	chr19	48933053	48934297	1244	622.0	
88248	chr19	48954221	48955766	1545	772.0	
88249	chr19	48959136	48960269	1133	566.0	
88250	chr19	48961914	48971528	9614	4807.0	
88251	chr19	48975922	48976630	708	354.0	
88252	chr19	48978901	48979251	350	175.0	
88253	chr19	48983412	48984090	678	339.0	
88254	chr19	48986241	48986655	414	207.0	
88255	chr19	48992136	48994463	2327	1164.0	
88256	chr19	48997995	48998411	416	208.0	
88257	chr19	48999488	49000203	715	358.0	
88258	chr19	49017268	49020069	2801	1400.0	
88259	chr19	49021016	49021777	761	380.0	
88260	chr19	49031629	49032087	458	229.0	
88261	chr19	49055830	49058271	2441	1220.0	
88262	chr19	49071803	49072982	1179	590.0	
88263	chr19	49073971	49074047	76	38.0	
88264	chr19	49074858	49075310	452	226.0	
88265	chr19	49084595	49086339	1744	872.0	
88266	chr19	49097579	49098402	823	412.0	
88267	chr19	49106609	49107107	498	249.0	
88268	chr19	49113610	49115344	1734	867.0	
88269	chr19	49116449	49116972	523	262.0	
88270	chr19	49118099	49120953	2854	1427.0	
88271	chr19	49127554	49129766	2212	1106.0	
88272	chr19	49132923	49134320	1397	698.0	
88273	chr19	49136080	49136418	338	169.0	
88274	chr19	49142734	49143352	618	309.0	
88275	chr19	49145575	49146598	1023	512.0	
88276	chr19	49148684	49152569	3885	1942.0	
88277	chr19	49157461	49158395	934	467.0	
88278	chr19	49198828	49199241	413	206.0	
88279	chr19	49200390	49200647	257	128.0	
88280	chr19	49205080	49205555	475	238.0	
88281	chr19	49207774	49208713	939	470.0	
88282	chr19	49210033	49210817	784	392.0	
88283	chr19	49224869	49225207	338	169.0	
88284	chr19	49225815	49226526	711	356.0	
88285	chr19	49231546	49231736	190	95.0	
88286	chr19	49266315	49266802	487	244.0	
88287	chr19	49301059	49301715	656	328.0	
88288	chr19	49326105	49326580	475	238.0	
88289	chr19	49327769	49328428	659	330.0	
88290	chr19	49331350	49332261	911	456.0	
88291	chr19	49333237	49336872	3635	1818.0	
88292	chr19	49338842	49339260	418	209.0	
88293	chr19	49340043	49340870	827	414.0	
88294	chr19	49347730	49348203	473	236.0	
88295	chr19	49355883	49356177	294	147.0	
88296	chr19	49360429	49360726	297	148.0	
88297	chr19	49361244	49364097	2853	1426.0	
88298	chr19	49387788	49388675	887	444.0	
88299	chr19	49390932	49392485	1553	776.0	
88300	chr19	49403392	49403626	234	117.0	
88301	chr19	49409167	49410035	868	434.0	
88302	chr19	49420892	49424423	3531	1766.0	
88303	chr19	49426212	49426395	183	92.0	
88304	chr19	49427802	49428612	810	405.0	
88305	chr19	49430748	49433907	3159	1580.0	
88306	chr19	49435301	49435538	237	118.0	
88307	chr19	49436223	49436810	587	294.0	
88308	chr19	49437326	49437328	2	1.0	
88309	chr19	49438532	49438646	114	57.0	
88310	chr19	49440960	49444228	3268	1634.0	
88311	chr19	49451202	49454364	3162	1581.0	
88312	chr19	49457968	49458700	732	366.0	
88313	chr19	49468243	49471070	2827	1414.0	
88314	chr19	49472814	49476940	4126	2063.0	
88315	chr19	49478616	49479443	827	414.0	
88316	chr19	49486050	49486294	244	122.0	
88317	chr19	49486837	49503612	16775	8388.0	
88318	chr19	49506330	49507331	1001	500.0	
88319	chr19	49511340	49513969	2629	1314.0	
88320	chr19	49515574	49516388	814	407.0	
88321	chr19	49527342	49528562	1220	610.0	
88322	chr19	49532975	49535284	2309	1154.0	
88323	chr19	49537824	49538339	515	258.0	
88324	chr19	49546593	49547600	1007	504.0	
88325	chr19	49551566	49551933	367	184.0	
88326	chr19	49552666	49559069	6403	3202.0	
88327	chr19	49559878	49561491	1613	806.0	
88328	chr19	49564496	49565647	1151	576.0	
88329	chr19	49567538	49571725	4187	2094.0	
88330	chr19	49579903	49581294	1391	696.0	
88331	chr19	49588434	49594187	5753	2876.0	
88332	chr19	49599944	49600224	280	140.0	
88333	chr19	49612159	49612506	347	174.0	
88334	chr19	49614096	49614691	595	298.0	
88335	chr19	49636083	49636432	349	174.0	
88336	chr19	49637637	49642915	5278	2639.0	
88337	chr19	49655794	49656279	485	242.0	
88338	chr19	49659511	49660405	894	447.0	
88339	chr19	49663410	49666767	3357	1678.0	
88340	chr19	49671990	49672939	949	474.0	
88341	chr19	49675510	49681313	5803	2902.0	
88342	chr19	49684375	49684816	441	220.0	
88343	chr19	49689686	49691716	2030	1015.0	
88344	chr19	49716194	49716446	252	126.0	
88345	chr19	49717202	49718304	1102	551.0	
88346	chr19	49745951	49746700	749	374.0	
88347	chr19	49749438	49749707	269	134.0	
88348	chr19	49761699	49762370	671	336.0	
88349	chr19	49765811	49767918	2107	1054.0	
88350	chr19	49771787	49772038	251	126.0	
88351	chr19	49779864	49780733	869	434.0	
88352	chr19	49781305	49781853	548	274.0	
88353	chr19	49807111	49810102	2991	1496.0	
88354	chr19	49812613	49814033	1420	710.0	
88355	chr19	49817072	49819508	2436	1218.0	
88356	chr19	49843311	49843698	387	194.0	
88357	chr19	49848019	49848843	824	412.0	
88358	chr19	49850065	49852454	2389	1194.0	
88359	chr19	49858146	49858362	216	108.0	
88360	chr19	49859830	49860526	696	348.0	
88361	chr19	49861459	49861642	183	92.0	
88362	chr19	49862769	49863204	435	218.0	
88363	chr19	49865217	49865736	519	260.0	
88364	chr19	49866419	49870566	4147	2074.0	
88365	chr19	49871864	49872206	342	171.0	
88366	chr19	49875628	49878724	3096	1548.0	
88367	chr19	49879254	49879718	464	232.0	
88368	chr19	49887577	49888307	730	365.0	
88369	chr19	49889636	49892045	2409	1204.0	
88370	chr19	49892834	49893370	536	268.0	
88371	chr19	49894041	49898399	4358	2179.0	
88372	chr19	49904048	49904612	564	282.0	
88373	chr19	49911014	49912043	1029	514.0	
88374	chr19	49916799	49917898	1099	550.0	
88375	chr19	49923280	49923829	549	274.0	
88376	chr19	49928307	49931082	2775	1388.0	
88377	chr19	49932434	49933257	823	412.0	
88378	chr19	49937234	49938389	1155	578.0	
88379	chr19	49944513	49945549	1036	518.0	
88380	chr19	49953166	49954808	1642	821.0	
88381	chr19	49966724	49967399	675	338.0	
88382	chr19	49968183	49969764	1581	790.0	
88383	chr19	49973992	49974386	394	197.0	
88384	chr19	49983357	49984229	872	436.0	
88385	chr19	49986932	49987787	855	428.0	
88386	chr19	49997631	49998123	492	246.0	
88387	chr19	50003245	50004421	1176	588.0	
88388	chr19	50024570	50026614	2044	1022.0	
88389	chr19	50046833	50047301	468	234.0	
88390	chr19	50050021	50051684	1663	832.0	
88391	chr19	50090704	50091075	371	186.0	
88392	chr19	50142996	50143339	343	172.0	
88393	chr19	50147377	50148656	1279	640.0	
88394	chr19	50173199	50173460	261	130.0	
88395	chr19	50203418	50203699	281	140.0	
88396	chr19	50234476	50234872	396	198.0	
88397	chr19	50315927	50316344	417	208.0	
88398	chr19	50325260	50326306	1046	523.0	
88399	chr19	50328064	50334682	6618	3309.0	
88400	chr19	50340309	50341759	1450	725.0	
88401	chr19	50342551	50343143	592	296.0	
88402	chr19	50344489	50345393	904	452.0	
88403	chr19	50347006	50347770	764	382.0	
88404	chr19	50356944	50360121	3177	1588.0	
88405	chr19	50361141	50361893	752	376.0	
88406	chr19	50364150	50365773	1623	812.0	
88407	chr19	50368270	50369799	1529	764.0	
88408	chr19	50371889	50372254	365	182.0	
88409	chr19	50375857	50388139	12282	6141.0	
88410	chr19	50414522	50416460	1938	969.0	
88411	chr19	50417297	50419911	2614	1307.0	
88412	chr19	50427665	50429132	1467	734.0	
88413	chr19	50430775	50433199	2424	1212.0	
88414	chr19	50434622	50434822	200	100.0	
88415	chr19	50459930	50461717	1787	894.0	
88416	chr19	50475007	50477212	2205	1102.0	
88417	chr19	50479102	50479295	193	96.0	
88418	chr19	50486866	50487267	401	200.0	
88419	chr19	50488222	50490001	1779	890.0	
88420	chr19	50491962	50492972	1010	505.0	
88421	chr19	50510417	50514501	4084	2042.0	
88422	chr19	50537688	50538091	403	202.0	
88423	chr19	50556108	50557042	934	467.0	
88424	chr19	50607868	50608567	699	350.0	
88425	chr19	50639096	50640121	1025	512.0	
88426	chr19	50657811	50659464	1653	826.0	
88427	chr19	50669421	50669729	308	154.0	
88428	chr19	50679097	50679902	805	402.0	
88429	chr19	50695165	50695540	375	188.0	
88430	chr19	50705428	50705839	411	206.0	
88431	chr19	50718451	50718726	275	138.0	
88432	chr19	50719662	50719922	260	130.0	
88433	chr19	50720932	50721379	447	224.0	
88434	chr19	50723213	50725862	2649	1324.0	
88435	chr19	50728212	50728878	666	333.0	
88436	chr19	50772414	50772809	395	198.0	
88437	chr19	50783323	50784046	723	362.0	
88438	chr19	50794658	50794660	2	1.0	
88439	chr19	50803533	50805714	2181	1090.0	
88440	chr19	50817499	50818763	1264	632.0	
88441	chr19	50820842	50821202	360	180.0	
88442	chr19	50835650	50836595	945	472.0	
88443	chr19	50896510	50897361	851	426.0	
88444	chr19	50909338	50909744	406	203.0	
88445	chr19	50922173	50922693	520	260.0	
88446	chr19	50929812	50930210	398	199.0	
88447	chr19	51016941	51017154	213	106.0	
88448	chr19	51018675	51019123	448	224.0	
88449	chr19	51020166	51020300	134	67.0	
88450	chr19	51094700	51095150	450	225.0	
88451	chr19	51097008	51097809	801	400.0	
88452	chr19	51098629	51099267	638	319.0	
88453	chr19	51107628	51109303	1675	838.0	
88454	chr19	51114293	51114761	468	234.0	
88455	chr19	51116766	51117082	316	158.0	
88456	chr19	51120176	51120540	364	182.0	
88457	chr19	51121203	51125305	4102	2051.0	
88458	chr19	51127612	51128278	666	333.0	
88459	chr19	51129057	51129075	18	9.0	
88460	chr19	51131855	51132761	906	453.0	
88461	chr19	51134981	51135408	427	214.0	
88462	chr19	51136469	51137831	1362	681.0	
88463	chr19	51138408	51139993	1585	792.0	
88464	chr19	51141917	51142679	762	381.0	
88465	chr19	51148570	51148973	403	202.0	
88466	chr19	51158350	51159204	854	427.0	
88467	chr19	51166937	51167607	670	335.0	
88468	chr19	51169115	51169760	645	322.0	
88469	chr19	51210743	51211509	766	383.0	
88470	chr19	51224753	51226376	1623	812.0	
88471	chr19	51242933	51243271	338	169.0	
88472	chr19	51245995	51246497	502	251.0	
88473	chr19	51249830	51250164	334	167.0	
88474	chr19	51259328	51259748	420	210.0	
88475	chr19	51272466	51272804	338	169.0	
88476	chr19	51325385	51325989	604	302.0	
88477	chr19	51327134	51328188	1054	527.0	
88478	chr19	51338506	51340973	2467	1234.0	
88479	chr19	51341808	51343170	1362	681.0	
88480	chr19	51354693	51355211	518	259.0	
88481	chr19	51365291	51370705	5414	2707.0	
88482	chr19	51371323	51374028	2705	1352.0	
88483	chr19	51375261	51376387	1126	563.0	
88484	chr19	51380860	51381197	337	168.0	
88485	chr19	51386822	51387436	614	307.0	
88486	chr19	51390452	51391199	747	374.0	
88487	chr19	51393716	51395949	2233	1116.0	
88488	chr19	51398018	51398530	512	256.0	
88489	chr19	51407085	51409302	2217	1108.0	
88490	chr19	51416876	51418217	1341	670.0	
88491	chr19	51421840	51422519	679	340.0	
88492	chr19	51427096	51427685	589	294.0	
88493	chr19	51430191	51431623	1432	716.0	
88494	chr19	51433005	51433545	540	270.0	
88495	chr19	51434406	51434878	472	236.0	
88496	chr19	51438177	51439344	1167	584.0	
88497	chr19	51440755	51442536	1781	890.0	
88498	chr19	51448427	51448676	249	124.0	
88499	chr19	51460502	51460876	374	187.0	
88500	chr19	51461386	51462133	747	374.0	
88501	chr19	51472883	51473366	483	242.0	
88502	chr19	51493729	51494230	501	250.0	
88503	chr19	51501527	51502270	743	372.0	
88504	chr19	51503306	51504254	948	474.0	
88505	chr19	51507213	51507973	760	380.0	
88506	chr19	51514859	51515293	434	217.0	
88507	chr19	51531397	51532182	785	392.0	
88508	chr19	51546741	51547053	312	156.0	
88509	chr19	51551695	51551953	258	129.0	
88510	chr19	51553154	51553571	417	208.0	
88511	chr19	51564828	51565309	481	240.0	
88512	chr19	51570786	51572738	1952	976.0	
88513	chr19	51586042	51586567	525	262.0	
88514	chr19	51593739	51595150	1411	706.0	
88515	chr19	51601188	51601586	398	199.0	
88516	chr19	51606923	51608441	1518	759.0	
88517	chr19	51621059	51621640	581	290.0	
88518	chr19	51630322	51630780	458	229.0	
88519	chr19	51637155	51637719	564	282.0	
88520	chr19	51644822	51645343	521	260.0	
88521	chr19	51646739	51647195	456	228.0	
88522	chr19	51651100	51652570	1470	735.0	
88523	chr19	51656877	51657347	470	235.0	
88524	chr19	51658495	51658959	464	232.0	
88525	chr19	51660942	51661378	436	218.0	
88526	chr19	51668223	51668559	336	168.0	
88527	chr19	51669072	51669534	462	231.0	
88528	chr19	51675933	51676995	1062	531.0	
88529	chr19	51688351	51691467	3116	1558.0	
88530	chr19	51702078	51704938	2860	1430.0	
88531	chr19	51714909	51715040	131	66.0	
88532	chr19	51735666	51736755	1089	544.0	
88533	chr19	51739792	51740744	952	476.0	
88534	chr19	51748222	51748229	7	4.0	
88535	chr19	51750619	51752448	1829	914.0	
88536	chr19	51753985	51754611	626	313.0	
88537	chr19	51760777	51761372	595	298.0	
88538	chr19	51764028	51764939	911	456.0	
88539	chr19	51766290	51766914	624	312.0	
88540	chr19	51771196	51772129	933	466.0	
88541	chr19	51773021	51773440	419	210.0	
88542	chr19	51777781	51778318	537	268.0	
88543	chr19	51781981	51782402	421	210.0	
88544	chr19	51783264	51783951	687	344.0	
88545	chr19	51784628	51785637	1009	504.0	
88546	chr19	51786599	51787120	521	260.0	
88547	chr19	51789025	51789609	584	292.0	
88548	chr19	51796097	51796513	416	208.0	
88549	chr19	51798933	51799828	895	448.0	
88550	chr19	51803601	51804433	832	416.0	
88551	chr19	51805396	51805817	421	210.0	
88552	chr19	51807141	51807377	236	118.0	
88553	chr19	51809778	51810239	461	230.0	
88554	chr19	51811131	51811987	856	428.0	
88555	chr19	51815096	51815361	265	132.0	
88556	chr19	51816653	51817190	537	268.0	
88557	chr19	51819918	51822874	2956	1478.0	
88558	chr19	51824208	51825222	1014	507.0	
88559	chr19	51830162	51830731	569	284.0	
88560	chr19	51887366	51888480	1114	557.0	
88561	chr19	51904187	51905509	1322	661.0	
88562	chr19	51926426	51928080	1654	827.0	
88563	chr19	51986141	51987368	1227	614.0	
88564	chr19	52007420	52008895	1475	738.0	
88565	chr19	52027757	52029140	1383	692.0	
88566	chr19	52047961	52049882	1921	960.0	
88567	chr19	52094968	52096269	1301	650.0	
88568	chr19	52138663	52140656	1993	996.0	
88569	chr19	52170292	52172324	2032	1016.0	
88570	chr19	52176551	52176936	385	192.0	
88571	chr19	52188870	52191168	2298	1149.0	
88572	chr19	52237704	52238279	575	288.0	
88573	chr19	52248290	52248790	500	250.0	
88574	chr19	52268916	52270810	1894	947.0	
88575	chr19	52296336	52298368	2032	1016.0	
88576	chr19	52335759	52337132	1373	686.0	
88577	chr19	52343479	52344038	559	280.0	
88578	chr19	52369418	52370598	1180	590.0	
88579	chr19	52397368	52398484	1116	558.0	
88580	chr19	52453243	52453979	736	368.0	
88581	chr19	52526716	52528459	1743	872.0	
88582	chr19	52535079	52536936	1857	928.0	
88583	chr19	52538802	52539427	625	312.0	
88584	chr19	52542823	52543534	711	356.0	
88585	chr19	52569572	52571105	1533	766.0	
88586	chr19	52600526	52602323	1797	898.0	
88587	chr19	52637446	52639099	1653	826.0	
88588	chr19	52689082	52691341	2259	1130.0	
88589	chr19	52715700	52716348	648	324.0	
88590	chr19	52733929	52735901	1972	986.0	
88591	chr19	52742688	52742948	260	130.0	
88592	chr19	52745776	52746509	733	366.0	
88593	chr19	52748273	52748792	519	260.0	
88594	chr19	52778686	52779400	714	357.0	
88595	chr19	52786091	52787717	1626	813.0	
88596	chr19	52820842	52822063	1221	610.0	
88597	chr19	52833509	52834027	518	259.0	
88598	chr19	52856837	52858268	1431	716.0	
88599	chr19	52896732	52898220	1488	744.0	
88600	chr19	52922614	52924688	2074	1037.0	
88601	chr19	52936284	52936760	476	238.0	
88602	chr19	52941514	52943375	1861	930.0	
88603	chr19	52962023	52963711	1688	844.0	
88604	chr19	52991101	52991115	14	7.0	
88605	chr19	52992635	52994329	1694	847.0	
88606	chr19	53101540	53104335	2795	1398.0	
88607	chr19	53132359	53133155	796	398.0	
88608	chr19	53158042	53159587	1545	772.0	
88609	chr19	53192365	53193917	1552	776.0	
88610	chr19	53195017	53197771	2754	1377.0	
88611	chr19	53254320	53255468	1148	574.0	
88612	chr19	53308468	53308647	179	90.0	
88613	chr19	53328974	53329323	349	174.0	
88614	chr19	53332965	53334480	1515	758.0	
88615	chr19	53360519	53360621	102	51.0	
88616	chr19	53364962	53366528	1566	783.0	
88617	chr19	53394457	53396343	1886	943.0	
88618	chr19	53424901	53425496	595	298.0	
88619	chr19	53431226	53432789	1563	782.0	
88620	chr19	53466986	53468846	1860	930.0	
88621	chr19	53511805	53512325	520	260.0	
88622	chr19	53520293	53521856	1563	782.0	
88623	chr19	53537036	53542185	5149	2574.0	
88624	chr19	53545196	53548183	2987	1494.0	
88625	chr19	53549232	53549756	524	262.0	
88626	chr19	53553073	53564417	11344	5672.0	
88627	chr19	53565023	53572283	7260	3630.0	
88628	chr19	53572967	53574894	1927	964.0	
88629	chr19	53577713	53577729	16	8.0	
88630	chr19	53580197	53582096	1899	950.0	
88631	chr19	53746243	53746721	478	239.0	
88632	chr19	53772861	53773272	411	206.0	
88633	chr19	53792850	53793492	642	321.0	
88634	chr19	53822620	53822914	294	147.0	
88635	chr19	53823656	53824986	1330	665.0	
88636	chr19	53829701	53830525	824	412.0	
88637	chr19	53840875	53841368	493	246.0	
88638	chr19	53841989	53842677	688	344.0	
88639	chr19	53844775	53846002	1227	614.0	
88640	chr19	53849057	53850470	1413	706.0	
88641	chr19	53851615	53853534	1919	960.0	
88642	chr19	53864456	53883971	19515	9758.0	
88643	chr19	53884759	53884779	20	10.0	
88644	chr19	53889515	53890415	900	450.0	
88645	chr19	53903018	53903538	520	260.0	
88646	chr19	53906635	53907324	689	344.0	
88647	chr19	53908007	53908529	522	261.0	
88648	chr19	53927769	53928010	241	120.0	
88649	chr19	53971572	53972215	643	322.0	
88650	chr19	53977259	53978837	1578	789.0	
88651	chr19	53979750	53980655	905	452.0	
88652	chr19	53982143	53983062	919	460.0	
88653	chr19	53991185	53991604	419	210.0	
88654	chr19	54008316	54008602	286	143.0	
88655	chr19	54017296	54017626	330	165.0	
88656	chr19	54018994	54020767	1773	886.0	
88657	chr19	54023474	54024344	870	435.0	
88658	chr19	54029318	54030312	994	497.0	
88659	chr19	54047487	54048113	626	313.0	
88660	chr19	54062575	54063065	490	245.0	
88661	chr19	54063762	54064080	318	159.0	
88662	chr19	54077322	54077784	462	231.0	
88663	chr19	54095618	54097342	1724	862.0	
88664	chr19	54099568	54101222	1654	827.0	
88665	chr19	54102115	54103631	1516	758.0	
88666	chr19	54114048	54116341	2293	1146.0	
88667	chr19	54136281	54139164	2883	1442.0	
88668	chr19	54154781	54155265	484	242.0	
88669	chr19	54158579	54160928	2349	1174.0	
88670	chr19	54161807	54163139	1332	666.0	
88671	chr19	54164340	54165545	1205	602.0	
88672	chr19	54168086	54168927	841	420.0	
88673	chr19	54172771	54173338	567	284.0	
88674	chr19	54178427	54178963	536	268.0	
88675	chr19	54179801	54180558	757	378.0	
88676	chr19	54187949	54192122	4173	2086.0	
88677	chr19	54200074	54211772	11698	5849.0	
88678	chr19	54231407	54232270	863	432.0	
88679	chr19	54247552	54248693	1141	570.0	
88680	chr19	54266022	54266534	512	256.0	
88681	chr19	54270957	54272698	1741	870.0	
88682	chr19	54280354	54281461	1107	554.0	
88683	chr19	54282423	54283192	769	384.0	
88684	chr19	54285649	54286099	450	225.0	
88685	chr19	54289869	54290294	425	212.0	
88686	chr19_KI270938v1_alt	275224	275627	403	202.0	
88687	chr19	54297809	54298150	341	170.0	
88688	chr19	54298740	54299155	415	208.0	
88689	chr19	54302180	54302809	629	314.0	
88690	chr19	54303900	54304360	460	230.0	
88691	chr19	54312242	54313438	1196	598.0	
88692	chr19	54316678	54317811	1133	566.0	
88693	chr19	54318915	54319538	623	312.0	
88694	chr19	54325048	54325716	668	334.0	
88695	chr19	54327209	54327678	469	234.0	
88696	chr19	54338953	54340150	1197	598.0	
88697	chr19	54343886	54344241	355	178.0	
88698	chr19	54345794	54346396	602	301.0	
88699	chr19	54352100	54352719	619	310.0	
88700	chr19	54353895	54354326	431	216.0	
88701	chr19	54361474	54363100	1626	813.0	
88702	chr19	54364380	54365883	1503	752.0	
88703	chr19	54369071	54371299	2228	1114.0	
88704	chr19	54371977	54372962	985	492.0	
88705	chr19	54373531	54376259	2728	1364.0	
88706	chr19	54377939	54378983	1044	522.0	
88707	chr19	54381698	54382438	740	370.0	
88708	chr19	54383344	54383659	315	158.0	
88709	chr19	54387788	54390005	2217	1108.0	
88710	chr19	54390904	54391580	676	338.0	
88711	chr19	54415126	54415575	449	224.0	
88712	chr19	54418086	54418683	597	298.0	
88713	chr19	54429993	54431395	1402	701.0	
88714	chr19	54439458	54439801	343	172.0	
88715	chr19	54447861	54452944	5083	2542.0	
88716	chr19	54453622	54466232	12610	6305.0	
88717	chr19	54470927	54471712	785	392.0	
88718	chr19	54473118	54473930	812	406.0	
88719	chr19	54478651	54479098	447	224.0	
88720	chr19	54480068	54480465	397	198.0	
88721	chr19	54481257	54481731	474	237.0	
88722	chr19	54482916	54483308	392	196.0	
88723	chr19	54485853	54486242	389	194.0	
88724	chr19	54497753	54498085	332	166.0	
88725	chr19	54502617	54503039	422	211.0	
88726	chr19	54506991	54507614	623	312.0	
88727	chr19	54517454	54517933	479	240.0	
88728	chr19	54521186	54521847	661	330.0	
88729	chr19	54523356	54523800	444	222.0	
88730	chr19	54532408	54533106	698	349.0	
88731	chr19	54542472	54542981	509	254.0	
88732	chr19	54551150	54552347	1197	598.0	
88733	chr19	54572162	54574034	1872	936.0	
88734	chr19	54593296	54594340	1044	522.0	
88735	chr19	54606130	54607587	1457	728.0	
88736	chr19	54608778	54609168	390	195.0	
88737	chr19	54612422	54612823	401	200.0	
88738	chr19	54616133	54617541	1408	704.0	
88739	chr19	54622415	54622816	401	200.0	
88740	chr19	54624493	54625482	989	494.0	
88741	chr19	54630163	54631155	992	496.0	
88742	chr19	54642853	54644565	1712	856.0	
88743	chr19	54653158	54653559	401	200.0	
88744	chr19	54654933	54655476	543	272.0	
88745	chr19	54660220	54661374	1154	577.0	
88746	chr19	54662120	54663229	1109	554.0	
88747	chr19	54670854	54671401	547	274.0	
88748	chr19	54674089	54674231	142	71.0	
88749	chr19	54676211	54676647	436	218.0	
88750	chr19	54682712	54682753	41	20.0	
88751	chr19	54684459	54684860	401	200.0	
88752	chr19	54691803	54692374	571	286.0	
88753	chr19	54694664	54695112	448	224.0	
88754	chr19	54696139	54696548	409	204.0	
88755	chr19	54707914	54708320	406	203.0	
88756	chr19	54756318	54756502	184	92.0	
88757	chr19	54764164	54764677	513	256.0	
88758	chr19	54835404	54835426	22	11.0	
88759	chr19	54837571	54837830	259	130.0	
88760	chr19	54871654	54872209	555	278.0	
88761	chr19	54873887	54874507	620	310.0	
88762	chr19	54875242	54875994	752	376.0	
88763	chr19	54877472	54877890	418	209.0	
88764	chr19	54881015	54881741	726	363.0	
88765	chr19	54882640	54883436	796	398.0	
88766	chr19	54888222	54888577	355	178.0	
88767	chr19	54901005	54901677	672	336.0	
88768	chr19	54903894	54904635	741	370.0	
88769	chr19	54905654	54907301	1647	824.0	
88770	chr19	54916682	54917453	771	386.0	
88771	chr19	54919650	54919996	346	173.0	
88772	chr19	54952286	54953014	728	364.0	
88773	chr19	54958713	54960225	1512	756.0	
88774	chr19	54966166	54966830	664	332.0	
88775	chr19	54973247	54974079	832	416.0	
88776	chr19	55005538	55006637	1099	550.0	
88777	chr19	55008878	55009090	212	106.0	
88778	chr19	55014449	55015583	1134	567.0	
88779	chr19	55018441	55018504	63	32.0	
88780	chr19	55027714	55028437	723	362.0	
88781	chr19	55041506	55042433	927	464.0	
88782	chr19	55062448	55063987	1539	770.0	
88783	chr19	55069067	55069891	824	412.0	
88784	chr19	55075394	55075747	353	176.0	
88785	chr19	55079862	55082953	3091	1546.0	
88786	chr19	55086286	55089147	2861	1430.0	
88787	chr19	55098643	55099045	402	201.0	
88788	chr19	55113095	55113833	738	369.0	
88789	chr19	55115587	55119483	3896	1948.0	
88790	chr19	55141148	55141806	658	329.0	
88791	chr19	55145107	55147088	1981	990.0	
88792	chr19	55152160	55152313	153	76.0	
88793	chr19	55156265	55157189	924	462.0	
88794	chr19	55160415	55161357	942	471.0	
88795	chr19	55165801	55167738	1937	968.0	
88796	chr19	55173472	55174482	1010	505.0	
88797	chr19	55178745	55180517	1772	886.0	
88798	chr19	55197522	55197886	364	182.0	
88799	chr19	55202300	55202311	11	6.0	
88800	chr19	55207038	55207530	492	246.0	
88801	chr19	55209130	55209623	493	246.0	
88802	chr19	55212416	55212848	432	216.0	
88803	chr19	55216357	55217378	1021	510.0	
88804	chr19	55223028	55223061	33	16.0	
88805	chr19	55247543	55248142	599	300.0	
88806	chr19	55251201	55252185	984	492.0	
88807	chr19	55253279	55260184	6905	3452.0	
88808	chr19	55266353	55266668	315	158.0	
88809	chr19	55275941	55277245	1304	652.0	
88810	chr19	55279401	55281331	1930	965.0	
88811	chr19	55283640	55285371	1731	866.0	
88812	chr19	55291831	55292406	575	288.0	
88813	chr19	55298738	55298817	79	40.0	
88814	chr19	55301482	55302611	1129	564.0	
88815	chr19	55304338	55304544	206	103.0	
88816	chr19	55305094	55306099	1005	502.0	
88817	chr19	55321704	55322173	469	234.0	
88818	chr19	55322840	55323794	954	477.0	
88819	chr19	55324651	55325595	944	472.0	
88820	chr19	55326408	55327115	707	354.0	
88821	chr19	55328940	55329275	335	168.0	
88822	chr19	55331639	55332351	712	356.0	
88823	chr19	55337290	55337616	326	163.0	
88824	chr19	55338237	55341808	3571	1786.0	
88825	chr19	55346042	55346730	688	344.0	
88826	chr19	55348371	55348809	438	219.0	
88827	chr19	55350582	55351159	577	288.0	
88828	chr19	55351809	55352578	769	384.0	
88829	chr19	55353126	55355580	2454	1227.0	
88830	chr19	55368865	55370605	1740	870.0	
88831	chr19	55372653	55373114	461	230.0	
88832	chr19	55383140	55393912	10772	5386.0	
88833	chr19	55395233	55395476	243	122.0	
88834	chr19	55396023	55409069	13046	6523.0	
88835	chr19	55417909	55418626	717	358.0	
88836	chr19	55421211	55421755	544	272.0	
88837	chr19	55437364	55437750	386	193.0	
88838	chr19	55440353	55442792	2439	1220.0	
88839	chr19	55443414	55443781	367	184.0	
88840	chr19	55447583	55448147	564	282.0	
88841	chr19	55451124	55453410	2286	1143.0	
88842	chr19	55454673	55455133	460	230.0	
88843	chr19	55460746	55462675	1929	964.0	
88844	chr19	55467519	55468532	1013	506.0	
88845	chr19	55475884	55477703	1819	910.0	
88846	chr19	55480117	55480144	27	14.0	
88847	chr19	55484361	55488674	4313	2156.0	
88848	chr19	55503130	55504601	1471	736.0	
88849	chr19	55516605	55517868	1263	632.0	
88850	chr19	55579925	55581677	1752	876.0	
88851	chr19	55585551	55587831	2280	1140.0	
88852	chr19	55598588	55601407	2819	1410.0	
88853	chr19	55604385	55606957	2572	1286.0	
88854	chr19	55612243	55612672	429	214.0	
88855	chr19	55619411	55619571	160	80.0	
88856	chr19	55620264	55620926	662	331.0	
88857	chr19	55623675	55625308	1633	816.0	
88858	chr19	55626105	55627020	915	458.0	
88859	chr19	55631410	55633003	1593	796.0	
88860	chr19	55634368	55637019	2651	1326.0	
88861	chr19	55637701	55637818	117	58.0	
88862	chr19	55638904	55644421	5517	2758.0	
88863	chr19	55647281	55649171	1890	945.0	
88864	chr19	55653221	55658621	5400	2700.0	
88865	chr19	55671349	55671934	585	292.0	
88866	chr19	55674408	55676251	1843	922.0	
88867	chr19	55677549	55678789	1240	620.0	
88868	chr19	55703661	55704159	498	249.0	
88869	chr19	55766429	55767009	580	290.0	
88870	chr19	55809346	55809840	494	247.0	
88871	chr19	56066347	56067098	751	376.0	
88872	chr19	56076380	56076885	505	252.0	
88873	chr19	56080512	56081578	1066	533.0	
88874	chr19	56091311	56092214	903	452.0	
88875	chr19	56105030	56105788	758	379.0	
88876	chr19	56110370	56113494	3124	1562.0	
88877	chr19	56118722	56122294	3572	1786.0	
88878	chr19	56124652	56124948	296	148.0	
88879	chr19	56133862	56134279	417	208.0	
88880	chr19	56140013	56142208	2195	1098.0	
88881	chr19	56171776	56172317	541	270.0	
88882	chr19	56252712	56254128	1416	708.0	
88883	chr19	56270568	56271415	847	424.0	
88884	chr19	56301793	56302319	526	263.0	
88885	chr19	56309482	56310056	574	287.0	
88886	chr19	56313873	56315954	2081	1040.0	
88887	chr19	56319920	56320414	494	247.0	
88888	chr19	56321799	56322550	751	376.0	
88889	chr19	56333478	56333945	467	234.0	
88890	chr19	56350421	56350865	444	222.0	
88891	chr19	56367662	56368877	1215	608.0	
88892	chr19	56392888	56394159	1271	636.0	
88893	chr19	56403248	56405286	2038	1019.0	
88894	chr19	56476473	56478555	2082	1041.0	
88895	chr19	56507269	56508675	1406	703.0	
88896	chr19	56537964	56539489	1525	762.0	
88897	chr19	56566793	56568205	1412	706.0	
88898	chr19	56594618	56595912	1294	647.0	
88899	chr19	56671143	56672357	1214	607.0	
88900	chr19	56765149	56765491	342	171.0	
88901	chr19	56837543	56840196	2653	1326.0	
88902	chr19	57099144	57099579	435	218.0	
88903	chr19	57103728	57104447	719	360.0	
88904	chr19	57171456	57172979	1523	762.0	
88905	chr19	57190912	57192364	1452	726.0	
88906	chr19	57193041	57193345	304	152.0	
88907	chr19	57239987	57241488	1501	750.0	
88908	chr19	57279309	57283620	4311	2156.0	
88909	chr19	57319774	57321353	1579	790.0	
88910	chr19	57350537	57352002	1465	732.0	
88911	chr19	57362764	57364299	1535	768.0	
88912	chr19	57389246	57390777	1531	766.0	
88913	chr19	57406315	57407000	685	342.0	
88914	chr19	57410575	57411847	1272	636.0	
88915	chr19	57434575	57436107	1532	766.0	
88916	chr19	57465713	57466133	420	210.0	
88917	chr19	57476962	57478107	1145	572.0	
88918	chr19	57487268	57488389	1121	560.0	
88919	chr19	57499391	57500519	1128	564.0	
88920	chr19	57526689	57528091	1402	701.0	
88921	chr19	57558839	57560435	1596	798.0	
88922	chr19	57578322	57579521	1199	600.0	
88923	chr19	57583323	57584838	1515	758.0	
88924	chr19	57599392	57600615	1223	612.0	
88925	chr19	57613606	57614893	1287	644.0	
88926	chr19	57632629	57633871	1242	621.0	
88927	chr19	57664217	57664632	415	208.0	
88928	chr19	57681371	57682601	1230	615.0	
88929	chr19	57708482	57709671	1189	594.0	
88930	chr19	57726696	57728257	1561	780.0	
88931	chr19	57738322	57738805	483	242.0	
88932	chr19	57746255	57747586	1331	666.0	
88933	chr19	57768974	57770606	1632	816.0	
88934	chr19	57771505	57771775	270	135.0	
88935	chr19	57775099	57775442	343	172.0	
88936	chr19	57798664	57799687	1023	512.0	
88937	chr19	57802275	57802575	300	150.0	
88938	chr19	57803509	57804027	518	259.0	
88939	chr19	57812520	57812544	24	12.0	
88940	chr19	57813286	57815613	2327	1164.0	
88941	chr19	57819058	57820498	1440	720.0	
88942	chr19	57830051	57830513	462	231.0	
88943	chr19	57849320	57850788	1468	734.0	
88944	chr19	57888291	57889539	1248	624.0	
88945	chr19	57903307	57903742	435	218.0	
88946	chr19	57915926	57917290	1364	682.0	
88947	chr19	57934721	57935752	1031	516.0	
88948	chr19	57946911	57948317	1406	703.0	
88949	chr19	58001971	58003521	1550	775.0	
88950	chr19	58009418	58010275	857	428.0	
88951	chr19	58021805	58022388	583	292.0	
88952	chr19	58033595	58034313	718	359.0	
88953	chr19	58058817	58059943	1126	563.0	
88954	chr19	58097075	58099465	2390	1195.0	
88955	chr19	58100167	58100208	41	20.0	
88956	chr19	58150125	58151114	989	494.0	
88957	chr19	58154340	58155698	1358	679.0	
88958	chr19	58181828	58184388	2560	1280.0	
88959	chr19	58218913	58219390	477	238.0	
88960	chr19	58228142	58229644	1502	751.0	
88961	chr19	58278058	58279904	1846	923.0	
88962	chr19	58304612	58306412	1800	900.0	
88963	chr19	58310699	58311100	401	200.0	
88964	chr19	58312628	58312631	3	2.0	
88965	chr19	58325887	58328135	2248	1124.0	
88966	chr19	58346627	58348432	1805	902.0	
88967	chr19	58356025	58357163	1138	569.0	
88968	chr19	58361776	58363414	1638	819.0	
88969	chr19	58364159	58364519	360	180.0	
88970	chr19	58379959	58381973	2014	1007.0	
88971	chr19	58385659	58388092	2433	1216.0	
88972	chr19	58395104	58397145	2041	1020.0	
88973	chr19	58400547	58402270	1723	862.0	
88974	chr19	58406823	58409734	2911	1456.0	
88975	chr19	58439458	58441196	1738	869.0	
88976	chr19	58450750	58452374	1624	812.0	
88977	chr19	58464763	58465334	571	286.0	
88978	chr19	58466311	58467834	1523	762.0	
88979	chr19	58473054	58473210	156	78.0	
88980	chr19	58475116	58477028	1912	956.0	
88981	chr19	58498686	58500845	2159	1080.0	
88982	chr19	58513315	58514769	1454	727.0	
88983	chr19	58518246	58520807	2561	1280.0	
88984	chr19	58538104	58539231	1127	564.0	
88985	chr19	58543408	58563627	20219	10110.0	
88986	chr19	58570667	58570697	30	15.0	
88987	chr19	58571936	58576585	4649	2324.0	
88988	chr19	58577667	58578716	1049	524.0	
88989	chr19	58580831	58581850	1019	510.0	
88990	chr20	208926	209417	491	246.0	
88991	chr20	219649	219653	4	2.0	
88992	chr20	227666	228134	468	234.0	
88993	chr20	237413	238364	951	476.0	
88994	chr20	266628	267438	810	405.0	
88995	chr20	289798	291569	1771	886.0	
88996	chr20	296898	299831	2933	1466.0	
88997	chr20	300391	300756	365	182.0	
88998	chr20	309472	311050	1578	789.0	
88999	chr20	312186	312514	328	164.0	
89000	chr20	323937	329552	5615	2808.0	
89001	chr20	330111	331126	1015	508.0	
89002	chr20	346687	348737	2050	1025.0	
89003	chr20	354199	355104	905	452.0	
89004	chr20	362331	362917	586	293.0	
89005	chr20	371580	374054	2474	1237.0	
89006	chr20	380422	383114	2692	1346.0	
89007	chr20	407022	409421	2399	1200.0	
89008	chr20	420661	421031	370	185.0	
89009	chr20	431395	431876	481	240.0	
89010	chr20	433186	434156	970	485.0	
89011	chr20	438051	439488	1437	718.0	
89012	chr20	461405	463268	1863	932.0	
89013	chr20	478852	479434	582	291.0	
89014	chr20	536012	536267	255	128.0	
89015	chr20	542744	544691	1947	974.0	
89016	chr20	561655	562113	458	229.0	
89017	chr20	610148	610611	463	232.0	
89018	chr20	645269	645975	706	353.0	
89019	chr20	651959	654243	2284	1142.0	
89020	chr20	655744	656062	318	159.0	
89021	chr20	658912	659416	504	252.0	
89022	chr20	660321	661067	746	373.0	
89023	chr20	667360	667842	482	241.0	
89024	chr20	675189	676906	1717	858.0	
89025	chr20	728337	728768	431	216.0	
89026	chr20	739041	739217	176	88.0	
89027	chr20	769790	770241	451	226.0	
89028	chr20	815919	816506	587	294.0	
89029	chr20	818862	819494	632	316.0	
89030	chr20	829103	830609	1506	753.0	
89031	chr20	832960	837391	4431	2216.0	
89032	chr20	841001	842527	1526	763.0	
89033	chr20	843721	847715	3994	1997.0	
89034	chr20	856227	856861	634	317.0	
89035	chr20	881200	882145	945	472.0	
89036	chr20	884957	885379	422	211.0	
89037	chr20	889140	889539	399	200.0	
89038	chr20	890942	891413	471	236.0	
89039	chr20	893622	893929	307	154.0	
89040	chr20	905143	906450	1307	654.0	
89041	chr20	906956	907181	225	112.0	
89042	chr20	914876	915096	220	110.0	
89043	chr20	924503	925126	623	312.0	
89044	chr20	956215	956904	689	344.0	
89045	chr20	968179	968479	300	150.0	
89046	chr20	973651	974292	641	320.0	
89047	chr20	1005627	1006028	401	200.0	
89048	chr20	1033973	1034691	718	359.0	
89049	chr20	1108338	1108874	536	268.0	
89050	chr20	1117876	1119524	1648	824.0	
89051	chr20	1122372	1122869	497	248.0	
89052	chr20	1130747	1131323	576	288.0	
89053	chr20	1185280	1186132	852	426.0	
89054	chr20	1212845	1213408	563	282.0	
89055	chr20	1215755	1215981	226	113.0	
89056	chr20	1224185	1227298	3113	1556.0	
89057	chr20	1265754	1267116	1362	681.0	
89058	chr20	1286556	1287079	523	262.0	
89059	chr20	1299567	1299876	309	154.0	
89060	chr20	1301009	1301363	354	177.0	
89061	chr20	1302877	1303662	785	392.0	
89062	chr20	1313075	1313942	867	434.0	
89063	chr20	1317519	1317920	401	200.0	
89064	chr20	1322834	1323279	445	222.0	
89065	chr20	1324288	1326573	2285	1142.0	
89066	chr20	1327430	1327589	159	80.0	
89067	chr20	1330012	1330603	591	296.0	
89068	chr20	1334829	1335175	346	173.0	
89069	chr20	1336653	1337083	430	215.0	
89070	chr20	1364190	1364336	146	73.0	
89071	chr20	1375496	1377698	2202	1101.0	
89072	chr20	1378930	1379381	451	226.0	
89073	chr20	1388296	1393799	5503	2752.0	
89074	chr20	1394909	1394923	14	7.0	
89075	chr20	1423707	1424251	544	272.0	
89076	chr20	1434760	1435541	781	390.0	
89077	chr20	1437086	1437743	657	328.0	
89078	chr20	1466016	1468511	2495	1248.0	
89079	chr20	1470051	1470533	482	241.0	
89080	chr20	1472799	1473407	608	304.0	
89081	chr20	1489273	1492658	3385	1692.0	
89082	chr20	1493477	1493956	479	240.0	
89083	chr20	1503459	1504183	724	362.0	
89084	chr20	1509210	1509659	449	224.0	
89085	chr20	1524072	1524357	285	142.0	
89086	chr20	1534598	1534964	366	183.0	
89087	chr20	1535680	1538493	2813	1406.0	
89088	chr20	1556047	1556269	222	111.0	
89089	chr20	1562559	1563128	569	284.0	
89090	chr20	1567995	1568162	167	84.0	
89091	chr20	1569313	1569890	577	288.0	
89092	chr20	1576669	1576974	305	152.0	
89093	chr20	1618975	1620642	1667	834.0	
89094	chr20	1622451	1622865	414	207.0	
89095	chr20	1623700	1624679	979	490.0	
89096	chr20	1626579	1627362	783	392.0	
89097	chr20	1651503	1651663	160	80.0	
89098	chr20	1654873	1655481	608	304.0	
89099	chr20	1656657	1656661	4	2.0	
89100	chr20	1657568	1658177	609	304.0	
89101	chr20	1660080	1660692	612	306.0	
89102	chr20	1661490	1662324	834	417.0	
89103	chr20	1663800	1665640	1840	920.0	
89104	chr20	1674234	1674930	696	348.0	
89105	chr20	1685319	1686726	1407	704.0	
89106	chr20	1696817	1696864	47	24.0	
89107	chr20	1702262	1703040	778	389.0	
89108	chr20	1708089	1708420	331	166.0	
89109	chr20	1731773	1732268	495	248.0	
89110	chr20	1734481	1734925	444	222.0	
89111	chr20	1741674	1742071	397	198.0	
89112	chr20	1757032	1757444	412	206.0	
89113	chr20	1764373	1764871	498	249.0	
89114	chr20	1776818	1777685	867	434.0	
89115	chr20	1801981	1804904	2923	1462.0	
89116	chr20	1810871	1811779	908	454.0	
89117	chr20	1816965	1817298	333	166.0	
89118	chr20	1819179	1819713	534	267.0	
89119	chr20	1820525	1821233	708	354.0	
89120	chr20	1823431	1824628	1197	598.0	
89121	chr20	1826014	1826288	274	137.0	
89122	chr20	1827856	1828994	1138	569.0	
89123	chr20	1831234	1831431	197	98.0	
89124	chr20	1839334	1840300	966	483.0	
89125	chr20	1841706	1842179	473	236.0	
89126	chr20	1844436	1845370	934	467.0	
89127	chr20	1850272	1851263	991	496.0	
89128	chr20	1857469	1857882	413	206.0	
89129	chr20	1867511	1867833	322	161.0	
89130	chr20	1870691	1872286	1595	798.0	
89131	chr20	1874776	1875416	640	320.0	
89132	chr20	1882908	1883568	660	330.0	
89133	chr20	1889011	1889614	603	302.0	
89134	chr20	1893826	1896832	3006	1503.0	
89135	chr20	1897487	1898550	1063	532.0	
89136	chr20	1900372	1900447	75	38.0	
89137	chr20	1934335	1935173	838	419.0	
89138	chr20	1943255	1947514	4259	2130.0	
89139	chr20	1953049	1953051	2	1.0	
89140	chr20	1953703	1954989	1286	643.0	
89141	chr20	1963907	1966094	2187	1094.0	
89142	chr20	2005782	2006204	422	211.0	
89143	chr20	2006726	2007022	296	148.0	
89144	chr20	2084663	2085152	489	244.0	
89145	chr20	2089108	2089499	391	196.0	
89146	chr20	2101250	2104144	2894	1447.0	
89147	chr20	2109811	2110069	258	129.0	
89148	chr20	2172487	2172960	473	236.0	
89149	chr20	2206855	2208109	1254	627.0	
89150	chr20	2210688	2211700	1012	506.0	
89151	chr20	2217845	2218773	928	464.0	
89152	chr20	2221934	2222251	317	158.0	
89153	chr20	2252478	2253160	682	341.0	
89154	chr20	2255902	2256419	517	258.0	
89155	chr20	2279228	2279705	477	238.0	
89156	chr20	2288679	2289656	977	488.0	
89157	chr20	2292405	2293345	940	470.0	
89158	chr20	2299211	2299891	680	340.0	
89159	chr20	2300829	2302135	1306	653.0	
89160	chr20	2311334	2311716	382	191.0	
89161	chr20	2314353	2315565	1212	606.0	
89162	chr20	2338719	2339056	337	168.0	
89163	chr20	2347091	2347563	472	236.0	
89164	chr20	2351757	2352470	713	356.0	
89165	chr20	2379518	2380029	511	256.0	
89166	chr20	2387151	2387605	454	227.0	
89167	chr20	2390974	2391336	362	181.0	
89168	chr20	2446808	2447330	522	261.0	
89169	chr20	2452066	2452577	511	256.0	
89170	chr20	2454700	2455140	440	220.0	
89171	chr20	2468278	2471608	3330	1665.0	
89172	chr20	2508053	2509730	1677	838.0	
89173	chr20	2521466	2522148	682	341.0	
89174	chr20	2523942	2525959	2017	1008.0	
89175	chr20	2530370	2530800	430	215.0	
89176	chr20	2637217	2637742	525	262.0	
89177	chr20	2646839	2647266	427	214.0	
89178	chr20	2651599	2654677	3078	1539.0	"repeat_region	sequence_feature"
89179	chr20	2655217	2655223	6	3.0	
89180	chr20	2655948	2657671	1723	862.0	
89181	chr20	2658241	2659552	1311	656.0	
89182	chr20	2663548	2664935	1387	694.0	
89183	chr20	2672017	2672257	240	120.0	
89184	chr20	2674055	2674460	405	202.0	
89185	chr20	2684786	2685220	434	217.0	
89186	chr20	2687710	2688799	1089	544.0	
89187	chr20	2691770	2694278	2508	1254.0	
89188	chr20	2713220	2713721	501	250.0	
89189	chr20	2729065	2730169	1104	552.0	
89190	chr20	2741049	2743541	2492	1246.0	
89191	chr20	2747935	2748441	506	253.0	
89192	chr20	2749940	2753218	3278	1639.0	
89193	chr20	2771630	2771983	353	176.0	
89194	chr20	2800137	2801594	1457	728.0	
89195	chr20	2816740	2817003	263	132.0	
89196	chr20	2821154	2822608	1454	727.0	
89197	chr20	2825951	2825974	23	12.0	
89198	chr20	2831883	2832422	539	270.0	
89199	chr20	2839774	2841672	1898	949.0	
89200	chr20	2851111	2852551	1440	720.0	
89201	chr20	2865563	2866695	1132	566.0	
89202	chr20	2871737	2874829	3092	1546.0	
89203	chr20	2900964	2901579	615	308.0	
89204	chr20	2983532	2984604	1072	536.0	
89205	chr20	2986389	2987006	617	308.0	
89206	chr20	3000863	3001358	495	248.0	
89207	chr20	3043015	3043197	182	91.0	
89208	chr20	3045048	3046952	1904	952.0	
89209	chr20	3053799	3054459	660	330.0	
89210	chr20	3069527	3069871	344	172.0	
89211	chr20	3071590	3072790	1200	600.0	
89212	chr20	3076771	3077962	1191	596.0	
89213	chr20	3082170	3084745	2575	1288.0	
89214	chr20	3092528	3094500	1972	986.0	
89215	chr20	3102018	3102695	677	338.0	
89216	chr20	3115330	3116017	687	344.0	
89217	chr20	3117836	3118399	563	282.0	
89218	chr20	3121246	3121674	428	214.0	
89219	chr20	3156977	3158060	1083	542.0	
89220	chr20	3158766	3160513	1747	874.0	
89221	chr20	3161371	3161401	30	15.0	
89222	chr20	3165394	3165994	600	300.0	
89223	chr20	3167999	3168555	556	278.0	
89224	chr20	3171065	3171309	244	122.0	
89225	chr20	3171961	3174700	2739	1370.0	
89226	chr20	3177855	3178155	300	150.0	
89227	chr20	3203084	3205175	2091	1046.0	
89228	chr20	3208570	3210426	1856	928.0	
89229	chr20	3218245	3219073	828	414.0	
89230	chr20	3222747	3223703	956	478.0	
89231	chr20	3237878	3240261	2383	1192.0	
89232	chr20	3248449	3249140	691	346.0	
89233	chr20	3312950	3313793	843	422.0	
89234	chr20	3316455	3317031	576	288.0	
89235	chr20	3323428	3323840	412	206.0	
89236	chr20	3328573	3328771	198	99.0	
89237	chr20	3371739	3372143	404	202.0	
89238	chr20	3405213	3405586	373	186.0	
89239	chr20	3406392	3409375	2983	1492.0	
89240	chr20	3420051	3420920	869	434.0	
89241	chr20	3430304	3431197	893	446.0	
89242	chr20	3434154	3434754	600	300.0	
89243	chr20	3470161	3472041	1880	940.0	
89244	chr20	3557372	3557634	262	131.0	
89245	chr20	3652988	3653363	375	188.0	
89246	chr20	3658789	3659370	581	290.0	
89247	chr20	3665621	3666714	1093	546.0	
89248	chr20	3672615	3673172	557	278.0	
89249	chr20	3676531	3677257	726	363.0	
89250	chr20	3710709	3713012	2303	1152.0	
89251	chr20	3713884	3714636	752	376.0	
89252	chr20	3716208	3716631	423	212.0	
89253	chr20	3744648	3745734	1086	543.0	
89254	chr20	3749644	3750193	549	274.0	
89255	chr20	3751627	3753797	2170	1085.0	
89256	chr20	3757398	3757510	112	56.0	
89257	chr20	3763389	3764235	846	423.0	
89258	chr20	3764951	3769257	4306	2153.0	
89259	chr20	3777281	3779415	2134	1067.0	
89260	chr20	3781007	3782093	1086	543.0	
89261	chr20	3783144	3787715	4571	2286.0	
89262	chr20	3795118	3800213	5095	2548.0	
89263	chr20	3802479	3802927	448	224.0	
89264	chr20	3804083	3804995	912	456.0	
89265	chr20	3807115	3808338	1223	612.0	
89266	chr20	3810188	3812499	2311	1156.0	enhancer
89267	chr20	3813535	3814285	750	375.0	
89268	chr20	3815073	3816578	1505	752.0	
89269	chr20	3818268	3818824	556	278.0	
89270	chr20	3819616	3821395	1779	890.0	
89271	chr20	3838618	3839487	869	434.0	
89272	chr20	3845997	3847893	1896	948.0	
89273	chr20	3854449	3855675	1226	613.0	
89274	chr20	3878589	3878949	360	180.0	
89275	chr20	3887901	3892768	4867	2434.0	
89276	chr20	3893584	3894185	601	300.0	
89277	chr20	3896785	3897943	1158	579.0	
89278	chr20	3900343	3900486	143	72.0	
89279	chr20	3901008	3902397	1389	694.0	
89280	chr20	3903179	3903190	11	6.0	
89281	chr20	3906737	3907893	1156	578.0	
89282	chr20	3923925	3928544	4619	2310.0	
89283	chr20	3929233	3931207	1974	987.0	
89284	chr20	3932651	3933728	1077	538.0	
89285	chr20	3980248	3981252	1004	502.0	
89286	chr20	3989022	3990012	990	495.0	
89287	chr20	3994975	3995467	492	246.0	
89288	chr20	4011184	4011698	514	257.0	
89289	chr20	4012561	4013081	520	260.0	
89290	chr20	4013682	4016253	2571	1286.0	
89291	chr20	4016996	4018522	1526	763.0	
89292	chr20	4025875	4026080	205	102.0	
89293	chr20	4037501	4038851	1350	675.0	
89294	chr20	4060078	4060834	756	378.0	
89295	chr20	4064496	4065004	508	254.0	
89296	chr20	4065608	4065615	7	4.0	
89297	chr20	4067813	4068340	527	264.0	
89298	chr20	4072048	4072435	387	194.0	
89299	chr20	4074934	4075580	646	323.0	
89300	chr20	4082216	4083531	1315	658.0	
89301	chr20	4084967	4086046	1079	540.0	
89302	chr20	4089947	4092263	2316	1158.0	
89303	chr20	4108510	4109101	591	296.0	
89304	chr20	4130990	4131114	124	62.0	
89305	chr20	4148355	4150022	1667	834.0	
89306	chr20	4151670	4152364	694	347.0	
89307	chr20	4154785	4155483	698	349.0	
89308	chr20	4160766	4161293	527	264.0	
89309	chr20	4171750	4172963	1213	606.0	
89310	chr20	4192552	4193107	555	278.0	
89311	chr20	4221205	4221765	560	280.0	
89312	chr20	4249570	4249842	272	136.0	
89313	chr20	4320068	4320872	804	402.0	
89314	chr20	4324891	4325293	402	201.0	
89315	chr20	4369653	4370193	540	270.0	
89316	chr20	4371662	4371981	319	160.0	
89317	chr20	4413299	4414182	883	442.0	
89318	chr20	4428219	4428525	306	153.0	
89319	chr20	4462814	4463269	455	228.0	
89320	chr20	4592158	4593195	1037	518.0	
89321	chr20	4607175	4607858	683	342.0	
89322	chr20	4613752	4614446	694	347.0	
89323	chr20	4632844	4634324	1480	740.0	
89324	chr20	4661120	4661698	578	289.0	
89325	chr20	4665513	4667735	2222	1111.0	
89326	chr20	4683677	4684974	1297	648.0	
89327	chr20	4685838	4687849	2011	1006.0	
89328	chr20	4689350	4689514	164	82.0	
89329	chr20	4697748	4698103	355	178.0	
89330	chr20	4699646	4699736	90	45.0	
89331	chr20	4702783	4703201	418	209.0	
89332	chr20	4719986	4721392	1406	703.0	
89333	chr20	4726647	4727582	935	468.0	
89334	chr20	4740732	4741237	505	252.0	
89335	chr20	4759106	4759558	452	226.0	
89336	chr20	4760260	4762026	1766	883.0	
89337	chr20	4764103	4764537	434	217.0	
89338	chr20	4766385	4767421	1036	518.0	
89339	chr20	4774152	4774613	461	230.0	
89340	chr20	4775568	4775964	396	198.0	
89341	chr20	4787172	4788124	952	476.0	
89342	chr20	4795334	4795844	510	255.0	
89343	chr20	4802470	4802964	494	247.0	
89344	chr20	4806042	4806693	651	326.0	
89345	chr20	4809000	4816145	7145	3572.0	
89346	chr20	4817183	4817224	41	20.0	
89347	chr20	4819438	4819580	142	71.0	
89348	chr20	4821478	4824662	3184	1592.0	
89349	chr20	4826745	4827279	534	267.0	
89350	chr20	4827911	4827954	43	22.0	
89351	chr20	4828679	4830162	1483	742.0	
89352	chr20	4844719	4845209	490	245.0	
89353	chr20	4847478	4847627	149	74.0	
89354	chr20	4869547	4869775	228	114.0	
89355	chr20	4886804	4887084	280	140.0	
89356	chr20	4949683	4950281	598	299.0	
89357	chr20	4956147	4956632	485	242.0	
89358	chr20	4961699	4962611	912	456.0	
89359	chr20	4973221	4974271	1050	525.0	
89360	chr20	4985678	4986038	360	180.0	
89361	chr20	4989617	4989799	182	91.0	
89362	chr20	4998276	4998719	443	222.0	
89363	chr20	4999533	5002445	2912	1456.0	
89364	chr20	5008627	5009331	704	352.0	
89365	chr20	5009974	5010565	591	296.0	
89366	chr20	5030450	5031654	1204	602.0	
89367	chr20	5038999	5039905	906	453.0	
89368	chr20	5046878	5047455	577	288.0	
89369	chr20	5056447	5057588	1141	570.0	
89370	chr20	5065485	5066516	1031	516.0	
89371	chr20	5068284	5068475	191	96.0	
89372	chr20	5073134	5074419	1285	642.0	
89373	chr20	5077800	5079150	1350	675.0	
89374	chr20	5080170	5082152	1982	991.0	
89375	chr20	5085355	5085887	532	266.0	
89376	chr20	5090084	5090705	621	310.0	
89377	chr20	5100526	5101392	866	433.0	
89378	chr20	5112210	5113962	1752	876.0	
89379	chr20	5118580	5120621	2041	1020.0	
89380	chr20	5125921	5128562	2641	1320.0	
89381	chr20	5143388	5143918	530	265.0	
89382	chr20	5146021	5147598	1577	788.0	
89383	chr20	5160939	5161206	267	134.0	
89384	chr20	5168498	5169471	973	486.0	
89385	chr20	5173785	5173799	14	7.0	
89386	chr20	5192054	5192944	890	445.0	
89387	chr20	5205315	5205824	509	254.0	
89388	chr20	5222922	5223350	428	214.0	
89389	chr20	5298134	5298584	450	225.0	
89390	chr20	5357933	5358322	389	194.0	
89391	chr20	5448560	5448634	74	37.0	
89392	chr20	5491099	5491251	152	76.0	
89393	chr20	5503974	5504787	813	406.0	
89394	chr20	5524969	5525020	51	26.0	
89395	chr20	5528617	5530361	1744	872.0	
89396	chr20	5531633	5532009	376	188.0	
89397	chr20	5534948	5535862	914	457.0	
89398	chr20	5539719	5540261	542	271.0	
89399	chr20	5550718	5551156	438	219.0	
89400	chr20	5557073	5557554	481	240.0	
89401	chr20	5568987	5569709	722	361.0	
89402	chr20	5570265	5571094	829	414.0	
89403	chr20	5586768	5587110	342	171.0	
89404	chr20	5592760	5594616	1856	928.0	
89405	chr20	5595700	5596402	702	351.0	
89406	chr20	5597511	5597626	115	58.0	
89407	chr20	5599445	5599457	12	6.0	
89408	chr20	5602089	5605759	3670	1835.0	
89409	chr20	5606307	5606698	391	196.0	
89410	chr20	5608219	5613432	5213	2606.0	
89411	chr20	5642122	5643228	1106	553.0	
89412	chr20	5645010	5648596	3586	1793.0	
89413	chr20	5650079	5650810	731	366.0	
89414	chr20	5653019	5655120	2101	1050.0	
89415	chr20	5656081	5656519	438	219.0	
89416	chr20	5657199	5658045	846	423.0	
89417	chr20	5658809	5659882	1073	536.0	
89418	chr20	5660730	5661207	477	238.0	
89419	chr20	5671158	5671908	750	375.0	
89420	chr20	5674065	5675999	1934	967.0	
89421	chr20	5686426	5686738	312	156.0	
89422	chr20	5687746	5689991	2245	1122.0	
89423	chr20	5691904	5692291	387	194.0	
89424	chr20	5714040	5715456	1416	708.0	
89425	chr20	5722947	5723210	263	132.0	
89426	chr20	5724697	5725007	310	155.0	
89427	chr20	5737073	5738468	1395	698.0	
89428	chr20	5749859	5751167	1308	654.0	
89429	chr20	5762418	5763058	640	320.0	
89430	chr20	5770183	5770662	479	240.0	
89431	chr20	5788254	5788817	563	282.0	
89432	chr20	5797741	5798556	815	408.0	
89433	chr20	5804467	5804703	236	118.0	
89434	chr20	5822595	5823120	525	262.0	
89435	chr20	5835308	5836936	1628	814.0	
89436	chr20	5842967	5843577	610	305.0	
89437	chr20	5844309	5844613	304	152.0	
89438	chr20	5846126	5846712	586	293.0	
89439	chr20	5849023	5849026	3	2.0	
89440	chr20	5863123	5863719	596	298.0	
89441	chr20	5865196	5865538	342	171.0	
89442	chr20	5911209	5911973	764	382.0	
89443	chr20	5919206	5919624	418	209.0	
89444	chr20	5933827	5934193	366	183.0	
89445	chr20	5947130	5947929	799	400.0	
89446	chr20	5949810	5951407	1597	798.0	
89447	chr20	5973993	5974325	332	166.0	
89448	chr20	5996635	5997435	800	400.0	
89449	chr20	6003257	6003749	492	246.0	
89450	chr20	6005529	6007347	1818	909.0	
89451	chr20	6008126	6008685	559	280.0	
89452	chr20	6010167	6010333	166	83.0	
89453	chr20	6074201	6074563	362	181.0	
89454	chr20	6077313	6077740	427	214.0	
89455	chr20	6700843	6701478	635	318.0	
89456	chr20	6767417	6768430	1013	506.0	"promoter	region	region	promoter	promoter	region"
89457	chr20	6828841	6829176	335	168.0	
89458	chr20	6855191	6855426	235	118.0	
89459	chr20	6888993	6889080	87	44.0	
89460	chr20	6956071	6956467	396	198.0	
89461	chr20	7856844	7857099	255	128.0	
89462	chr20	7897957	7898112	155	78.0	
89463	chr20	7924742	7925166	424	212.0	
89464	chr20	7935259	7935305	46	23.0	
89465	chr20	7936436	7936837	401	200.0	
89466	chr20	7980536	7980955	419	210.0	
89467	chr20	8000411	8000860	449	224.0	
89468	chr20	8005494	8005809	315	158.0	
89469	chr20	8006800	8006868	68	34.0	
89470	chr20	8014676	8015039	363	182.0	
89471	chr20	8017988	8021427	3439	1720.0	
89472	chr20	8043627	8044124	497	248.0	
89473	chr20	8073197	8073918	721	360.0	
89474	chr20	8094792	8095334	542	271.0	
89475	chr20	8131449	8133696	2247	1124.0	
89476	chr20	8144732	8145560	828	414.0	
89477	chr20	8151396	8151602	206	103.0	
89478	chr20	8153244	8153826	582	291.0	
89479	chr20	8154606	8155041	435	218.0	
89480	chr20	8156247	8157043	796	398.0	
89481	chr20	8161721	8162025	304	152.0	
89482	chr20	8213478	8214538	1060	530.0	
89483	chr20	8260848	8261474	626	313.0	
89484	chr20	8271717	8272108	391	196.0	
89485	chr20	8272842	8273188	346	173.0	
89486	chr20	8305295	8305895	600	300.0	
89487	chr20	8319137	8319281	144	72.0	
89488	chr20	8320145	8320665	520	260.0	
89489	chr20	8330371	8330631	260	130.0	
89490	chr20	8352720	8353121	401	200.0	
89491	chr20	8356870	8356964	94	47.0	
89492	chr20	8369061	8369446	385	192.0	
89493	chr20	8389410	8390449	1039	520.0	
89494	chr20	8394235	8394841	606	303.0	
89495	chr20	8399835	8400493	658	329.0	
89496	chr20	8425795	8426119	324	162.0	
89497	chr20	8427583	8428451	868	434.0	
89498	chr20	8428996	8429341	345	172.0	
89499	chr20	8433312	8433723	411	206.0	
89500	chr20	8434396	8435755	1359	680.0	
89501	chr20	8453975	8454864	889	444.0	
89502	chr20	8457891	8458461	570	285.0	
89503	chr20	8466779	8467188	409	204.0	
89504	chr20	8475780	8476536	756	378.0	
89505	chr20	8505816	8506216	400	200.0	
89506	chr20	8523675	8524047	372	186.0	
89507	chr20	8527921	8528418	497	248.0	
89508	chr20	8547260	8547706	446	223.0	
89509	chr20	8571715	8571842	127	64.0	
89510	chr20	8602576	8603237	661	330.0	
89511	chr20	8721067	8721521	454	227.0	
89512	chr20	8722257	8722765	508	254.0	
89513	chr20	8751477	8751845	368	184.0	
89514	chr20	8759616	8759960	344	172.0	
89515	chr20	8790467	8790763	296	148.0	
89516	chr20	8853735	8854189	454	227.0	
89517	chr20	9258976	9259221	245	122.0	
89518	chr20	9393233	9393785	552	276.0	
89519	chr20	9397709	9398494	785	392.0	
89520	chr20	9401475	9401753	278	139.0	
89521	chr20	9408017	9408486	469	234.0	
89522	chr20	9457007	9457493	486	243.0	
89523	chr20	9458547	9458864	317	158.0	
89524	chr20	9482168	9482649	481	240.0	
89525	chr20	9491240	9491754	514	257.0	
89526	chr20	9496199	9496519	320	160.0	
89527	chr20	9498209	9498740	531	266.0	
89528	chr20	9500037	9500539	502	251.0	
89529	chr20	9503640	9504281	641	320.0	
89530	chr20	9506542	9506914	372	186.0	
89531	chr20	9508820	9509354	534	267.0	
89532	chr20	9514377	9514840	463	232.0	
89533	chr20	9515647	9516865	1218	609.0	
89534	chr20	9523628	9523989	361	180.0	
89535	chr20	9609898	9610283	385	192.0	
89536	chr20	9615837	9617422	1585	792.0	
89537	chr20	9889593	9889818	225	112.0	
89538	chr20	9919349	9919776	427	214.0	
89539	chr20	9978289	9978880	591	296.0	
89540	chr20	9988908	9989479	571	286.0	
89541	chr20	9993144	9993535	391	196.0	
89542	chr20	9999565	10000055	490	245.0	
89543	chr20	10034588	10035782	1194	597.0	
89544	chr20	10090541	10090926	385	192.0	
89545	chr20	10172124	10172749	625	312.0	
89546	chr20	10218040	10219994	1954	977.0	
89547	chr20	10350571	10352025	1454	727.0	
89548	chr20	10404278	10404390	112	56.0	
89549	chr20	10426886	10427507	621	310.0	
89550	chr20	10433203	10435906	2703	1352.0	
89551	chr20	10446922	10447469	547	274.0	
89552	chr20	10453154	10453761	607	304.0	
89553	chr20	10469529	10470651	1122	561.0	
89554	chr20	10474449	10475037	588	294.0	
89555	chr20	10476228	10476845	617	308.0	
89556	chr20	10487451	10489277	1826	913.0	
89557	chr20	10490749	10491198	449	224.0	
89558	chr20	10492017	10492508	491	246.0	
89559	chr20	10501302	10502460	1158	579.0	
89560	chr20	10504615	10505734	1119	560.0	
89561	chr20	10511144	10512181	1037	518.0	
89562	chr20	10540570	10541482	912	456.0	
89563	chr20	10550240	10550611	371	186.0	
89564	chr20	10553408	10553694	286	143.0	
89565	chr20	10558676	10559064	388	194.0	
89566	chr20	10662996	10663431	435	218.0	
89567	chr20	10671290	10675192	3902	1951.0	
89568	chr20	10676621	10676624	3	2.0	
89569	chr20	10857265	10857859	594	297.0	
89570	chr20	11182707	11183179	472	236.0	
89571	chr20	11205124	11205540	416	208.0	
89572	chr20	11436574	11436847	273	136.0	
89573	chr20	11452405	11452616	211	106.0	
89574	chr20	11453523	11453630	107	54.0	
89575	chr20	11459550	11459912	362	181.0	
89576	chr20	11544166	11544411	245	122.0	
89577	chr20	11890427	11892663	2236	1118.0	
89578	chr20	12012164	12012679	515	258.0	
89579	chr20	12023349	12023558	209	104.0	
89580	chr20	12053266	12053797	531	266.0	
89581	chr20	12074509	12074559	50	25.0	
89582	chr20	12093314	12093390	76	38.0	
89583	chr20	12166425	12166524	99	50.0	
89584	chr20	12243404	12243665	261	130.0	
89585	chr20	12925091	12925597	506	253.0	
89586	chr20	12965855	12965996	141	70.0	
89587	chr20	13009315	13010383	1068	534.0	
89588	chr20	13119475	13119946	471	236.0	
89589	chr20	13219944	13222326	2382	1191.0	
89590	chr20	13230846	13231765	919	460.0	
89591	chr20	13247073	13248221	1148	574.0	
89592	chr20	13262025	13262473	448	224.0	
89593	chr20	13458897	13459303	406	203.0	
89594	chr20	13546556	13546880	324	162.0	
89595	chr20	13638172	13639663	1491	746.0	
89596	chr20	13659208	13659754	546	273.0	
89597	chr20	13684604	13684947	343	172.0	
89598	chr20	13722971	13723419	448	224.0	
89599	chr20	13771885	13772157	272	136.0	
89600	chr20	13784267	13785836	1569	784.0	
89601	chr20	13788189	13788598	409	204.0	
89602	chr20	13820152	13820582	430	215.0	
89603	chr20	13825437	13825517	80	40.0	
89604	chr20	13865973	13866203	230	115.0	
89605	chr20	13868207	13868838	631	316.0	
89606	chr20	13995062	13995900	838	419.0	
89607	chr20	14055200	14055505	305	152.0	
89608	chr20	14337592	14337680	88	44.0	
89609	chr20	15162367	15162670	303	152.0	
89610	chr20	15196899	15197009	110	55.0	
89611	chr20	15236874	15237055	181	90.0	
89612	chr20	15310324	15310905	581	290.0	
89613	chr20	15317675	15318286	611	306.0	
89614	chr20	15475532	15475800	268	134.0	
89615	chr20	15654089	15654488	399	200.0	
89616	chr20	15807734	15808161	427	214.0	
89617	chr20	15857375	15857524	149	74.0	
89618	chr20	15923049	15923541	492	246.0	
89619	chr20	15937194	15937414	220	110.0	
89620	chr20	16028992	16029262	270	135.0	
89621	chr20	16040669	16041250	581	290.0	
89622	chr20	16055072	16055280	208	104.0	
89623	chr20	16069398	16069835	437	218.0	
89624	chr20	16158635	16159044	409	204.0	
89625	chr20	16292374	16292585	211	106.0	
89626	chr20	16317684	16318494	810	405.0	
89627	chr20	16387650	16388121	471	236.0	
89628	chr20	16390897	16391524	627	314.0	
89629	chr20	16392331	16392740	409	204.0	
89630	chr20	16476009	16476128	119	60.0	
89631	chr20	16491136	16491959	823	412.0	
89632	chr20	16514053	16514573	520	260.0	
89633	chr20	16518283	16518657	374	187.0	
89634	chr20	16572834	16575831	2997	1498.0	
89635	chr20	16709017	16709457	440	220.0	
89636	chr20	16729307	16730845	1538	769.0	
89637	chr20	16732694	16733213	519	260.0	
89638	chr20	16761201	16761647	446	223.0	
89639	chr20	16804171	16804231	60	30.0	
89640	chr20	16821464	16821839	375	188.0	
89641	chr20	17504354	17507388	3034	1517.0	
89642	chr20	17511447	17511787	340	170.0	
89643	chr20	17518452	17518752	300	150.0	
89644	chr20	17525690	17525990	300	150.0	
89645	chr20	17530442	17531683	1241	620.0	
89646	chr20	17533427	17533830	403	202.0	
89647	chr20	17536834	17537569	735	368.0	
89648	chr20	17538582	17538850	268	134.0	
89649	chr20	17558605	17559046	441	220.0	
89650	chr20	17568215	17568217	2	1.0	
89651	chr20	17568891	17571570	2679	1340.0	
89652	chr20	17580904	17581268	364	182.0	
89653	chr20	17610122	17614067	3945	1972.0	
89654	chr20	17615228	17616281	1053	526.0	
89655	chr20	17617272	17617942	670	335.0	
89656	chr20	17634635	17635467	832	416.0	
89657	chr20	17648337	17648484	147	74.0	
89658	chr20	17649113	17649556	443	222.0	
89659	chr20	17662266	17662619	353	176.0	
89660	chr20	17664116	17664667	551	276.0	
89661	chr20	17670975	17671597	622	311.0	
89662	chr20	17673159	17673445	286	143.0	
89663	chr20	17679732	17683332	3600	1800.0	
89664	chr20	17843623	17844298	675	338.0	
89665	chr20	17846063	17846488	425	212.0	
89666	chr20	17856193	17856625	432	216.0	
89667	chr20	17859132	17860620	1488	744.0	
89668	chr20	17878858	17879219	361	180.0	
89669	chr20	17885498	17885929	431	216.0	
89670	chr20	17895387	17896026	639	320.0	
89671	chr20	17898444	17898952	508	254.0	
89672	chr20	17904087	17904443	356	178.0	
89673	chr20	17910857	17911170	313	156.0	
89674	chr20	17916522	17917011	489	244.0	
89675	chr20	17938698	17939708	1010	505.0	
89676	chr20	17943511	17943724	213	106.0	
89677	chr20	17958784	17959893	1109	554.0	
89678	chr20	17960991	17961881	890	445.0	
89679	chr20	17962427	17970485	8058	4029.0	
89680	chr20	17971750	17971822	72	36.0	
89681	chr20	17972534	17973732	1198	599.0	
89682	chr20	17987932	17988457	525	262.0	
89683	chr20	17995964	17996711	747	374.0	
89684	chr20	18005321	18005737	416	208.0	
89685	chr20	18019057	18019532	475	238.0	
89686	chr20	18048177	18048468	291	146.0	
89687	chr20	18053424	18054028	604	302.0	
89688	chr20	18056361	18057250	889	444.0	
89689	chr20	18136994	18138863	1869	934.0	
89690	chr20	18276712	18277196	484	242.0	
89691	chr20	18287466	18289242	1776	888.0	
89692	chr20	18395528	18395900	372	186.0	
89693	chr20	18412221	18413679	1458	729.0	
89694	chr20	18465610	18468223	2613	1306.0	
89695	chr20	18496411	18497629	1218	609.0	
89696	chr20	18506739	18508679	1940	970.0	
89697	chr20	18511854	18511924	70	35.0	
89698	chr20	18566680	18568083	1403	702.0	
89699	chr20	18571534	18572033	499	250.0	
89700	chr20	18587317	18589031	1714	857.0	
89701	chr20	18590248	18590740	492	246.0	
89702	chr20	18632176	18632610	434	217.0	
89703	chr20	18678573	18679333	760	380.0	
89704	chr20	18737932	18738687	755	378.0	
89705	chr20	18793451	18795001	1550	775.0	
89706	chr20	18831921	18832253	332	166.0	
89707	chr20	19015296	19015624	328	164.0	
89708	chr20	19074935	19075577	642	321.0	
89709	chr20	19205928	19206317	389	194.0	
89710	chr20	19212338	19213205	867	434.0	
89711	chr20	19214028	19214309	281	140.0	
89712	chr20	19233142	19233168	26	13.0	
89713	chr20	19249361	19249951	590	295.0	
89714	chr20	19252316	19253292	976	488.0	
89715	chr20	19260571	19261122	551	276.0	
89716	chr20	19308106	19308561	455	228.0	
89717	chr20	19319816	19320198	382	191.0	
89718	chr20	19428247	19428733	486	243.0	
89719	chr20	19583780	19584218	438	219.0	
89720	chr20	19628556	19628924	368	184.0	
89721	chr20	19657920	19658658	738	369.0	
89722	chr20	19662347	19662795	448	224.0	
89723	chr20	19668483	19668735	252	126.0	
89724	chr20	19692625	19692964	339	170.0	
89725	chr20	19701341	19701879	538	269.0	
89726	chr20	19706201	19707122	921	460.0	
89727	chr20	19722438	19722466	28	14.0	
89728	chr20	19735409	19735891	482	241.0	
89729	chr20	19736946	19737604	658	329.0	
89730	chr20	19743214	19743807	593	296.0	
89731	chr20	19757362	19760389	3027	1514.0	
89732	chr20	19784824	19785344	520	260.0	
89733	chr20	19815429	19815944	515	258.0	
89734	chr20	19827890	19828791	901	450.0	
89735	chr20	19867092	19868904	1812	906.0	
89736	chr20	19875741	19876384	643	322.0	
89737	chr20	19884895	19885609	714	357.0	
89738	chr20	19901288	19901561	273	136.0	
89739	chr20	19903063	19903989	926	463.0	
89740	chr20	19909749	19910170	421	210.0	
89741	chr20	19913407	19913863	456	228.0	
89742	chr20	19915047	19916078	1031	516.0	
89743	chr20	19917865	19918408	543	272.0	
89744	chr20	19928289	19928691	402	201.0	
89745	chr20	19932063	19932641	578	289.0	
89746	chr20	19934574	19936169	1595	798.0	
89747	chr20	19937140	19938149	1009	504.0	
89748	chr20	19941016	19941557	541	270.0	
89749	chr20	19942871	19943708	837	418.0	
89750	chr20	19968618	19968821	203	102.0	
89751	chr20	19971063	19971691	628	314.0	
89752	chr20	19973835	19975602	1767	884.0	
89753	chr20	19976925	19977377	452	226.0	
89754	chr20	19986410	19986772	362	181.0	
89755	chr20	19995250	19995690	440	220.0	
89756	chr20	20000216	20000546	330	165.0	
89757	chr20	20002637	20004160	1523	762.0	
89758	chr20	20008646	20008970	324	162.0	
89759	chr20	20016735	20018218	1483	742.0	
89760	chr20	20051594	20053239	1645	822.0	
89761	chr20	20083799	20084406	607	304.0	
89762	chr20	20181241	20181817	576	288.0	
89763	chr20	20184218	20184804	586	293.0	
89764	chr20	20207857	20208300	443	222.0	
89765	chr20	20215881	20216768	887	444.0	
89766	chr20	20237307	20237773	466	233.0	
89767	chr20	20248843	20249215	372	186.0	
89768	chr20	20254954	20255773	819	410.0	
89769	chr20	20259336	20260115	779	390.0	
89770	chr20	20261028	20261679	651	326.0	
89771	chr20	20267856	20268609	753	376.0	
89772	chr20	20271321	20271462	141	70.0	
89773	chr20	20272568	20273120	552	276.0	
89774	chr20	20276825	20277214	389	194.0	
89775	chr20	20277973	20278394	421	210.0	
89776	chr20	20303602	20304205	603	302.0	
89777	chr20	20317232	20317673	441	220.0	
89778	chr20	20318663	20319173	510	255.0	
89779	chr20	20331715	20332193	478	239.0	
89780	chr20	20333862	20334831	969	484.0	
89781	chr20	20360315	20361076	761	380.0	
89782	chr20	20362890	20362891	1	0.0	
89783	chr20	20367599	20369288	1689	844.0	
89784	chr20	20452233	20452835	602	301.0	
89785	chr20	20464102	20464330	228	114.0	
89786	chr20	20505875	20505935	60	30.0	
89787	chr20	20603173	20603898	725	362.0	
89788	chr20	20664754	20665157	403	202.0	
89789	chr20	20668534	20669115	581	290.0	
89790	chr20	20680897	20681403	506	253.0	
89791	chr20	20691062	20691526	464	232.0	
89792	chr20	20710521	20713610	3089	1544.0	
89793	chr20	20731953	20732385	432	216.0	
89794	chr20	20733979	20734985	1006	503.0	
89795	chr20	20743480	20744172	692	346.0	
89796	chr20	20752685	20753192	507	254.0	
89797	chr20	20755008	20755667	659	330.0	
89798	chr20	20780025	20780984	959	480.0	
89799	chr20	20786383	20786855	472	236.0	
89800	chr20	20823508	20824049	541	270.0	
89801	chr20	20824885	20825393	508	254.0	
89802	chr20	20860142	20860606	464	232.0	
89803	chr20	21048761	21049221	460	230.0	
89804	chr20	21089985	21090371	386	193.0	
89805	chr20	21096131	21096715	584	292.0	
89806	chr20	21099586	21103953	4367	2184.0	
89807	chr20	21104917	21106685	1768	884.0	
89808	chr20	21125115	21126844	1729	864.0	
89809	chr20	21147891	21147911	20	10.0	
89810	chr20	21228557	21228807	250	125.0	
89811	chr20	21235590	21236447	857	428.0	enhancer
89812	chr20	21302623	21304742	2119	1060.0	
89813	chr20	21314965	21315755	790	395.0	
89814	chr20	21325001	21325776	775	388.0	
89815	chr20	21326771	21327130	359	180.0	
89816	chr20	21361394	21361724	330	165.0	
89817	chr20	21391529	21392005	476	238.0	
89818	chr20	21395424	21397569	2145	1072.0	
89819	chr20	21414034	21414192	158	79.0	
89820	chr20	21505001	21507056	2055	1028.0	
89821	chr20	21510726	21510775	49	24.0	
89822	chr20	21512869	21513129	260	130.0	
89823	chr20	21548070	21548878	808	404.0	
89824	chr20	21557383	21557806	423	212.0	
89825	chr20	21572100	21572310	210	105.0	
89826	chr20	22334182	22334468	286	143.0	
89827	chr20	22371863	22372238	375	188.0	
89828	chr20	22683981	22684426	445	222.0	
89829	chr20	22686080	22686456	376	188.0	
89830	chr20	22687858	22688893	1035	518.0	
89831	chr20	22691576	22692070	494	247.0	
89832	chr20	22729258	22729518	260	130.0	
89833	chr20	22921894	22922342	448	224.0	
89834	chr20	22984717	22984784	67	34.0	
89835	chr20	23025399	23026064	665	332.0	
89836	chr20	23027695	23028243	548	274.0	
89837	chr20	23029362	23029687	325	162.0	
89838	chr20	23047736	23051637	3901	1950.0	
89839	chr20	23062144	23062504	360	180.0	
89840	chr20	23081500	23081716	216	108.0	
89841	chr20	23085314	23088328	3014	1507.0	
89842	chr20	23103355	23103651	296	148.0	
89843	chr20	23106356	23106847	491	246.0	
89844	chr20	23113975	23114622	647	324.0	
89845	chr20	23115643	23117126	1483	742.0	
89846	chr20	23119323	23119874	551	276.0	
89847	chr20	23122665	23123251	586	293.0	
89848	chr20	23125391	23127095	1704	852.0	
89849	chr20	23132404	23133138	734	367.0	
89850	chr20	23135593	23136419	826	413.0	
89851	chr20	23142145	23143520	1375	688.0	
89852	chr20	23145143	23145670	527	264.0	
89853	chr20	23147317	23148756	1439	720.0	
89854	chr20	23152189	23152912	723	362.0	
89855	chr20	23155205	23156659	1454	727.0	
89856	chr20	23159264	23159749	485	242.0	
89857	chr20	23161175	23162774	1599	800.0	
89858	chr20	23187585	23188427	842	421.0	
89859	chr20	23193916	23194402	486	243.0	
89860	chr20	23195607	23196070	463	232.0	
89861	chr20	23200332	23200820	488	244.0	
89862	chr20	23225222	23225889	667	334.0	
89863	chr20	23235178	23235842	664	332.0	
89864	chr20	23245585	23246148	563	282.0	
89865	chr20	23258310	23258844	534	267.0	
89866	chr20	23334082	23334541	459	230.0	
89867	chr20	23340457	23340900	443	222.0	
89868	chr20	23346341	23346636	295	148.0	
89869	chr20	23349114	23352188	3074	1537.0	
89870	chr20	23354917	23355269	352	176.0	
89871	chr20	23355809	23358982	3173	1586.0	
89872	chr20	23361012	23363722	2710	1355.0	
89873	chr20	23366067	23367071	1004	502.0	
89874	chr20	23371656	23371859	203	102.0	
89875	chr20	23398009	23398370	361	180.0	
89876	chr20	23399707	23399954	247	124.0	
89877	chr20	23408020	23408475	455	228.0	
89878	chr20	23415734	23416401	667	334.0	
89879	chr20	23419711	23422201	2490	1245.0	
89880	chr20	23441742	23442411	669	334.0	
89881	chr20	23446650	23446955	305	152.0	
89882	chr20	23449383	23449828	445	222.0	
89883	chr20	23456218	23457275	1057	528.0	
89884	chr20	23602162	23602924	762	381.0	
89885	chr20	23606402	23607079	677	338.0	
89886	chr20	23622711	23623420	709	354.0	
89887	chr20	23631933	23632449	516	258.0	
89888	chr20	23637178	23638466	1288	644.0	
89889	chr20	23642363	23642845	482	241.0	
89890	chr20	23643610	23644072	462	231.0	
89891	chr20	23646609	23646806	197	98.0	
89892	chr20	23654789	23656747	1958	979.0	
89893	chr20	23668346	23668846	500	250.0	
89894	chr20	23889598	23890348	750	375.0	
89895	chr20	23902298	23903017	719	360.0	
89896	chr20	23919746	23920832	1086	543.0	
89897	chr20	23927438	23927867	429	214.0	
89898	chr20	23928496	23929369	873	436.0	
89899	chr20	23937238	23937918	680	340.0	
89900	chr20	23996157	23996528	371	186.0	
89901	chr20	24027114	24028039	925	462.0	
89902	chr20	24032430	24033551	1121	560.0	
89903	chr20	24045886	24046044	158	79.0	
89904	chr20	24066408	24066411	3	2.0	
89905	chr20	24100427	24101105	678	339.0	
89906	chr20	24102278	24102690	412	206.0	
89907	chr20	24108769	24109964	1195	598.0	
89908	chr20	24131792	24132003	211	106.0	
89909	chr20	24148223	24148871	648	324.0	
89910	chr20	24157061	24157722	661	330.0	
89911	chr20	24389579	24390190	611	306.0	
89912	chr20	24842906	24843366	460	230.0	
89913	chr20	24918213	24918754	541	270.0	
89914	chr20	24930116	24932032	1916	958.0	
89915	chr20	24948570	24956700	8130	4065.0	
89916	chr20	24957559	24961818	4259	2130.0	
89917	chr20	24965112	24965782	670	335.0	
89918	chr20	24968432	24968740	308	154.0	
89919	chr20	24969655	24971227	1572	786.0	
89920	chr20	24980187	24980540	353	176.0	
89921	chr20	24981142	24982280	1138	569.0	
89922	chr20	24984917	24986263	1346	673.0	
89923	chr20	24987224	24989551	2327	1164.0	
89924	chr20	24990899	24995500	4601	2300.0	
89925	chr20	25037853	25038254	401	200.0	
89926	chr20	25042529	25044236	1707	854.0	
89927	chr20	25052962	25054301	1339	670.0	
89928	chr20	25056413	25059582	3169	1584.0	
89929	chr20	25065319	25066328	1009	504.0	
89930	chr20	25076774	25078014	1240	620.0	
89931	chr20	25080966	25081703	737	368.0	
89932	chr20	25084334	25084988	654	327.0	
89933	chr20	25090281	25091558	1277	638.0	
89934	chr20	25148241	25149120	879	440.0	
89935	chr20	25178943	25179559	616	308.0	
89936	chr20	25194816	25198113	3297	1648.0	
89937	chr20	25203770	25205442	1672	836.0	
89938	chr20	25227025	25227486	461	230.0	
89939	chr20	25237537	25238413	876	438.0	
89940	chr20	25246963	25249352	2389	1194.0	
89941	chr20	25259766	25260250	484	242.0	
89942	chr20	25260795	25261203	408	204.0	
89943	chr20	25281453	25282323	870	435.0	
89944	chr20	25285804	25285921	117	58.0	
89945	chr20	25288794	25288980	186	93.0	
89946	chr20	25294325	25294904	579	290.0	
89947	chr20	25296605	25297049	444	222.0	
89948	chr20	25309710	25311183	1473	736.0	
89949	chr20	25313639	25314029	390	195.0	
89950	chr20	25318408	25319306	898	449.0	
89951	chr20	25321430	25321999	569	284.0	
89952	chr20	25324333	25325120	787	394.0	
89953	chr20	25360749	25361443	694	347.0	
89954	chr20	25389363	25391685	2322	1161.0	
89955	chr20	25399054	25399550	496	248.0	
89956	chr20	25407058	25408465	1407	704.0	
89957	chr20	25439321	25439758	437	218.0	
89958	chr20	25461732	25462250	518	259.0	
89959	chr20	25470045	25470397	352	176.0	
89960	chr20	25584649	25586090	1441	720.0	
89961	chr20	25619854	25619937	83	42.0	
89962	chr20	25622962	25624820	1858	929.0	
89963	chr20	25643753	25644074	321	160.0	
89964	chr20	25695749	25697402	1653	826.0	
89965	chr20	25706383	25707248	865	432.0	
89966	chr20	25718902	25719842	940	470.0	
89967	chr20	25739508	25740288	780	390.0	
89968	chr20	25750509	25751822	1313	656.0	
89969	chr20	25853475	25854534	1059	530.0	
89970	chr20	25858206	25858647	441	220.0	
89971	chr20	25859526	25860446	920	460.0	
89972	chr20	25861093	25863853	2760	1380.0	
89973	chr20	25865327	25866354	1027	514.0	
89974	chr20	25867822	25868769	947	474.0	
89975	chr20	25982751	25983032	281	140.0	
89976	chr20	25984888	25985370	482	241.0	
89977	chr20	25986949	25987793	844	422.0	
89978	chr20	26008183	26008584	401	200.0	
89979	chr20	26009404	26011053	1649	824.0	
89980	chr20	26207915	26209900	1985	992.0	
89981	chr20	26252555	26253040	485	242.0	
89982	chr20	26308890	26308968	78	39.0	
89983	chr20	26337176	26338098	922	461.0	
89984	chr20	30282866	30284828	1962	981.0	
89985	chr20	30288885	30290933	2048	1024.0	
89986	chr20	30300461	30300464	3	2.0	
89987	chr20	30348995	30349411	416	208.0	
89988	chr20	30356808	30357259	451	226.0	
89989	chr20	30376326	30377939	1613	806.0	
89990	chr20	30417170	30419108	1938	969.0	
89991	chr20	31243880	31244321	441	220.0	
89992	chr20	31460369	31460909	540	270.0	
89993	chr20	31474003	31474349	346	173.0	
89994	chr20	31502881	31503793	912	456.0	
89995	chr20	31513716	31517718	4002	2001.0	
89996	chr20	31521168	31522196	1028	514.0	
89997	chr20	31522746	31524259	1513	756.0	
89998	chr20	31537838	31538297	459	230.0	
89999	chr20	31542033	31542516	483	242.0	
90000	chr20	31546759	31548073	1314	657.0	
90001	chr20	31557123	31557797	674	337.0	
90002	chr20	31559817	31561267	1450	725.0	
90003	chr20	31562753	31563385	632	316.0	
90004	chr20	31567030	31567289	259	130.0	
90005	chr20	31568220	31571560	3340	1670.0	
90006	chr20	31572289	31574100	1811	906.0	
90007	chr20	31577641	31578498	857	428.0	
90008	chr20	31587483	31588825	1342	671.0	
90009	chr20	31602675	31607756	5081	2540.0	enhancer
90010	chr20	31608290	31608965	675	338.0	
90011	chr20	31610354	31611236	882	441.0	
90012	chr20	31612425	31613523	1098	549.0	
90013	chr20	31617375	31618054	679	340.0	
90014	chr20	31634190	31634640	450	225.0	
90015	chr20	31661262	31662552	1290	645.0	
90016	chr20	31666327	31667877	1550	775.0	
90017	chr20	31673927	31676846	2919	1460.0	enhancer
90018	chr20	31684300	31685555	1255	628.0	
90019	chr20	31699076	31699653	577	288.0	
90020	chr20	31717271	31717958	687	344.0	
90021	chr20	31719243	31724636	5393	2696.0	
90022	chr20	31727540	31728093	553	276.0	
90023	chr20	31738626	31740630	2004	1002.0	
90024	chr20	31770484	31770621	137	68.0	
90025	chr20	31810505	31810677	172	86.0	
90026	chr20	31822490	31823395	905	452.0	
90027	chr20	31833352	31833809	457	228.0	
90028	chr20	31835888	31836643	755	378.0	
90029	chr20	31837857	31838184	327	164.0	
90030	chr20	31846286	31847102	816	408.0	
90031	chr20	31852579	31853160	581	290.0	
90032	chr20	31858265	31858726	461	230.0	
90033	chr20	31861027	31862112	1085	542.0	
90034	chr20	31868190	31868278	88	44.0	
90035	chr20	31868869	31871404	2535	1268.0	
90036	chr20	31879097	31880724	1627	814.0	
90037	chr20	31894942	31895765	823	412.0	
90038	chr20	31951094	31952654	1560	780.0	
90039	chr20	31967702	31969011	1309	654.0	
90040	chr20	32017726	32020234	2508	1254.0	
90041	chr20	32024719	32024996	277	138.0	
90042	chr20	32031075	32032114	1039	520.0	
90043	chr20	32033590	32037133	3543	1772.0	
90044	chr20	32039944	32041223	1279	640.0	
90045	chr20	32050597	32053902	3305	1652.0	
90046	chr20	32056297	32057588	1291	646.0	
90047	chr20	32062359	32064275	1916	958.0	
90048	chr20	32064969	32064977	8	4.0	
90049	chr20	32067139	32067648	509	254.0	
90050	chr20	32068604	32069539	935	468.0	
90051	chr20	32070317	32071111	794	397.0	
90052	chr20	32077204	32077654	450	225.0	
90053	chr20	32078836	32079154	318	159.0	
90054	chr20	32082515	32082733	218	109.0	
90055	chr20	32091751	32092336	585	292.0	
90056	chr20	32109168	32110650	1482	741.0	
90057	chr20	32111331	32114016	2685	1342.0	
90058	chr20	32117206	32117531	325	162.0	
90059	chr20	32154751	32156057	1306	653.0	
90060	chr20	32189438	32192037	2599	1300.0	
90061	chr20	32202031	32202343	312	156.0	
90062	chr20	32204978	32208442	3464	1732.0	
90063	chr20	32227862	32228631	769	384.0	
90064	chr20	32231570	32232384	814	407.0	
90065	chr20	32234132	32234504	372	186.0	
90066	chr20	32249015	32249798	783	392.0	
90067	chr20	32252336	32252567	231	116.0	
90068	chr20	32277046	32278854	1808	904.0	
90069	chr20	32285305	32286506	1201	600.0	
90070	chr20	32333415	32334679	1264	632.0	
90071	chr20	32336823	32337386	563	282.0	
90072	chr20	32356638	32366035	9397	4698.0	
90073	chr20	32369084	32369210	126	63.0	
90074	chr20	32387178	32387859	681	340.0	
90075	chr20	32391071	32391505	434	217.0	
90076	chr20	32407196	32407927	731	366.0	
90077	chr20	32412378	32412664	286	143.0	
90078	chr20	32437630	32438026	396	198.0	
90079	chr20	32439543	32439786	243	122.0	
90080	chr20	32443583	32443592	9	4.0	
90081	chr20	32445986	32446396	410	205.0	
90082	chr20	32448410	32450286	1876	938.0	
90083	chr20	32451589	32452252	663	332.0	
90084	chr20	32456904	32458764	1860	930.0	
90085	chr20	32465062	32465876	814	407.0	
90086	chr20	32469896	32470835	939	470.0	
90087	chr20	32474843	32477088	2245	1122.0	
90088	chr20	32477955	32478032	77	38.0	
90089	chr20	32479633	32480017	384	192.0	
90090	chr20	32481357	32486332	4975	2488.0	
90091	chr20	32487614	32487630	16	8.0	
90092	chr20	32504924	32506488	1564	782.0	
90093	chr20	32508242	32510985	2743	1372.0	
90094	chr20	32512066	32512126	60	30.0	
90095	chr20	32513291	32513683	392	196.0	
90096	chr20	32521436	32523640	2204	1102.0	
90097	chr20	32526068	32529227	3159	1580.0	enhancer
90098	chr20	32534067	32541103	7036	3518.0	
90099	chr20	32554424	32554830	406	203.0	
90100	chr20	32560829	32561366	537	268.0	
90101	chr20	32564851	32565742	891	446.0	
90102	chr20	32569106	32569907	801	400.0	
90103	chr20	32570434	32570786	352	176.0	
90104	chr20	32574390	32575289	899	450.0	
90105	chr20	32578987	32579508	521	260.0	
90106	chr20	32580826	32587792	6966	3483.0	
90107	chr20	32589202	32589649	447	224.0	
90108	chr20	32602849	32603712	863	432.0	
90109	chr20	32604969	32605572	603	302.0	
90110	chr20	32627009	32628232	1223	612.0	
90111	chr20	32648745	32649524	779	390.0	
90112	chr20	32651665	32651677	12	6.0	
90113	chr20	32652497	32653535	1038	519.0	
90114	chr20	32665336	32665616	280	140.0	
90115	chr20	32672306	32674918	2612	1306.0	
90116	chr20	32681438	32681896	458	229.0	
90117	chr20	32685982	32686399	417	208.0	
90118	chr20	32731966	32732003	37	18.0	
90119	chr20	32737388	32738312	924	462.0	
90120	chr20	32742174	32744373	2199	1100.0	
90121	chr20	32744897	32745217	320	160.0	
90122	chr20	32761646	32763887	2241	1120.0	
90123	chr20	32778341	32779037	696	348.0	
90124	chr20	32789801	32790648	847	424.0	
90125	chr20	32792183	32792751	568	284.0	
90126	chr20	32793370	32794632	1262	631.0	
90127	chr20	32819177	32824379	5202	2601.0	
90128	chr20	32829816	32831024	1208	604.0	
90129	chr20	32832486	32833108	622	311.0	
90130	chr20	32871700	32871980	280	140.0	
90131	chr20	32902412	32902960	548	274.0	
90132	chr20	32945694	32946363	669	334.0	
90133	chr20	32965494	32965950	456	228.0	
90134	chr20	32966811	32969076	2265	1132.0	
90135	chr20	32971007	32973281	2274	1137.0	
90136	chr20	33005120	33005305	185	92.0	
90137	chr20	33095905	33096344	439	220.0	
90138	chr20	33261956	33263028	1072	536.0	
90139	chr20	33267709	33268098	389	194.0	
90140	chr20	33268917	33269413	496	248.0	
90141	chr20	33291835	33292218	383	192.0	
90142	chr20	33299047	33299538	491	246.0	
90143	chr20	33350553	33351134	581	290.0	
90144	chr20	33369189	33370986	1797	898.0	
90145	chr20	33372308	33373181	873	436.0	
90146	chr20	33399776	33402173	2397	1198.0	
90147	chr20	33408662	33409739	1077	538.0	
90148	chr20	33442373	33445311	2938	1469.0	
90149	chr20	33456935	33457759	824	412.0	
90150	chr20	33476046	33476400	354	177.0	
90151	chr20	33489393	33491060	1667	834.0	
90152	chr20	33554326	33555707	1381	690.0	
90153	chr20	33602988	33603156	168	84.0	
90154	chr20	33624442	33624884	442	221.0	
90155	chr20	33647605	33648006	401	200.0	
90156	chr20	33653159	33653660	501	250.0	
90157	chr20	33662714	33665272	2558	1279.0	
90158	chr20	33666154	33668682	2528	1264.0	
90159	chr20	33673623	33675238	1615	808.0	
90160	chr20	33678659	33680270	1611	806.0	
90161	chr20	33685089	33687769	2680	1340.0	
90162	chr20	33689892	33690728	836	418.0	
90163	chr20	33719168	33721076	1908	954.0	
90164	chr20	33724370	33724861	491	246.0	
90165	chr20	33731327	33734632	3305	1652.0	
90166	chr20	33756191	33756502	311	156.0	
90167	chr20	33773700	33774011	311	156.0	
90168	chr20	33778422	33779401	979	490.0	
90169	chr20	33792087	33792553	466	233.0	
90170	chr20	33800794	33801111	317	158.0	
90171	chr20	33810516	33813396	2880	1440.0	
90172	chr20	33814147	33814603	456	228.0	
90173	chr20	33826516	33826743	227	114.0	
90174	chr20	33830012	33830311	299	150.0	
90175	chr20	33838699	33839087	388	194.0	
90176	chr20	33853370	33853779	409	204.0	
90177	chr20	33859113	33859766	653	326.0	
90178	chr20	33862603	33863080	477	238.0	
90179	chr20	33875047	33875484	437	218.0	
90180	chr20	33914930	33916094	1164	582.0	
90181	chr20	33919626	33920033	407	204.0	
90182	chr20	33933380	33933900	520	260.0	
90183	chr20	33947662	33948095	433	216.0	
90184	chr20	33992232	33996194	3962	1981.0	
90185	chr20	33999364	33999455	91	46.0	
90186	chr20	34000026	34000384	358	179.0	
90187	chr20	34009387	34010933	1546	773.0	
90188	chr20	34015891	34016170	279	140.0	
90189	chr20	34019449	34020647	1198	599.0	
90190	chr20	34022060	34023001	941	470.0	
90191	chr20	34024955	34025350	395	198.0	
90192	chr20	34037088	34037550	462	231.0	
90193	chr20	34042362	34042496	134	67.0	
90194	chr20	34058744	34059271	527	264.0	
90195	chr20	34069157	34070258	1101	550.0	
90196	chr20	34104189	34104409	220	110.0	
90197	chr20	34110402	34113298	2896	1448.0	
90198	chr20	34124506	34124790	284	142.0	
90199	chr20	34129393	34130108	715	358.0	
90200	chr20	34190638	34190980	342	171.0	
90201	chr20	34215929	34216498	569	284.0	
90202	chr20	34241269	34241345	76	38.0	
90203	chr20	34247355	34247791	436	218.0	
90204	chr20	34249193	34249746	553	276.0	
90205	chr20	34255600	34255951	351	176.0	
90206	chr20	34262506	34263335	829	414.0	
90207	chr20	34268877	34269622	745	372.0	
90208	chr20	34293594	34293958	364	182.0	
90209	chr20	34299564	34299866	302	151.0	
90210	chr20	34302256	34304115	1859	930.0	
90211	chr20	34305855	34306183	328	164.0	
90212	chr20	34311522	34313392	1870	935.0	
90213	chr20	34324459	34324998	539	270.0	
90214	chr20	34335947	34336502	555	278.0	
90215	chr20	34337801	34339015	1214	607.0	
90216	chr20	34350362	34350561	199	100.0	
90217	chr20	34362688	34364303	1615	808.0	
90218	chr20	34364882	34366520	1638	819.0	
90219	chr20	34369181	34369759	578	289.0	
90220	chr20	34405089	34405817	728	364.0	
90221	chr20	34449953	34450363	410	205.0	
90222	chr20	34476151	34476741	590	295.0	
90223	chr20	34513001	34513393	392	196.0	
90224	chr20	34514889	34517503	2614	1307.0	
90225	chr20	34522982	34523507	525	262.0	
90226	chr20	34536963	34537424	461	230.0	
90227	chr20	34538562	34539097	535	268.0	
90228	chr20	34540874	34541936	1062	531.0	
90229	chr20	34544260	34544711	451	226.0	
90230	chr20	34549583	34549979	396	198.0	
90231	chr20	34557769	34563065	5296	2648.0	
90232	chr20	34563779	34564011	232	116.0	
90233	chr20	34564738	34565149	411	206.0	
90234	chr20	34570951	34571425	474	237.0	
90235	chr20	34580128	34580748	620	310.0	
90236	chr20	34620809	34621092	283	142.0	
90237	chr20	34623012	34623482	470	235.0	
90238	chr20	34643940	34644410	470	235.0	
90239	chr20	34676236	34677934	1698	849.0	
90240	chr20	34680473	34681144	671	336.0	
90241	chr20	34703018	34714080	11062	5531.0	
90242	chr20	34715368	34716001	633	316.0	
90243	chr20	34769665	34770134	469	234.0	
90244	chr20	34824192	34826230	2038	1019.0	
90245	chr20	34831889	34832084	195	98.0	
90246	chr20	34834309	34834807	498	249.0	
90247	chr20	34871633	34877247	5614	2807.0	
90248	chr20	34890956	34891629	673	336.0	
90249	chr20	34892785	34893160	375	188.0	
90250	chr20	34904378	34904692	314	157.0	
90251	chr20	34918007	34918430	423	212.0	
90252	chr20	34938390	34939707	1317	658.0	
90253	chr20	34941247	34941517	270	135.0	
90254	chr20	34954817	34956488	1671	836.0	
90255	chr20	34960550	34961227	677	338.0	
90256	chr20	34997348	34997660	312	156.0	
90257	chr20	35002085	35002138	53	26.0	
90258	chr20	35055634	35056237	603	302.0	
90259	chr20	35070043	35070421	378	189.0	
90260	chr20	35079726	35080689	963	482.0	
90261	chr20	35085484	35086036	552	276.0	
90262	chr20	35088739	35089124	385	192.0	
90263	chr20	35091786	35093907	2121	1060.0	
90264	chr20	35096059	35096982	923	462.0	
90265	chr20	35120459	35120490	31	16.0	
90266	chr20	35144497	35145845	1348	674.0	
90267	chr20	35146454	35148514	2060	1030.0	
90268	chr20	35161355	35162054	699	350.0	
90269	chr20	35171592	35172696	1104	552.0	
90270	chr20	35208116	35208842	726	363.0	
90271	chr20	35226633	35227478	845	422.0	
90272	chr20	35250610	35252851	2241	1120.0	
90273	chr20	35269188	35269730	542	271.0	
90274	chr20	35274514	35274525	11	6.0	
90275	chr20	35275450	35279324	3874	1937.0	
90276	chr20	35283636	35286138	2502	1251.0	
90277	chr20	35303531	35304606	1075	538.0	
90278	chr20	35306909	35307369	460	230.0	
90279	chr20	35329600	35329839	239	120.0	
90280	chr20	35404872	35405237	365	182.0	
90281	chr20	35411164	35412710	1546	773.0	
90282	chr20	35438926	35439466	540	270.0	
90283	chr20	35446916	35447646	730	365.0	
90284	chr20	35454223	35456125	1902	951.0	
90285	chr20	35463474	35464306	832	416.0	
90286	chr20	35489678	35491647	1969	984.0	
90287	chr20	35502245	35502786	541	270.0	
90288	chr20	35523262	35523708	446	223.0	
90289	chr20	35539733	35540201	468	234.0	
90290	chr20	35541404	35542876	1472	736.0	
90291	chr20	35561347	35561533	186	93.0	
90292	chr20	35600656	35602325	1669	834.0	
90293	chr20	35604381	35604767	386	193.0	
90294	chr20	35614631	35620220	5589	2794.0	
90295	chr20	35621421	35621525	104	52.0	
90296	chr20	35629500	35629783	283	142.0	
90297	chr20	35658565	35659221	656	328.0	
90298	chr20	35660280	35666031	5751	2876.0	
90299	chr20	35680453	35681266	813	406.0	
90300	chr20	35697695	35703265	5570	2785.0	
90301	chr20	35705732	35705942	210	105.0	
90302	chr20	35709469	35709471	2	1.0	
90303	chr20	35711935	35712395	460	230.0	
90304	chr20	35713173	35713454	281	140.0	
90305	chr20	35715318	35715658	340	170.0	
90306	chr20	35717641	35717985	344	172.0	
90307	chr20	35718582	35721032	2450	1225.0	
90308	chr20	35722371	35724125	1754	877.0	
90309	chr20	35725422	35725963	541	270.0	
90310	chr20	35726804	35728108	1304	652.0	
90311	chr20	35728849	35728853	4	2.0	
90312	chr20	35729711	35729713	2	1.0	
90313	chr20	35732068	35732144	76	38.0	
90314	chr20	35732970	35744732	11762	5881.0	
90315	chr20	35757174	35757324	150	75.0	
90316	chr20	35767534	35769904	2370	1185.0	
90317	chr20	35770969	35774706	3737	1868.0	
90318	chr20	35776042	35776045	3	2.0	
90319	chr20	35776671	35777654	983	492.0	
90320	chr20	35791616	35792332	716	358.0	
90321	chr20	35796374	35797142	768	384.0	
90322	chr20	35839936	35840522	586	293.0	
90323	chr20	35851632	35852167	535	268.0	
90324	chr20	35884155	35884681	526	263.0	
90325	chr20	35887388	35888083	695	348.0	
90326	chr20	35895554	35895652	98	49.0	
90327	chr20	35942364	35942595	231	116.0	
90328	chr20	35947410	35947826	416	208.0	
90329	chr20	35952707	35955389	2682	1341.0	
90330	chr20	35977823	35978679	856	428.0	
90331	chr20	35981943	35982361	418	209.0	
90332	chr20	35992662	35993177	515	258.0	
90333	chr20	35994936	35995475	539	270.0	
90334	chr20	36040510	36040923	413	206.0	
90335	chr20	36050131	36051769	1638	819.0	
90336	chr20	36064061	36065817	1756	878.0	
90337	chr20	36092304	36093937	1633	816.0	
90338	chr20	36098222	36098869	647	324.0	
90339	chr20	36113861	36114333	472	236.0	
90340	chr20	36117737	36117877	140	70.0	
90341	chr20	36138579	36139109	530	265.0	
90342	chr20	36142918	36143279	361	180.0	
90343	chr20	36154295	36154912	617	308.0	
90344	chr20	36156588	36157075	487	244.0	
90345	chr20	36173474	36173980	506	253.0	
90346	chr20	36199502	36200342	840	420.0	
90347	chr20	36202752	36203362	610	305.0	
90348	chr20	36214995	36215007	12	6.0	
90349	chr20	36235986	36237389	1403	702.0	
90350	chr20	36435947	36436760	813	406.0	
90351	chr20	36439320	36440034	714	357.0	
90352	chr20	36442825	36443151	326	163.0	
90353	chr20	36460494	36464016	3522	1761.0	
90354	chr20	36464583	36468535	3952	1976.0	
90355	chr20	36470702	36471103	401	200.0	
90356	chr20	36472245	36473234	989	494.0	
90357	chr20	36481610	36482039	429	214.0	
90358	chr20	36491492	36493425	1933	966.0	
90359	chr20	36506268	36506609	341	170.0	
90360	chr20	36541159	36542192	1033	516.0	
90361	chr20	36556344	36557145	801	400.0	
90362	chr20	36564019	36565369	1350	675.0	
90363	chr20	36571217	36576751	5534	2767.0	
90364	chr20	36582564	36582695	131	66.0	
90365	chr20	36584188	36584229	41	20.0	
90366	chr20	36585868	36585995	127	64.0	
90367	chr20	36587636	36588889	1253	626.0	
90368	chr20	36591826	36592682	856	428.0	
90369	chr20	36593528	36596495	2967	1484.0	
90370	chr20	36599719	36600380	661	330.0	
90371	chr20	36601533	36602009	476	238.0	
90372	chr20	36604588	36607387	2799	1400.0	
90373	chr20	36611876	36611914	38	19.0	
90374	chr20	36612427	36613327	900	450.0	
90375	chr20	36624278	36624309	31	16.0	
90376	chr20	36627480	36628723	1243	622.0	
90377	chr20	36629632	36630729	1097	548.0	
90378	chr20	36631829	36631994	165	82.0	
90379	chr20	36642208	36642649	441	220.0	
90380	chr20	36643916	36646745	2829	1414.0	
90381	chr20	36658282	36658781	499	250.0	
90382	chr20	36663023	36663483	460	230.0	
90383	chr20	36701931	36702295	364	182.0	
90384	chr20	36717668	36718064	396	198.0	
90385	chr20	36720691	36720717	26	13.0	
90386	chr20	36733153	36734109	956	478.0	
90387	chr20	36744883	36746687	1804	902.0	
90388	chr20	36754480	36755222	742	371.0	
90389	chr20	36756496	36756866	370	185.0	
90390	chr20	36757462	36758176	714	357.0	
90391	chr20	36773056	36774818	1762	881.0	
90392	chr20	36775911	36776034	123	62.0	
90393	chr20	36776727	36776941	214	107.0	
90394	chr20	36808420	36809527	1107	554.0	
90395	chr20	36835205	36837377	2172	1086.0	
90396	chr20	36838426	36838674	248	124.0	
90397	chr20	36841615	36843970	2355	1178.0	
90398	chr20	36845997	36846512	515	258.0	
90399	chr20	36856585	36857066	481	240.0	
90400	chr20	36861822	36864570	2748	1374.0	
90401	chr20	36866753	36867435	682	341.0	
90402	chr20	36883951	36884572	621	310.0	
90403	chr20	36886459	36888495	2036	1018.0	
90404	chr20	36889120	36889812	692	346.0	
90405	chr20	36891190	36892146	956	478.0	
90406	chr20	36893398	36893928	530	265.0	
90407	chr20	36902467	36902475	8	4.0	
90408	chr20	36919680	36920371	691	346.0	
90409	chr20	36930259	36931619	1360	680.0	
90410	chr20	36932120	36932465	345	172.0	
90411	chr20	36939885	36940136	251	126.0	
90412	chr20	36941814	36941896	82	41.0	
90413	chr20	36943816	36945110	1294	647.0	
90414	chr20	36946641	36947989	1348	674.0	
90415	chr20	36949474	36952546	3072	1536.0	
90416	chr20	36954325	36954411	86	43.0	
90417	chr20	36955257	36955714	457	228.0	
90418	chr20	36957591	36958418	827	414.0	
90419	chr20	36967618	36968437	819	410.0	
90420	chr20	36968977	36970027	1050	525.0	
90421	chr20	36974653	36975584	931	466.0	
90422	chr20	36988478	36990263	1785	892.0	
90423	chr20	36991765	36992038	273	136.0	
90424	chr20	37005073	37006175	1102	551.0	
90425	chr20	37007662	37009341	1679	840.0	
90426	chr20	37014753	37016055	1302	651.0	
90427	chr20	37042880	37044588	1708	854.0	
90428	chr20	37071405	37071986	581	290.0	
90429	chr20	37081636	37082314	678	339.0	
90430	chr20	37094520	37096866	2346	1173.0	
90431	chr20	37123353	37123952	599	300.0	
90432	chr20	37177887	37180399	2512	1256.0	
90433	chr20	37192009	37192741	732	366.0	
90434	chr20	37195306	37196183	877	438.0	
90435	chr20	37202306	37202704	398	199.0	
90436	chr20	37222899	37223587	688	344.0	
90437	chr20	37249180	37249452	272	136.0	
90438	chr20	37265033	37265559	526	263.0	
90439	chr20	37269602	37271485	1883	942.0	
90440	chr20	37274907	37275550	643	322.0	
90441	chr20	37276492	37277475	983	492.0	
90442	chr20	37288068	37290344	2276	1138.0	
90443	chr20	37294173	37294973	800	400.0	
90444	chr20	37296388	37296773	385	192.0	
90445	chr20	37315624	37317021	1397	698.0	
90446	chr20	37317865	37318625	760	380.0	
90447	chr20	37333391	37334354	963	482.0	
90448	chr20	37335675	37337948	2273	1136.0	
90449	chr20	37342778	37342979	201	100.0	
90450	chr20	37345535	37346715	1180	590.0	
90451	chr20	37348008	37348427	419	210.0	
90452	chr20	37349812	37350581	769	384.0	
90453	chr20	37356207	37358124	1917	958.0	
90454	chr20	37366000	37366872	872	436.0	
90455	chr20	37378956	37379612	656	328.0	
90456	chr20	37381947	37382531	584	292.0	
90457	chr20	37384137	37385317	1180	590.0	
90458	chr20	37392487	37392492	5	2.0	
90459	chr20	37406322	37407071	749	374.0	
90460	chr20	37409172	37409658	486	243.0	
90461	chr20	37411301	37412977	1676	838.0	
90462	chr20	37520766	37521425	659	330.0	
90463	chr20	37524909	37525398	489	244.0	
90464	chr20	37526064	37528791	2727	1364.0	
90465	chr20	37534147	37535208	1061	530.0	
90466	chr20	37564388	37564861	473	236.0	
90467	chr20	37575886	37576239	353	176.0	
90468	chr20	37651871	37652231	360	180.0	
90469	chr20	37693391	37694807	1416	708.0	
90470	chr20	37697218	37697770	552	276.0	
90471	chr20	37701799	37702200	401	200.0	
90472	chr20	37714729	37715490	761	380.0	
90473	chr20	37803926	37805157	1231	616.0	
90474	chr20	37990170	37991161	991	496.0	
90475	chr20	37992900	37993405	505	252.0	
90476	chr20	38000151	38000174	23	12.0	
90477	chr20	38023498	38024117	619	310.0	
90478	chr20	38032649	38034603	1954	977.0	
90479	chr20	38057270	38057978	708	354.0	
90480	chr20	38073396	38073931	535	268.0	
90481	chr20	38076664	38076720	56	28.0	
90482	chr20	38091507	38092215	708	354.0	
90483	chr20	38094088	38096149	2061	1030.0	
90484	chr20	38113415	38113876	461	230.0	
90485	chr20	38143675	38144851	1176	588.0	
90486	chr20	38149548	38149844	296	148.0	
90487	chr20	38152012	38153376	1364	682.0	
90488	chr20	38164991	38165718	727	364.0	
90489	chr20	38167781	38169501	1720	860.0	
90490	chr20	38178138	38178676	538	269.0	
90491	chr20	38186960	38187277	317	158.0	
90492	chr20	38196148	38197239	1091	546.0	
90493	chr20	38201217	38201779	562	281.0	
90494	chr20	38210788	38211215	427	214.0	
90495	chr20	38216898	38217058	160	80.0	
90496	chr20	38221000	38221533	533	266.0	
90497	chr20	38222606	38223077	471	236.0	
90498	chr20	38224510	38224906	396	198.0	
90499	chr20	38229770	38230091	321	160.0	
90500	chr20	38243613	38244408	795	398.0	
90501	chr20	38267327	38267645	318	159.0	
90502	chr20	38275759	38276284	525	262.0	
90503	chr20	38287899	38288564	665	332.0	
90504	chr20	38291744	38292341	597	298.0	
90505	chr20	38294262	38294520	258	129.0	
90506	chr20	38298570	38299276	706	353.0	
90507	chr20	38300400	38300846	446	223.0	
90508	chr20	38303768	38305295	1527	764.0	
90509	chr20	38307632	38308109	477	238.0	
90510	chr20	38356234	38356717	483	242.0	
90511	chr20	38369369	38369850	481	240.0	
90512	chr20	38395769	38396396	627	314.0	
90513	chr20	38408559	38409000	441	220.0	
90514	chr20	38433754	38436045	2291	1146.0	
90515	chr20	38446027	38447371	1344	672.0	
90516	chr20	38448100	38448568	468	234.0	
90517	chr20	38471356	38473648	2292	1146.0	
90518	chr20	38633523	38634074	551	276.0	
90519	chr20	38635921	38636227	306	153.0	
90520	chr20	38645575	38646950	1375	688.0	
90521	chr20	38658926	38659297	371	186.0	
90522	chr20	38673738	38674961	1223	612.0	
90523	chr20	38722942	38723370	428	214.0	
90524	chr20	38725157	38726508	1351	676.0	
90525	chr20	38727103	38727897	794	397.0	
90526	chr20	38729202	38732113	2911	1456.0	
90527	chr20	38747419	38749193	1774	887.0	
90528	chr20	38751289	38751943	654	327.0	
90529	chr20	38776279	38776729	450	225.0	
90530	chr20	38790170	38790898	728	364.0	
90531	chr20	38799184	38799679	495	248.0	
90532	chr20	38804258	38808262	4004	2002.0	
90533	chr20	38808794	38809897	1103	552.0	
90534	chr20	38810805	38811278	473	236.0	
90535	chr20	38812147	38812477	330	165.0	
90536	chr20	38813107	38813394	287	144.0	
90537	chr20	38833281	38834216	935	468.0	
90538	chr20	38839930	38843483	3553	1776.0	
90539	chr20	38844946	38845347	401	200.0	
90540	chr20	38858896	38859720	824	412.0	
90541	chr20	38860473	38860952	479	240.0	
90542	chr20	38862349	38863746	1397	698.0	
90543	chr20	38864559	38865074	515	258.0	
90544	chr20	38870537	38871170	633	316.0	
90545	chr20	38872368	38876600	4232	2116.0	
90546	chr20	38879028	38879327	299	150.0	
90547	chr20	38883057	38883588	531	266.0	
90548	chr20	38884168	38884430	262	131.0	
90549	chr20	38892599	38894443	1844	922.0	
90550	chr20	38924690	38924892	202	101.0	
90551	chr20	38925613	38927354	1741	870.0	
90552	chr20	38928614	38929064	450	225.0	
90553	chr20	38961513	38963269	1756	878.0	
90554	chr20	39047773	39050841	3068	1534.0	
90555	chr20	39078296	39079005	709	354.0	
90556	chr20	39081119	39081593	474	237.0	
90557	chr20	39339094	39339146	52	26.0	
90558	chr20	40160061	40160485	424	212.0	
90559	chr20	40241923	40242254	331	166.0	
90560	chr20	40278935	40279809	874	437.0	
90561	chr20	40321629	40322224	595	298.0	
90562	chr20	40323217	40324045	828	414.0	
90563	chr20	40325200	40325518	318	159.0	
90564	chr20	40326645	40327281	636	318.0	
90565	chr20	40339640	40340645	1005	502.0	
90566	chr20	40359108	40359874	766	383.0	
90567	chr20	40436473	40437148	675	338.0	
90568	chr20	40464578	40465372	794	397.0	
90569	chr20	40470584	40471395	811	406.0	
90570	chr20	40491273	40491544	271	136.0	
90571	chr20	40493490	40495066	1576	788.0	
90572	chr20	40496032	40496273	241	120.0	
90573	chr20	40497708	40499721	2013	1006.0	
90574	chr20	40506268	40507214	946	473.0	
90575	chr20	40561922	40562563	641	320.0	
90576	chr20	40571514	40572679	1165	582.0	
90577	chr20	40583185	40584136	951	476.0	
90578	chr20	40641133	40641651	518	259.0	
90579	chr20	40676418	40676801	383	192.0	
90580	chr20	40680491	40681261	770	385.0	
90581	chr20	40682423	40684394	1971	986.0	
90582	chr20	40684956	40685560	604	302.0	
90583	chr20	40686614	40690989	4375	2188.0	
90584	chr20	40703954	40704191	237	118.0	
90585	chr20	40719255	40719853	598	299.0	
90586	chr20	40741501	40741946	445	222.0	
90587	chr20	40753464	40753941	477	238.0	
90588	chr20	40757073	40757643	570	285.0	
90589	chr20	40765838	40766487	649	324.0	
90590	chr20	40769851	40770332	481	240.0	
90591	chr20	40771023	40771424	401	200.0	
90592	chr20	40774210	40774551	341	170.0	
90593	chr20	40778909	40779579	670	335.0	
90594	chr20	40781466	40782853	1387	694.0	
90595	chr20	40785484	40785656	172	86.0	
90596	chr20	40810620	40810744	124	62.0	
90597	chr20	40941337	40941499	162	81.0	
90598	chr20	40942006	40942391	385	192.0	
90599	chr20	40956473	40956885	412	206.0	
90600	chr20	40961740	40962103	363	182.0	
90601	chr20	40962643	40963454	811	406.0	
90602	chr20	40966091	40966417	326	163.0	
90603	chr20	40968521	40969560	1039	520.0	
90604	chr20	40980687	40980688	1	0.0	
90605	chr20	40986758	40987092	334	167.0	
90606	chr20	40990411	40992190	1779	890.0	
90607	chr20	41001442	41001880	438	219.0	
90608	chr20	41002843	41004362	1519	760.0	
90609	chr20	41005745	41005802	57	28.0	
90610	chr20	41006872	41008854	1982	991.0	
90611	chr20	41011471	41012106	635	318.0	
90612	chr20	41012887	41013181	294	147.0	
90613	chr20	41027877	41031653	3776	1888.0	origin_of_replication
90614	chr20	41034363	41034684	321	160.0	
90615	chr20	41036124	41036997	873	436.0	
90616	chr20	41039110	41039120	10	5.0	
90617	chr20	41040548	41041182	634	317.0	
90618	chr20	41044643	41044649	6	3.0	
90619	chr20	41046297	41049841	3544	1772.0	
90620	chr20	41050406	41051991	1585	792.0	
90621	chr20	41055487	41055874	387	194.0	
90622	chr20	41061366	41061391	25	12.0	
90623	chr20	41063364	41063844	480	240.0	
90624	chr20	41064441	41064469	28	14.0	
90625	chr20	41066014	41066017	3	2.0	
90626	chr20	41068105	41068151	46	23.0	
90627	chr20	41072261	41073052	791	396.0	
90628	chr20	41075938	41075941	3	2.0	
90629	chr20	41078235	41078866	631	316.0	
90630	chr20	41085820	41086931	1111	556.0	
90631	chr20	41095121	41095826	705	352.0	
90632	chr20	41126818	41126856	38	19.0	
90633	chr20	41133876	41144790	10914	5457.0	
90634	chr20	41145960	41145967	7	4.0	
90635	chr20	41148082	41148446	364	182.0	
90636	chr20	41150618	41151114	496	248.0	
90637	chr20	41152741	41153040	299	150.0	
90638	chr20	41154395	41155003	608	304.0	
90639	chr20	41156167	41158874	2707	1354.0	
90640	chr20	41161862	41162358	496	248.0	
90641	chr20	41167820	41168302	482	241.0	
90642	chr20	41172618	41173697	1079	540.0	
90643	chr20	41232011	41232848	837	418.0	
90644	chr20	41290684	41291318	634	317.0	
90645	chr20	41316654	41318536	1882	941.0	
90646	chr20	41321517	41322066	549	274.0	
90647	chr20	41329327	41330154	827	414.0	
90648	chr20	41339681	41341136	1455	728.0	
90649	chr20	41407715	41408751	1036	518.0	
90650	chr20	41443694	41444038	344	172.0	
90651	chr20	41480141	41480438	297	148.0	
90652	chr20	41592822	41593233	411	206.0	
90653	chr20	41615406	41616023	617	308.0	
90654	chr20	41617230	41619783	2553	1276.0	
90655	chr20	41627801	41628194	393	196.0	
90656	chr20	41632707	41633469	762	381.0	
90657	chr20	41657638	41658009	371	186.0	
90658	chr20	41664586	41664987	401	200.0	
90659	chr20	41692344	41694495	2151	1076.0	
90660	chr20	41697702	41698187	485	242.0	
90661	chr20	41734552	41734578	26	13.0	
90662	chr20	42483773	42484003	230	115.0	
90663	chr20	42484932	42485416	484	242.0	
90664	chr20	42492186	42492832	646	323.0	
90665	chr20	43448715	43449440	725	362.0	
90666	chr20	43456375	43459570	3195	1598.0	
90667	chr20	43460766	43461167	401	200.0	
90668	chr20	43463175	43466738	3563	1782.0	
90669	chr20	43467256	43467405	149	74.0	
90670	chr20	43468536	43468689	153	76.0	
90671	chr20	43472159	43472763	604	302.0	
90672	chr20	43507337	43508502	1165	582.0	
90673	chr20	43513407	43515362	1955	978.0	
90674	chr20	43537866	43538497	631	316.0	
90675	chr20	43554241	43554566	325	162.0	
90676	chr20	43583889	43584481	592	296.0	
90677	chr20	43590004	43591553	1549	774.0	
90678	chr20	43656761	43658436	1675	838.0	
90679	chr20	43666351	43668222	1871	936.0	
90680	chr20	43681406	43682743	1337	668.0	
90681	chr20	43691913	43692355	442	221.0	
90682	chr20	43721851	43722588	737	368.0	
90683	chr20	43728161	43729158	997	498.0	
90684	chr20	43733418	43733702	284	142.0	
90685	chr20	43736777	43737093	316	158.0	
90686	chr20	43745059	43745763	704	352.0	
90687	chr20	43748230	43748671	441	220.0	
90688	chr20	43749644	43750330	686	343.0	
90689	chr20	43751004	43753113	2109	1054.0	
90690	chr20	43840549	43840910	361	180.0	
90691	chr20	43914234	43916540	2306	1153.0	
90692	chr20	43921582	43921711	129	64.0	
90693	chr20	43925156	43926122	966	483.0	
90694	chr20	43939026	43939893	867	434.0	
90695	chr20	43941473	43943296	1823	912.0	
90696	chr20	43949829	43950814	985	492.0	
90697	chr20	43955200	43956070	870	435.0	
90698	chr20	43959038	43960048	1010	505.0	
90699	chr20	43964042	43965100	1058	529.0	
90700	chr20	43976474	43976962	488	244.0	
90701	chr20	43984034	43984289	255	128.0	
90702	chr20	44011252	44011653	401	200.0	
90703	chr20	44019469	44020399	930	465.0	
90704	chr20	44029027	44029568	541	270.0	
90705	chr20	44055976	44056520	544	272.0	
90706	chr20	44068379	44071033	2654	1327.0	
90707	chr20	44073158	44073202	44	22.0	
90708	chr20	44074790	44075997	1207	604.0	
90709	chr20	44080482	44081342	860	430.0	
90710	chr20	44089912	44090417	505	252.0	
90711	chr20	44093006	44093375	369	184.0	
90712	chr20	44116617	44117047	430	215.0	
90713	chr20	44153578	44154133	555	278.0	enhancer
90714	chr20	44187535	44188039	504	252.0	
90715	chr20	44188847	44189250	403	202.0	
90716	chr20	44190158	44190625	467	234.0	
90717	chr20	44198948	44199379	431	216.0	
90718	chr20	44204476	44204489	13	6.0	
90719	chr20	44207215	44207662	447	224.0	
90720	chr20	44208264	44208973	709	354.0	
90721	chr20	44209654	44212080	2426	1213.0	
90722	chr20	44214949	44215639	690	345.0	
90723	chr20	44217199	44219754	2555	1278.0	
90724	chr20	44309868	44311782	1914	957.0	
90725	chr20	44326668	44327182	514	257.0	
90726	chr20	44384324	44384987	663	332.0	
90727	chr20	44386521	44386844	323	162.0	
90728	chr20	44388369	44389050	681	340.0	
90729	chr20	44435578	44436074	496	248.0	
90730	chr20	44460851	44461204	353	176.0	
90731	chr20	44475232	44476831	1599	800.0	
90732	chr20	44479721	44479991	270	135.0	
90733	chr20	44491229	44492399	1170	585.0	
90734	chr20	44495318	44496035	717	358.0	
90735	chr20	44517438	44517738	300	150.0	
90736	chr20	44519189	44520230	1041	520.0	
90737	chr20	44520850	44522841	1991	996.0	
90738	chr20	44531270	44533313	2043	1022.0	
90739	chr20	44536223	44536631	408	204.0	
90740	chr20	44576176	44577408	1232	616.0	
90741	chr20	44582303	44582610	307	154.0	
90742	chr20	44584048	44584490	442	221.0	
90743	chr20	44585317	44585422	105	52.0	
90744	chr20	44585946	44586792	846	423.0	
90745	chr20	44587548	44587854	306	153.0	
90746	chr20	44594814	44595021	207	104.0	
90747	chr20	44597929	44599063	1134	567.0	
90748	chr20	44604623	44604748	125	62.0	
90749	chr20	44609571	44611747	2176	1088.0	
90750	chr20	44614852	44615734	882	441.0	
90751	chr20	44617308	44617536	228	114.0	
90752	chr20	44618216	44618860	644	322.0	
90753	chr20	44641459	44647352	5893	2946.0	"region	enhancer	locus_control_region	region	region	region	region	locus_control_region	enhancer	region	protein_binding_site	protein_binding_site	region	protein_binding_site	protein_binding_site	protein_binding_site	region	region	region"
90754	chr20	44648214	44648442	228	114.0	locus_control_region
90755	chr20	44649398	44653223	3825	1912.0	"locus_control_region	mobile_genetic_element	recombination_feature	mobile_genetic_element	recombination_feature"
90756	chr20	44663969	44664694	725	362.0	
90757	chr20	44671301	44672394	1093	546.0	
90758	chr20	44685087	44685625	538	269.0	
90759	chr20	44728908	44729265	357	178.0	
90760	chr20	44733249	44733820	571	286.0	
90761	chr20	44736022	44737107	1085	542.0	
90762	chr20	44738735	44739309	574	287.0	
90763	chr20	44745499	44746456	957	478.0	
90764	chr20	44747423	44747930	507	254.0	
90765	chr20	44867355	44868157	802	401.0	
90766	chr20	44884616	44887734	3118	1559.0	
90767	chr20	44888463	44889346	883	442.0	
90768	chr20	44896347	44897043	696	348.0	
90769	chr20	44908902	44910789	1887	944.0	
90770	chr20	44911370	44911847	477	238.0	
90771	chr20	44947243	44947739	496	248.0	
90772	chr20	44958970	44960996	2026	1013.0	
90773	chr20	44965789	44972077	6288	3144.0	
90774	chr20	44977259	44977272	13	6.0	
90775	chr20	44978163	44980249	2086	1043.0	
90776	chr20	44986202	44986682	480	240.0	
90777	chr20	44990365	44991911	1546	773.0	
90778	chr20	44993322	44993812	490	245.0	
90779	chr20	45011027	45011502	475	238.0	
90780	chr20	45034455	45034823	368	184.0	
90781	chr20	45039202	45040075	873	436.0	
90782	chr20	45043782	45044673	891	446.0	
90783	chr20	45049923	45050425	502	251.0	
90784	chr20	45051415	45051996	581	290.0	
90785	chr20	45053009	45053604	595	298.0	
90786	chr20	45080827	45081172	345	172.0	
90787	chr20	45087087	45087514	427	214.0	
90788	chr20	45095700	45096282	582	291.0	
90789	chr20	45097642	45098793	1151	576.0	
90790	chr20	45100885	45100951	66	33.0	
90791	chr20	45138802	45139143	341	170.0	
90792	chr20	45153700	45155292	1592	796.0	
90793	chr20	45156705	45157167	462	231.0	
90794	chr20	45254376	45255322	946	473.0	
90795	chr20	45290794	45291368	574	287.0	
90796	chr20	45293223	45294346	1123	562.0	
90797	chr20	45300974	45301303	329	164.0	
90798	chr20	45306469	45306897	428	214.0	
90799	chr20	45311500	45311986	486	243.0	
90800	chr20	45319289	45319988	699	350.0	
90801	chr20	45321007	45321680	673	336.0	
90802	chr20	45322900	45323399	499	250.0	
90803	chr20	45344088	45344761	673	336.0	
90804	chr20	45346158	45346597	439	220.0	
90805	chr20	45347582	45348887	1305	652.0	
90806	chr20	45355266	45355410	144	72.0	
90807	chr20	45357384	45357718	334	167.0	
90808	chr20	45358243	45358716	473	236.0	
90809	chr20	45361475	45364443	2968	1484.0	
90810	chr20	45367881	45369103	1222	611.0	
90811	chr20	45372887	45374564	1677	838.0	
90812	chr20	45405468	45409312	3844	1922.0	
90813	chr20	45415443	45417289	1846	923.0	
90814	chr20	45419466	45420069	603	302.0	
90815	chr20	45432233	45432842	609	304.0	
90816	chr20	45436589	45437533	944	472.0	
90817	chr20	45444032	45444445	413	206.0	
90818	chr20	45445943	45446360	417	208.0	
90819	chr20	45450212	45450924	712	356.0	
90820	chr20	45452264	45452665	401	200.0	
90821	chr20	45453215	45453475	260	130.0	
90822	chr20	45470333	45470971	638	319.0	
90823	chr20	45495386	45496111	725	362.0	
90824	chr20	45592602	45592921	319	160.0	
90825	chr20	45629471	45629896	425	212.0	
90826	chr20	45770931	45771781	850	425.0	
90827	chr20	45790956	45793189	2233	1116.0	
90828	chr20	45798901	45799801	900	450.0	
90829	chr20	45811823	45813358	1535	768.0	
90830	chr20	45822558	45823261	703	352.0	
90831	chr20	45823795	45824711	916	458.0	
90832	chr20	45832930	45834596	1666	833.0	
90833	chr20	45835180	45835769	589	294.0	
90834	chr20	45842058	45842596	538	269.0	
90835	chr20	45856705	45858313	1608	804.0	
90836	chr20	45880659	45881834	1175	588.0	
90837	chr20	45884842	45885411	569	284.0	
90838	chr20	45889903	45893418	3515	1758.0	
90839	chr20	45909782	45912490	2708	1354.0	
90840	chr20	45913110	45913505	395	198.0	
90841	chr20	45914335	45915144	809	404.0	
90842	chr20	45933236	45936110	2874	1437.0	
90843	chr20	45937893	45938056	163	82.0	
90844	chr20	45944103	45944632	529	264.0	
90845	chr20	45945731	45947343	1612	806.0	
90846	chr20	45948078	45950613	2535	1268.0	
90847	chr20	45952334	45952673	339	170.0	
90848	chr20	45953782	45953894	112	56.0	
90849	chr20	45957191	45958302	1111	556.0	
90850	chr20	45959202	45959575	373	186.0	
90851	chr20	45962913	45963574	661	330.0	
90852	chr20	45968391	45968447	56	28.0	
90853	chr20	45969397	45973072	3675	1838.0	
90854	chr20	45987185	45987896	711	356.0	
90855	chr20	45993336	45993914	578	289.0	
90856	chr20	45998083	45999275	1192	596.0	
90857	chr20	46000599	46001005	406	203.0	
90858	chr20	46004120	46006592	2472	1236.0	
90859	chr20	46008034	46012255	4221	2110.0	
90860	chr20	46012871	46014788	1917	958.0	
90861	chr20	46020534	46023354	2820	1410.0	
90862	chr20	46027261	46027643	382	191.0	
90863	chr20	46029378	46029755	377	188.0	
90864	chr20	46057514	46057584	70	35.0	
90865	chr20	46058153	46059121	968	484.0	
90866	chr20	46060401	46060905	504	252.0	
90867	chr20	46087181	46087538	357	178.0	
90868	chr20	46088897	46090539	1642	821.0	
90869	chr20	46099500	46099893	393	196.0	
90870	chr20	46108255	46108924	669	334.0	
90871	chr20	46111077	46111792	715	358.0	
90872	chr20	46117522	46119705	2183	1092.0	
90873	chr20	46128826	46128878	52	26.0	
90874	chr20	46132556	46133080	524	262.0	
90875	chr20	46174431	46174968	537	268.0	
90876	chr20	46199132	46199630	498	249.0	
90877	chr20	46205355	46206738	1383	692.0	
90878	chr20	46207875	46208326	451	226.0	
90879	chr20	46260544	46260694	150	75.0	
90880	chr20	46306656	46309110	2454	1227.0	
90881	chr20	46311610	46312561	951	476.0	
90882	chr20	46342951	46343748	797	398.0	
90883	chr20	46348915	46349391	476	238.0	
90884	chr20	46350412	46350809	397	198.0	
90885	chr20	46356972	46357980	1008	504.0	
90886	chr20	46359218	46359834	616	308.0	
90887	chr20	46361089	46366234	5145	2572.0	
90888	chr20	46394940	46395255	315	158.0	
90889	chr20	46399290	46402821	3531	1766.0	
90890	chr20	46405453	46407727	2274	1137.0	
90891	chr20	46410617	46411554	937	468.0	
90892	chr20	46438328	46438444	116	58.0	
90893	chr20	46513501	46513657	156	78.0	
90894	chr20	46520944	46521435	491	246.0	
90895	chr20	46544860	46545682	822	411.0	
90896	chr20	46550527	46550838	311	156.0	
90897	chr20	46552965	46553491	526	263.0	
90898	chr20	46562197	46562900	703	352.0	
90899	chr20	46624769	46625429	660	330.0	
90900	chr20	46631106	46631782	676	338.0	
90901	chr20	46681104	46681990	886	443.0	
90902	chr20	46688417	46690410	1993	996.0	
90903	chr20	46694446	46695011	565	282.0	
90904	chr20	46709642	46710075	433	216.0	
90905	chr20	46752619	46753002	383	192.0	
90906	chr20	46758018	46758527	509	254.0	
90907	chr20	46971324	46971631	307	154.0	
90908	chr20	46994333	46994681	348	174.0	
90909	chr20	47124158	47125333	1175	588.0	
90910	chr20	47143580	47144142	562	281.0	
90911	chr20	47150572	47151171	599	300.0	
90912	chr20	47181248	47181739	491	246.0	
90913	chr20	47196305	47196942	637	318.0	
90914	chr20	47205598	47206121	523	262.0	
90915	chr20	47220023	47220476	453	226.0	
90916	chr20	47258980	47259349	369	184.0	
90917	chr20	47262441	47263070	629	314.0	
90918	chr20	47272743	47273260	517	258.0	
90919	chr20	47305861	47305943	82	41.0	
90920	chr20	47316903	47319726	2823	1412.0	
90921	chr20	47333956	47334416	460	230.0	
90922	chr20	47346245	47346305	60	30.0	
90923	chr20	47348658	47348728	70	35.0	
90924	chr20	47350113	47350631	518	259.0	
90925	chr20	47351545	47352391	846	423.0	
90926	chr20	47354327	47359437	5110	2555.0	
90927	chr20	47360042	47361189	1147	574.0	
90928	chr20	47362760	47362926	166	83.0	
90929	chr20	47365140	47365375	235	118.0	
90930	chr20	47383778	47384637	859	430.0	
90931	chr20	47390080	47390360	280	140.0	
90932	chr20	47391804	47392726	922	461.0	
90933	chr20	47412126	47413257	1131	566.0	
90934	chr20	47414866	47417112	2246	1123.0	
90935	chr20	47438472	47440432	1960	980.0	
90936	chr20	47464314	47464720	406	203.0	
90937	chr20	47468255	47468754	499	250.0	
90938	chr20	47473386	47473830	444	222.0	
90939	chr20	47479587	47479959	372	186.0	
90940	chr20	47486981	47489839	2858	1429.0	
90941	chr20	47490753	47491190	437	218.0	
90942	chr20	47493123	47493881	758	379.0	
90943	chr20	47500658	47503650	2992	1496.0	
90944	chr20	47507278	47507614	336	168.0	
90945	chr20	47508270	47508634	364	182.0	
90946	chr20	47531346	47531915	569	284.0	
90947	chr20	47541013	47541404	391	196.0	
90948	chr20	47576513	47577053	540	270.0	
90949	chr20	47610390	47611112	722	361.0	
90950	chr20	47621186	47621585	399	200.0	
90951	chr20	47663527	47664587	1060	530.0	
90952	chr20	47677608	47678270	662	331.0	
90953	chr20	47695349	47695567	218	109.0	
90954	chr20	47725203	47726001	798	399.0	
90955	chr20	47726775	47728504	1729	864.0	
90956	chr20	47735372	47736443	1071	536.0	
90957	chr20	47740042	47741480	1438	719.0	
90958	chr20	47747227	47747793	566	283.0	
90959	chr20	47748597	47749377	780	390.0	
90960	chr20	47765235	47766125	890	445.0	
90961	chr20	47767900	47768931	1031	516.0	
90962	chr20	47770829	47771539	710	355.0	
90963	chr20	47773333	47773758	425	212.0	
90964	chr20	47775843	47776267	424	212.0	
90965	chr20	47782025	47782444	419	210.0	
90966	chr20	47784527	47786977	2450	1225.0	
90967	chr20	47797003	47797351	348	174.0	
90968	chr20	47824764	47825075	311	156.0	
90969	chr20	47972483	47972632	149	74.0	
90970	chr20	47975130	47975817	687	344.0	
90971	chr20	47998792	47999193	401	200.0	
90972	chr20	48002506	48003076	570	285.0	
90973	chr20	48006062	48006529	467	234.0	
90974	chr20	48359626	48360631	1005	502.0	
90975	chr20	48467753	48467980	227	114.0	
90976	chr20	48503373	48515874	12501	6250.0	
90977	chr20	48617596	48617852	256	128.0	
90978	chr20	48620073	48622183	2110	1055.0	
90979	chr20	48622880	48623784	904	452.0	
90980	chr20	48624541	48624556	15	8.0	
90981	chr20	48626374	48627833	1459	730.0	
90982	chr20	48629466	48629592	126	63.0	
90983	chr20	48635594	48636307	713	356.0	
90984	chr20	48638668	48638866	198	99.0	
90985	chr20	48657207	48658679	1472	736.0	
90986	chr20	48668482	48668532	50	25.0	
90987	chr20	48669970	48670348	378	189.0	
90988	chr20	48671747	48671824	77	38.0	
90989	chr20	48679657	48680544	887	444.0	
90990	chr20	48682883	48682914	31	16.0	
90991	chr20	48684131	48684154	23	12.0	
90992	chr20	48686604	48686863	259	130.0	
90993	chr20	48688682	48690250	1568	784.0	
90994	chr20	48691654	48692023	369	184.0	
90995	chr20	48702790	48703181	391	196.0	
90996	chr20	48706880	48707311	431	216.0	
90997	chr20	48711831	48713364	1533	766.0	
90998	chr20	48715789	48718196	2407	1204.0	
90999	chr20	48718940	48720071	1131	566.0	
91000	chr20	48720718	48724437	3719	1860.0	
91001	chr20	48725437	48725939	502	251.0	
91002	chr20	48728455	48728974	519	260.0	
91003	chr20	48729579	48729940	361	180.0	
91004	chr20	48733121	48733588	467	234.0	
91005	chr20	48736522	48736713	191	96.0	
91006	chr20	48738397	48739822	1425	712.0	
91007	chr20	48750945	48751995	1050	525.0	
91008	chr20	48752906	48753196	290	145.0	
91009	chr20	48756738	48757074	336	168.0	
91010	chr20	48757799	48762307	4508	2254.0	
91011	chr20	48765926	48766660	734	367.0	
91012	chr20	48767265	48767997	732	366.0	
91013	chr20	48768832	48770138	1306	653.0	
91014	chr20	48771022	48771401	379	190.0	
91015	chr20	48772209	48775289	3080	1540.0	
91016	chr20	48776299	48777578	1279	640.0	
91017	chr20	48781503	48784407	2904	1452.0	
91018	chr20	48787671	48789457	1786	893.0	
91019	chr20	48790695	48790817	122	61.0	
91020	chr20	48795104	48795247	143	72.0	
91021	chr20	48797133	48797938	805	402.0	
91022	chr20	48809738	48810027	289	144.0	
91023	chr20	48816477	48817245	768	384.0	
91024	chr20	48818012	48819525	1513	756.0	
91025	chr20	48820067	48829032	8965	4482.0	
91026	chr20	48831599	48832803	1204	602.0	
91027	chr20	48839053	48839534	481	240.0	
91028	chr20	48843032	48843531	499	250.0	
91029	chr20	48846721	48847331	610	305.0	
91030	chr20	48858147	48858447	300	150.0	
91031	chr20	48870363	48870797	434	217.0	
91032	chr20	48872607	48873375	768	384.0	
91033	chr20	48875890	48876241	351	176.0	
91034	chr20	48877261	48877778	517	258.0	
91035	chr20	48879836	48879874	38	19.0	
91036	chr20	48901403	48901635	232	116.0	
91037	chr20	48904740	48905627	887	444.0	
91038	chr20	48908521	48909139	618	309.0	
91039	chr20	48909888	48911083	1195	598.0	
91040	chr20	48911957	48912575	618	309.0	
91041	chr20	48919993	48922688	2695	1348.0	
91042	chr20	48923859	48924890	1031	516.0	
91043	chr20	49037602	49038548	946	473.0	
91044	chr20	49045383	49047918	2535	1268.0	
91045	chr20	49100723	49101533	810	405.0	
91046	chr20	49132858	49133522	664	332.0	
91047	chr20	49166581	49166833	252	126.0	
91048	chr20	49186473	49189005	2532	1266.0	
91049	chr20	49216720	49217625	905	452.0	
91050	chr20	49218668	49220605	1937	968.0	
91051	chr20	49230255	49231321	1066	533.0	
91052	chr20	49246221	49246907	686	343.0	
91053	chr20	49247580	49247859	279	140.0	
91054	chr20	49248604	49249032	428	214.0	
91055	chr20	49251026	49251042	16	8.0	
91056	chr20	49267232	49268117	885	442.0	
91057	chr20	49270638	49271034	396	198.0	
91058	chr20	49275987	49285560	9573	4786.0	
91059	chr20	49286115	49291377	5262	2631.0	
91060	chr20	49297535	49298310	775	388.0	
91061	chr20	49318383	49319281	898	449.0	
91062	chr20	49320752	49320798	46	23.0	
91063	chr20	49323406	49324389	983	492.0	
91064	chr20	49333823	49334531	708	354.0	
91065	chr20	49347752	49348171	419	210.0	
91066	chr20	49385396	49385882	486	243.0	
91067	chr20	49482573	49483139	566	283.0	
91068	chr20	49484077	49484747	670	335.0	
91069	chr20	49508891	49508934	43	22.0	
91070	chr20	49518679	49518926	247	124.0	
91071	chr20	49534179	49535232	1053	526.0	
91072	chr20	49541677	49542335	658	329.0	
91073	chr20	49583415	49584049	634	317.0	
91074	chr20	49584931	49585029	98	49.0	
91075	chr20	49590139	49590592	453	226.0	
91076	chr20	49594266	49594777	511	256.0	
91077	chr20	49595926	49596473	547	274.0	
91078	chr20	49597421	49597725	304	152.0	
91079	chr20	49608624	49609473	849	424.0	
91080	chr20	49610619	49611742	1123	562.0	
91081	chr20	49620213	49620935	722	361.0	
91082	chr20	49625619	49625765	146	73.0	
91083	chr20	49661541	49662343	802	401.0	
91084	chr20	49668194	49670516	2322	1161.0	
91085	chr20	49675603	49675738	135	68.0	
91086	chr20	49676421	49677531	1110	555.0	
91087	chr20	49678653	49679532	879	440.0	
91088	chr20	49681508	49682007	499	250.0	
91089	chr20	49694449	49694607	158	79.0	
91090	chr20	49699240	49699743	503	252.0	
91091	chr20	49700514	49701696	1182	591.0	
91092	chr20	49702907	49703307	400	200.0	
91093	chr20	49705407	49705708	301	150.0	
91094	chr20	49710839	49711482	643	322.0	
91095	chr20	49712166	49714769	2603	1302.0	
91096	chr20	49718014	49718153	139	70.0	
91097	chr20	49724547	49725311	764	382.0	
91098	chr20	49727345	49727965	620	310.0	
91099	chr20	49750481	49751346	865	432.0	
91100	chr20	49765023	49765574	551	276.0	
91101	chr20	49768128	49769093	965	482.0	
91102	chr20	49772241	49772583	342	171.0	
91103	chr20	49775273	49776769	1496	748.0	
91104	chr20	49785666	49786687	1021	510.0	
91105	chr20	49789199	49790235	1036	518.0	
91106	chr20	49793656	49795384	1728	864.0	
91107	chr20	49800579	49801346	767	384.0	
91108	chr20	49802348	49803081	733	366.0	
91109	chr20	49805105	49805748	643	322.0	
91110	chr20	49808766	49809146	380	190.0	
91111	chr20	49811929	49814706	2777	1388.0	
91112	chr20	49822005	49822365	360	180.0	
91113	chr20	49823250	49824068	818	409.0	
91114	chr20	49832407	49833109	702	351.0	
91115	chr20	49846202	49846661	459	230.0	
91116	chr20	49888262	49889960	1698	849.0	
91117	chr20	49890839	49891425	586	293.0	
91118	chr20	49892211	49892997	786	393.0	
91119	chr20	49893635	49894492	857	428.0	
91120	chr20	49896131	49896717	586	293.0	
91121	chr20	49906256	49906601	345	172.0	
91122	chr20	49914179	49917554	3375	1688.0	
91123	chr20	49925937	49926265	328	164.0	
91124	chr20	49928321	49929308	987	494.0	
91125	chr20	49934766	49938037	3271	1636.0	
91126	chr20	49957267	49957630	363	182.0	
91127	chr20	49964875	49965286	411	206.0	
91128	chr20	49968819	49969625	806	403.0	
91129	chr20	49978728	49979774	1046	523.0	
91130	chr20	49981838	49984668	2830	1415.0	
91131	chr20	49985206	49988519	3313	1656.0	
91132	chr20	49989081	49990645	1564	782.0	
91133	chr20	49993311	49993869	558	279.0	
91134	chr20	49999204	49999816	612	306.0	
91135	chr20	50000734	50001213	479	240.0	
91136	chr20	50003051	50004833	1782	891.0	
91137	chr20	50005362	50006627	1265	632.0	
91138	chr20	50012160	50012556	396	198.0	
91139	chr20	50013949	50014303	354	177.0	
91140	chr20	50020054	50020951	897	448.0	
91141	chr20	50029546	50030472	926	463.0	
91142	chr20	50033546	50034493	947	474.0	
91143	chr20	50041105	50041968	863	432.0	
91144	chr20	50046731	50047626	895	448.0	
91145	chr20	50048205	50049904	1699	850.0	
91146	chr20	50058580	50059892	1312	656.0	
91147	chr20	50070948	50072077	1129	564.0	
91148	chr20	50085234	50087545	2311	1156.0	
91149	chr20	50103612	50104143	531	266.0	
91150	chr20	50109714	50114189	4475	2238.0	
91151	chr20	50115285	50116647	1362	681.0	
91152	chr20	50119653	50120046	393	196.0	
91153	chr20	50120598	50122135	1537	768.0	
91154	chr20	50144182	50144925	743	372.0	
91155	chr20	50146294	50147743	1449	724.0	
91156	chr20	50152102	50154656	2554	1277.0	
91157	chr20	50159614	50160028	414	207.0	
91158	chr20	50165664	50166805	1141	570.0	
91159	chr20	50169262	50169953	691	346.0	
91160	chr20	50171801	50173000	1199	600.0	
91161	chr20	50179146	50179845	699	350.0	
91162	chr20	50186015	50187934	1919	960.0	
91163	chr20	50188868	50196387	7519	3760.0	
91164	chr20	50197407	50198694	1287	644.0	
91165	chr20	50219778	50219931	153	76.0	
91166	chr20	50220493	50222346	1853	926.0	
91167	chr20	50224450	50224852	402	201.0	
91168	chr20	50226389	50227162	773	386.0	
91169	chr20	50237363	50237724	361	180.0	
91170	chr20	50252625	50253102	477	238.0	
91171	chr20	50259605	50261242	1637	818.0	
91172	chr20	50267166	50267873	707	354.0	
91173	chr20	50268473	50268807	334	167.0	
91174	chr20	50270246	50272660	2414	1207.0	
91175	chr20	50273227	50276891	3664	1832.0	
91176	chr20	50278339	50278545	206	103.0	
91177	chr20	50282066	50284657	2591	1296.0	
91178	chr20	50285407	50286086	679	340.0	
91179	chr20	50292383	50293107	724	362.0	
91180	chr20	50297423	50297976	553	276.0	
91181	chr20	50308180	50309247	1067	534.0	
91182	chr20	50321323	50321703	380	190.0	
91183	chr20	50324432	50324716	284	142.0	
91184	chr20	50332226	50332311	85	42.0	
91185	chr20	50335069	50335561	492	246.0	
91186	chr20	50338428	50339499	1071	536.0	
91187	chr20	50340058	50340527	469	234.0	
91188	chr20	50346371	50346869	498	249.0	
91189	chr20	50347691	50348537	846	423.0	
91190	chr20	50349072	50349799	727	364.0	
91191	chr20	50366498	50367009	511	256.0	
91192	chr20	50379057	50379825	768	384.0	
91193	chr20	50382042	50382734	692	346.0	
91194	chr20	50384757	50385021	264	132.0	
91195	chr20	50385812	50386967	1155	578.0	
91196	chr20	50392028	50392590	562	281.0	
91197	chr20	50394518	50395551	1033	516.0	
91198	chr20	50400084	50400630	546	273.0	
91199	chr20	50409417	50409965	548	274.0	
91200	chr20	50425057	50425468	411	206.0	
91201	chr20	50427136	50427260	124	62.0	
91202	chr20	50440472	50441300	828	414.0	
91203	chr20	50450831	50451805	974	487.0	
91204	chr20	50455768	50456255	487	244.0	
91205	chr20	50457864	50458160	296	148.0	
91206	chr20	50460362	50461197	835	418.0	
91207	chr20	50464016	50464846	830	415.0	
91208	chr20	50467962	50468475	513	256.0	
91209	chr20	50470501	50470579	78	39.0	
91210	chr20	50473077	50473677	600	300.0	
91211	chr20	50478013	50478909	896	448.0	
91212	chr20	50483155	50484707	1552	776.0	
91213	chr20	50497942	50499844	1902	951.0	
91214	chr20	50502836	50503354	518	259.0	
91215	chr20	50504138	50504529	391	196.0	
91216	chr20	50509606	50511741	2135	1068.0	
91217	chr20	50513669	50514214	545	272.0	
91218	chr20	50514879	50515191	312	156.0	
91219	chr20	50515937	50520984	5047	2524.0	
91220	chr20	50521951	50522343	392	196.0	
91221	chr20	50523681	50524203	522	261.0	
91222	chr20	50524801	50524802	1	0.0	
91223	chr20	50526565	50526799	234	117.0	
91224	chr20	50529097	50529100	3	2.0	
91225	chr20	50531711	50532158	447	224.0	
91226	chr20	50538135	50538499	364	182.0	
91227	chr20	50541359	50542188	829	414.0	
91228	chr20	50545953	50547224	1271	636.0	
91229	chr20	50570147	50570900	753	376.0	
91230	chr20	50575696	50576326	630	315.0	
91231	chr20	50579801	50580584	783	392.0	
91232	chr20	50582425	50582869	444	222.0	
91233	chr20	50586881	50588571	1690	845.0	
91234	chr20	50593603	50593643	40	20.0	
91235	chr20	50594314	50595869	1555	778.0	
91236	chr20	50635865	50636297	432	216.0	
91237	chr20	50710656	50711012	356	178.0	
91238	chr20	50730371	50732463	2092	1046.0	
91239	chr20	50749256	50749675	419	210.0	
91240	chr20	50790353	50791258	905	452.0	
91241	chr20	50793492	50796198	2706	1353.0	
91242	chr20	50804561	50805381	820	410.0	
91243	chr20	50815224	50815982	758	379.0	
91244	chr20	50816550	50816905	355	178.0	
91245	chr20	50817989	50819000	1011	506.0	
91246	chr20	50848777	50849137	360	180.0	
91247	chr20	50921072	50921392	320	160.0	
91248	chr20	50928419	50932526	4107	2054.0	
91249	chr20	50957622	50959704	2082	1041.0	
91250	chr20	50980129	50980642	513	256.0	
91251	chr20	50981370	50982613	1243	622.0	
91252	chr20	50987638	50988185	547	274.0	
91253	chr20	50992960	50993513	553	276.0	
91254	chr20	51022817	51023512	695	348.0	
91255	chr20	51220173	51220555	382	191.0	
91256	chr20	51306697	51307220	523	262.0	
91257	chr20	51318035	51318565	530	265.0	
91258	chr20	51372228	51372727	499	250.0	
91259	chr20	51384918	51385174	256	128.0	
91260	chr20	51385880	51386973	1093	546.0	
91261	chr20	51389891	51390196	305	152.0	
91262	chr20	51399960	51402939	2979	1490.0	
91263	chr20	51404231	51405685	1454	727.0	
91264	chr20	51409456	51411162	1706	853.0	
91265	chr20	51412184	51412636	452	226.0	
91266	chr20	51413916	51418577	4661	2330.0	
91267	chr20	51419399	51419567	168	84.0	
91268	chr20	51423285	51425898	2613	1306.0	
91269	chr20	51426828	51427326	498	249.0	
91270	chr20	51431342	51431724	382	191.0	
91271	chr20	51434795	51435308	513	256.0	
91272	chr20	51439086	51439579	493	246.0	
91273	chr20	51440576	51441010	434	217.0	
91274	chr20	51457447	51457526	79	40.0	
91275	chr20	51460823	51461352	529	264.0	
91276	chr20	51480253	51482093	1840	920.0	
91277	chr20	51492162	51495226	3064	1532.0	
91278	chr20	51497361	51498671	1310	655.0	
91279	chr20	51500163	51501775	1612	806.0	
91280	chr20	51504793	51505972	1179	590.0	
91281	chr20	51512601	51513050	449	224.0	
91282	chr20	51514371	51514680	309	154.0	
91283	chr20	51525104	51527300	2196	1098.0	
91284	chr20	51528282	51531915	3633	1816.0	
91285	chr20	51532459	51535258	2799	1400.0	
91286	chr20	51536131	51536923	792	396.0	
91287	chr20	51539963	51543627	3664	1832.0	
91288	chr20	51554262	51555020	758	379.0	
91289	chr20	51562173	51562943	770	385.0	
91290	chr20	51594898	51595639	741	370.0	
91291	chr20	51624181	51624674	493	246.0	
91292	chr20	51628801	51629288	487	244.0	
91293	chr20	51630939	51632152	1213	606.0	
91294	chr20	51639171	51639826	655	328.0	
91295	chr20	51650519	51651338	819	410.0	
91296	chr20	51661517	51662002	485	242.0	
91297	chr20	51662519	51662886	367	184.0	
91298	chr20	51666815	51667532	717	358.0	
91299	chr20	51766863	51769299	2436	1218.0	
91300	chr20	51773499	51773793	294	147.0	
91301	chr20	51800110	51800592	482	241.0	
91302	chr20	51801272	51801636	364	182.0	
91303	chr20	52031680	52032340	660	330.0	
91304	chr20	52047746	52048338	592	296.0	
91305	chr20	52054142	52054504	362	181.0	
91306	chr20	52083617	52084022	405	202.0	
91307	chr20	52103455	52104413	958	479.0	
91308	chr20	52126985	52127770	785	392.0	
91309	chr20	52128457	52128891	434	217.0	
91310	chr20	52150659	52150982	323	162.0	
91311	chr20	52190661	52192715	2054	1027.0	
91312	chr20	52305901	52306240	339	170.0	
91313	chr20	52312141	52312554	413	206.0	
91314	chr20	52379727	52380119	392	196.0	
91315	chr20	52402954	52403363	409	204.0	
91316	chr20	52404618	52406364	1746	873.0	
91317	chr20	52407346	52407387	41	20.0	
91318	chr20	52409829	52411069	1240	620.0	
91319	chr20	52422666	52423133	467	234.0	
91320	chr20	52425246	52425662	416	208.0	
91321	chr20	52438334	52438681	347	174.0	
91322	chr20	52652326	52652698	372	186.0	
91323	chr20	52675243	52676745	1502	751.0	
91324	chr20	52682124	52682659	535	268.0	
91325	chr20	52971923	52974578	2655	1328.0	
91326	chr20	53000956	53002216	1260	630.0	
91327	chr20	53158225	53158370	145	72.0	
91328	chr20	53208412	53208756	344	172.0	
91329	chr20	53217015	53217495	480	240.0	
91330	chr20	53388198	53388760	562	281.0	
91331	chr20	53413053	53413549	496	248.0	
91332	chr20	53532687	53533109	422	211.0	
91333	chr20	53547743	53548161	418	209.0	
91334	chr20	53563813	53564070	257	128.0	
91335	chr20	53576603	53577095	492	246.0	
91336	chr20	53578482	53583499	5017	2508.0	
91337	chr20	53585013	53586836	1823	912.0	
91338	chr20	53588621	53589999	1378	689.0	
91339	chr20	53591580	53595463	3883	1942.0	
91340	chr20	53596065	53596984	919	460.0	
91341	chr20	53598665	53599177	512	256.0	
91342	chr20	53608490	53610429	1939	970.0	
91343	chr20	53611476	53611984	508	254.0	
91344	chr20	53621250	53624424	3174	1587.0	
91345	chr20	53635277	53635423	146	73.0	
91346	chr20	53636540	53637062	522	261.0	
91347	chr20	53642247	53643803	1556	778.0	
91348	chr20	53652212	53653053	841	420.0	
91349	chr20	53654867	53655728	861	430.0	
91350	chr20	53656826	53657654	828	414.0	
91351	chr20	53659939	53661618	1679	840.0	
91352	chr20	53662661	53663012	351	176.0	
91353	chr20	53677915	53678494	579	290.0	
91354	chr20	53685889	53686464	575	288.0	
91355	chr20	53692777	53693740	963	482.0	
91356	chr20	53696725	53697204	479	240.0	
91357	chr20	53700194	53700262	68	34.0	
91358	chr20	53700786	53701342	556	278.0	
91359	chr20	53706544	53708935	2391	1196.0	
91360	chr20	53716461	53716750	289	144.0	
91361	chr20	53718553	53718555	2	1.0	
91362	chr20	53725578	53725610	32	16.0	
91363	chr20	53729463	53730088	625	312.0	
91364	chr20	53735509	53735829	320	160.0	
91365	chr20	53736678	53737896	1218	609.0	
91366	chr20	53739283	53739289	6	3.0	
91367	chr20	53740078	53740979	901	450.0	
91368	chr20	53741565	53741663	98	49.0	
91369	chr20	53749081	53749125	44	22.0	
91370	chr20	53750866	53752070	1204	602.0	
91371	chr20	53754273	53755013	740	370.0	
91372	chr20	53759882	53760277	395	198.0	
91373	chr20	53767520	53767910	390	195.0	
91374	chr20	53814744	53815068	324	162.0	
91375	chr20	53827031	53827432	401	200.0	
91376	chr20	53828632	53830652	2020	1010.0	
91377	chr20	53833568	53834414	846	423.0	
91378	chr20	53835289	53836006	717	358.0	
91379	chr20	53839140	53840074	934	467.0	
91380	chr20	53840674	53840737	63	32.0	
91381	chr20	53842189	53843452	1263	632.0	
91382	chr20	53844925	53845674	749	374.0	
91383	chr20	53847055	53848152	1097	548.0	
91384	chr20	53855716	53856169	453	226.0	
91385	chr20	53865759	53867520	1761	880.0	
91386	chr20	53869320	53870214	894	447.0	
91387	chr20	53872019	53873646	1627	814.0	
91388	chr20	53875386	53876011	625	312.0	
91389	chr20	53880936	53881425	489	244.0	
91390	chr20	53884888	53885245	357	178.0	
91391	chr20	53892767	53893775	1008	504.0	
91392	chr20	53899425	53900145	720	360.0	
91393	chr20	53903355	53904153	798	399.0	
91394	chr20	53906340	53907646	1306	653.0	
91395	chr20	53908998	53909346	348	174.0	
91396	chr20	53910347	53910831	484	242.0	
91397	chr20	53914393	53914425	32	16.0	
91398	chr20	53915079	53917757	2678	1339.0	
91399	chr20	53922738	53923404	666	333.0	
91400	chr20	53926404	53927103	699	350.0	
91401	chr20	53934337	53935839	1502	751.0	
91402	chr20	53939557	53940462	905	452.0	
91403	chr20	53941081	53941519	438	219.0	
91404	chr20	53943684	53944331	647	324.0	
91405	chr20	53948464	53950421	1957	978.0	
91406	chr20	54017135	54018328	1193	596.0	
91407	chr20	54062742	54063180	438	219.0	
91408	chr20	54063982	54064439	457	228.0	
91409	chr20	54078256	54078678	422	211.0	
91410	chr20	54090440	54090611	171	86.0	
91411	chr20	54096689	54097151	462	231.0	
91412	chr20	54103371	54103829	458	229.0	
91413	chr20	54115036	54115482	446	223.0	
91414	chr20	54132389	54133242	853	426.0	
91415	chr20	54174098	54174906	808	404.0	
91416	chr20	54199405	54200087	682	341.0	
91417	chr20	54207353	54209046	1693	846.0	
91418	chr20	54221434	54221755	321	160.0	
91419	chr20	54606551	54606665	114	57.0	
91420	chr20	54649692	54649776	84	42.0	
91421	chr20	56343876	56344216	340	170.0	
91422	chr20	56358365	56359743	1378	689.0	
91423	chr20	56373803	56374478	675	338.0	
91424	chr20	56376376	56377171	795	398.0	
91425	chr20	56379892	56379989	97	48.0	
91426	chr20	56391349	56393572	2223	1112.0	
91427	chr20	56399795	56400657	862	431.0	
91428	chr20	56409457	56410056	599	300.0	
91429	chr20	56411554	56413731	2177	1088.0	
91430	chr20	56414849	56415588	739	370.0	
91431	chr20	56418168	56419707	1539	770.0	
91432	chr20	56421400	56422905	1505	752.0	
91433	chr20	56427816	56428250	434	217.0	
91434	chr20	56428978	56430141	1163	582.0	
91435	chr20	56433997	56434040	43	22.0	
91436	chr20	56439988	56441106	1118	559.0	
91437	chr20	56442391	56443016	625	312.0	
91438	chr20	56453389	56453686	297	148.0	
91439	chr20	56460285	56461066	781	390.0	
91440	chr20	56463391	56463951	560	280.0	
91441	chr20	56465852	56466662	810	405.0	
91442	chr20	56467871	56469498	1627	814.0	
91443	chr20	56483889	56484555	666	333.0	
91444	chr20	56487151	56487638	487	244.0	
91445	chr20	56504385	56504815	430	215.0	
91446	chr20	56550541	56551013	472	236.0	
91447	chr20	56554749	56555312	563	282.0	
91448	chr20	56577609	56577875	266	133.0	
91449	chr20	56722082	56722559	477	238.0	
91450	chr20	57089629	57089982	353	176.0	
91451	chr20	57090918	57091049	131	66.0	
91452	chr20	57092083	57092499	416	208.0	
91453	chr20	57346326	57346808	482	241.0	
91454	chr20	57350758	57351992	1234	617.0	
91455	chr20	57369556	57370040	484	242.0	
91456	chr20	57374613	57375973	1360	680.0	
91457	chr20	57381524	57382569	1045	522.0	
91458	chr20	57383492	57383712	220	110.0	
91459	chr20	57388766	57403726	14960	7480.0	
91460	chr20	57404352	57413008	8656	4328.0	
91461	chr20	57413883	57415322	1439	720.0	
91462	chr20	57416493	57417510	1017	508.0	
91463	chr20	57421033	57421129	96	48.0	
91464	chr20	57423542	57424048	506	253.0	
91465	chr20	57425125	57425951	826	413.0	
91466	chr20	57429467	57431737	2270	1135.0	
91467	chr20	57432487	57434708	2221	1110.0	
91468	chr20	57435227	57436219	992	496.0	
91469	chr20	57450074	57452505	2431	1216.0	
91470	chr20	57458389	57458863	474	237.0	
91471	chr20	57463627	57464139	512	256.0	
91472	chr20	57464810	57465344	534	267.0	
91473	chr20	57473060	57474349	1289	644.0	
91474	chr20	57476040	57476449	409	204.0	
91475	chr20	57480665	57481767	1102	551.0	
91476	chr20	57494997	57495819	822	411.0	
91477	chr20	57498379	57499193	814	407.0	
91478	chr20	57503152	57503938	786	393.0	
91479	chr20	57514105	57514657	552	276.0	
91480	chr20	57581619	57582195	576	288.0	
91481	chr20	57594203	57594754	551	276.0	
91482	chr20	57596707	57597607	900	450.0	
91483	chr20	57604716	57606423	1707	854.0	
91484	chr20	57617927	57621437	3510	1755.0	
91485	chr20	57622405	57623009	604	302.0	
91486	chr20	57627542	57630636	3094	1547.0	
91487	chr20	57633970	57634454	484	242.0	
91488	chr20	57654196	57654886	690	345.0	
91489	chr20	57657638	57658206	568	284.0	
91490	chr20	57672046	57672487	441	220.0	
91491	chr20	57680031	57681819	1788	894.0	
91492	chr20	57682607	57683124	517	258.0	
91493	chr20	57693355	57693632	277	138.0	
91494	chr20	57698338	57698378	40	20.0	
91495	chr20	57699352	57699753	401	200.0	
91496	chr20	57701709	57702028	319	160.0	
91497	chr20	57702810	57704044	1234	617.0	
91498	chr20	57704927	57711807	6880	3440.0	
91499	chr20	57713410	57713997	587	294.0	
91500	chr20	57718279	57719279	1000	500.0	
91501	chr20	57748564	57749166	602	301.0	
91502	chr20	57856653	57857054	401	200.0	
91503	chr20	57999368	58000107	739	370.0	
91504	chr20	58014584	58015023	439	220.0	
91505	chr20	58179320	58180190	870	435.0	
91506	chr20	58192576	58192957	381	190.0	
91507	chr20	58209342	58210450	1108	554.0	
91508	chr20	58228097	58229078	981	490.0	
91509	chr20	58233863	58234279	416	208.0	
91510	chr20	58235014	58235354	340	170.0	
91511	chr20	58236518	58237662	1144	572.0	
91512	chr20	58252360	58252373	13	6.0	
91513	chr20	58286920	58287072	152	76.0	
91514	chr20	58305987	58307744	1757	878.0	
91515	chr20	58308266	58310766	2500	1250.0	
91516	chr20	58312973	58313841	868	434.0	
91517	chr20	58315516	58315533	17	8.0	
91518	chr20	58374035	58374253	218	109.0	
91519	chr20	58388595	58390210	1615	808.0	
91520	chr20	58391395	58391803	408	204.0	
91521	chr20	58401472	58401578	106	53.0	
91522	chr20	58407538	58409179	1641	820.0	
91523	chr20	58417003	58417109	106	53.0	
91524	chr20	58447786	58448167	381	190.0	
91525	chr20	58458728	58459136	408	204.0	
91526	chr20	58481465	58481899	434	217.0	
91527	chr20	58627364	58627848	484	242.0	
91528	chr20	58634689	58635017	328	164.0	
91529	chr20	58647522	58647824	302	151.0	
91530	chr20	58649230	58653363	4133	2066.0	
91531	chr20	58659842	58662313	2471	1236.0	
91532	chr20	58690847	58693769	2922	1461.0	
91533	chr20	58703324	58703568	244	122.0	
91534	chr20	58721945	58722273	328	164.0	
91535	chr20	58839400	58839826	426	213.0	
91536	chr20	58847569	58847570	1	0.0	
91537	chr20	58850577	58851565	988	494.0	
91538	chr20	58852404	58853141	737	368.0	
91539	chr20	58854448	58855403	955	478.0	
91540	chr20	58856152	58856167	15	8.0	
91541	chr20	58864417	58864785	368	184.0	
91542	chr20	58870180	58870969	789	394.0	
91543	chr20	58888173	58904036	15863	7932.0	
91544	chr20	58906199	58908622	2423	1212.0	
91545	chr20	58909649	58910129	480	240.0	
91546	chr20	58911383	58913408	2025	1012.0	
91547	chr20	58918697	58918898	201	100.0	
91548	chr20	58938459	58938866	407	204.0	
91549	chr20	58955755	58956535	780	390.0	
91550	chr20	58973777	58974248	471	236.0	
91551	chr20	58980541	58983440	2899	1450.0	
91552	chr20	59001498	59001885	387	194.0	
91553	chr20	59003989	59008774	4785	2392.0	
91554	chr20	59013901	59014340	439	220.0	
91555	chr20	59031320	59033196	1876	938.0	
91556	chr20	59041859	59044244	2385	1192.0	
91557	chr20	59055324	59055640	316	158.0	
91558	chr20	59071147	59071664	517	258.0	
91559	chr20	59087773	59088440	667	334.0	
91560	chr20	59101959	59103720	1761	880.0	
91561	chr20	59104904	59105220	316	158.0	
91562	chr20	59120288	59121204	916	458.0	
91563	chr20	59121758	59123919	2161	1080.0	
91564	chr20	59144290	59144959	669	334.0	
91565	chr20	59145510	59147478	1968	984.0	
91566	chr20	59148540	59150887	2347	1174.0	
91567	chr20	59151780	59152272	492	246.0	
91568	chr20	59158975	59162257	3282	1641.0	
91569	chr20	59163141	59167170	4029	2014.0	
91570	chr20	59177377	59178555	1178	589.0	
91571	chr20	59182344	59183350	1006	503.0	
91572	chr20	59185262	59185359	97	48.0	
91573	chr20	59207353	59208457	1104	552.0	
91574	chr20	59221204	59221500	296	148.0	
91575	chr20	59222001	59223318	1317	658.0	
91576	chr20	59253183	59254469	1286	643.0	
91577	chr20	59258113	59258452	339	170.0	
91578	chr20	59341735	59342033	298	149.0	
91579	chr20	59385306	59385702	396	198.0	
91580	chr20	59403219	59404139	920	460.0	
91581	chr20	59495901	59496217	316	158.0	
91582	chr20	59519450	59519782	332	166.0	
91583	chr20	59571502	59571972	470	235.0	
91584	chr20	59598757	59598775	18	9.0	
91585	chr20	59722599	59723577	978	489.0	
91586	chr20	59751036	59751532	496	248.0	
91587	chr20	59752212	59753122	910	455.0	
91588	chr20	59787129	59787170	41	20.0	
91589	chr20	59912672	59912995	323	162.0	
91590	chr20	59933101	59934638	1537	768.0	
91591	chr20	59938507	59941345	2838	1419.0	
91592	chr20	59942125	59942338	213	106.0	
91593	chr20	59948692	59949549	857	428.0	
91594	chr20	59955234	59955551	317	158.0	
91595	chr20	59984602	59984640	38	19.0	
91596	chr20	59994106	59995018	912	456.0	
91597	chr20	60008098	60009055	957	478.0	
91598	chr20	60011801	60012085	284	142.0	
91599	chr20	60016431	60016765	334	167.0	
91600	chr20	60045906	60046711	805	402.0	
91601	chr20	60054553	60059007	4454	2227.0	
91602	chr20	60060606	60061035	429	214.0	
91603	chr20	60078246	60078705	459	230.0	
91604	chr20	60097201	60097781	580	290.0	
91605	chr20	60100909	60101345	436	218.0	
91606	chr20	60112933	60114214	1281	640.0	
91607	chr20	60116514	60117510	996	498.0	
91608	chr20	60131306	60131816	510	255.0	
91609	chr20	60133204	60133794	590	295.0	
91610	chr20	60136690	60138701	2011	1006.0	
91611	chr20	60140043	60140397	354	177.0	
91612	chr20	60206235	60206592	357	178.0	
91613	chr20	60211033	60211510	477	238.0	
91614	chr20	60226568	60226803	235	118.0	
91615	chr20	60228157	60228784	627	314.0	
91616	chr20	60230502	60230562	60	30.0	
91617	chr20	60262951	60263428	477	238.0	
91618	chr20	61119849	61121069	1220	610.0	
91619	chr20	61229172	61229478	306	153.0	
91620	chr20	61719527	61720427	900	450.0	
91621	chr20	61980962	61982605	1643	822.0	
91622	chr20	61984506	61984780	274	137.0	
91623	chr20	61989753	61990238	485	242.0	
91624	chr20	62010798	62011452	654	327.0	
91625	chr20	62025988	62026431	443	222.0	
91626	chr20	62030847	62031225	378	189.0	
91627	chr20	62065009	62068324	3315	1658.0	
91628	chr20	62088526	62088630	104	52.0	
91629	chr20	62117387	62118423	1036	518.0	
91630	chr20	62120992	62124011	3019	1510.0	
91631	chr20	62132420	62135856	3436	1718.0	
91632	chr20	62136389	62137833	1444	722.0	
91633	chr20	62141153	62144985	3832	1916.0	
91634	chr20	62145814	62146421	607	304.0	
91635	chr20	62147125	62147629	504	252.0	
91636	chr20	62149351	62150486	1135	568.0	
91637	chr20	62151047	62151067	20	10.0	
91638	chr20	62155906	62157950	2044	1022.0	
91639	chr20	62164224	62164839	615	308.0	
91640	chr20	62165740	62165786	46	23.0	
91641	chr20	62182128	62183857	1729	864.0	
91642	chr20	62185711	62186191	480	240.0	
91643	chr20	62219768	62221389	1621	810.0	
91644	chr20	62228266	62228365	99	50.0	
91645	chr20	62230110	62230367	257	128.0	
91646	chr20	62237607	62240535	2928	1464.0	
91647	chr20	62244532	62244992	460	230.0	
91648	chr20	62292068	62292608	540	270.0	
91649	chr20	62301528	62305224	3696	1848.0	
91650	chr20	62318953	62319036	83	42.0	
91651	chr20	62321586	62321728	142	71.0	
91652	chr20	62337397	62338441	1044	522.0	
91653	chr20	62339523	62340242	719	360.0	
91654	chr20	62365736	62366011	275	138.0	
91655	chr20	62366592	62369334	2742	1371.0	
91656	chr20	62382455	62383228	773	386.0	
91657	chr20	62385691	62388176	2485	1242.0	
91658	chr20	62395377	62395574	197	98.0	
91659	chr20	62405289	62408236	2947	1474.0	
91660	chr20	62409712	62410982	1270	635.0	
91661	chr20	62496442	62496789	347	174.0	
91662	chr20	62500073	62500801	728	364.0	
91663	chr20	62501722	62502460	738	369.0	
91664	chr20	62550535	62551218	683	342.0	
91665	chr20	62571738	62572110	372	186.0	
91666	chr20	62595572	62596336	764	382.0	
91667	chr20	62598602	62599201	599	300.0	
91668	chr20	62602294	62604599	2305	1152.0	
91669	chr20	62605823	62606478	655	328.0	
91670	chr20	62641432	62643620	2188	1094.0	
91671	chr20	62644765	62645543	778	389.0	
91672	chr20	62647115	62647261	146	73.0	
91673	chr20	62650850	62652978	2128	1064.0	
91674	chr20	62662305	62662697	392	196.0	
91675	chr20	62667059	62667283	224	112.0	
91676	chr20	62668394	62669125	731	366.0	
91677	chr20	62675292	62675875	583	292.0	
91678	chr20	62678371	62679038	667	334.0	
91679	chr20	62685914	62686660	746	373.0	
91680	chr20	62695821	62696249	428	214.0	
91681	chr20	62696883	62697323	440	220.0	
91682	chr20	62703508	62703791	283	142.0	
91683	chr20	62707891	62709043	1152	576.0	
91684	chr20	62711064	62711498	434	217.0	
91685	chr20	62716090	62716768	678	339.0	
91686	chr20	62727666	62728873	1207	604.0	
91687	chr20	62734847	62735092	245	122.0	
91688	chr20	62739268	62741790	2522	1261.0	
91689	chr20	62752325	62752675	350	175.0	
91690	chr20	62759879	62760336	457	228.0	
91691	chr20	62774728	62775187	459	230.0	
91692	chr20	62776419	62777925	1506	753.0	
91693	chr20	62787206	62788272	1066	533.0	
91694	chr20	62791226	62792241	1015	508.0	
91695	chr20	62793126	62797891	4765	2382.0	
91696	chr20	62802602	62806496	3894	1947.0	
91697	chr20	62807700	62808809	1109	554.0	
91698	chr20	62812746	62812965	219	110.0	
91699	chr20	62814909	62817414	2505	1252.0	
91700	chr20	62822647	62823166	519	260.0	
91701	chr20	62824831	62825292	461	230.0	
91702	chr20	62832285	62833426	1141	570.0	
91703	chr20	62837840	62838826	986	493.0	
91704	chr20	62860598	62863380	2782	1391.0	
91705	chr20	62873579	62874320	741	370.0	
91706	chr20	62875480	62875917	437	218.0	
91707	chr20	62887340	62888106	766	383.0	
91708	chr20	62890948	62891557	609	304.0	
91709	chr20	62892738	62893298	560	280.0	
91710	chr20	62899144	62901205	2061	1030.0	
91711	chr20	62907362	62907831	469	234.0	
91712	chr20	62914907	62915382	475	238.0	
91713	chr20	62917994	62920307	2313	1156.0	
91714	chr20	62920986	62923457	2471	1236.0	
91715	chr20	62924423	62930142	5719	2860.0	
91716	chr20	62936967	62939126	2159	1080.0	
91717	chr20	62952143	62955994	3851	1926.0	
91718	chr20	62959428	62959935	507	254.0	
91719	chr20	62972206	62973177	971	486.0	
91720	chr20	62974349	62974369	20	10.0	
91721	chr20	62977340	62978993	1653	826.0	
91722	chr20	62979552	62982543	2991	1496.0	
91723	chr20	62989008	62989746	738	369.0	
91724	chr20	63004811	63005212	401	200.0	
91725	chr20	63005976	63010989	5013	2506.0	
91726	chr20	63033107	63033594	487	244.0	
91727	chr20	63056177	63057034	857	428.0	
91728	chr20	63071708	63072114	406	203.0	
91729	chr20	63082337	63082682	345	172.0	
91730	chr20	63100986	63104586	3600	1800.0	
91731	chr20	63177355	63177593	238	119.0	
91732	chr20	63178742	63179880	1138	569.0	
91733	chr20	63183109	63183742	633	316.0	
91734	chr20	63215031	63217322	2291	1146.0	
91735	chr20	63223109	63223771	662	331.0	
91736	chr20	63230862	63231136	274	137.0	
91737	chr20	63234739	63236279	1540	770.0	
91738	chr20	63238510	63238856	346	173.0	
91739	chr20	63271937	63274164	2227	1114.0	
91740	chr20	63284023	63285009	986	493.0	
91741	chr20	63290637	63292253	1616	808.0	
91742	chr20	63295384	63296108	724	362.0	
91743	chr20	63309489	63309903	414	207.0	
91744	chr20	63326967	63327362	395	198.0	
91745	chr20	63381802	63382201	399	200.0	
91746	chr20	63434395	63435340	945	472.0	
91747	chr20	63441224	63442547	1323	662.0	
91748	chr20	63495837	63496939	1102	551.0	
91749	chr20	63497695	63499927	2232	1116.0	
91750	chr20	63501879	63502214	335	168.0	
91751	chr20	63514556	63514789	233	116.0	
91752	chr20	63519272	63521786	2514	1257.0	
91753	chr20	63525977	63526365	388	194.0	
91754	chr20	63529259	63529870	611	306.0	
91755	chr20	63532001	63532780	779	390.0	
91756	chr20	63533526	63535657	2131	1066.0	
91757	chr20	63536355	63538849	2494	1247.0	
91758	chr20	63542691	63543208	517	258.0	
91759	chr20	63544562	63544639	77	38.0	
91760	chr20	63545689	63546455	766	383.0	
91761	chr20	63547665	63548004	339	170.0	
91762	chr20	63549766	63549958	192	96.0	
91763	chr20	63552298	63557514	5216	2608.0	
91764	chr20	63558980	63560906	1926	963.0	
91765	chr20	63561636	63561947	311	156.0	
91766	chr20	63564175	63564318	143	72.0	
91767	chr20	63565103	63565530	427	214.0	
91768	chr20	63566837	63569855	3018	1509.0	
91769	chr20	63570554	63570976	422	211.0	
91770	chr20	63573197	63575079	1882	941.0	
91771	chr20	63578567	63579547	980	490.0	
91772	chr20	63580666	63581456	790	395.0	
91773	chr20	63588052	63588519	467	234.0	
91774	chr20	63606613	63607000	387	194.0	
91775	chr20	63612128	63613582	1454	727.0	
91776	chr20	63614407	63614550	143	72.0	
91777	chr20	63624659	63625019	360	180.0	
91778	chr20	63625737	63628858	3121	1560.0	
91779	chr20	63634919	63637246	2327	1164.0	
91780	chr20	63638408	63643070	4662	2331.0	
91781	chr20	63651369	63654344	2975	1488.0	
91782	chr20	63657640	63659270	1630	815.0	
91783	chr20	63686008	63687760	1752	876.0	
91784	chr20	63689942	63693702	3760	1880.0	
91785	chr20	63694620	63694990	370	185.0	
91786	chr20	63695935	63697623	1688	844.0	
91787	chr20	63698804	63699482	678	339.0	
91788	chr20	63706665	63708941	2276	1138.0	
91789	chr20	63728189	63728934	745	372.0	
91790	chr20	63730268	63731504	1236	618.0	
91791	chr20	63735647	63741568	5921	2960.0	
91792	chr20	63750670	63751974	1304	652.0	
91793	chr20	63756608	63757009	401	200.0	
91794	chr20	63781865	63782867	1002	501.0	
91795	chr20	63786160	63786851	691	346.0	
91796	chr20	63796043	63796572	529	264.0	
91797	chr20	63803039	63804578	1539	770.0	
91798	chr20	63816515	63816798	283	142.0	
91799	chr20	63829604	63832584	2980	1490.0	
91800	chr20	63834921	63835314	393	196.0	
91801	chr20	63846188	63846533	345	172.0	
91802	chr20	63847617	63848027	410	205.0	
91803	chr20	63850793	63851417	624	312.0	
91804	chr20	63853813	63855556	1743	872.0	
91805	chr20	63858338	63859293	955	478.0	
91806	chr20	63860474	63861062	588	294.0	
91807	chr20	63863409	63866243	2834	1417.0	
91808	chr20	63873106	63874693	1587	794.0	
91809	chr20	63878109	63878156	47	24.0	
91810	chr20	63889184	63889645	461	230.0	
91811	chr20	63894169	63897128	2959	1480.0	
91812	chr20	63898821	63899612	791	396.0	
91813	chr20	63900260	63901215	955	478.0	
91814	chr20	63902523	63903424	901	450.0	
91815	chr20	63904142	63904578	436	218.0	
91816	chr20	63909520	63910093	573	286.0	
91817	chr20	63911232	63911690	458	229.0	
91818	chr20	63912914	63913395	481	240.0	
91819	chr20	63938524	63939579	1055	528.0	
91820	chr20	63940699	63943519	2820	1410.0	
91821	chr20	63945162	63945380	218	109.0	
91822	chr20	63947156	63950248	3092	1546.0	
91823	chr20	63950803	63951981	1178	589.0	
91824	chr20	63954250	63958209	3959	1980.0	
91825	chr20	63959079	63959349	270	135.0	
91826	chr20	63961222	63961378	156	78.0	
91827	chr20	63968546	63970820	2274	1137.0	
91828	chr20	63973435	63974639	1204	602.0	
91829	chr20	63977295	63981794	4499	2250.0	
91830	chr20	64011336	64011849	513	256.0	
91831	chr20	64012731	64013354	623	312.0	
91832	chr20	64033326	64033377	51	26.0	
91833	chr20	64034090	64034294	204	102.0	
91834	chr20	64034889	64035877	988	494.0	
91835	chr20	64036616	64036649	33	16.0	
91836	chr20	64037192	64042901	5709	2854.0	
91837	chr20	64044787	64045113	326	163.0	
91838	chr20	64048336	64049827	1491	746.0	"promoter	promoter	promoter	protein_binding_site	protein_binding_site	protein_binding_site	protein_binding_site"
91839	chr20	64050547	64050655	108	54.0	promoter
91840	chr20	64054213	64054571	358	179.0	
91841	chr20	64057018	64058352	1334	667.0	
91842	chr20	64062410	64064785	2375	1188.0	
91843	chr20	64065359	64066630	1271	636.0	
91844	chr20	64067238	64067466	228	114.0	
91845	chr20	64069666	64070151	485	242.0	
91846	chr20	64076458	64084980	8522	4261.0	
91847	chr20	64100100	64100785	685	342.0	
91848	chr20	64101751	64102844	1093	546.0	
91849	chr20	64107363	64108338	975	488.0	
91850	chr20	64119947	64120908	961	480.0	
91851	chr20	64161963	64162012	49	24.0	
91852	chr20	64227331	64227610	279	140.0	
91853	chr20	64252756	64253067	311	156.0	
91854	chr20	64255025	64256695	1670	835.0	
91855	chr20	64285589	64286474	885	442.0	
91856	chr21	8758753	8759158	405	202.0	
91857	chr21	8986789	8988578	1789	894.0	
91858	chr21	8990290	8990636	346	173.0	
91859	chr21	8991191	8993233	2042	1021.0	
91860	chr21	9246087	9247364	1277	638.0	
91861	chr21	10808748	10814345	5597	2798.0	
91862	chr21	10805021	10808163	3142	1571.0	
91863	chr21	10800818	10803406	2588	1294.0	
91864	chr21	10787257	10800050	12793	6396.0	
91865	chr21	10786153	10786445	292	146.0	
91866	chr21	10778346	10779458	1112	556.0	
91867	chr21	10776082	10776530	448	224.0	
91868	chr21	10768361	10769334	973	486.0	
91869	chr21	10761657	10761858	201	100.0	
91870	chr21	10759600	10760661	1061	530.0	
91871	chr21	10758427	10758622	195	98.0	
91872	chr21	10755919	10755921	2	1.0	
91873	chr21	10752636	10752999	363	182.0	
91874	chr21	10751217	10751956	739	370.0	
91875	chr21	10748512	10750393	1881	940.0	
91876	chr21	10746169	10747446	1277	638.0	
91877	chr21	10734422	10739456	5034	2517.0	
91878	chr21	10733136	10733790	654	327.0	
91879	chr21	10728947	10732340	3393	1696.0	
91880	chr21	10727011	10727457	446	223.0	
91881	chr21	10725819	10726178	359	180.0	
91882	chr21	10719771	10723591	3820	1910.0	
91883	chr21	10711741	10719066	7325	3662.0	
91884	chr21	10710078	10710380	302	151.0	
91885	chr21	10709442	10709556	114	57.0	
91886	chr21	10707878	10708801	923	462.0	
91887	chr21	10704940	10707126	2186	1093.0	
91888	chr21	10700014	10703861	3847	1924.0	
91889	chr21	10697728	10697737	9	4.0	
91890	chr21	10470782	10470978	196	98.0	
91891	chr21	10465632	10466071	439	220.0	
91892	chr21	10464707	10464709	2	1.0	
91893	chr21	10455461	10456132	671	336.0	
91894	chr21	10452723	10453372	649	324.0	
91895	chr21	10450587	10450633	46	23.0	
91896	chr21	10447173	10447688	515	258.0	
91897	chr21	10445348	10445350	2	1.0	
91898	chr21	10440525	10441201	676	338.0	
91899	chr21	10439518	10439540	22	11.0	
91900	chr21	10438158	10438613	455	228.0	
91901	chr21	10435310	10435831	521	260.0	
91902	chr21	10433623	10434469	846	423.0	
91903	chr21	10431866	10432991	1125	562.0	
91904	chr21	10430859	10431351	492	246.0	
91905	chr21	10429076	10430339	1263	632.0	
91906	chr21	10427121	10428063	942	471.0	
91907	chr21	10419024	10419639	615	308.0	
91908	chr21	10415538	10417939	2401	1200.0	
91909	chr21	10330728	10331566	838	419.0	
91910	chr21	10325314	10326480	1166	583.0	
91911	chr21	10324328	10324561	233	116.0	
91912	chr21	13979566	13980873	1307	654.0	
91913	chr21	14027010	14027935	925	462.0	
91914	chr21	14076520	14076809	289	144.0	
91915	chr21	14116220	14116517	297	148.0	
91916	chr21	14215773	14216971	1198	599.0	
91917	chr21	14241275	14241651	376	188.0	
91918	chr21	14253624	14254231	607	304.0	
91919	chr21	14259650	14260098	448	224.0	
91920	chr21	14308293	14308578	285	142.0	
91921	chr21	14361935	14362335	400	200.0	
91922	chr21	14367003	14367340	337	168.0	
91923	chr21	14382340	14384312	1972	986.0	
91924	chr21	14403697	14404118	421	210.0	
91925	chr21	14480630	14481177	547	274.0	
91926	chr21	14481741	14482704	963	482.0	
91927	chr21	14499504	14499635	131	66.0	
91928	chr21	14520375	14521117	742	371.0	
91929	chr21	14522745	14523859	1114	557.0	
91930	chr21	14526999	14528639	1640	820.0	
91931	chr21	14533444	14535232	1788	894.0	
91932	chr21	14541531	14543243	1712	856.0	
91933	chr21	14543991	14544440	449	224.0	
91934	chr21	14545883	14546707	824	412.0	
91935	chr21	14547939	14549426	1487	744.0	
91936	chr21	14549963	14550683	720	360.0	
91937	chr21	14567565	14568299	734	367.0	
91938	chr21	14569247	14569551	304	152.0	
91939	chr21	14581919	14582360	441	220.0	
91940	chr21	14589849	14590269	420	210.0	
91941	chr21	14591462	14592618	1156	578.0	
91942	chr21	14602542	14603035	493	246.0	
91943	chr21	14618495	14618581	86	43.0	
91944	chr21	14620294	14620310	16	8.0	
91945	chr21	14630482	14630890	408	204.0	
91946	chr21	14675700	14676818	1118	559.0	
91947	chr21	14683150	14683446	296	148.0	
91948	chr21	14684076	14684416	340	170.0	
91949	chr21	14685287	14687794	2507	1254.0	
91950	chr21	14690916	14691315	399	200.0	
91951	chr21	14734141	14734628	487	244.0	
91952	chr21	14737898	14738361	463	232.0	
91953	chr21	14762634	14763752	1118	559.0	
91954	chr21	14773738	14774161	423	212.0	
91955	chr21	14858317	14858667	350	175.0	
91956	chr21	14863704	14865036	1332	666.0	
91957	chr21	14866294	14866643	349	174.0	
91958	chr21	14868516	14869256	740	370.0	
91959	chr21	14870211	14870702	491	246.0	
91960	chr21	14877638	14878213	575	288.0	
91961	chr21	14879353	14880076	723	362.0	
91962	chr21	14901639	14902084	445	222.0	
91963	chr21	15005308	15005699	391	196.0	
91964	chr21	15028276	15028578	302	151.0	
91965	chr21	15029149	15029417	268	134.0	
91966	chr21	15050585	15052562	1977	988.0	
91967	chr21	15054799	15055156	357	178.0	
91968	chr21	15056858	15057740	882	441.0	
91969	chr21	15058659	15059238	579	290.0	
91970	chr21	15060751	15066835	6084	3042.0	
91971	chr21	15128273	15128618	345	172.0	
91972	chr21	15134631	15135173	542	271.0	
91973	chr21	15159627	15160012	385	192.0	
91974	chr21	15206406	15207361	955	478.0	
91975	chr21	15210055	15210699	644	322.0	
91976	chr21	15211538	15211554	16	8.0	
91977	chr21	15219842	15220292	450	225.0	
91978	chr21	15221765	15223161	1396	698.0	
91979	chr21	15224244	15224903	659	330.0	
91980	chr21	15252523	15252724	201	100.0	
91981	chr21	15414007	15414513	506	253.0	
91982	chr21	15443028	15443247	219	110.0	
91983	chr21	15445166	15446389	1223	612.0	
91984	chr21	15483092	15483640	548	274.0	
91985	chr21	15496914	15497350	436	218.0	
91986	chr21	15508533	15508993	460	230.0	
91987	chr21	15513938	15514891	953	476.0	
91988	chr21	15534597	15534894	297	148.0	
91989	chr21	15553049	15553503	454	227.0	
91990	chr21	15592331	15592666	335	168.0	
91991	chr21	15682064	15683418	1354	677.0	
91992	chr21	15686141	15687200	1059	530.0	
91993	chr21	15688800	15689545	745	372.0	
91994	chr21	15729245	15731632	2387	1194.0	
91995	chr21	15732215	15734360	2145	1072.0	
91996	chr21	15735873	15736391	518	259.0	
91997	chr21	15741950	15742483	533	266.0	
91998	chr21	15776792	15777194	402	201.0	
91999	chr21	15809806	15810254	448	224.0	
92000	chr21	15823705	15824168	463	232.0	
92001	chr21	15826102	15826534	432	216.0	
92002	chr21	15837649	15837920	271	136.0	
92003	chr21	16193995	16194672	677	338.0	
92004	chr21	16197166	16197407	241	120.0	
92005	chr21	16264386	16264775	389	194.0	
92006	chr21	16330369	16330678	309	154.0	
92007	chr21	17387016	17387423	407	204.0	
92008	chr21	17451226	17451630	404	202.0	
92009	chr21	17476071	17476474	403	202.0	
92010	chr21	17492098	17492390	292	146.0	
92011	chr21	17511909	17514118	2209	1104.0	
92012	chr21	17536381	17536782	401	200.0	
92013	chr21	17539182	17540369	1187	594.0	
92014	chr21	17585900	17586254	354	177.0	
92015	chr21	17610763	17613861	3098	1549.0	
92016	chr21	17614640	17614795	155	78.0	
92017	chr21	17678918	17679458	540	270.0	
92018	chr21	17688756	17689535	779	390.0	
92019	chr21	17730719	17731295	576	288.0	
92020	chr21	17753752	17754079	327	164.0	
92021	chr21	17758737	17759020	283	142.0	
92022	chr21	17775137	17776396	1259	630.0	
92023	chr21	17779436	17781328	1892	946.0	
92024	chr21	17781969	17782483	514	257.0	
92025	chr21	17783541	17785401	1860	930.0	
92026	chr21	17786082	17786549	467	234.0	
92027	chr21	17787213	17787306	93	46.0	
92028	chr21	17789029	17790047	1018	509.0	
92029	chr21	17793261	17796885	3624	1812.0	
92030	chr21	17799246	17799888	642	321.0	
92031	chr21	17814540	17814811	271	136.0	
92032	chr21	17818029	17820626	2597	1298.0	
92033	chr21	17835031	17835312	281	140.0	
92034	chr21	17900623	17900854	231	116.0	
92035	chr21	17902987	17903428	441	220.0	
92036	chr21	17924924	17925425	501	250.0	
92037	chr21	18151862	18151899	37	18.0	
92038	chr21	18155521	18155936	415	208.0	
92039	chr21	18443602	18444098	496	248.0	
92040	chr21	18460999	18461346	347	174.0	
92041	chr21	20308870	20309178	308	154.0	
92042	chr21	20377308	20377666	358	179.0	
92043	chr21	20997255	20998822	1567	784.0	
92044	chr21	20999611	20999973	362	181.0	
92045	chr21	21034347	21034354	7	4.0	
92046	chr21	21051070	21052069	999	500.0	
92047	chr21	22421366	22421777	411	206.0	
92048	chr21	22516237	22516626	389	194.0	
92049	chr21	23853773	23854197	424	212.0	
92050	chr21	23887381	23888321	940	470.0	
92051	chr21	23921859	23922427	568	284.0	
92052	chr21	23955367	23955780	413	206.0	
92053	chr21	23968500	23969668	1168	584.0	
92054	chr21	23977932	23978427	495	248.0	
92055	chr21	24047019	24047434	415	208.0	
92056	chr21	24093191	24093312	121	60.0	
92057	chr21	24290110	24290676	566	283.0	
92058	chr21	24424842	24425058	216	108.0	
92059	chr21	24428503	24429174	671	336.0	
92060	chr21	25176642	25176854	212	106.0	
92061	chr21	25215978	25216403	425	212.0	
92062	chr21	25385888	25386308	420	210.0	
92063	chr21	25406038	25406341	303	152.0	
92064	chr21	25421291	25422176	885	442.0	
92065	chr21	25428542	25428862	320	160.0	
92066	chr21	25456518	25458049	1531	766.0	
92067	chr21	25487273	25487500	227	114.0	
92068	chr21	25501758	25502679	921	460.0	
92069	chr21	25560003	25564868	4865	2432.0	
92070	chr21	25566633	25568648	2015	1008.0	
92071	chr21	25572710	25574335	1625	812.0	
92072	chr21	25606861	25608969	2108	1054.0	
92073	chr21	25638880	25640648	1768	884.0	
92074	chr21	25647723	25647963	240	120.0	
92075	chr21	25649160	25649527	367	184.0	
92076	chr21	25708392	25708899	507	254.0	
92077	chr21	25722606	25722980	374	187.0	
92078	chr21	25733990	25736647	2657	1328.0	
92079	chr21	25772817	25773429	612	306.0	
92080	chr21	25790281	25790844	563	282.0	
92081	chr21	25801242	25802006	764	382.0	
92082	chr21	25862510	25862895	385	192.0	
92083	chr21	25881720	25882216	496	248.0	
92084	chr21	25895729	25896184	455	228.0	
92085	chr21	25903500	25904422	922	461.0	
92086	chr21	25963973	25964516	543	272.0	
92087	chr21	25967295	25968223	928	464.0	
92088	chr21	25970563	25970691	128	64.0	
92089	chr21	25999906	26000335	429	214.0	
92090	chr21	26070919	26071477	558	279.0	
92091	chr21	26140047	26140561	514	257.0	
92092	chr21	26168903	26171369	2466	1233.0	
92093	chr21	26385870	26385878	8	4.0	
92094	chr21	26390332	26390644	312	156.0	
92095	chr21	26405935	26406374	439	220.0	
92096	chr21	26469765	26470617	852	426.0	
92097	chr21	26534487	26534830	343	172.0	
92098	chr21	26546423	26547224	801	400.0	
92099	chr21	26565117	26565561	444	222.0	
92100	chr21	26572603	26572982	379	190.0	
92101	chr21	26686251	26686673	422	211.0	
92102	chr21	26715889	26716290	401	200.0	
92103	chr21	26806894	26807348	454	227.0	
92104	chr21	26833762	26834296	534	267.0	
92105	chr21	26840163	26840636	473	236.0	
92106	chr21	26843345	26846937	3592	1796.0	
92107	chr21	26849412	26849822	410	205.0	
92108	chr21	26943660	26944379	719	360.0	
92109	chr21	26946813	26947155	342	171.0	
92110	chr21	26952160	26952276	116	58.0	
92111	chr21	26965428	26967988	2560	1280.0	
92112	chr21	26972000	26972764	764	382.0	
92113	chr21	27700993	27701409	416	208.0	
92114	chr21	28135475	28136113	638	319.0	
92115	chr21	28142622	28143156	534	267.0	
92116	chr21	28227837	28228544	707	354.0	
92117	chr21	28235158	28235960	802	401.0	
92118	chr21	28346251	28346253	2	1.0	
92119	chr21	28516954	28517423	469	234.0	
92120	chr21	28521957	28522358	401	200.0	
92121	chr21	28605060	28605581	521	260.0	
92122	chr21	28744972	28746130	1158	579.0	
92123	chr21	28831872	28832802	930	465.0	
92124	chr21	28836524	28837889	1365	682.0	
92125	chr21	28884174	28885820	1646	823.0	
92126	chr21	28940175	28940571	396	198.0	
92127	chr21	28991931	28993712	1781	890.0	
92128	chr21	29002259	29003681	1422	711.0	
92129	chr21	29017526	29019976	2450	1225.0	
92130	chr21	29021978	29022850	872	436.0	
92131	chr21	29023850	29025760	1910	955.0	
92132	chr21	29064804	29065488	684	342.0	
92133	chr21	29072767	29074397	1630	815.0	
92134	chr21	29076381	29078100	1719	860.0	
92135	chr21	29078757	29081054	2297	1148.0	
92136	chr21	29089570	29090684	1114	557.0	
92137	chr21	29096536	29097076	540	270.0	
92138	chr21	29099516	29100492	976	488.0	
92139	chr21	29155547	29155805	258	129.0	
92140	chr21	29157048	29157496	448	224.0	
92141	chr21	29159926	29160174	248	124.0	
92142	chr21	29162743	29164708	1965	982.0	
92143	chr21	29166287	29166638	351	176.0	
92144	chr21	29181979	29182526	547	274.0	
92145	chr21	29183884	29184549	665	332.0	
92146	chr21	29190807	29191517	710	355.0	
92147	chr21	29195875	29197167	1292	646.0	
92148	chr21	29208233	29209262	1029	514.0	
92149	chr21	29217682	29218340	658	329.0	
92150	chr21	29219065	29219567	502	251.0	
92151	chr21	29233076	29234074	998	499.0	
92152	chr21	29235704	29236607	903	452.0	
92153	chr21	29237460	29239342	1882	941.0	
92154	chr21	29248150	29248431	281	140.0	
92155	chr21	29256628	29256946	318	159.0	
92156	chr21	29271979	29272373	394	197.0	
92157	chr21	29287321	29287943	622	311.0	
92158	chr21	29293436	29293990	554	277.0	
92159	chr21	29295021	29295822	801	400.0	
92160	chr21	29296617	29296797	180	90.0	
92161	chr21	29297507	29301069	3562	1781.0	
92162	chr21	29302190	29303250	1060	530.0	
92163	chr21	29304317	29304958	641	320.0	
92164	chr21	29306059	29306483	424	212.0	
92165	chr21	29308005	29308036	31	16.0	
92166	chr21	29315335	29315488	153	76.0	
92167	chr21	29342652	29342916	264	132.0	
92168	chr21	29347234	29348978	1744	872.0	
92169	chr21	29356741	29357213	472	236.0	
92170	chr21	29372131	29372822	691	346.0	
92171	chr21	29376491	29377025	534	267.0	
92172	chr21	29404023	29404669	646	323.0	
92173	chr21	29418903	29419103	200	100.0	
92174	chr21	29436178	29436772	594	297.0	
92175	chr21	29449248	29449929	681	340.0	
92176	chr21	29476345	29476888	543	272.0	
92177	chr21	29638062	29639228	1166	583.0	
92178	chr21	29639731	29640616	885	442.0	
92179	chr21	29647370	29647677	307	154.0	
92180	chr21	29649411	29649764	353	176.0	
92181	chr21	29656593	29657390	797	398.0	
92182	chr21	29667658	29668101	443	222.0	
92183	chr21	29814088	29814602	514	257.0	
92184	chr21	29849647	29850131	484	242.0	
92185	chr21	30979068	30979429	361	180.0	
92186	chr21	31011393	31011765	372	186.0	
92187	chr21	31012663	31012834	171	86.0	
92188	chr21	31086400	31086843	443	222.0	
92189	chr21	31098334	31099291	957	478.0	
92190	chr21	31102937	31103255	318	159.0	
92191	chr21	31107743	31109346	1603	802.0	
92192	chr21	31117033	31117720	687	344.0	
92193	chr21	31123950	31124498	548	274.0	
92194	chr21	31132401	31133797	1396	698.0	
92195	chr21	31138023	31138380	357	178.0	
92196	chr21	31142631	31142943	312	156.0	
92197	chr21	31159057	31159790	733	366.0	
92198	chr21	31173831	31174681	850	425.0	
92199	chr21	31175908	31176732	824	412.0	
92200	chr21	31180501	31182961	2460	1230.0	
92201	chr21	31184330	31185030	700	350.0	
92202	chr21	31185678	31187495	1817	908.0	
92203	chr21	31198463	31198924	461	230.0	
92204	chr21	31201063	31202004	941	470.0	
92205	chr21	31221069	31221448	379	190.0	
92206	chr21	31283075	31283320	245	122.0	
92207	chr21	31326560	31327382	822	411.0	
92208	chr21	31339644	31340164	520	260.0	
92209	chr21	31341017	31341288	271	136.0	
92210	chr21	31342312	31342787	475	238.0	
92211	chr21	31343563	31344530	967	484.0	
92212	chr21	31352843	31353181	338	169.0	
92213	chr21	31354309	31355362	1053	526.0	
92214	chr21	31363709	31364040	331	166.0	
92215	chr21	31397717	31398544	827	414.0	
92216	chr21	31410610	31411055	445	222.0	
92217	chr21	31444115	31444462	347	174.0	
92218	chr21	31446442	31446914	472	236.0	
92219	chr21	31448467	31448901	434	217.0	
92220	chr21	31460960	31461259	299	150.0	
92221	chr21	31506613	31507235	622	311.0	
92222	chr21	31509332	31510038	706	353.0	
92223	chr21	31554570	31554898	328	164.0	
92224	chr21	31557492	31560254	2762	1381.0	
92225	chr21	31577368	31577673	305	152.0	
92226	chr21	31580735	31581220	485	242.0	
92227	chr21	31604546	31605043	497	248.0	
92228	chr21	31612923	31613844	921	460.0	
92229	chr21	31654602	31656510	1908	954.0	
92230	chr21	31658893	31660901	2008	1004.0	
92231	chr21	31665440	31665841	401	200.0	
92232	chr21	31730297	31733735	3438	1719.0	
92233	chr21	31745441	31745787	346	173.0	
92234	chr21	31766989	31767306	317	158.0	
92235	chr21	31772519	31773258	739	370.0	
92236	chr21	31785869	31786250	381	190.0	
92237	chr21	31866024	31866452	428	214.0	
92238	chr21	31872664	31874409	1745	872.0	
92239	chr21	31974495	31974834	339	170.0	
92240	chr21	32258391	32258540	149	74.0	
92241	chr21	32278092	32279957	1865	932.0	
92242	chr21	32371790	32372309	519	260.0	
92243	chr21	32392244	32394004	1760	880.0	
92244	chr21	32403073	32403744	671	336.0	
92245	chr21	32407711	32408453	742	371.0	
92246	chr21	32411289	32414491	3202	1601.0	
92247	chr21	32484642	32485078	436	218.0	
92248	chr21	32493167	32493829	662	331.0	
92249	chr21	32538360	32538874	514	257.0	
92250	chr21	32569070	32570607	1537	768.0	
92251	chr21	32578356	32578435	79	40.0	
92252	chr21	32600776	32601454	678	339.0	
92253	chr21	32611399	32613675	2276	1138.0	
92254	chr21	32653311	32653717	406	203.0	
92255	chr21	32707869	32708570	701	350.0	
92256	chr21	32712057	32712379	322	161.0	
92257	chr21	32717862	32718463	601	300.0	
92258	chr21	32726568	32729270	2702	1351.0	
92259	chr21	32770723	32773089	2366	1183.0	
92260	chr21	32780041	32780302	261	130.0	
92261	chr21	32826534	32827012	478	239.0	
92262	chr21	32878678	32879062	384	192.0	
92263	chr21	32886223	32887014	791	396.0	
92264	chr21	32914720	32915020	300	150.0	
92265	chr21	32921681	32922013	332	166.0	
92266	chr21	32929514	32929990	476	238.0	
92267	chr21	32932018	32933096	1078	539.0	
92268	chr21	32940415	32940837	422	211.0	
92269	chr21	32966149	32966502	353	176.0	
92270	chr21	33007438	33008355	917	458.0	
92271	chr21	33011237	33012028	791	396.0	
92272	chr21	33015081	33015532	451	226.0	
92273	chr21	33019062	33020743	1681	840.0	
92274	chr21	33022713	33024588	1875	938.0	
92275	chr21	33025602	33026574	972	486.0	
92276	chr21	33027227	33027844	617	308.0	
92277	chr21	33028567	33029217	650	325.0	
92278	chr21	33036296	33036937	641	320.0	
92279	chr21	33055968	33056460	492	246.0	
92280	chr21	33058953	33060271	1318	659.0	
92281	chr21	33066520	33066634	114	57.0	
92282	chr21	33067386	33067967	581	290.0	
92283	chr21	33069690	33072381	2691	1346.0	
92284	chr21	33078856	33079422	566	283.0	
92285	chr21	33089195	33089931	736	368.0	
92286	chr21	33096457	33096782	325	162.0	enhancer
92287	chr21	33101156	33101714	558	279.0	
92288	chr21	33109602	33110136	534	267.0	
92289	chr21	33127090	33127746	656	328.0	
92290	chr21	33169509	33169713	204	102.0	
92291	chr21	33185667	33186520	853	426.0	
92292	chr21	33196663	33197470	807	404.0	
92293	chr21	33198227	33200572	2345	1172.0	
92294	chr21	33202654	33203117	463	232.0	
92295	chr21	33203643	33206059	2416	1208.0	
92296	chr21	33206810	33208101	1291	646.0	
92297	chr21	33212182	33212674	492	246.0	
92298	chr21	33215116	33216970	1854	927.0	
92299	chr21	33220099	33220183	84	42.0	
92300	chr21	33227729	33228374	645	322.0	
92301	chr21	33229268	33232986	3718	1859.0	
92302	chr21	33234703	33235068	365	182.0	
92303	chr21	33237393	33239456	2063	1032.0	
92304	chr21	33244031	33245077	1046	523.0	
92305	chr21	33260022	33260371	349	174.0	
92306	chr21	33261548	33262057	509	254.0	
92307	chr21	33265310	33267562	2252	1126.0	
92308	chr21	33268282	33270285	2003	1002.0	
92309	chr21	33271504	33271988	484	242.0	
92310	chr21	33293647	33294141	494	247.0	
92311	chr21	33296149	33296613	464	232.0	
92312	chr21	33298930	33299963	1033	516.0	
92313	chr21	33300584	33302495	1911	956.0	
92314	chr21	33304597	33305083	486	243.0	
92315	chr21	33308910	33309362	452	226.0	
92316	chr21	33317154	33317338	184	92.0	
92317	chr21	33323978	33326105	2127	1064.0	
92318	chr21	33332133	33332308	175	88.0	
92319	chr21	33339770	33340297	527	264.0	
92320	chr21	33347572	33347978	406	203.0	
92321	chr21	33360742	33362817	2075	1038.0	
92322	chr21	33363876	33364742	866	433.0	
92323	chr21	33368071	33368533	462	231.0	
92324	chr21	33373952	33375451	1499	750.0	
92325	chr21	33379732	33381697	1965	982.0	
92326	chr21	33382716	33385460	2744	1372.0	
92327	chr21	33388103	33388685	582	291.0	
92328	chr21	33391627	33392092	465	232.0	
92329	chr21	33393397	33395077	1680	840.0	
92330	chr21	33399441	33399882	441	220.0	
92331	chr21	33400801	33405478	4677	2338.0	
92332	chr21	33406475	33406884	409	204.0	
92333	chr21	33433298	33433905	607	304.0	
92334	chr21	33434602	33435325	723	362.0	
92335	chr21	33441993	33442438	445	222.0	
92336	chr21	33445023	33445762	739	370.0	
92337	chr21	33478401	33480824	2423	1212.0	
92338	chr21	33484182	33484184	2	1.0	
92339	chr21	33490872	33492385	1513	756.0	
92340	chr21	33525712	33526325	613	306.0	
92341	chr21	33532832	33533375	543	272.0	
92342	chr21	33541209	33544112	2903	1452.0	
92343	chr21	33549903	33551284	1381	690.0	
92344	chr21	33551931	33552861	930	465.0	
92345	chr21	33587715	33589451	1736	868.0	
92346	chr21	33605532	33606265	733	366.0	
92347	chr21	33619827	33619877	50	25.0	
92348	chr21	33641041	33645048	4007	2004.0	
92349	chr21	33657072	33657562	490	245.0	
92350	chr21	33761742	33762064	322	161.0	
92351	chr21	33842436	33843199	763	382.0	
92352	chr21	33894670	33895180	510	255.0	
92353	chr21	33915033	33916571	1538	769.0	
92354	chr21	33923738	33924860	1122	561.0	
92355	chr21	33931213	33932988	1775	888.0	
92356	chr21	33936139	33938665	2526	1263.0	
92357	chr21	33940360	33940498	138	69.0	
92358	chr21	33945780	33946167	387	194.0	
92359	chr21	33947267	33950864	3597	1798.0	
92360	chr21	33951395	33952215	820	410.0	
92361	chr21	33955662	33955724	62	31.0	
92362	chr21	33968112	33968701	589	294.0	
92363	chr21	33975340	33977187	1847	924.0	
92364	chr21	33993767	33994312	545	272.0	
92365	chr21	34018222	34018513	291	146.0	
92366	chr21	34019821	34020968	1147	574.0	
92367	chr21	34022614	34023492	878	439.0	
92368	chr21	34025697	34026048	351	176.0	
92369	chr21	34029979	34030685	706	353.0	
92370	chr21	34046886	34047437	551	276.0	
92371	chr21	34072475	34074956	2481	1240.0	
92372	chr21	34075800	34076102	302	151.0	
92373	chr21	34078138	34079391	1253	626.0	
92374	chr21	34086811	34087300	489	244.0	
92375	chr21	34092465	34092943	478	239.0	
92376	chr21	34126344	34126600	256	128.0	
92377	chr21	34128967	34130039	1072	536.0	
92378	chr21	34132500	34133719	1219	610.0	
92379	chr21	34189636	34189994	358	179.0	
92380	chr21	34198122	34199210	1088	544.0	
92381	chr21	34200100	34203397	3297	1648.0	
92382	chr21	34205796	34206612	816	408.0	
92383	chr21	34223183	34223802	619	310.0	
92384	chr21	34243543	34243941	398	199.0	
92385	chr21	34347831	34348395	564	282.0	
92386	chr21	34351731	34352124	393	196.0	
92387	chr21	34361583	34362489	906	453.0	
92388	chr21	34367288	34367778	490	245.0	
92389	chr21	34374282	34376252	1970	985.0	
92390	chr21	34384098	34384503	405	202.0	
92391	chr21	34390766	34391150	384	192.0	
92392	chr21	34405855	34407722	1867	934.0	
92393	chr21	34417392	34417968	576	288.0	
92394	chr21	34443469	34443930	461	230.0	
92395	chr21	34510444	34513603	3159	1580.0	
92396	chr21	34517413	34517967	554	277.0	
92397	chr21	34520707	34521177	470	235.0	
92398	chr21	34522271	34522671	400	200.0	
92399	chr21	34526506	34527271	765	382.0	
92400	chr21	34534475	34534959	484	242.0	
92401	chr21	34543940	34545885	1945	972.0	enhancer
92402	chr21	34570417	34570573	156	78.0	
92403	chr21	34582732	34583227	495	248.0	
92404	chr21	34602992	34603455	463	232.0	
92405	chr21	34613931	34615905	1974	987.0	
92406	chr21	34618100	34618241	141	70.0	
92407	chr21	34619111	34619280	169	84.0	
92408	chr21	34623465	34623881	416	208.0	
92409	chr21	34630493	34631173	680	340.0	
92410	chr21	34635352	34635680	328	164.0	
92411	chr21	34640116	34640855	739	370.0	
92412	chr21	34669415	34670570	1155	578.0	
92413	chr21	34679159	34679379	220	110.0	
92414	chr21	34693233	34693618	385	192.0	
92415	chr21	34707952	34708351	399	200.0	
92416	chr21	34722703	34722994	291	146.0	
92417	chr21	34745425	34746128	703	352.0	
92418	chr21	34801096	34802142	1046	523.0	
92419	chr21	34807211	34809037	1826	913.0	"enhancer	enhancer	protein_binding_site"
92420	chr21	34813494	34814032	538	269.0	
92421	chr21	34826812	34827362	550	275.0	
92422	chr21	34830719	34831227	508	254.0	
92423	chr21	34834884	34836556	1672	836.0	
92424	chr21	34844343	34846365	2022	1011.0	
92425	chr21	34865297	34866460	1163	582.0	
92426	chr21	34874718	34875003	285	142.0	
92427	chr21	34881838	34884053	2215	1108.0	
92428	chr21	34885862	34891590	5728	2864.0	
92429	chr21	34892176	34892692	516	258.0	
92430	chr21	34894491	34894897	406	203.0	
92431	chr21	34907661	34910456	2795	1398.0	
92432	chr21	34911258	34911815	557	278.0	
92433	chr21	34914194	34914643	449	224.0	
92434	chr21	34924672	34925736	1064	532.0	
92435	chr21	34932369	34934814	2445	1222.0	
92436	chr21	34935355	34936773	1418	709.0	
92437	chr21	34946243	34946959	716	358.0	
92438	chr21	34967462	34968075	613	306.0	
92439	chr21	34968687	34969518	831	416.0	
92440	chr21	34973937	34974844	907	454.0	
92441	chr21	34983026	34984929	1903	952.0	
92442	chr21	34986644	34988435	1791	896.0	
92443	chr21	34994648	34995310	662	331.0	
92444	chr21	34999298	35000058	760	380.0	
92445	chr21	35007441	35007670	229	114.0	
92446	chr21	35014572	35015902	1330	665.0	
92447	chr21	35020371	35020911	540	270.0	
92448	chr21	35022019	35022368	349	174.0	
92449	chr21	35025246	35028574	3328	1664.0	enhancer
92450	chr21	35032654	35032930	276	138.0	
92451	chr21	35035536	35035993	457	228.0	
92452	chr21	35036523	35038928	2405	1202.0	
92453	chr21	35040019	35040642	623	312.0	
92454	chr21	35042070	35052060	9990	4995.0	
92455	chr21	35102472	35103551	1079	540.0	
92456	chr21	35138764	35139137	373	186.0	
92457	chr21	35189420	35189816	396	198.0	
92458	chr21	35204748	35206331	1583	792.0	
92459	chr21	35222466	35222887	421	210.0	
92460	chr21	35226815	35228133	1318	659.0	
92461	chr21	35234901	35235046	145	72.0	enhancer
92462	chr21	35342602	35342612	10	5.0	
92463	chr21	35400346	35400925	579	290.0	
92464	chr21	35428439	35428840	401	200.0	
92465	chr21	35438532	35439185	653	326.0	
92466	chr21	35474966	35476183	1217	608.0	
92467	chr21	35478108	35479104	996	498.0	
92468	chr21	35491827	35492409	582	291.0	
92469	chr21	35503825	35503860	35	18.0	
92470	chr21	35508246	35509505	1259	630.0	
92471	chr21	35525295	35525800	505	252.0	
92472	chr21	35528246	35529749	1503	752.0	
92473	chr21	35530700	35531157	457	228.0	
92474	chr21	35840219	35840570	351	176.0	
92475	chr21	35905008	35905737	729	364.0	
92476	chr21	35924695	35925633	938	469.0	
92477	chr21	35932028	35933940	1912	956.0	
92478	chr21	35940247	35940710	463	232.0	
92479	chr21	35942282	35942390	108	54.0	
92480	chr21	36028217	36028928	711	356.0	
92481	chr21	36059687	36061198	1511	756.0	
92482	chr21	36065538	36065956	418	209.0	
92483	chr21	36069496	36070650	1154	577.0	
92484	chr21	36077281	36077864	583	292.0	
92485	chr21	36078888	36079572	684	342.0	
92486	chr21	36104577	36105096	519	260.0	
92487	chr21	36112524	36114855	2331	1166.0	
92488	chr21	36125376	36126151	775	388.0	
92489	chr21	36129833	36130790	957	478.0	
92490	chr21	36134427	36136808	2381	1190.0	
92491	chr21	36141148	36142225	1077	538.0	
92492	chr21	36145238	36145686	448	224.0	
92493	chr21	36149863	36150943	1080	540.0	
92494	chr21	36152973	36153661	688	344.0	
92495	chr21	36155549	36157738	2189	1094.0	
92496	chr21	36159303	36159995	692	346.0	
92497	chr21	36163770	36164190	420	210.0	
92498	chr21	36169452	36170100	648	324.0	
92499	chr21	36171801	36172305	504	252.0	
92500	chr21	36173610	36174491	881	440.0	
92501	chr21	36181202	36182054	852	426.0	
92502	chr21	36185575	36185833	258	129.0	
92503	chr21	36200143	36200423	280	140.0	
92504	chr21	36209552	36210020	468	234.0	
92505	chr21	36253653	36256103	2450	1225.0	
92506	chr21	36260142	36261306	1164	582.0	
92507	chr21	36288576	36289784	1208	604.0	
92508	chr21	36297470	36299310	1840	920.0	
92509	chr21	36310108	36310519	411	206.0	
92510	chr21	36319350	36322192	2842	1421.0	
92511	chr21	36322752	36323580	828	414.0	
92512	chr21	36329480	36329808	328	164.0	
92513	chr21	36330507	36331358	851	426.0	
92514	chr21	36385020	36386178	1158	579.0	
92515	chr21	36389641	36389997	356	178.0	
92516	chr21	36403811	36403925	114	57.0	
92517	chr21	36419873	36420365	492	246.0	
92518	chr21	36422235	36422556	321	160.0	
92519	chr21	36429678	36430716	1038	519.0	
92520	chr21	36504236	36504625	389	194.0	
92521	chr21	36603266	36603560	294	147.0	
92522	chr21	36859750	36860612	862	431.0	"enhancer	sequence_feature"
92523	chr21	36927596	36928012	416	208.0	
92524	chr21	36939400	36939852	452	226.0	
92525	chr21	36965030	36967648	2618	1309.0	
92526	chr21	36976710	36977819	1109	554.0	
92527	chr21	36980489	36981336	847	424.0	
92528	chr21	36985676	36986240	564	282.0	
92529	chr21	36989282	36990742	1460	730.0	
92530	chr21	36994481	36994925	444	222.0	
92531	chr21	37006289	37007182	893	446.0	
92532	chr21	37009673	37010339	666	333.0	
92533	chr21	37045219	37045495	276	138.0	
92534	chr21	37071846	37074669	2823	1412.0	
92535	chr21	37079085	37079823	738	369.0	
92536	chr21	37165697	37166014	317	158.0	
92537	chr21	37207544	37209054	1510	755.0	
92538	chr21	37210328	37210424	96	48.0	
92539	chr21	37219750	37221814	2064	1032.0	
92540	chr21	37224743	37226146	1403	702.0	
92541	chr21	37250923	37251747	824	412.0	
92542	chr21	37256908	37259051	2143	1072.0	
92543	chr21	37266435	37268552	2117	1058.0	
92544	chr21	37364614	37371508	6894	3447.0	
92545	chr21	37372213	37373741	1528	764.0	
92546	chr21	37374455	37375346	891	446.0	
92547	chr21	37375861	37376746	885	442.0	
92548	chr21	37378737	37379145	408	204.0	
92549	chr21	37380436	37381036	600	300.0	
92550	chr21	37383143	37383505	362	181.0	
92551	chr21	37385089	37385525	436	218.0	
92552	chr21	37386608	37386688	80	40.0	
92553	chr21	37389910	37390035	125	62.0	
92554	chr21	37392968	37394079	1111	556.0	
92555	chr21	37396868	37397202	334	167.0	
92556	chr21	37398625	37399293	668	334.0	
92557	chr21	37401596	37401961	365	182.0	
92558	chr21	37404402	37404406	4	2.0	
92559	chr21	37405647	37406008	361	180.0	
92560	chr21	37407966	37408295	329	164.0	
92561	chr21	37413704	37414769	1065	532.0	
92562	chr21	37415338	37416139	801	400.0	
92563	chr21	37419534	37419816	282	141.0	
92564	chr21	37429369	37429569	200	100.0	
92565	chr21	37430388	37430819	431	216.0	
92566	chr21	37434878	37435756	878	439.0	
92567	chr21	37458037	37459154	1117	558.0	
92568	chr21	37461342	37463867	2525	1262.0	
92569	chr21	37475141	37475545	404	202.0	
92570	chr21	37522593	37522982	389	194.0	
92571	chr21	37547399	37547493	94	47.0	
92572	chr21	37557407	37557645	238	119.0	
92573	chr21	37563129	37565178	2049	1024.0	
92574	chr21	37566012	37566023	11	6.0	
92575	chr21	37582620	37582891	271	136.0	
92576	chr21	37675267	37675576	309	154.0	
92577	chr21	37700641	37701015	374	187.0	
92578	chr21	37815758	37816257	499	250.0	
92579	chr21	37829401	37829930	529	264.0	
92580	chr21	37862435	37863080	645	322.0	
92581	chr21	37863752	37864379	627	314.0	
92582	chr21	37865190	37866698	1508	754.0	
92583	chr21	38159276	38159643	367	184.0	
92584	chr21	38170216	38170632	416	208.0	
92585	chr21	38196021	38196405	384	192.0	
92586	chr21	38218998	38219478	480	240.0	
92587	chr21	38228585	38228587	2	1.0	
92588	chr21	38242074	38242388	314	157.0	
92589	chr21	38244755	38245405	650	325.0	
92590	chr21	38274019	38274696	677	338.0	
92591	chr21	38277294	38278264	970	485.0	
92592	chr21	38282812	38283433	621	310.0	
92593	chr21	38289480	38290349	869	434.0	
92594	chr21	38296331	38297476	1145	572.0	
92595	chr21	38306271	38306884	613	306.0	
92596	chr21	38310453	38311026	573	286.0	
92597	chr21	38323608	38324224	616	308.0	
92598	chr21	38351893	38353016	1123	562.0	
92599	chr21	38355959	38356455	496	248.0	
92600	chr21	38376158	38376897	739	370.0	
92601	chr21	38384710	38385083	373	186.0	
92602	chr21	38387225	38387329	104	52.0	
92603	chr21	38439936	38440371	435	218.0	
92604	chr21	38440878	38440895	17	8.0	
92605	chr21	38467314	38467760	446	223.0	
92606	chr21	38472553	38473113	560	280.0	
92607	chr21	38476309	38476722	413	206.0	
92608	chr21	38477258	38477482	224	112.0	
92609	chr21	38486750	38487223	473	236.0	
92610	chr21	38494191	38494215	24	12.0	
92611	chr21	38494763	38495042	279	140.0	
92612	chr21	38497807	38498133	326	163.0	
92613	chr21	38505635	38506043	408	204.0	
92614	chr21	38506624	38506963	339	170.0	
92615	chr21	38639601	38640179	578	289.0	
92616	chr21	38660410	38661706	1296	648.0	
92617	chr21	38667382	38667985	603	302.0	
92618	chr21	38679518	38679978	460	230.0	
92619	chr21	38733833	38734700	867	434.0	
92620	chr21	38751256	38752264	1008	504.0	
92621	chr21	38755498	38756456	958	479.0	
92622	chr21	38766681	38769030	2349	1174.0	
92623	chr21	38772915	38773091	176	88.0	
92624	chr21	38777763	38777865	102	51.0	
92625	chr21	38780763	38781444	681	340.0	
92626	chr21	38797463	38797864	401	200.0	
92627	chr21	38804346	38808467	4121	2060.0	
92628	chr21	38809085	38809786	701	350.0	
92629	chr21	38810960	38811780	820	410.0	
92630	chr21	38820632	38821585	953	476.0	
92631	chr21	38830672	38832332	1660	830.0	
92632	chr21	38853441	38853627	186	93.0	
92633	chr21	38861992	38862512	520	260.0	
92634	chr21	38869147	38869608	461	230.0	
92635	chr21	38874601	38874981	380	190.0	
92636	chr21	38878403	38878786	383	192.0	
92637	chr21	38918590	38918989	399	200.0	
92638	chr21	38925878	38926490	612	306.0	
92639	chr21	38930574	38931706	1132	566.0	
92640	chr21	38938413	38938714	301	150.0	
92641	chr21	38959203	38959604	401	200.0	
92642	chr21	38979454	38980069	615	308.0	
92643	chr21	38985592	38985965	373	186.0	
92644	chr21	38992929	38992979	50	25.0	
92645	chr21	38997555	38998590	1035	518.0	
92646	chr21	38999266	38999724	458	229.0	
92647	chr21	39000492	39000883	391	196.0	
92648	chr21	39004178	39005307	1129	564.0	
92649	chr21	39006502	39007441	939	470.0	
92650	chr21	39010661	39011446	785	392.0	
92651	chr21	39014650	39015235	585	292.0	
92652	chr21	39016834	39017419	585	292.0	
92653	chr21	39020783	39021227	444	222.0	
92654	chr21	39078013	39078342	329	164.0	
92655	chr21	39079256	39080165	909	454.0	
92656	chr21	39083658	39083874	216	108.0	
92657	chr21	39090157	39090421	264	132.0	
92658	chr21	39094071	39095430	1359	680.0	
92659	chr21	39097187	39098010	823	412.0	
92660	chr21	39104381	39105738	1357	678.0	
92661	chr21	39125900	39126339	439	220.0	
92662	chr21	39138410	39138455	45	22.0	
92663	chr21	39180605	39181001	396	198.0	
92664	chr21	39182251	39184711	2460	1230.0	
92665	chr21	39196355	39196665	310	155.0	
92666	chr21	39311965	39314994	3029	1514.0	
92667	chr21	39316016	39316528	512	256.0	
92668	chr21	39317166	39318023	857	428.0	
92669	chr21	39347577	39350324	2747	1374.0	
92670	chr21	39362241	39362705	464	232.0	
92671	chr21	39370014	39371015	1001	500.0	
92672	chr21	39373612	39374082	470	235.0	
92673	chr21	39379875	39381291	1416	708.0	
92674	chr21	39385405	39386636	1231	616.0	
92675	chr21	39387324	39389229	1905	952.0	
92676	chr21	39441458	39441932	474	237.0	
92677	chr21	39444822	39446418	1596	798.0	
92678	chr21	39518271	39518664	393	196.0	
92679	chr21	40546696	40547038	342	171.0	
92680	chr21	40976633	40977122	489	244.0	
92681	chr21	41113402	41113532	130	65.0	
92682	chr21	41121839	41122106	267	134.0	
92683	chr21	41167571	41168348	777	388.0	
92684	chr21	41208044	41208336	292	146.0	
92685	chr21	41229777	41230207	430	215.0	
92686	chr21	41283132	41283669	537	268.0	
92687	chr21	41347538	41348004	466	233.0	
92688	chr21	41361196	41365168	3972	1986.0	
92689	chr21	41366158	41370618	4460	2230.0	
92690	chr21	41371451	41372069	618	309.0	
92691	chr21	41373299	41377097	3798	1899.0	
92692	chr21	41377993	41380487	2494	1247.0	
92693	chr21	41381720	41381834	114	57.0	
92694	chr21	41386494	41386781	287	144.0	
92695	chr21	41387844	41387962	118	59.0	
92696	chr21	41396378	41397326	948	474.0	
92697	chr21	41406120	41406767	647	324.0	
92698	chr21	41410928	41412011	1083	542.0	
92699	chr21	41418715	41419073	358	179.0	
92700	chr21	41419751	41421037	1286	643.0	
92701	chr21	41423201	41424255	1054	527.0	
92702	chr21	41425552	41427361	1809	904.0	
92703	chr21	41431786	41432188	402	201.0	
92704	chr21	41459830	41461052	1222	611.0	
92705	chr21	41610368	41610721	353	176.0	
92706	chr21	41651411	41651848	437	218.0	
92707	chr21	41664073	41664612	539	270.0	
92708	chr21	41666591	41667292	701	350.0	
92709	chr21	41671804	41672166	362	181.0	
92710	chr21	41678438	41679576	1138	569.0	
92711	chr21	41681017	41681372	355	178.0	
92712	chr21	41692906	41693458	552	276.0	
92713	chr21	41701722	41702315	593	296.0	
92714	chr21	41725548	41726661	1113	556.0	
92715	chr21	41760878	41762433	1555	778.0	
92716	chr21	41766598	41769292	2694	1347.0	
92717	chr21	41778154	41779259	1105	552.0	
92718	chr21	41801421	41802951	1530	765.0	
92719	chr21	41816503	41817560	1057	528.0	
92720	chr21	41865372	41865724	352	176.0	
92721	chr21	41868557	41868565	8	4.0	
92722	chr21	41877838	41880133	2295	1148.0	
92723	chr21	41895768	41896360	592	296.0	
92724	chr21	41899420	41899891	471	236.0	
92725	chr21	41901103	41901537	434	217.0	
92726	chr21	41921161	41921545	384	192.0	
92727	chr21	41925923	41927169	1246	623.0	
92728	chr21	41927825	41929746	1921	960.0	
92729	chr21	41933039	41933810	771	386.0	
92730	chr21	41953078	41954700	1622	811.0	
92731	chr21	41973960	41974535	575	288.0	
92732	chr21	42002505	42002880	375	188.0	
92733	chr21	42008755	42011606	2851	1426.0	
92734	chr21	42061004	42064654	3650	1825.0	
92735	chr21	42073605	42073607	2	1.0	
92736	chr21	42080273	42081497	1224	612.0	
92737	chr21	42097786	42098280	494	247.0	
92738	chr21	42107521	42108628	1107	554.0	
92739	chr21	42114065	42114502	437	218.0	
92740	chr21	42117161	42119347	2186	1093.0	
92741	chr21	42125742	42126092	350	175.0	
92742	chr21	42140611	42141111	500	250.0	
92743	chr21	42142622	42142998	376	188.0	
92744	chr21	42145236	42146258	1022	511.0	
92745	chr21	42159958	42160440	482	241.0	
92746	chr21	42161830	42162173	343	172.0	
92747	chr21	42164170	42164996	826	413.0	
92748	chr21	42187558	42189102	1544	772.0	
92749	chr21	42189969	42190575	606	303.0	
92750	chr21	42191836	42192417	581	290.0	
92751	chr21	42192998	42193706	708	354.0	
92752	chr21	42195034	42195944	910	455.0	
92753	chr21	42198858	42200069	1211	606.0	
92754	chr21	42200886	42201337	451	226.0	
92755	chr21	42218366	42221028	2662	1331.0	
92756	chr21	42221544	42221995	451	226.0	
92757	chr21	42227555	42229017	1462	731.0	
92758	chr21	42232393	42235783	3390	1695.0	
92759	chr21	42236503	42239336	2833	1416.0	
92760	chr21	42247749	42248188	439	220.0	
92761	chr21	42249120	42249700	580	290.0	
92762	chr21	42258332	42259055	723	362.0	
92763	chr21	42262789	42264178	1389	694.0	
92764	chr21	42267242	42268627	1385	692.0	
92765	chr21	42289874	42290430	556	278.0	
92766	chr21	42292333	42292785	452	226.0	
92767	chr21	42308484	42308911	427	214.0	
92768	chr21	42309445	42310187	742	371.0	
92769	chr21	42319272	42320049	777	388.0	
92770	chr21	42337746	42338524	778	389.0	
92771	chr21	42379433	42379802	369	184.0	
92772	chr21	42381369	42381796	427	214.0	
92773	chr21	42384996	42385324	328	164.0	
92774	chr21	42387128	42387594	466	233.0	
92775	chr21	42388994	42389454	460	230.0	
92776	chr21	42398111	42398377	266	133.0	
92777	chr21	42403363	42407174	3811	1906.0	
92778	chr21	42411567	42411812	245	122.0	
92779	chr21	42414393	42416006	1613	806.0	
92780	chr21	42417462	42417954	492	246.0	
92781	chr21	42421062	42421415	353	176.0	
92782	chr21	42423088	42423879	791	396.0	
92783	chr21	42424393	42426171	1778	889.0	
92784	chr21	42439509	42440187	678	339.0	
92785	chr21	42449643	42450773	1130	565.0	
92786	chr21	42456403	42456864	461	230.0	
92787	chr21	42460068	42461582	1514	757.0	
92788	chr21	42463780	42465969	2189	1094.0	
92789	chr21	42467305	42467632	327	164.0	
92790	chr21	42474473	42474864	391	196.0	
92791	chr21	42495344	42497265	1921	960.0	
92792	chr21	42505067	42505545	478	239.0	
92793	chr21	42513062	42515112	2050	1025.0	
92794	chr21	42524296	42525608	1312	656.0	
92795	chr21	42527324	42528593	1269	634.0	
92796	chr21	42532604	42533363	759	380.0	
92797	chr21	42534358	42535417	1059	530.0	
92798	chr21	42535924	42536151	227	114.0	
92799	chr21	42537364	42537765	401	200.0	
92800	chr21	42593161	42593678	517	258.0	enhancer
92801	chr21	42609781	42610184	403	202.0	
92802	chr21	42614283	42615621	1338	669.0	
92803	chr21	42616227	42616810	583	292.0	
92804	chr21	42652431	42654872	2441	1220.0	
92805	chr21	42665922	42666393	471	236.0	
92806	chr21	42681215	42681689	474	237.0	
92807	chr21	42683790	42685097	1307	654.0	
92808	chr21	42734554	42734987	433	216.0	
92809	chr21	42737755	42738777	1022	511.0	
92810	chr21	42745813	42747677	1864	932.0	
92811	chr21	42761443	42761818	375	188.0	
92812	chr21	42763660	42764198	538	269.0	
92813	chr21	42777952	42778405	453	226.0	
92814	chr21	42781317	42781974	657	328.0	
92815	chr21	42783546	42784733	1187	594.0	
92816	chr21	42799849	42800420	571	286.0	
92817	chr21	42818209	42818697	488	244.0	
92818	chr21	42830822	42831259	437	218.0	
92819	chr21	42831946	42833831	1885	942.0	
92820	chr21	42850748	42851149	401	200.0	
92821	chr21	42878471	42880581	2110	1055.0	
92822	chr21	42892251	42894322	2071	1036.0	
92823	chr21	42923585	42924452	867	434.0	
92824	chr21	42925578	42925841	263	132.0	
92825	chr21	42959015	42959488	473	236.0	
92826	chr21	42973439	42976264	2825	1412.0	
92827	chr21	42981039	42981223	184	92.0	
92828	chr21	43036734	43037509	775	388.0	
92829	chr21	43044843	43046514	1671	836.0	
92830	chr21	43052871	43053573	702	351.0	
92831	chr21	43074697	43076881	2184	1092.0	
92832	chr21	43086621	43086906	285	142.0	
92833	chr21	43090853	43091401	548	274.0	
92834	chr21	43091943	43093696	1753	876.0	
92835	chr21	43103828	43105205	1377	688.0	
92836	chr21	43106630	43109821	3191	1596.0	
92837	chr21	43117185	43117596	411	206.0	
92838	chr21	43137627	43138027	400	200.0	
92839	chr21	43138916	43139399	483	242.0	
92840	chr21	43153556	43153984	428	214.0	
92841	chr21	43172126	43173950	1824	912.0	
92842	chr21	43176333	43179144	2811	1406.0	
92843	chr21	43188635	43188952	317	158.0	
92844	chr21	43290638	43290779	141	70.0	
92845	chr21	43307338	43307702	364	182.0	
92846	chr21	43315166	43315593	427	214.0	
92847	chr21	43326031	43326289	258	129.0	
92848	chr21	43332135	43332522	387	194.0	
92849	chr21	43345731	43346541	810	405.0	
92850	chr21	43352476	43353310	834	417.0	
92851	chr21	43355866	43356272	406	203.0	
92852	chr21	43361007	43363277	2270	1135.0	
92853	chr21	43365755	43365759	4	2.0	
92854	chr21	43369086	43369519	433	216.0	
92855	chr21	43379577	43381979	2402	1201.0	
92856	chr21	43382801	43385310	2509	1254.0	
92857	chr21	43397099	43401029	3930	1965.0	
92858	chr21	43401862	43402751	889	444.0	
92859	chr21	43409256	43431686	22430	11215.0	
92860	chr21	43433359	43433710	351	176.0	
92861	chr21	43444074	43445090	1016	508.0	
92862	chr21	43447595	43447899	304	152.0	
92863	chr21	43454125	43454670	545	272.0	
92864	chr21	43456456	43457158	702	351.0	
92865	chr21	43467937	43468043	106	53.0	
92866	chr21	43493489	43495274	1785	892.0	
92867	chr21	43502425	43503765	1340	670.0	
92868	chr21	43516966	43517020	54	27.0	
92869	chr21	43574624	43575865	1241	620.0	
92870	chr21	43602854	43603742	888	444.0	
92871	chr21	43608395	43608523	128	64.0	
92872	chr21	43611856	43612204	348	174.0	
92873	chr21	43645444	43647125	1681	840.0	
92874	chr21	43658922	43661067	2145	1072.0	
92875	chr21	43687952	43688752	800	400.0	
92876	chr21	43701143	43701542	399	200.0	
92877	chr21	43702928	43703429	501	250.0	
92878	chr21	43706361	43707133	772	386.0	
92879	chr21	43711085	43711629	544	272.0	
92880	chr21	43716635	43717491	856	428.0	
92881	chr21	43718274	43722629	4355	2178.0	
92882	chr21	43725484	43729912	4428	2214.0	
92883	chr21	43735657	43735738	81	40.0	
92884	chr21	43739845	43741072	1227	614.0	
92885	chr21	43743907	43744321	414	207.0	
92886	chr21	43758357	43758432	75	38.0	
92887	chr21	43768124	43768659	535	268.0	"sequence_feature	enhancer"
92888	chr21	43771498	43772046	548	274.0	
92889	chr21	43775508	43777231	1723	862.0	"repeat_region	sequence_feature"
92890	chr21	43778463	43779481	1018	509.0	
92891	chr21	43788710	43790522	1812	906.0	
92892	chr21	43805030	43806411	1381	690.0	
92893	chr21	43810360	43812993	2633	1316.0	
92894	chr21	43817762	43819274	1512	756.0	
92895	chr21	43829510	43829877	367	184.0	
92896	chr21	43833477	43833759	282	141.0	
92897	chr21	43834380	43835462	1082	541.0	
92898	chr21	43842542	43843168	626	313.0	
92899	chr21	43850757	43851106	349	174.0	
92900	chr21	43854778	43855757	979	490.0	
92901	chr21	43864053	43867407	3354	1677.0	
92902	chr21	43872441	43873284	843	422.0	
92903	chr21	43883976	43884668	692	346.0	
92904	chr21	43893426	43894465	1039	520.0	
92905	chr21	43916600	43918519	1919	960.0	
92906	chr21	43921439	43922633	1194	597.0	
92907	chr21	43937726	43939721	1995	998.0	
92908	chr21	43958288	43959636	1348	674.0	
92909	chr21	43975071	43975904	833	416.0	
92910	chr21	43985455	43986145	690	345.0	
92911	chr21	44009970	44010705	735	368.0	
92912	chr21	44011467	44015167	3700	1850.0	
92913	chr21	44018804	44019615	811	406.0	
92914	chr21	44020658	44020911	253	126.0	
92915	chr21	44021473	44022098	625	312.0	
92916	chr21	44024942	44026162	1220	610.0	
92917	chr21	44051640	44051972	332	166.0	
92918	chr21	44057834	44058571	737	368.0	
92919	chr21	44063184	44063387	203	102.0	
92920	chr21	44064903	44066452	1549	774.0	
92921	chr21	44074208	44074913	705	352.0	
92922	chr21	44078454	44078756	302	151.0	
92923	chr21	44082508	44088248	5740	2870.0	
92924	chr21	44089122	44090818	1696	848.0	
92925	chr21	44106548	44109822	3274	1637.0	
92926	chr21	44113932	44114411	479	240.0	
92927	chr21	44121280	44122334	1054	527.0	
92928	chr21	44131282	44131819	537	268.0	
92929	chr21	44132621	44135696	3075	1538.0	
92930	chr21	44137544	44147838	10294	5147.0	
92931	chr21	44153267	44161387	8120	4060.0	
92932	chr21	44167233	44167910	677	338.0	
92933	chr21	44170817	44171384	567	284.0	
92934	chr21	44172407	44173649	1242	621.0	
92935	chr21	44174736	44176357	1621	810.0	
92936	chr21	44181158	44182517	1359	680.0	
92937	chr21	44194386	44194856	470	235.0	
92938	chr21	44195916	44197122	1206	603.0	
92939	chr21	44202721	44202976	255	128.0	
92940	chr21	44203620	44204586	966	483.0	
92941	chr21	44206349	44208638	2289	1144.0	
92942	chr21	44218470	44218785	315	158.0	
92943	chr21	44220472	44221156	684	342.0	
92944	chr21	44223233	44223743	510	255.0	
92945	chr21	44239488	44244802	5314	2657.0	
92946	chr21	44245692	44246390	698	349.0	
92947	chr21	44247470	44247911	441	220.0	
92948	chr21	44267559	44268230	671	336.0	
92949	chr21	44292337	44292494	157	78.0	
92950	chr21	44293586	44296471	2885	1442.0	
92951	chr21	44297382	44301401	4019	2010.0	
92952	chr21	44301971	44303560	1589	794.0	
92953	chr21	44304878	44305385	507	254.0	
92954	chr21	44324121	44324448	327	164.0	
92955	chr21	44325369	44325400	31	16.0	
92956	chr21	44326378	44329680	3302	1651.0	
92957	chr21	44330522	44330715	193	96.0	
92958	chr21	44331406	44331777	371	186.0	
92959	chr21	44334695	44334775	80	40.0	
92960	chr21	44337799	44340100	2301	1150.0	
92961	chr21	44350002	44350950	948	474.0	
92962	chr21	44352685	44354564	1879	940.0	
92963	chr21	44355213	44355732	519	260.0	
92964	chr21	44356578	44357114	536	268.0	
92965	chr21	44359999	44361187	1188	594.0	
92966	chr21	44370026	44370310	284	142.0	
92967	chr21	44375088	44375801	713	356.0	
92968	chr21	44391683	44392127	444	222.0	
92969	chr21	44428118	44429076	958	479.0	
92970	chr21	44454495	44456425	1930	965.0	
92971	chr21	44479537	44480053	516	258.0	
92972	chr21	44485143	44486132	989	494.0	
92973	chr21	44488030	44488155	125	62.0	
92974	chr21	44503900	44504421	521	260.0	
92975	chr21	44510227	44511224	997	498.0	
92976	chr21	44547531	44548067	536	268.0	
92977	chr21	44564921	44565306	385	192.0	
92978	chr21	44566434	44566738	304	152.0	
92979	chr21	44618470	44619560	1090	545.0	
92980	chr21	44626157	44626710	553	276.0	
92981	chr21	44630577	44630776	199	100.0	
92982	chr21	44653664	44654996	1332	666.0	
92983	chr21	44657210	44659483	2273	1136.0	
92984	chr21	44709442	44710283	841	420.0	
92985	chr21	44710989	44711766	777	388.0	
92986	chr21	44723307	44723998	691	346.0	
92987	chr21	44742443	44742814	371	186.0	
92988	chr21	44764943	44766036	1093	546.0	
92989	chr21	44793054	44793803	749	374.0	
92990	chr21	44800785	44802796	2011	1006.0	
92991	chr21	44816971	44818957	1986	993.0	
92992	chr21	44836718	44836938	220	110.0	
92993	chr21	44845479	44847232	1753	876.0	
92994	chr21	44849612	44849949	337	168.0	
92995	chr21	44854254	44855460	1206	603.0	
92996	chr21	44865465	44866240	775	388.0	
92997	chr21	44868111	44869087	976	488.0	
92998	chr21	44869669	44875819	6150	3075.0	
92999	chr21	44877975	44879160	1185	592.0	
93000	chr21	44880505	44884812	4307	2154.0	
93001	chr21	44885634	44891084	5450	2725.0	
93002	chr21	44892672	44893859	1187	594.0	
93003	chr21	44896719	44898297	1578	789.0	
93004	chr21	44902935	44903412	477	238.0	
93005	chr21	44905746	44906179	433	216.0	
93006	chr21	44907599	44908578	979	490.0	
93007	chr21	44910881	44912722	1841	920.0	
93008	chr21	44913544	44915716	2172	1086.0	
93009	chr21	44916634	44917385	751	376.0	
93010	chr21	44918159	44921693	3534	1767.0	
93011	chr21	44922365	44922371	6	3.0	
93012	chr21	44923274	44923923	649	324.0	
93013	chr21	44924599	44933553	8954	4477.0	
93014	chr21	44939275	44940802	1527	764.0	
93015	chr21	44949506	44950350	844	422.0	
93016	chr21	44965268	44965845	577	288.0	
93017	chr21	44966656	44968933	2277	1138.0	"enhancer	sequence_feature"
93018	chr21	44969701	44970340	639	320.0	
93019	chr21	45018776	45018871	95	48.0	
93020	chr21	45041149	45041857	708	354.0	
93021	chr21	45073648	45075762	2114	1057.0	
93022	chr21	45076344	45076790	446	223.0	
93023	chr21	45078279	45080083	1804	902.0	
93024	chr21	45080986	45081425	439	220.0	
93025	chr21	45086961	45087661	700	350.0	
93026	chr21	45093255	45093589	334	167.0	
93027	chr21	45104017	45104956	939	470.0	
93028	chr21	45109304	45110426	1122	561.0	
93029	chr21	45110934	45111326	392	196.0	
93030	chr21	45128533	45129093	560	280.0	
93031	chr21	45130265	45130854	589	294.0	
93032	chr21	45137043	45137670	627	314.0	
93033	chr21	45138511	45139032	521	260.0	
93034	chr21	45140224	45140831	607	304.0	
93035	chr21	45152119	45152939	820	410.0	
93036	chr21	45154698	45155269	571	286.0	
93037	chr21	45169070	45169286	216	108.0	
93038	chr21	45208545	45208818	273	136.0	
93039	chr21	45209820	45210439	619	310.0	
93040	chr21	45223363	45225254	1891	946.0	
93041	chr21	45226432	45228906	2474	1237.0	
93042	chr21	45236464	45236860	396	198.0	
93043	chr21	45256834	45257188	354	177.0	
93044	chr21	45266080	45267216	1136	568.0	
93045	chr21	45286648	45288837	2189	1094.0	
93046	chr21	45289820	45289870	50	25.0	
93047	chr21	45292027	45293345	1318	659.0	
93048	chr21	45301837	45302905	1068	534.0	
93049	chr21	45304970	45305427	457	228.0	
93050	chr21	45308642	45309463	821	410.0	
93051	chr21	45322226	45323140	914	457.0	
93052	chr21	45363918	45364479	561	280.0	
93053	chr21	45369786	45370319	533	266.0	
93054	chr21	45404274	45406088	1814	907.0	
93055	chr21	45436274	45436675	401	200.0	
93056	chr21	45438957	45440021	1064	532.0	
93057	chr21	45470831	45471320	489	244.0	
93058	chr21	45477672	45480047	2375	1188.0	
93059	chr21	45482356	45483936	1580	790.0	
93060	chr21	45517688	45518112	424	212.0	
93061	chr21	45532695	45533376	681	340.0	
93062	chr21	45535185	45536192	1007	504.0	
93063	chr21	45541101	45543959	2858	1429.0	
93064	chr21	45549834	45552104	2270	1135.0	
93065	chr21	45552720	45552994	274	137.0	
93066	chr21	45554379	45557892	3513	1756.0	
93067	chr21	45589891	45593073	3182	1591.0	
93068	chr21	45596489	45597322	833	416.0	
93069	chr21	45607048	45607639	591	296.0	
93070	chr21	45608828	45609042	214	107.0	
93071	chr21	45614838	45616388	1550	775.0	
93072	chr21	45617424	45617839	415	208.0	
93073	chr21	45618525	45619475	950	475.0	
93074	chr21	45640124	45641485	1361	680.0	
93075	chr21	45642309	45644554	2245	1122.0	
93076	chr21	45645762	45646281	519	260.0	
93077	chr21	45709164	45709549	385	192.0	
93078	chr21	45739844	45740025	181	90.0	
93079	chr21	45818427	45819261	834	417.0	
93080	chr21	45820469	45821056	587	294.0	
93081	chr21	45827447	45827644	197	98.0	
93082	chr21	45880382	45880824	442	221.0	
93083	chr21	45885819	45887050	1231	616.0	
93084	chr21	45892046	45892620	574	287.0	
93085	chr21	45923147	45923579	432	216.0	
93086	chr21	45970550	45971251	701	350.0	
93087	chr21	45972907	45975977	3070	1535.0	
93088	chr21	45980990	45982768	1778	889.0	
93089	chr21	46031550	46031887	337	168.0	
93090	chr21	46052594	46053776	1182	591.0	
93091	chr21	46057145	46057611	466	233.0	
93092	chr21	46093866	46094401	535	268.0	
93093	chr21	46097443	46099597	2154	1077.0	
93094	chr21	46100921	46101250	329	164.0	
93095	chr21	46142558	46144588	2030	1015.0	
93096	chr21	46147391	46147765	374	187.0	
93097	chr21	46153198	46153664	466	233.0	
93098	chr21	46161489	46161495	6	3.0	
93099	chr21	46170724	46171353	629	314.0	
93100	chr21	46183839	46185535	1696	848.0	
93101	chr21	46225148	46225530	382	191.0	
93102	chr21	46227163	46230039	2876	1438.0	
93103	chr21	46253588	46254285	697	348.0	
93104	chr21	46284296	46284333	37	18.0	
93105	chr21	46285390	46287234	1844	922.0	
93106	chr21	46294804	46298318	3514	1757.0	
93107	chr21	46320495	46320827	332	166.0	
93108	chr21	46321641	46321643	2	1.0	
93109	chr21	46322422	46325672	3250	1625.0	
93110	chr21	46355244	46355550	306	153.0	
93111	chr21	46368401	46369342	941	470.0	
93112	chr21	46394006	46394349	343	172.0	
93113	chr21	46423757	46426328	2571	1286.0	
93114	chr21	46431948	46432562	614	307.0	
93115	chr21	46457601	46460250	2649	1324.0	
93116	chr21	46462076	46462088	12	6.0	
93117	chr21	46472284	46472774	490	245.0	
93118	chr21	46483293	46483718	425	212.0	
93119	chr21	46500396	46500857	461	230.0	
93120	chr21	46515023	46515640	617	308.0	
93121	chr21	46532158	46532322	164	82.0	
93122	chr21	46550186	46552879	2693	1346.0	
93123	chr21	46559115	46560284	1169	584.0	
93124	chr21	46561136	46561623	487	244.0	
93125	chr21	46605119	46606675	1556	778.0	
93126	chr21	46621582	46623127	1545	772.0	
93127	chr21	46626394	46627697	1303	652.0	
93128	chr21	46633215	46637351	4136	2068.0	
93129	chr21	46637886	46638781	895	448.0	
93130	chr21	46639749	46640156	407	204.0	
93131	chr21	46661174	46661833	659	330.0	
93132	chr21	46667184	46668089	905	452.0	
93133	chr22	16380996	16381172	176	88.0	
93134	chr22	16600942	16602437	1495	748.0	
93135	chr22	16721638	16723021	1383	692.0	
93136	chr22	16819262	16819597	335	168.0	
93137	chr22	16825056	16825734	678	339.0	
93138	chr22	16854637	16855028	391	196.0	
93139	chr22	16917401	16917824	423	212.0	
93140	chr22	17036261	17036514	253	126.0	
93141	chr22	17046508	17046902	394	197.0	
93142	chr22	17047724	17048036	312	156.0	
93143	chr22	17058141	17058613	472	236.0	
93144	chr22	17074885	17075847	962	481.0	
93145	chr22	17084160	17088410	4250	2125.0	
93146	chr22	17095886	17095909	23	12.0	
93147	chr22	17097071	17097509	438	219.0	
93148	chr22	17098163	17099187	1024	512.0	
93149	chr22	17100560	17101003	443	222.0	
93150	chr22	17102339	17102630	291	146.0	
93151	chr22	17106345	17107642	1297	648.0	
93152	chr22	17115750	17118520	2770	1385.0	
93153	chr22	17119499	17121891	2392	1196.0	
93154	chr22	17154992	17155480	488	244.0	
93155	chr22	17158080	17160097	2017	1008.0	
93156	chr22	17171026	17172465	1439	720.0	
93157	chr22	17213970	17214827	857	428.0	
93158	chr22	17216681	17217932	1251	626.0	
93159	chr22	17218687	17219997	1310	655.0	enhancer
93160	chr22	17220916	17221545	629	314.0	
93161	chr22	17228493	17229190	697	348.0	
93162	chr22	17236792	17237749	957	478.0	
93163	chr22	17241566	17242692	1126	563.0	
93164	chr22	17243348	17244262	914	457.0	
93165	chr22	17250705	17251106	401	200.0	
93166	chr22	17257785	17258730	945	472.0	
93167	chr22	17268432	17268793	361	180.0	
93168	chr22	17272968	17272977	9	4.0	
93169	chr22	17280169	17280719	550	275.0	
93170	chr22	17281304	17281856	552	276.0	
93171	chr22	17303727	17304532	805	402.0	
93172	chr22	17366957	17367253	296	148.0	
93173	chr22	17368573	17369274	701	350.0	
93174	chr22	17436504	17436825	321	160.0	
93175	chr22	17477081	17478000	919	460.0	
93176	chr22	17483884	17484357	473	236.0	
93177	chr22	17496722	17497252	530	265.0	
93178	chr22	17498227	17498723	496	248.0	
93179	chr22	17501614	17502105	491	246.0	
93180	chr22	17594530	17595374	844	422.0	
93181	chr22	17627904	17630135	2231	1116.0	
93182	chr22	17637556	17640258	2702	1351.0	
93183	chr22	17641266	17641615	349	174.0	
93184	chr22	17647901	17649002	1101	550.0	
93185	chr22	17655306	17655733	427	214.0	
93186	chr22	17665962	17665964	2	1.0	
93187	chr22	17673012	17673616	604	302.0	
93188	chr22	17675624	17675922	298	149.0	
93189	chr22	17684222	17684676	454	227.0	
93190	chr22	17685709	17685768	59	30.0	
93191	chr22	17688615	17689016	401	200.0	
93192	chr22	17699876	17700413	537	268.0	
93193	chr22	17706188	17707027	839	420.0	
93194	chr22	17726832	17727319	487	244.0	
93195	chr22	17734243	17734609	366	183.0	
93196	chr22	17742261	17742996	735	368.0	
93197	chr22	17748570	17748945	375	188.0	
93198	chr22	17754248	17754704	456	228.0	
93199	chr22	17759910	17761000	1090	545.0	
93200	chr22	17767398	17768550	1152	576.0	
93201	chr22	17769109	17770142	1033	516.0	
93202	chr22	17771290	17782359	11069	5534.0	enhancer
93203	chr22	17784975	17785840	865	432.0	
93204	chr22	17788054	17788087	33	16.0	
93205	chr22	17795595	17796308	713	356.0	
93206	chr22	17798055	17798727	672	336.0	
93207	chr22	17799936	17801272	1336	668.0	
93208	chr22	17829729	17830785	1056	528.0	
93209	chr22	17842065	17842886	821	410.0	
93210	chr22	17964644	17964972	328	164.0	
93211	chr22	17980495	17981098	603	302.0	
93212	chr22	17994661	17995146	485	242.0	
93213	chr22	17996230	17997406	1176	588.0	
93214	chr22	17999913	18002274	2361	1180.0	
93215	chr22	18005185	18005599	414	207.0	
93216	chr22	18023544	18025066	1522	761.0	
93217	chr22	18056871	18057964	1093	546.0	
93218	chr22	18066161	18066721	560	280.0	
93219	chr22	18075774	18078908	3134	1567.0	
93220	chr22	18091485	18092628	1143	572.0	
93221	chr22	18110228	18111017	789	394.0	
93222	chr22	18149462	18150552	1090	545.0	
93223	chr22	18152579	18152898	319	160.0	
93224	chr22	18156170	18156423	253	126.0	
93225	chr22	18157112	18157508	396	198.0	
93226	chr22	18730469	18730744	275	138.0	
93227	chr22	18890671	18891275	604	302.0	
93228	chr22	18892280	18893097	817	408.0	
93229	chr22	18895995	18896712	717	358.0	
93230	chr22	18902180	18902661	481	240.0	
93231	chr22	18905045	18907409	2364	1182.0	
93232	chr22	18908038	18908847	809	404.0	
93233	chr22	18928061	18928065	4	2.0	
93234	chr22	18936068	18936505	437	218.0	"region	repeat_region"
93235	chr22	18954358	18954840	482	241.0	
93236	chr22	19022870	19023163	293	146.0	
93237	chr22	19029377	19029523	146	73.0	
93238	chr22	19033045	19033471	426	213.0	
93239	chr22	19035565	19036159	594	297.0	
93240	chr22	19085145	19086767	1622	811.0	
93241	chr22	19106187	19106747	560	280.0	
93242	chr22	19108787	19110559	1772	886.0	
93243	chr22	19111329	19111544	215	108.0	
93244	chr22	19118275	19118748	473	236.0	
93245	chr22	19121045	19123371	2326	1163.0	
93246	chr22	19143842	19145338	1496	748.0	
93247	chr22	19149046	19150299	1253	626.0	
93248	chr22	19159723	19160098	375	188.0	
93249	chr22	19169157	19172600	3443	1722.0	
93250	chr22	19173962	19174667	705	352.0	
93251	chr22	19175598	19180197	4599	2300.0	
93252	chr22	19191458	19191851	393	196.0	
93253	chr22	19217913	19218319	406	203.0	
93254	chr22	19241211	19241743	532	266.0	
93255	chr22	19259559	19260015	456	228.0	
93256	chr22	19289765	19292818	3053	1526.0	
93257	chr22	19361595	19362179	584	292.0	
93258	chr22	19390459	19390773	314	157.0	
93259	chr22	19418999	19420604	1605	802.0	
93260	chr22	19421165	19421430	265	132.0	
93261	chr22	19422387	19422794	407	204.0	
93262	chr22	19424099	19424518	419	210.0	
93263	chr22	19426320	19426487	167	84.0	
93264	chr22	19428504	19428671	167	84.0	
93265	chr22	19429794	19433574	3780	1890.0	
93266	chr22	19446531	19448611	2080	1040.0	
93267	chr22	19477506	19480510	3004	1502.0	
93268	chr22	19523911	19523914	3	2.0	
93269	chr22	19576532	19577487	955	478.0	
93270	chr22	19579966	19580166	200	100.0	
93271	chr22	19596942	19598682	1740	870.0	
93272	chr22	19607220	19607864	644	322.0	
93273	chr22	19621876	19622560	684	342.0	
93274	chr22	19629688	19630398	710	355.0	
93275	chr22	19632185	19632531	346	173.0	
93276	chr22	19643833	19644637	804	402.0	
93277	chr22	19679548	19679999	451	226.0	
93278	chr22	19687757	19688476	719	360.0	
93279	chr22	19714187	19715015	828	414.0	
93280	chr22	19717488	19719465	1977	988.0	
93281	chr22	19720000	19720004	4	2.0	
93282	chr22	19723211	19724474	1263	632.0	
93283	chr22	19730375	19731410	1035	518.0	
93284	chr22	19756288	19757815	1527	764.0	
93285	chr22	19765517	19767632	2115	1058.0	
93286	chr22	19772969	19773252	283	142.0	
93287	chr22	19780398	19780735	337	168.0	
93288	chr22	19844097	19845190	1093	546.0	
93289	chr22	19853558	19856482	2924	1462.0	
93290	chr22	19874201	19874850	649	324.0	
93291	chr22	19886529	19887565	1036	518.0	
93292	chr22	19890021	19890349	328	164.0	
93293	chr22	19891047	19892820	1773	886.0	
93294	chr22	19896593	19897027	434	217.0	
93295	chr22	19909562	19910386	824	412.0	
93296	chr22	19932290	19932986	696	348.0	
93297	chr22	19937694	19938508	814	407.0	
93298	chr22	19940819	19943476	2657	1328.0	
93299	chr22	19947324	19948191	867	434.0	
93300	chr22	19953624	19954067	443	222.0	
93301	chr22	19955437	19956145	708	354.0	
93302	chr22	19962210	19962725	515	258.0	
93303	chr22	19965970	19966227	257	128.0	
93304	chr22	19970093	19972150	2057	1028.0	
93305	chr22	19974375	19975571	1196	598.0	
93306	chr22	19986204	19987713	1509	754.0	
93307	chr22	20013169	20013849	680	340.0	
93308	chr22	20015891	20017638	1747	874.0	
93309	chr22	20020261	20022236	1975	988.0	
93310	chr22	20022809	20023585	776	388.0	
93311	chr22	20028192	20028340	148	74.0	
93312	chr22	20031864	20032613	749	374.0	
93313	chr22	20079406	20081417	2011	1006.0	
93314	chr22	20084908	20085266	358	179.0	
93315	chr22	20087605	20088052	447	224.0	
93316	chr22	20091411	20092260	849	424.0	
93317	chr22	20100251	20101747	1496	748.0	
93318	chr22	20110112	20110257	145	72.0	
93319	chr22	20111018	20112201	1183	592.0	
93320	chr22	20116027	20118428	2401	1200.0	
93321	chr22	20122552	20124018	1466	733.0	
93322	chr22	20128844	20132836	3992	1996.0	
93323	chr22	20133928	20134088	160	80.0	
93324	chr22	20155283	20155699	416	208.0	
93325	chr22	20156744	20157737	993	496.0	"insulator	region"
93326	chr22	20205915	20207195	1280	640.0	
93327	chr22	20213113	20213511	398	199.0	
93328	chr22	20237776	20239710	1934	967.0	
93329	chr22	20242192	20245762	3570	1785.0	
93330	chr22	20247104	20247474	370	185.0	
93331	chr22	20266970	20268785	1815	908.0	
93332	chr22	20285500	20286301	801	400.0	
93333	chr22	20295699	20295749	50	25.0	
93334	chr22	20297209	20300257	3048	1524.0	
93335	chr22	20305951	20306264	313	156.0	
93336	chr22	20317563	20318350	787	394.0	
93337	chr22	20319163	20321102	1939	970.0	
93338	chr22	20322610	20323295	685	342.0	
93339	chr22	20324083	20324512	429	214.0	
93340	chr22	20327905	20328884	979	490.0	
93341	chr22	18528415	18529431	1016	508.0	
93342	chr22	20393438	20394807	1369	684.0	
93343	chr22	20417861	20418894	1033	516.0	
93344	chr22	20425054	20426144	1090	545.0	
93345	chr22	20428757	20431838	3081	1540.0	
93346	chr22	20436096	20439288	3192	1596.0	
93347	chr22	20454292	20454623	331	166.0	
93348	chr22	20456027	20456870	843	422.0	
93349	chr22	20463104	20464969	1865	932.0	
93350	chr22	20494319	20497137	2818	1409.0	
93351	chr22	20497675	20497753	78	39.0	
93352	chr22	20506987	20510134	3147	1574.0	
93353	chr22	20523569	20524600	1031	516.0	
93354	chr22	20543926	20544397	471	236.0	
93355	chr22	20549019	20552455	3436	1718.0	
93356	chr22	20555471	20555698	227	114.0	
93357	chr22	20556209	20558374	2165	1082.0	
93358	chr22	20563373	20567817	4444	2222.0	
93359	chr22	20568602	20570197	1595	798.0	
93360	chr22	20570997	20571935	938	469.0	
93361	chr22	20576458	20576838	380	190.0	
93362	chr22	20577480	20577944	464	232.0	
93363	chr22	20580299	20580420	121	60.0	
93364	chr22	20588251	20591017	2766	1383.0	
93365	chr22	20605998	20606856	858	429.0	
93366	chr22	20695327	20695582	255	128.0	
93367	chr22	20697223	20698006	783	392.0	
93368	chr22	20701845	20704626	2781	1390.0	
93369	chr22	20738616	20739082	466	233.0	
93370	chr22	20741815	20742224	409	204.0	
93371	chr22	20748675	20749140	465	232.0	
93372	chr22	20750473	20750973	500	250.0	
93373	chr22	20784064	20784692	628	314.0	
93374	chr22	20810593	20811046	453	226.0	
93375	chr22	20836339	20836641	302	151.0	
93376	chr22	20857304	20859804	2500	1250.0	
93377	chr22	20867037	20868012	975	488.0	
93378	chr22	20885378	20886171	793	396.0	
93379	chr22	20904377	20905103	726	363.0	
93380	chr22	20916567	20919185	2618	1309.0	
93381	chr22	20920279	20921025	746	373.0	
93382	chr22	20926169	20926283	114	57.0	
93383	chr22	20956581	20958402	1821	910.0	
93384	chr22	20961528	20962543	1015	508.0	
93385	chr22	20964650	20966247	1597	798.0	
93386	chr22	20968273	20968791	518	259.0	
93387	chr22	20972100	20972846	746	373.0	
93388	chr22	20979114	20980083	969	484.0	
93389	chr22	20981319	20983182	1863	932.0	
93390	chr22	20996985	20997176	191	96.0	
93391	chr22	20998424	20998806	382	191.0	
93392	chr22	21000432	21003326	2894	1447.0	
93393	chr22	21003889	21004139	250	125.0	
93394	chr22	21009597	21010024	427	214.0	
93395	chr22	21011860	21015307	3447	1724.0	
93396	chr22	21021037	21021151	114	57.0	
93397	chr22	21025224	21025620	396	198.0	
93398	chr22	21032378	21032718	340	170.0	
93399	chr22	21044968	21046229	1261	630.0	
93400	chr22	21055841	21056223	382	191.0	
93401	chr22	21074057	21074587	530	265.0	
93402	chr22	21102688	21103243	555	278.0	
93403	chr22	21417061	21418162	1101	550.0	
93404	chr22	21448060	21448344	284	142.0	
93405	chr22	21467848	21468870	1022	511.0	
93406	chr22	21566752	21569002	2250	1125.0	
93407	chr22	21569826	21570261	435	218.0	
93408	chr22	21571006	21571499	493	246.0	
93409	chr22	21587676	21588386	710	355.0	
93410	chr22	21621834	21622548	714	357.0	
93411	chr22	21624061	21625341	1280	640.0	
93412	chr22	21628771	21630665	1894	947.0	
93413	chr22	21632327	21633126	799	400.0	
93414	chr22	21641314	21644241	2927	1464.0	
93415	chr22	21646417	21647345	928	464.0	
93416	chr22	21651219	21652784	1565	782.0	
93417	chr22	21656769	21658573	1804	902.0	
93418	chr22	21665405	21666964	1559	780.0	
93419	chr22	21681212	21681505	293	146.0	
93420	chr22	21689421	21690794	1373	686.0	
93421	chr22	21695422	21695701	279	140.0	
93422	chr22	21712888	21713782	894	447.0	
93423	chr22	21726536	21727122	586	293.0	
93424	chr22	21734523	21736696	2173	1086.0	
93425	chr22	21738050	21738449	399	200.0	
93426	chr22	21754439	21754938	499	250.0	
93427	chr22	21762753	21764906	2153	1076.0	
93428	chr22	21766292	21767826	1534	767.0	
93429	chr22	21772751	21773407	656	328.0	
93430	chr22	21780248	21780712	464	232.0	
93431	chr22	21810458	21811131	673	336.0	
93432	chr22	21816353	21817751	1398	699.0	
93433	chr22	21818343	21819294	951	476.0	
93434	chr22	21824490	21824589	99	50.0	
93435	chr22	21832367	21833032	665	332.0	
93436	chr22	21834850	21835305	455	228.0	
93437	chr22	21855722	21856231	509	254.0	
93438	chr22	21857309	21858775	1466	733.0	
93439	chr22	21859976	21860343	367	184.0	
93440	chr22	21861563	21863199	1636	818.0	
93441	chr22	21865148	21865528	380	190.0	
93442	chr22	21866071	21868605	2534	1267.0	
93443	chr22	21876436	21877015	579	290.0	
93444	chr22	21936156	21940999	4843	2422.0	
93445	chr22	21942201	21943078	877	438.0	
93446	chr22	21950335	21950929	594	297.0	
93447	chr22	21951882	21953418	1536	768.0	
93448	chr22	21972233	21972715	482	241.0	
93449	chr22	21982141	21983136	995	498.0	
93450	chr22	22026511	22026628	117	58.0	
93451	chr22	22030545	22031481	936	468.0	
93452	chr22	22037272	22037564	292	146.0	
93453	chr22	22058689	22058709	20	10.0	
93454	chr22	22060521	22062088	1567	784.0	
93455	chr22	22062999	22063716	717	358.0	
93456	chr22	22085666	22086694	1028	514.0	
93457	chr22	22098629	22099494	865	432.0	
93458	chr22	22103505	22103609	104	52.0	
93459	chr22	22110800	22111720	920	460.0	
93460	chr22	22117812	22118295	483	242.0	
93461	chr22	22156661	22157389	728	364.0	
93462	chr22	22159449	22159751	302	151.0	
93463	chr22	22161858	22162317	459	230.0	
93464	chr22	22167660	22168875	1215	608.0	
93465	chr22	22195268	22196508	1240	620.0	
93466	chr22	22201038	22201602	564	282.0	
93467	chr22	22207752	22208433	681	340.0	
93468	chr22	22210408	22210784	376	188.0	
93469	chr22	22235585	22235986	401	200.0	
93470	chr22	22297151	22298857	1706	853.0	
93471	chr22	22321929	22322496	567	284.0	
93472	chr22	22342813	22344015	1202	601.0	
93473	chr22	22357161	22357856	695	348.0	
93474	chr22	22362968	22363230	262	131.0	
93475	chr22	22369233	22369662	429	214.0	
93476	chr22	22380395	22380893	498	249.0	
93477	chr22	22381432	22381548	116	58.0	
93478	chr22	22395274	22395694	420	210.0	
93479	chr22	22404625	22404937	312	156.0	
93480	chr22	22409580	22410587	1007	504.0	
93481	chr22	22422613	22423238	625	312.0	
93482	chr22	22431455	22431939	484	242.0	
93483	chr22	22450222	22450958	736	368.0	
93484	chr22	22464014	22464425	411	206.0	
93485	chr22	22508160	22509319	1159	580.0	
93486	chr22	22546505	22546667	162	81.0	
93487	chr22	22559024	22559564	540	270.0	insulator
93488	chr22	22576327	22576728	401	200.0	
93489	chr22	22586966	22587301	335	168.0	
93490	chr22	22593985	22594418	433	216.0	
93491	chr22	22666554	22666917	363	182.0	
93492	chr22	22685031	22685386	355	178.0	
93493	chr22	22686494	22686827	333	166.0	
93494	chr22	22687656	22687997	341	170.0	
93495	chr22	22692741	22693164	423	212.0	
93496	chr22	22698305	22698623	318	159.0	
93497	chr22	22710665	22711163	498	249.0	
93498	chr22	22713020	22713435	415	208.0	
93499	chr22	22714680	22715735	1055	528.0	
93500	chr22	22720035	22722362	2327	1164.0	
93501	chr22	22735276	22735677	401	200.0	
93502	chr22	22737660	22737948	288	144.0	
93503	chr22	22745610	22746242	632	316.0	
93504	chr22	22747083	22747537	454	227.0	
93505	chr22	22748227	22748743	516	258.0	
93506	chr22	22752447	22754150	1703	852.0	
93507	chr22	22756375	22757181	806	403.0	
93508	chr22	22758225	22759965	1740	870.0	
93509	chr22	22770127	22770644	517	258.0	
93510	chr22	22772533	22772803	270	135.0	
93511	chr22	22774067	22775042	975	488.0	
93512	chr22	22787698	22788811	1113	556.0	
93513	chr22	22790427	22790660	233	116.0	
93514	chr22	22802297	22802822	525	262.0	
93515	chr22	22809910	22810704	794	397.0	
93516	chr22	22812144	22812465	321	160.0	
93517	chr22	22815532	22816241	709	354.0	
93518	chr22	22818635	22819479	844	422.0	
93519	chr22	22820536	22821184	648	324.0	
93520	chr22	22822400	22823582	1182	591.0	
93521	chr22	22836560	22836987	427	214.0	
93522	chr22	22837998	22838598	600	300.0	
93523	chr22	22840988	22841027	39	20.0	
93524	chr22	22848280	22848978	698	349.0	
93525	chr22	22855625	22856088	463	232.0	
93526	chr22	22865345	22866320	975	488.0	
93527	chr22	22871028	22871394	366	183.0	
93528	chr22	22877382	22878019	637	318.0	
93529	chr22	22881202	22882880	1678	839.0	
93530	chr22	22883790	22885520	1730	865.0	
93531	chr22	22903414	22903928	514	257.0	
93532	chr22	22914050	22914231	181	90.0	
93533	chr22	22928292	22930613	2321	1160.0	
93534	chr22	22934795	22936175	1380	690.0	
93535	chr22	22942221	22943315	1094	547.0	
93536	chr22	22946907	22947556	649	324.0	
93537	chr22	22952875	22953177	302	151.0	
93538	chr22	22954657	22955110	453	226.0	
93539	chr22	22955740	22956355	615	308.0	
93540	chr22	22959121	22959635	514	257.0	
93541	chr22	22982089	22982560	471	236.0	
93542	chr22	23035971	23036256	285	142.0	
93543	chr22	23069145	23071431	2286	1143.0	
93544	chr22	23086905	23086946	41	20.0	
93545	chr22	23119264	23120205	941	470.0	
93546	chr22	23121509	23121702	193	96.0	
93547	chr22	23128216	23128879	663	332.0	
93548	chr22	23136841	23139197	2356	1178.0	
93549	chr22	23141236	23142827	1591	796.0	
93550	chr22	23144581	23146801	2220	1110.0	
93551	chr22	23150748	23151013	265	132.0	
93552	chr22	23152686	23154018	1332	666.0	
93553	chr22	23157113	23157216	103	52.0	
93554	chr22	23159165	23159675	510	255.0	
93555	chr22	23173636	23174383	747	374.0	
93556	chr22	23176180	23177292	1112	556.0	
93557	chr22	23178200	23186440	8240	4120.0	insulator
93558	chr22	23215687	23217364	1677	838.0	
93559	chr22	23218507	23221131	2624	1312.0	recombination_feature
93560	chr22	23222224	23223437	1213	606.0	recombination_feature
93561	chr22	23225630	23226717	1087	544.0	recombination_feature
93562	chr22	23237749	23238197	448	224.0	recombination_feature
93563	chr22	23240768	23241619	851	426.0	"recombination_feature	recombination_feature	recombination_feature"
93564	chr22	23242542	23243789	1247	624.0	"recombination_feature	recombination_feature	recombination_feature"
93565	chr22	23245234	23246166	932	466.0	recombination_feature
93566	chr22	23249745	23250469	724	362.0	recombination_feature
93567	chr22	23263528	23264864	1336	668.0	
93568	chr22	23268977	23270171	1194	597.0	
93569	chr22	23276734	23277657	923	462.0	recombination_feature
93570	chr22	23278634	23280188	1554	777.0	recombination_feature
93571	chr22	23280908	23282411	1503	752.0	recombination_feature
93572	chr22	23289830	23290923	1093	546.0	"recombination_feature	recombination_feature	recombination_feature	recombination_feature"
93573	chr22	23314380	23314381	1	0.0	
93574	chr22	23315191	23316059	868	434.0	
93575	chr22	23376316	23376629	313	156.0	
93576	chr22	23385808	23386487	679	340.0	
93577	chr22	23402319	23403120	801	400.0	
93578	chr22	23417454	23417688	234	117.0	
93579	chr22	23433168	23433754	586	293.0	
93580	chr22	23521337	23523006	1669	834.0	
93581	chr22	23528326	23528761	435	218.0	
93582	chr22	23539332	23540050	718	359.0	
93583	chr22	23541792	23542152	360	180.0	
93584	chr22	23565611	23565969	358	179.0	
93585	chr22	23591090	23591886	796	398.0	
93586	chr22	23627384	23627887	503	252.0	
93587	chr22	23675914	23676515	601	300.0	
93588	chr22	23695436	23697609	2173	1086.0	
93589	chr22	23698312	23698408	96	48.0	
93590	chr22	23715356	23717962	2606	1303.0	
93591	chr22	23736395	23736399	4	2.0	
93592	chr22	23750452	23753432	2980	1490.0	
93593	chr22	23762739	23764213	1474	737.0	
93594	chr22	23766545	23768870	2325	1162.0	
93595	chr22	23770795	23771748	953	476.0	
93596	chr22	23772371	23773633	1262	631.0	
93597	chr22	23786283	23788052	1769	884.0	
93598	chr22	23798949	23799292	343	172.0	
93599	chr22	23800335	23801355	1020	510.0	
93600	chr22	23836475	23836714	239	120.0	
93601	chr22	23837348	23840021	2673	1336.0	
93602	chr22	23844371	23844828	457	228.0	
93603	chr22	23849104	23850162	1058	529.0	
93604	chr22	23856667	23858657	1990	995.0	
93605	chr22	23862059	23862526	467	234.0	
93606	chr22	23893496	23896081	2585	1292.0	
93607	chr22	23913262	23914628	1366	683.0	
93608	chr22	23956295	23956994	699	350.0	
93609	chr22	23984339	23984986	647	324.0	
93610	chr22	23996406	23996494	88	44.0	
93611	chr22	24010699	24012688	1989	994.0	
93612	chr22	24038071	24038570	499	250.0	
93613	chr22	24053832	24054166	334	167.0	
93614	chr22	24064060	24064112	52	26.0	
93615	chr22	24106963	24107446	483	242.0	
93616	chr22	24133143	24134708	1565	782.0	
93617	chr22	24140151	24142090	1939	970.0	
93618	chr22	24145744	24146789	1045	522.0	
93619	chr22	24147787	24148055	268	134.0	
93620	chr22	24153139	24158648	5509	2754.0	
93621	chr22	24174989	24175719	730	365.0	
93622	chr22	24189575	24190102	527	264.0	
93623	chr22	24197889	24198627	738	369.0	
93624	chr22	24205589	24205960	371	186.0	
93625	chr22	24207760	24208509	749	374.0	
93626	chr22	24231195	24231672	477	238.0	
93627	chr22	24242512	24243250	738	369.0	
93628	chr22	24247361	24247980	619	310.0	
93629	chr22	24259266	24259915	649	324.0	
93630	chr22	24270259	24271837	1578	789.0	
93631	chr22	24285168	24285623	455	228.0	
93632	chr22	24325017	24325469	452	226.0	
93633	chr22	24331712	24332189	477	238.0	
93634	chr22	24355530	24355993	463	232.0	
93635	chr22	24400617	24403274	2657	1328.0	
93636	chr22	24409770	24410435	665	332.0	
93637	chr22	24419951	24419958	7	4.0	
93638	chr22	24421261	24421819	558	279.0	
93639	chr22	24423379	24424881	1502	751.0	
93640	chr22	24425767	24430197	4430	2215.0	
93641	chr22	24432230	24432610	380	190.0	
93642	chr22	24433680	24435589	1909	954.0	
93643	chr22	24437567	24438308	741	370.0	
93644	chr22	24440176	24440976	800	400.0	
93645	chr22	24449504	24449571	67	34.0	
93646	chr22	24460906	24460944	38	19.0	
93647	chr22	24463162	24463898	736	368.0	
93648	chr22	24466913	24467334	421	210.0	
93649	chr22	24473242	24473986	744	372.0	
93650	chr22	24482437	24483028	591	296.0	
93651	chr22	24485660	24486872	1212	606.0	
93652	chr22	24497598	24498142	544	272.0	
93653	chr22	24502599	24504983	2384	1192.0	
93654	chr22	24506817	24507481	664	332.0	
93655	chr22	24510970	24512511	1541	770.0	
93656	chr22	24516176	24516955	779	390.0	
93657	chr22	24521708	24522180	472	236.0	
93658	chr22	24525168	24526047	879	440.0	
93659	chr22	24541585	24542951	1366	683.0	
93660	chr22	24550059	24550812	753	376.0	
93661	chr22	24552875	24556645	3770	1885.0	
93662	chr22	24592495	24593495	1000	500.0	
93663	chr22	24601235	24601701	466	233.0	
93664	chr22	24603905	24604594	689	344.0	
93665	chr22	24607225	24608203	978	489.0	
93666	chr22	24635096	24635457	361	180.0	
93667	chr22	24751592	24751835	243	122.0	
93668	chr22	24768809	24769100	291	146.0	
93669	chr22	24802983	24803455	472	236.0	
93670	chr22	24805727	24807872	2145	1072.0	
93671	chr22	24844951	24845561	610	305.0	
93672	chr22	24850261	24850667	406	203.0	
93673	chr22	24938733	24939195	462	231.0	
93674	chr22	24951827	24953946	2119	1060.0	
93675	chr22	24994142	24994313	171	86.0	
93676	chr22	25060384	25061169	785	392.0	
93677	chr22	25061923	25063247	1324	662.0	
93678	chr22	25067423	25071206	3783	1892.0	
93679	chr22	25076096	25076862	766	383.0	
93680	chr22	25081371	25081841	470	235.0	
93681	chr22	25110695	25111857	1162	581.0	
93682	chr22	25172222	25172525	303	152.0	
93683	chr22	25202373	25202645	272	136.0	
93684	chr22	25235827	25236283	456	228.0	
93685	chr22	25362087	25362570	483	242.0	
93686	chr22	25388783	25389310	527	264.0	
93687	chr22	25403639	25406948	3309	1654.0	
93688	chr22	25418521	25420329	1808	904.0	
93689	chr22	25420863	25421933	1070	535.0	
93690	chr22	25427991	25428617	626	313.0	
93691	chr22	25447538	25449024	1486	743.0	
93692	chr22	25462417	25463017	600	300.0	
93693	chr22	25494745	25495059	314	157.0	
93694	chr22	25543879	25544585	706	353.0	
93695	chr22	25546405	25547227	822	411.0	
93696	chr22	25561903	25562408	505	252.0	
93697	chr22	25562964	25567534	4570	2285.0	
93698	chr22	25570065	25570712	647	324.0	
93699	chr22	25572802	25573342	540	270.0	
93700	chr22	25584975	25585476	501	250.0	
93701	chr22	25627492	25627954	462	231.0	
93702	chr22	25650850	25651194	344	172.0	
93703	chr22	25656798	25657234	436	218.0	
93704	chr22	25686263	25686298	35	18.0	
93705	chr22	25729693	25730060	367	184.0	
93706	chr22	25759816	25760223	407	204.0	
93707	chr22	25772906	25773350	444	222.0	
93708	chr22	26095140	26095679	539	270.0	
93709	chr22	26168336	26168704	368	184.0	
93710	chr22	26169348	26169783	435	218.0	
93711	chr22	26294518	26294974	456	228.0	
93712	chr22	26330963	26331381	418	209.0	
93713	chr22	26356681	26357128	447	224.0	
93714	chr22	26360196	26361030	834	417.0	
93715	chr22	26364370	26364890	520	260.0	
93716	chr22	26367596	26368090	494	247.0	
93717	chr22	26398597	26399091	494	247.0	
93718	chr22	26404850	26405348	498	249.0	
93719	chr22	26428023	26430493	2470	1235.0	
93720	chr22	26431468	26431512	44	22.0	
93721	chr22	26432489	26433125	636	318.0	
93722	chr22	26435345	26435712	367	184.0	
93723	chr22	26461185	26461640	455	228.0	
93724	chr22	26475072	26475514	442	221.0	
93725	chr22	26479232	26480281	1049	524.0	
93726	chr22	26481905	26481913	8	4.0	
93727	chr22	26483056	26484765	1709	854.0	
93728	chr22	26502621	26503758	1137	568.0	
93729	chr22	26511901	26513096	1195	598.0	
93730	chr22	26529441	26529679	238	119.0	
93731	chr22	26535024	26535764	740	370.0	
93732	chr22	26542589	26543379	790	395.0	
93733	chr22	26547370	26547865	495	248.0	
93734	chr22	26570257	26570609	352	176.0	
93735	chr22	26571216	26571574	358	179.0	
93736	chr22	26573038	26574014	976	488.0	
93737	chr22	26576119	26577278	1159	580.0	
93738	chr22	26578975	26580201	1226	613.0	
93739	chr22	26586570	26587442	872	436.0	
93740	chr22	26588103	26591077	2974	1487.0	
93741	chr22	26591936	26593219	1283	642.0	
93742	chr22	26594108	26594274	166	83.0	
93743	chr22	26596881	26597555	674	337.0	
93744	chr22	26610180	26610797	617	308.0	
93745	chr22	26617670	26618330	660	330.0	
93746	chr22	26628664	26629191	527	264.0	
93747	chr22	26641979	26644038	2059	1030.0	
93748	chr22	26644868	26645954	1086	543.0	
93749	chr22	26647709	26649565	1856	928.0	
93750	chr22	26656856	26659488	2632	1316.0	
93751	chr22	26665115	26666103	988	494.0	
93752	chr22	26668972	26669349	377	188.0	
93753	chr22	26670886	26674991	4105	2052.0	
93754	chr22	26678929	26679474	545	272.0	
93755	chr22	26711322	26711748	426	213.0	
93756	chr22	26756577	26757065	488	244.0	
93757	chr22	27107829	27108230	401	200.0	
93758	chr22	27112995	27113989	994	497.0	
93759	chr22	27124123	27125059	936	468.0	
93760	chr22	27128744	27129770	1026	513.0	
93761	chr22	27132969	27134964	1995	998.0	enhancer
93762	chr22	27150274	27151132	858	429.0	
93763	chr22	27370350	27370723	373	186.0	
93764	chr22	27669130	27669972	842	421.0	
93765	chr22	27717971	27718745	774	387.0	
93766	chr22	27719656	27720026	370	185.0	
93767	chr22	27726629	27727306	677	338.0	
93768	chr22	27729327	27729665	338	169.0	
93769	chr22	27748870	27749001	131	66.0	
93770	chr22	27800657	27802675	2018	1009.0	
93771	chr22	27804659	27805124	465	232.0	
93772	chr22	27875964	27876360	396	198.0	
93773	chr22	27879947	27881201	1254	627.0	
93774	chr22	27886508	27887150	642	321.0	
93775	chr22	27903937	27904141	204	102.0	
93776	chr22	27918197	27920470	2273	1136.0	
93777	chr22	28009263	28009756	493	246.0	
93778	chr22	28019959	28020438	479	240.0	
93779	chr22	28401008	28401363	355	178.0	
93780	chr22	28442056	28443057	1001	500.0	
93781	chr22	28561488	28561872	384	192.0	
93782	chr22	28594734	28595073	339	170.0	
93783	chr22	28600610	28600905	295	148.0	
93784	chr22	28673945	28674705	760	380.0	
93785	chr22	28679103	28680407	1304	652.0	
93786	chr22	28706851	28707234	383	192.0	
93787	chr22	28741207	28743235	2028	1014.0	
93788	chr22	28748893	28749628	735	368.0	
93789	chr22	28760058	28760907	849	424.0	
93790	chr22	28769230	28769279	49	24.0	
93791	chr22	28772209	28773889	1680	840.0	
93792	chr22	28790105	28790785	680	340.0	
93793	chr22	28791816	28793256	1440	720.0	
93794	chr22	28795070	28795726	656	328.0	
93795	chr22	28798130	28803094	4964	2482.0	
93796	chr22	28808006	28808410	404	202.0	
93797	chr22	28810359	28812729	2370	1185.0	
93798	chr22	28813683	28814352	669	334.0	
93799	chr22	28815231	28815452	221	110.0	
93800	chr22	28822814	28823369	555	278.0	
93801	chr22	28829256	28830115	859	430.0	
93802	chr22	28855570	28856157	587	294.0	
93803	chr22	28868307	28868839	532	266.0	
93804	chr22	28882497	28884633	2136	1068.0	
93805	chr22	28894429	28894741	312	156.0	
93806	chr22	28899218	28899672	454	227.0	
93807	chr22	28943506	28943820	314	157.0	
93808	chr22	28955662	28956322	660	330.0	
93809	chr22	29040642	29041105	463	232.0	
93810	chr22	29071281	29074534	3253	1626.0	
93811	chr22	29079435	29079742	307	154.0	
93812	chr22	29083606	29084498	892	446.0	
93813	chr22	29117891	29118733	842	421.0	
93814	chr22	29152282	29153317	1035	518.0	
93815	chr22	29154367	29154885	518	259.0	
93816	chr22	29167207	29167958	751	376.0	
93817	chr22	29202347	29203261	914	457.0	
93818	chr22	29205695	29206306	611	306.0	
93819	chr22	29208952	29209248	296	148.0	
93820	chr22	29217229	29217687	458	229.0	
93821	chr22	29245309	29245982	673	336.0	
93822	chr22	29267086	29270769	3683	1842.0	
93823	chr22	29301131	29301627	496	248.0	
93824	chr22	29303147	29304225	1078	539.0	
93825	chr22	29305895	29307740	1845	922.0	
93826	chr22	29308752	29309153	401	200.0	
93827	chr22	29309654	29309655	1	0.0	
93828	chr22	29310508	29311849	1341	670.0	
93829	chr22	29313054	29313650	596	298.0	
93830	chr22	29314648	29315754	1106	553.0	
93831	chr22	29337113	29337277	164	82.0	
93832	chr22	29363991	29364818	827	414.0	
93833	chr22	29369297	29369842	545	272.0	
93834	chr22	29375704	29375721	17	8.0	
93835	chr22	29385359	29386898	1539	770.0	
93836	chr22	29387518	29389142	1624	812.0	
93837	chr22	29393239	29393593	354	177.0	
93838	chr22	29394720	29395596	876	438.0	
93839	chr22	29411507	29412269	762	381.0	
93840	chr22	29412859	29412869	10	5.0	
93841	chr22	29414455	29415718	1263	632.0	
93842	chr22	29420072	29420559	487	244.0	
93843	chr22	29457791	29458196	405	202.0	
93844	chr22	29470112	29470843	731	366.0	
93845	chr22	29475599	29475922	323	162.0	
93846	chr22	29478468	29478874	406	203.0	
93847	chr22	29480539	29481520	981	490.0	
93848	chr22	29489036	29489643	607	304.0	
93849	chr22	29524405	29524816	411	206.0	
93850	chr22	29541865	29542217	352	176.0	
93851	chr22	29553092	29554413	1321	660.0	
93852	chr22	29580156	29581838	1682	841.0	
93853	chr22	29589836	29590675	839	420.0	
93854	chr22	29596892	29597911	1019	510.0	
93855	chr22	29602852	29605399	2547	1274.0	
93856	chr22	29621721	29622273	552	276.0	
93857	chr22	29623516	29624235	719	360.0	
93858	chr22	29625537	29626005	468	234.0	
93859	chr22	29635723	29636152	429	214.0	
93860	chr22	29640938	29641799	861	430.0	
93861	chr22	29658029	29658625	596	298.0	
93862	chr22	29689925	29689936	11	6.0	
93863	chr22	29701046	29701619	573	286.0	
93864	chr22	29703114	29703332	218	109.0	
93865	chr22	29716922	29717111	189	94.0	
93866	chr22	29727259	29727574	315	158.0	
93867	chr22	29751010	29751614	604	302.0	
93868	chr22	29766173	29768170	1997	998.0	
93869	chr22	29797289	29797794	505	252.0	
93870	chr22	29799077	29800036	959	480.0	
93871	chr22	29820864	29822180	1316	658.0	
93872	chr22	29837621	29839384	1763	882.0	
93873	chr22	29855545	29856248	703	352.0	
93874	chr22	29859906	29860978	1072	536.0	
93875	chr22	29872237	29873598	1361	680.0	
93876	chr22	29879819	29880143	324	162.0	
93877	chr22	29882584	29884230	1646	823.0	
93878	chr22	29886512	29886990	478	239.0	
93879	chr22	29901347	29901806	459	230.0	
93880	chr22	29907763	29908531	768	384.0	
93881	chr22	29932405	29932431	26	13.0	
93882	chr22	29964785	29965159	374	187.0	
93883	chr22	30004989	30005677	688	344.0	
93884	chr22	30033067	30034097	1030	515.0	
93885	chr22	30047243	30047908	665	332.0	
93886	chr22	30078883	30079117	234	117.0	
93887	chr22	30088846	30089591	745	372.0	
93888	chr22	30108602	30109067	465	232.0	
93889	chr22	30178852	30178882	30	15.0	
93890	chr22	30186511	30186938	427	214.0	
93891	chr22	30192434	30193821	1387	694.0	
93892	chr22	30194973	30197181	2208	1104.0	
93893	chr22	30205751	30206253	502	251.0	
93894	chr22	30212312	30214036	1724	862.0	
93895	chr22	30220624	30221835	1211	606.0	
93896	chr22	30223316	30223540	224	112.0	
93897	chr22	30240885	30240989	104	52.0	
93898	chr22	30245740	30247526	1786	893.0	
93899	chr22	30252587	30253580	993	496.0	
93900	chr22	30255716	30256724	1008	504.0	
93901	chr22	30258057	30258530	473	236.0	
93902	chr22	30260466	30261860	1394	697.0	
93903	chr22	30262477	30264227	1750	875.0	
93904	chr22	30264800	30269301	4501	2250.0	
93905	chr22	30270503	30271588	1085	542.0	
93906	chr22	30272876	30274204	1328	664.0	
93907	chr22	30275556	30276607	1051	526.0	
93908	chr22	30277602	30278123	521	260.0	
93909	chr22	30279023	30280022	999	500.0	
93910	chr22	30282382	30283149	767	384.0	
93911	chr22	30284775	30284944	169	84.0	
93912	chr22	30286578	30291991	5413	2706.0	
93913	chr22	30296283	30297039	756	378.0	
93914	chr22	30302001	30303197	1196	598.0	
93915	chr22	30304466	30307514	3048	1524.0	
93916	chr22	30308517	30311540	3023	1512.0	
93917	chr22	30312851	30313499	648	324.0	
93918	chr22	30314783	30315383	600	300.0	
93919	chr22	30316295	30316537	242	121.0	
93920	chr22	30318630	30319829	1199	600.0	origin_of_replication
93921	chr22	30323975	30328098	4123	2062.0	
93922	chr22	30352652	30352865	213	106.0	
93923	chr22	30355990	30357758	1768	884.0	
93924	chr22	30372693	30373391	698	349.0	
93925	chr22	30386138	30387965	1827	914.0	
93926	chr22	30390853	30391859	1006	503.0	
93927	chr22	30396544	30399280	2736	1368.0	
93928	chr22	30414258	30414551	293	146.0	
93929	chr22	30422734	30427382	4648	2324.0	
93930	chr22	30429526	30430285	759	380.0	
93931	chr22	30435019	30436671	1652	826.0	
93932	chr22	30442019	30443237	1218	609.0	
93933	chr22	30444972	30445632	660	330.0	
93934	chr22	30454174	30454177	3	2.0	
93935	chr22	30475254	30475294	40	20.0	
93936	chr22	30485274	30485994	720	360.0	
93937	chr22	30591176	30592806	1630	815.0	
93938	chr22	30602034	30602478	444	222.0	
93939	chr22	30605389	30607612	2223	1112.0	
93940	chr22	30608886	30610900	2014	1007.0	
93941	chr22	30615480	30616104	624	312.0	
93942	chr22	30634139	30636621	2482	1241.0	
93943	chr22	30649203	30649992	789	394.0	
93944	chr22	30666677	30668665	1988	994.0	
93945	chr22	30694005	30695302	1297	648.0	
93946	chr22	30706056	30706240	184	92.0	
93947	chr22	30755332	30755803	471	236.0	
93948	chr22	30763731	30764203	472	236.0	
93949	chr22	30802593	30803263	670	335.0	
93950	chr22	30890606	30891017	411	206.0	
93951	chr22	30903064	30903264	200	100.0	
93952	chr22	30920088	30920801	713	356.0	
93953	chr22	30921494	30922848	1354	677.0	
93954	chr22	30940438	30941746	1308	654.0	
93955	chr22	30943337	30943814	477	238.0	
93956	chr22	30947777	30948249	472	236.0	
93957	chr22	30968278	30970177	1899	950.0	
93958	chr22	30989308	30990031	723	362.0	
93959	chr22	31063940	31064277	337	168.0	
93960	chr22	31079534	31079582	48	24.0	
93961	chr22	31080366	31083060	2694	1347.0	
93962	chr22	31083866	31086161	2295	1148.0	
93963	chr22	31088709	31089765	1056	528.0	
93964	chr22	31103155	31103971	816	408.0	
93965	chr22	31104936	31105362	426	213.0	
93966	chr22	31105964	31108287	2323	1162.0	
93967	chr22	31127154	31127467	313	156.0	
93968	chr22	31148942	31149422	480	240.0	
93969	chr22	31159557	31161600	2043	1022.0	
93970	chr22	31171700	31172279	579	290.0	
93971	chr22	31204306	31204827	521	260.0	
93972	chr22	31210402	31213715	3313	1656.0	
93973	chr22	31217115	31218146	1031	516.0	
93974	chr22	31221751	31222319	568	284.0	
93975	chr22	31227807	31228651	844	422.0	
93976	chr22	31229348	31231777	2429	1214.0	
93977	chr22	31233069	31233342	273	136.0	
93978	chr22	31234929	31235731	802	401.0	
93979	chr22	31238012	31238489	477	238.0	
93980	chr22	31247662	31248666	1004	502.0	
93981	chr22	31270008	31270627	619	310.0	
93982	chr22	31272400	31273565	1165	582.0	
93983	chr22	31276333	31281059	4726	2363.0	
93984	chr22	31281583	31283311	1728	864.0	
93985	chr22	31284303	31294186	9883	4942.0	
93986	chr22	31295391	31296735	1344	672.0	
93987	chr22	31306661	31306826	165	82.0	
93988	chr22	31308329	31308591	262	131.0	
93989	chr22	31313036	31313839	803	402.0	
93990	chr22	31342479	31348073	5594	2797.0	
93991	chr22	31398884	31400438	1554	777.0	
93992	chr22	31451735	31452077	342	171.0	
93993	chr22	31488518	31491287	2769	1384.0	
93994	chr22	31493991	31494416	425	212.0	
93995	chr22	31495700	31497912	2212	1106.0	
93996	chr22	31524157	31524497	340	170.0	
93997	chr22	31526058	31526683	625	312.0	
93998	chr22	31553026	31553073	47	24.0	
93999	chr22	31556656	31557033	377	188.0	
94000	chr22	31561265	31561666	401	200.0	
94001	chr22	31582412	31582935	523	262.0	
94002	chr22	31584972	31585153	181	90.0	
94003	chr22	31611718	31611722	4	2.0	
94004	chr22	31614835	31615067	232	116.0	
94005	chr22	31615581	31618311	2730	1365.0	
94006	chr22	31619900	31620256	356	178.0	
94007	chr22	31621384	31623086	1702	851.0	
94008	chr22	31623675	31623876	201	100.0	enhancer
94009	chr22	31624541	31624950	409	204.0	enhancer
94010	chr22	31626083	31626452	369	184.0	enhancer
94011	chr22	31628878	31631921	3043	1522.0	
94012	chr22	31633588	31634562	974	487.0	
94013	chr22	31637149	31639171	2022	1011.0	
94014	chr22	31639674	31640008	334	167.0	
94015	chr22	31642929	31643414	485	242.0	
94016	chr22	31660867	31662941	2074	1037.0	
94017	chr22	31665334	31666265	931	466.0	
94018	chr22	31674124	31674668	544	272.0	
94019	chr22	31676268	31677522	1254	627.0	
94020	chr22	31692191	31692633	442	221.0	
94021	chr22	31741034	31741432	398	199.0	
94022	chr22	31742215	31742435	220	110.0	
94023	chr22	31748552	31750749	2197	1098.0	
94024	chr22	31752910	31754983	2073	1036.0	
94025	chr22	31790188	31790511	323	162.0	
94026	chr22	31871440	31871973	533	266.0	
94027	chr22	31916954	31919034	2080	1040.0	
94028	chr22	31922540	31923697	1157	578.0	
94029	chr22	31943471	31947859	4388	2194.0	
94030	chr22	31951828	31952430	602	301.0	
94031	chr22	31958011	31959251	1240	620.0	
94032	chr22	31969727	31971455	1728	864.0	
94033	chr22	31977098	31977752	654	327.0	
94034	chr22	32050631	32051184	553	276.0	
94035	chr22	32080910	32081288	378	189.0	
94036	chr22	32137503	32138885	1382	691.0	
94037	chr22	32144370	32145466	1096	548.0	
94038	chr22	32150594	32150995	401	200.0	
94039	chr22	32151579	32152061	482	241.0	
94040	chr22	32164260	32165031	771	386.0	
94041	chr22	32200764	32201153	389	194.0	
94042	chr22	32202352	32203408	1056	528.0	
94043	chr22	32204145	32205411	1266	633.0	
94044	chr22	32206654	32207319	665	332.0	
94045	chr22	32211022	32211423	401	200.0	
94046	chr22	32218400	32219529	1129	564.0	
94047	chr22	32226422	32226729	307	154.0	
94048	chr22	32232454	32232796	342	171.0	
94049	chr22	32266120	32266568	448	224.0	
94050	chr22	32407094	32407810	716	358.0	
94051	chr22	32411460	32412783	1323	662.0	
94052	chr22	32473237	32476703	3466	1733.0	
94053	chr22	32529039	32529075	36	18.0	
94054	chr22	32644362	32644924	562	281.0	
94055	chr22	32712810	32713084	274	137.0	
94056	chr22	32723475	32724086	611	306.0	
94057	chr22	32796930	32797332	402	201.0	
94058	chr22	32881883	32882371	488	244.0	
94059	chr22	32904093	32904389	296	148.0	
94060	chr22	32986072	32986378	306	153.0	
94061	chr22	33271296	33271785	489	244.0	
94062	chr22	33299476	33300028	552	276.0	
94063	chr22	33301993	33302413	420	210.0	
94064	chr22	33325533	33325926	393	196.0	
94065	chr22	33492358	33492480	122	61.0	
94066	chr22	33519527	33519642	115	58.0	
94067	chr22	33568030	33568935	905	452.0	
94068	chr22	33579435	33579825	390	195.0	
94069	chr22	33853694	33854165	471	236.0	
94070	chr22	33919294	33922762	3468	1734.0	
94071	chr22	33923651	33924065	414	207.0	
94072	chr22	35150570	35150663	93	46.0	
94073	chr22	35231429	35231913	484	242.0	
94074	chr22	35256940	35258502	1562	781.0	
94075	chr22	35298849	35302151	3302	1651.0	
94076	chr22	35303157	35303337	180	90.0	
94077	chr22	35306293	35307087	794	397.0	
94078	chr22	35307979	35309823	1844	922.0	
94079	chr22	35310908	35313830	2922	1461.0	
94080	chr22	35316051	35316421	370	185.0	
94081	chr22	35320555	35320558	3	2.0	
94082	chr22	35328141	35329224	1083	542.0	
94083	chr22	35329989	35331024	1035	518.0	
94084	chr22	35334030	35334460	430	215.0	
94085	chr22	35338002	35338233	231	116.0	
94086	chr22	35342150	35342944	794	397.0	
94087	chr22	35348116	35348871	755	378.0	
94088	chr22	35349564	35353826	4262	2131.0	
94089	chr22	35355989	35356949	960	480.0	
94090	chr22	35364058	35364710	652	326.0	
94091	chr22	35367233	35367981	748	374.0	
94092	chr22	35371403	35372514	1111	556.0	
94093	chr22	35375045	35375523	478	239.0	
94094	chr22	35376649	35378164	1515	758.0	
94095	chr22	35380038	35381790	1752	876.0	
94096	chr22	35396522	35397295	773	386.0	
94097	chr22	35399321	35400815	1494	747.0	
94098	chr22	35407337	35407810	473	236.0	
94099	chr22	35409625	35411511	1886	943.0	
94100	chr22	35430745	35431279	534	267.0	
94101	chr22	35437242	35437296	54	27.0	
94102	chr22	35477829	35478371	542	271.0	
94103	chr22	35530900	35531138	238	119.0	
94104	chr22	35536086	35537620	1534	767.0	
94105	chr22	35538736	35539191	455	228.0	
94106	chr22	35539733	35542245	2512	1256.0	
94107	chr22	35544243	35544249	6	3.0	
94108	chr22	35552179	35553151	972	486.0	
94109	chr22	35582837	35583676	839	420.0	
94110	chr22	35589070	35589855	785	392.0	
94111	chr22	35600380	35601001	621	310.0	
94112	chr22	35602050	35603187	1137	568.0	
94113	chr22	35611898	35612428	530	265.0	
94114	chr22	35623036	35623717	681	340.0	
94115	chr22	35627089	35628204	1115	558.0	
94116	chr22	35629619	35630406	787	394.0	
94117	chr22	35631592	35632024	432	216.0	
94118	chr22	35633959	35634404	445	222.0	
94119	chr22	35647752	35650004	2252	1126.0	
94120	chr22	35660113	35661759	1646	823.0	
94121	chr22	35662464	35662786	322	161.0	
94122	chr22	35663505	35663574	69	34.0	
94123	chr22	35676168	35676428	260	130.0	
94124	chr22	35752211	35752630	419	210.0	
94125	chr22	35817343	35817794	451	226.0	
94126	chr22	35894519	35895299	780	390.0	
94127	chr22	35900961	35901063	102	51.0	
94128	chr22	35914526	35914983	457	228.0	
94129	chr22	35921690	35922130	440	220.0	
94130	chr22	36017579	36018012	433	216.0	
94131	chr22	36027511	36029679	2168	1084.0	
94132	chr22	36065498	36066678	1180	590.0	
94133	chr22	36123440	36125102	1662	831.0	
94134	chr22	36145038	36145650	612	306.0	
94135	chr22	36149489	36149797	308	154.0	
94136	chr22	36153641	36153781	140	70.0	
94137	chr22	36155317	36157593	2276	1138.0	
94138	chr22	36158180	36163153	4973	2486.0	
94139	chr22	36164442	36167346	2904	1452.0	
94140	chr22	36179850	36180896	1046	523.0	
94141	chr22	36194885	36195383	498	249.0	
94142	chr22	36197080	36197555	475	238.0	
94143	chr22	36204859	36204873	14	7.0	
94144	chr22	36211220	36211674	454	227.0	
94145	chr22	36212862	36213438	576	288.0	
94146	chr22	36221719	36222228	509	254.0	
94147	chr22	36232808	36233174	366	183.0	
94148	chr22	36237334	36240271	2937	1468.0	
94149	chr22	36252487	36254011	1524	762.0	
94150	chr22	36258689	36259486	797	398.0	
94151	chr22	36276506	36281291	4785	2392.0	
94152	chr22	36281972	36282663	691	346.0	
94153	chr22	36284133	36284421	288	144.0	
94154	chr22	36285153	36285554	401	200.0	
94155	chr22	36286157	36288295	2138	1069.0	
94156	chr22	36289146	36290473	1327	664.0	
94157	chr22	36291906	36295283	3377	1688.0	
94158	chr22	36300917	36305065	4148	2074.0	
94159	chr22	36306086	36306452	366	183.0	
94160	chr22	36308602	36308997	395	198.0	
94161	chr22	36313577	36313898	321	160.0	
94162	chr22	36317841	36318028	187	94.0	
94163	chr22	36327953	36336623	8670	4335.0	
94164	chr22	36337275	36338171	896	448.0	
94165	chr22	36339360	36339892	532	266.0	
94166	chr22	36340566	36341469	903	452.0	
94167	chr22	36344071	36345660	1589	794.0	
94168	chr22	36347435	36347593	158	79.0	
94169	chr22	36348633	36349891	1258	629.0	
94170	chr22	36350614	36353597	2983	1492.0	
94171	chr22	36354696	36360210	5514	2757.0	
94172	chr22	36360776	36374091	13315	6658.0	
94173	chr22	36374595	36375728	1133	566.0	
94174	chr22	36376229	36378359	2130	1065.0	
94175	chr22	36379037	36388910	9873	4936.0	
94176	chr22	36390963	36391490	527	264.0	
94177	chr22	36394163	36394637	474	237.0	
94178	chr22	36397506	36397887	381	190.0	
94179	chr22	36399238	36399807	569	284.0	
94180	chr22	36404868	36406553	1685	842.0	
94181	chr22	36409438	36410707	1269	634.0	
94182	chr22	36411497	36411876	379	190.0	
94183	chr22	36417284	36417558	274	137.0	
94184	chr22	36419023	36419926	903	452.0	
94185	chr22	36423375	36423951	576	288.0	
94186	chr22	36426177	36426659	482	241.0	
94187	chr22	36434707	36436435	1728	864.0	
94188	chr22	36443357	36443721	364	182.0	
94189	chr22	36445400	36445754	354	177.0	
94190	chr22	36447568	36448115	547	274.0	
94191	chr22	36449646	36450247	601	300.0	
94192	chr22	36451145	36456213	5068	2534.0	
94193	chr22	36466926	36467050	124	62.0	
94194	chr22	36467933	36468340	407	204.0	
94195	chr22	36469971	36470879	908	454.0	
94196	chr22	36480673	36482775	2102	1051.0	
94197	chr22	36486535	36487058	523	262.0	
94198	chr22	36493511	36494469	958	479.0	
94199	chr22	36506427	36507688	1261	630.0	
94200	chr22	36510934	36511404	470	235.0	
94201	chr22	36519900	36520710	810	405.0	
94202	chr22	36527731	36530239	2508	1254.0	
94203	chr22	36546183	36546634	451	226.0	
94204	chr22	36552241	36552723	482	241.0	
94205	chr22	36659719	36660380	661	330.0	
94206	chr22	36703253	36703788	535	268.0	
94207	chr22	36734453	36734826	373	186.0	
94208	chr22	36737650	36738138	488	244.0	
94209	chr22	36757513	36758049	536	268.0	
94210	chr22	36770913	36771006	93	46.0	
94211	chr22	36773935	36774336	401	200.0	
94212	chr22	36775253	36777245	1992	996.0	
94213	chr22	36781662	36782668	1006	503.0	
94214	chr22	36816724	36817105	381	190.0	
94215	chr22	36832971	36833551	580	290.0	
94216	chr22	36839728	36839751	23	12.0	
94217	chr22	36853158	36854063	905	452.0	
94218	chr22	36856067	36857012	945	472.0	
94219	chr22	36860531	36861563	1032	516.0	
94220	chr22	36862189	36862750	561	280.0	
94221	chr22	36864422	36864770	348	174.0	
94222	chr22	36873533	36874462	929	464.0	
94223	chr22	36885443	36885900	457	228.0	
94224	chr22	36900487	36900586	99	50.0	
94225	chr22	36902501	36902900	399	200.0	
94226	chr22	36912922	36914474	1552	776.0	
94227	chr22	36921136	36922119	983	492.0	
94228	chr22	36923416	36923918	502	251.0	
94229	chr22	36936652	36937128	476	238.0	
94230	chr22	36967168	36967456	288	144.0	
94231	chr22	36969680	36970147	467	234.0	
94232	chr22	36976921	36978822	1901	950.0	
94233	chr22	36986203	36986603	400	200.0	
94234	chr22	37018658	37020460	1802	901.0	
94235	chr22	37021870	37022397	527	264.0	
94236	chr22	37032836	37032858	22	11.0	
94237	chr22	37043960	37045418	1458	729.0	
94238	chr22	37045952	37046352	400	200.0	
94239	chr22	37050327	37052392	2065	1032.0	
94240	chr22	37069146	37069466	320	160.0	
94241	chr22	37077722	37078571	849	424.0	
94242	chr22	37079109	37080888	1779	890.0	
94243	chr22	37098860	37099463	603	302.0	
94244	chr22	37120891	37125520	4629	2314.0	
94245	chr22	37126155	37127699	1544	772.0	
94246	chr22	37128876	37129227	351	176.0	
94247	chr22	37133644	37133773	129	64.0	
94248	chr22	37139216	37139417	201	100.0	
94249	chr22	37141080	37141300	220	110.0	
94250	chr22	37143754	37144295	541	270.0	
94251	chr22	37145158	37150717	5559	2780.0	
94252	chr22	37158381	37159541	1160	580.0	
94253	chr22	37161322	37165037	3715	1858.0	
94254	chr22	37165917	37167484	1567	784.0	
94255	chr22	37168238	37168722	484	242.0	
94256	chr22	37170354	37170476	122	61.0	
94257	chr22	37176121	37177238	1117	558.0	
94258	chr22	37178089	37178686	597	298.0	
94259	chr22	37183564	37183923	359	180.0	
94260	chr22	37185814	37187359	1545	772.0	
94261	chr22	37193715	37194417	702	351.0	
94262	chr22	37197751	37200855	3104	1552.0	
94263	chr22	37205165	37205611	446	223.0	
94264	chr22	37207990	37208384	394	197.0	
94265	chr22	37218366	37226794	8428	4214.0	
94266	chr22	37227468	37232892	5424	2712.0	
94267	chr22	37233719	37235681	1962	981.0	
94268	chr22	37236187	37240289	4102	2051.0	
94269	chr22	37240879	37245864	4985	2492.0	
94270	chr22	37259470	37261478	2008	1004.0	
94271	chr22	37266601	37268473	1872	936.0	
94272	chr22	37269989	37270466	477	238.0	
94273	chr22	37271099	37271942	843	422.0	
94274	chr22	37273476	37275047	1571	786.0	
94275	chr22	37276796	37277207	411	206.0	
94276	chr22	37279264	37279950	686	343.0	
94277	chr22	37281582	37285791	4209	2104.0	
94278	chr22	37295649	37295845	196	98.0	
94279	chr22	37298635	37299157	522	261.0	
94280	chr22	37300169	37301825	1656	828.0	
94281	chr22	37303538	37304504	966	483.0	
94282	chr22	37306330	37308606	2276	1138.0	
94283	chr22	37309131	37311997	2866	1433.0	
94284	chr22	37312562	37317616	5054	2527.0	
94285	chr22	37321281	37321644	363	182.0	
94286	chr22	37330480	37330860	380	190.0	
94287	chr22	37332129	37332272	143	72.0	
94288	chr22	37370211	37370927	716	358.0	
94289	chr22	37409970	37410577	607	304.0	
94290	chr22	37416330	37417283	953	476.0	
94291	chr22	37419611	37421466	1855	928.0	
94292	chr22	37425958	37426279	321	160.0	
94293	chr22	37426964	37427902	938	469.0	
94294	chr22	37428770	37429427	657	328.0	
94295	chr22	37442492	37442861	369	184.0	
94296	chr22	37449697	37449706	9	4.0	
94297	chr22	37457093	37457918	825	412.0	
94298	chr22	37472339	37472798	459	230.0	
94299	chr22	37482409	37482529	120	60.0	
94300	chr22	37483675	37487314	3639	1820.0	
94301	chr22	37492591	37493455	864	432.0	
94302	chr22	37498133	37498855	722	361.0	
94303	chr22	37518809	37520008	1199	600.0	
94304	chr22	37534010	37534410	400	200.0	
94305	chr22	37537877	37539453	1576	788.0	
94306	chr22	37541793	37542529	736	368.0	
94307	chr22	37545048	37545800	752	376.0	
94308	chr22	37560001	37562316	2315	1158.0	
94309	chr22	37565767	37567936	2169	1084.0	
94310	chr22	37574202	37575204	1002	501.0	
94311	chr22	37579896	37580574	678	339.0	
94312	chr22	37581564	37581937	373	186.0	
94313	chr22	37590165	37591147	982	491.0	
94314	chr22	37592176	37593162	986	493.0	
94315	chr22	37601651	37601924	273	136.0	
94316	chr22	37604759	37605787	1028	514.0	
94317	chr22	37606770	37611698	4928	2464.0	
94318	chr22	37616268	37616600	332	166.0	
94319	chr22	37618328	37618644	316	158.0	
94320	chr22	37622996	37624338	1342	671.0	
94321	chr22	37626889	37628275	1386	693.0	
94322	chr22	37631420	37635056	3636	1818.0	
94323	chr22	37636029	37637151	1122	561.0	
94324	chr22	37637957	37641809	3852	1926.0	
94325	chr22	37642848	37643915	1067	534.0	
94326	chr22	37657441	37662482	5041	2520.0	
94327	chr22	37672029	37673572	1543	772.0	
94328	chr22	37674689	37677909	3220	1610.0	
94329	chr22	37681190	37682732	1542	771.0	
94330	chr22	37685899	37687265	1366	683.0	
94331	chr22	37696393	37697424	1031	516.0	
94332	chr22	37701312	37701867	555	278.0	
94333	chr22	37708506	37709022	516	258.0	
94334	chr22	37726562	37726828	266	133.0	
94335	chr22	37728096	37728608	512	256.0	
94336	chr22	37730680	37732255	1575	788.0	
94337	chr22	37735101	37735511	410	205.0	
94338	chr22	37737182	37737341	159	80.0	
94339	chr22	37739123	37740272	1149	574.0	
94340	chr22	37740972	37741755	783	392.0	
94341	chr22	37742541	37742774	233	116.0	
94342	chr22	37745227	37747773	2546	1273.0	
94343	chr22	37791725	37792226	501	250.0	
94344	chr22	37801883	37803408	1525	762.0	
94345	chr22	37804350	37808617	4267	2134.0	
94346	chr22	37817351	37819333	1982	991.0	
94347	chr22	37824679	37825390	711	356.0	
94348	chr22	37843459	37845264	1805	902.0	
94349	chr22	37848608	37850222	1614	807.0	
94350	chr22	37863235	37863939	704	352.0	
94351	chr22	37896003	37896864	861	430.0	
94352	chr22	37904980	37908078	3098	1549.0	
94353	chr22	37920099	37920529	430	215.0	
94354	chr22	37930617	37931044	427	214.0	
94355	chr22	37933452	37934513	1061	530.0	
94356	chr22	37940790	37940932	142	71.0	
94357	chr22	37952674	37954450	1776	888.0	
94358	chr22	37964943	37965615	672	336.0	
94359	chr22	37994007	37994596	589	294.0	
94360	chr22	37996037	37996665	628	314.0	
94361	chr22	37999804	38000305	501	250.0	
94362	chr22	38009253	38009530	277	138.0	
94363	chr22	38034201	38034614	413	206.0	enhancer
94364	chr22	38042195	38042725	530	265.0	
94365	chr22	38052001	38052943	942	471.0	
94366	chr22	38056609	38058251	1642	821.0	
94367	chr22	38062837	38063266	429	214.0	
94368	chr22	38081068	38081756	688	344.0	
94369	chr22	38082608	38082885	277	138.0	
94370	chr22	38100829	38101131	302	151.0	
94371	chr22	38104647	38105156	509	254.0	
94372	chr22	38109375	38110101	726	363.0	
94373	chr22	38114412	38115136	724	362.0	
94374	chr22	38143144	38144308	1164	582.0	
94375	chr22	38147603	38148578	975	488.0	
94376	chr22	38161990	38162564	574	287.0	
94377	chr22	38172575	38173376	801	400.0	
94378	chr22	38176087	38177617	1530	765.0	
94379	chr22	38179758	38182466	2708	1354.0	
94380	chr22	38193293	38194222	929	464.0	
94381	chr22	38200655	38222344	21689	10844.0	
94382	chr22	38223167	38223663	496	248.0	
94383	chr22	38229079	38229112	33	16.0	
94384	chr22	38230066	38230670	604	302.0	
94385	chr22	38260092	38261147	1055	528.0	
94386	chr22	38262036	38262527	491	246.0	
94387	chr22	38266849	38267779	930	465.0	
94388	chr22	38268720	38268818	98	49.0	
94389	chr22	38270100	38270526	426	213.0	
94390	chr22	38271852	38273860	2008	1004.0	
94391	chr22	38289650	38290181	531	266.0	
94392	chr22	38298260	38298870	610	305.0	
94393	chr22	38305605	38306609	1004	502.0	
94394	chr22	38308849	38309409	560	280.0	
94395	chr22	38312437	38318849	6412	3206.0	
94396	chr22	38327805	38328236	431	216.0	
94397	chr22	38335716	38336695	979	490.0	
94398	chr22	38343418	38343691	273	136.0	
94399	chr22	38353059	38353910	851	426.0	
94400	chr22	38373991	38374505	514	257.0	
94401	chr22	38395296	38395307	11	6.0	
94402	chr22	38396994	38399684	2690	1345.0	
94403	chr22	38406485	38407087	602	301.0	
94404	chr22	38412575	38413214	639	320.0	
94405	chr22	38415605	38415995	390	195.0	
94406	chr22	38454191	38456418	2227	1114.0	
94407	chr22	38461235	38461967	732	366.0	
94408	chr22	38467682	38468575	893	446.0	
94409	chr22	38475505	38475541	36	18.0	
94410	chr22	38485864	38486230	366	183.0	
94411	chr22	38489976	38490085	109	54.0	
94412	chr22	38494688	38494693	5	2.0	
94413	chr22	38501887	38503330	1443	722.0	
94414	chr22	38503975	38507339	3364	1682.0	
94415	chr22	38512949	38513484	535	268.0	
94416	chr22	38524417	38524734	317	158.0	
94417	chr22	38531632	38532286	654	327.0	
94418	chr22	38549348	38550542	1194	597.0	
94419	chr22	38569442	38571283	1841	920.0	
94420	chr22	38572110	38572573	463	232.0	
94421	chr22	38631747	38632158	411	206.0	
94422	chr22	38655808	38657754	1946	973.0	
94423	chr22	38681373	38682688	1315	658.0	
94424	chr22	38686435	38686581	146	73.0	
94425	chr22	38691734	38691769	35	18.0	
94426	chr22	38693315	38694227	912	456.0	
94427	chr22	38696367	38701998	5631	2816.0	
94428	chr22	38703606	38703930	324	162.0	
94429	chr22	38704657	38709871	5214	2607.0	
94430	chr22	38712566	38716747	4181	2090.0	
94431	chr22	38717509	38719431	1922	961.0	
94432	chr22	38722560	38722633	73	36.0	
94433	chr22	38723286	38739646	16360	8180.0	
94434	chr22	38741403	38741781	378	189.0	
94435	chr22	38744248	38744374	126	63.0	
94436	chr22	38744885	38744889	4	2.0	
94437	chr22	38745915	38746289	374	187.0	
94438	chr22	38750442	38757705	7263	3632.0	
94439	chr22	38758227	38759243	1016	508.0	
94440	chr22	38761166	38761203	37	18.0	
94441	chr22	38766036	38766572	536	268.0	
94442	chr22	38768733	38769355	622	311.0	
94443	chr22	38782421	38782798	377	188.0	
94444	chr22	38793362	38794877	1515	758.0	
94445	chr22	38824493	38824901	408	204.0	
94446	chr22	38842956	38844714	1758	879.0	
94447	chr22	38868588	38874515	5927	2964.0	
94448	chr22	38927011	38927794	783	392.0	
94449	chr22	38941205	38942322	1117	558.0	
94450	chr22	38943009	38943774	765	382.0	
94451	chr22	38947111	38947759	648	324.0	
94452	chr22	38951635	38954961	3326	1663.0	
94453	chr22	38957029	38958366	1337	668.0	
94454	chr22	38964861	38965274	413	206.0	
94455	chr22	38967061	38968462	1401	700.0	
94456	chr22	38972319	38972807	488	244.0	
94457	chr22	38973314	38974037	723	362.0	
94458	chr22	38981323	38982834	1511	756.0	
94459	chr22	38984835	38985746	911	456.0	
94460	chr22	39002893	39003798	905	452.0	
94461	chr22	39007623	39008338	715	358.0	
94462	chr22	39013564	39015437	1873	936.0	
94463	chr22	39019991	39022433	2442	1221.0	
94464	chr22	39024568	39025480	912	456.0	
94465	chr22	39040007	39041601	1594	797.0	
94466	chr22	39063880	39064231	351	176.0	
94467	chr22	39065926	39066629	703	352.0	
94468	chr22	39072469	39073172	703	352.0	
94469	chr22	39076243	39079635	3392	1696.0	
94470	chr22	39080153	39081396	1243	622.0	
94471	chr22	39083346	39084135	789	394.0	
94472	chr22	39087926	39092922	4996	2498.0	
94473	chr22	39094407	39095678	1271	636.0	
94474	chr22	39096836	39100779	3943	1972.0	
94475	chr22	39110919	39111205	286	143.0	
94476	chr22	39115052	39118569	3517	1758.0	
94477	chr22	39121986	39122466	480	240.0	
94478	chr22	39135086	39135509	423	212.0	
94479	chr22	39143731	39147043	3312	1656.0	
94480	chr22	39148574	39153847	5273	2636.0	
94481	chr22	39170567	39171750	1183	592.0	
94482	chr22	39172735	39172771	36	18.0	
94483	chr22	39173560	39175419	1859	930.0	
94484	chr22	39205257	39206306	1049	524.0	
94485	chr22	39207336	39207715	379	190.0	
94486	chr22	39215621	39216231	610	305.0	
94487	chr22	39221381	39221495	114	57.0	
94488	chr22	39223324	39223636	312	156.0	
94489	chr22	39230638	39230959	321	160.0	
94490	chr22	39234413	39234558	145	72.0	
94491	chr22	39235298	39235690	392	196.0	
94492	chr22	39236200	39237744	1544	772.0	
94493	chr22	39239585	39245331	5746	2873.0	
94494	chr22	39245950	39245991	41	20.0	
94495	chr22	39253034	39253870	836	418.0	
94496	chr22	39254737	39255363	626	313.0	
94497	chr22	39264268	39265167	899	450.0	
94498	chr22	39266293	39266997	704	352.0	
94499	chr22	39276505	39277819	1314	657.0	
94500	chr22	39282275	39283196	921	460.0	
94501	chr22	39286747	39287766	1019	510.0	
94502	chr22	39292289	39293156	867	434.0	
94503	chr22	39297391	39297779	388	194.0	
94504	chr22	39299452	39301356	1904	952.0	
94505	chr22	39302215	39302614	399	200.0	
94506	chr22	39306355	39307505	1150	575.0	
94507	chr22	39308243	39320733	12490	6245.0	
94508	chr22	39329072	39329599	527	264.0	
94509	chr22	39331966	39332371	405	202.0	
94510	chr22	39343423	39343964	541	270.0	
94511	chr22	39348836	39350830	1994	997.0	
94512	chr22	39351624	39352228	604	302.0	
94513	chr22	39353365	39353667	302	151.0	
94514	chr22	39388149	39389134	985	492.0	
94515	chr22	39399098	39400611	1513	756.0	
94516	chr22	39408393	39408519	126	63.0	
94517	chr22	39410150	39410742	592	296.0	
94518	chr22	39412240	39413226	986	493.0	
94519	chr22	39437161	39437831	670	335.0	
94520	chr22	39439049	39439792	743	372.0	
94521	chr22	39446539	39447498	959	480.0	
94522	chr22	39456089	39456498	409	204.0	
94523	chr22	39457176	39458188	1012	506.0	
94524	chr22	39462485	39463021	536	268.0	
94525	chr22	39465282	39465758	476	238.0	
94526	chr22	39468863	39469456	593	296.0	
94527	chr22	39471562	39472122	560	280.0	
94528	chr22	39489656	39490781	1125	562.0	
94529	chr22	39493249	39493767	518	259.0	
94530	chr22	39494681	39496972	2291	1146.0	
94531	chr22	39501555	39503340	1785	892.0	
94532	chr22	39514142	39514782	640	320.0	
94533	chr22	39519052	39525712	6660	3330.0	
94534	chr22	39526263	39533348	7085	3542.0	
94535	chr22	39534282	39535577	1295	648.0	
94536	chr22	39543353	39543498	145	72.0	
94537	chr22	39545240	39546402	1162	581.0	
94538	chr22	39557288	39557903	615	308.0	
94539	chr22	39559760	39560003	243	122.0	
94540	chr22	39567265	39567929	664	332.0	
94541	chr22	39576410	39576764	354	177.0	
94542	chr22	39597884	39598641	757	378.0	
94543	chr22	39600714	39601352	638	319.0	
94544	chr22	39602070	39602695	625	312.0	
94545	chr22	39622815	39623403	588	294.0	
94546	chr22	39658331	39658832	501	250.0	
94547	chr22	39661807	39663508	1701	850.0	
94548	chr22	39664288	39665203	915	458.0	
94549	chr22	39773872	39774363	491	246.0	
94550	chr22	39825825	39825989	164	82.0	
94551	chr22	39839239	39839570	331	166.0	
94552	chr22	39875302	39875385	83	42.0	
94553	chr22	39896634	39896955	321	160.0	
94554	chr22	39898935	39899463	528	264.0	
94555	chr22	39900243	39901906	1663	832.0	
94556	chr22	39905675	39911549	5874	2937.0	
94557	chr22	39912559	39912744	185	92.0	
94558	chr22	39915208	39915592	384	192.0	
94559	chr22	39917197	39918053	856	428.0	
94560	chr22	39920072	39921617	1545	772.0	
94561	chr22	39926217	39927940	1723	862.0	
94562	chr22	39928975	39929422	447	224.0	
94563	chr22	39931160	39934362	3202	1601.0	
94564	chr22	39935725	39936984	1259	630.0	
94565	chr22	39937765	39938376	611	306.0	
94566	chr22	39939822	39941251	1429	714.0	
94567	chr22	39942135	39944572	2437	1218.0	
94568	chr22	39946475	39947075	600	300.0	
94569	chr22	39951444	39952780	1336	668.0	
94570	chr22	39956802	39957388	586	293.0	
94571	chr22	39959287	39959972	685	342.0	
94572	chr22	39960780	39961979	1199	600.0	
94573	chr22	39979945	39980955	1010	505.0	
94574	chr22	39988576	39989122	546	273.0	
94575	chr22	39993942	39995498	1556	778.0	
94576	chr22	40007714	40008663	949	474.0	
94577	chr22	40009740	40010505	765	382.0	
94578	chr22	40024538	40025238	700	350.0	
94579	chr22	40036554	40037065	511	256.0	
94580	chr22	40042931	40046401	3470	1735.0	
94581	chr22	40050134	40050921	787	394.0	
94582	chr22	40055054	40056023	969	484.0	
94583	chr22	40058301	40058649	348	174.0	
94584	chr22	40076945	40077601	656	328.0	
94585	chr22	40094425	40094871	446	223.0	
94586	chr22	40107196	40108452	1256	628.0	
94587	chr22	40116408	40117326	918	459.0	
94588	chr22	40121574	40121848	274	137.0	
94589	chr22	40128954	40129405	451	226.0	
94590	chr22	40176693	40179497	2804	1402.0	
94591	chr22	40180088	40180430	342	171.0	
94592	chr22	40182857	40183568	711	356.0	
94593	chr22	40192869	40193181	312	156.0	
94594	chr22	40200862	40201229	367	184.0	
94595	chr22	40203467	40204053	586	293.0	
94596	chr22	40209967	40211916	1949	974.0	
94597	chr22	40215206	40216761	1555	778.0	
94598	chr22	40217896	40218475	579	290.0	
94599	chr22	40239018	40239428	410	205.0	
94600	chr22	40240665	40241754	1089	544.0	
94601	chr22	40243812	40244299	487	244.0	
94602	chr22	40247789	40248575	786	393.0	
94603	chr22	40258359	40258760	401	200.0	
94604	chr22	40265769	40266207	438	219.0	
94605	chr22	40276110	40277209	1099	550.0	
94606	chr22	40289206	40290908	1702	851.0	
94607	chr22	40312797	40313438	641	320.0	
94608	chr22	40314116	40314376	260	130.0	
94609	chr22	40323629	40325807	2178	1089.0	
94610	chr22	40327334	40327755	421	210.0	
94611	chr22	40329154	40329393	239	120.0	
94612	chr22	40331757	40333224	1467	734.0	
94613	chr22	40334327	40336751	2424	1212.0	
94614	chr22	40345345	40348555	3210	1605.0	
94615	chr22	40369947	40371441	1494	747.0	
94616	chr22	40378448	40378852	404	202.0	
94617	chr22	40383493	40383558	65	32.0	
94618	chr22	40384919	40386114	1195	598.0	
94619	chr22	40399248	40402492	3244	1622.0	
94620	chr22	40404439	40404440	1	0.0	
94621	chr22	40406969	40407208	239	120.0	
94622	chr22	40408546	40408562	16	8.0	
94623	chr22	40409826	40410073	247	124.0	
94624	chr22	40412349	40413124	775	388.0	
94625	chr22	40413815	40416483	2668	1334.0	
94626	chr22	40418460	40419186	726	363.0	
94627	chr22	40432107	40432575	468	234.0	
94628	chr22	40434684	40435145	461	230.0	
94629	chr22	40435840	40437610	1770	885.0	
94630	chr22	40438389	40438698	309	154.0	
94631	chr22	40440399	40440519	120	60.0	
94632	chr22	40441793	40442125	332	166.0	
94633	chr22	40443586	40445838	2252	1126.0	
94634	chr22	40451218	40451631	413	206.0	
94635	chr22	40452813	40453562	749	374.0	
94636	chr22	40461723	40464314	2591	1296.0	
94637	chr22	40476630	40476688	58	29.0	
94638	chr22	40479902	40480373	471	236.0	
94639	chr22	40480951	40481458	507	254.0	
94640	chr22	40486174	40486463	289	144.0	
94641	chr22	40487258	40488099	841	420.0	
94642	chr22	40491893	40493009	1116	558.0	
94643	chr22	40499120	40499614	494	247.0	
94644	chr22	40509491	40510295	804	402.0	
94645	chr22	40519027	40520016	989	494.0	
94646	chr22	40524555	40525689	1134	567.0	
94647	chr22	40532539	40532548	9	4.0	
94648	chr22	40533537	40535439	1902	951.0	
94649	chr22	40621197	40622195	998	499.0	
94650	chr22	40628065	40629096	1031	516.0	
94651	chr22	40635724	40638295	2571	1286.0	
94652	chr22	40645969	40646901	932	466.0	
94653	chr22	40647690	40647863	173	86.0	
94654	chr22	40651496	40652674	1178	589.0	
94655	chr22	40682865	40683649	784	392.0	
94656	chr22	40684846	40685707	861	430.0	
94657	chr22	40711509	40711939	430	215.0	
94658	chr22	40726484	40727302	818	409.0	
94659	chr22	40728596	40729319	723	362.0	
94660	chr22	40731447	40733100	1653	826.0	
94661	chr22	40760281	40760286	5	2.0	
94662	chr22	40764711	40765101	390	195.0	
94663	chr22	40817900	40820106	2206	1103.0	
94664	chr22	40855589	40857855	2266	1133.0	
94665	chr22	40863919	40864478	559	280.0	
94666	chr22	40898968	40899497	529	264.0	
94667	chr22	40922644	40923360	716	358.0	
94668	chr22	40941802	40942518	716	358.0	
94669	chr22	40943489	40943976	487	244.0	
94670	chr22	40950254	40952676	2422	1211.0	
94671	chr22	40965845	40967463	1618	809.0	
94672	chr22	41009506	41009969	463	232.0	
94673	chr22	41015046	41015197	151	76.0	
94674	chr22	41021167	41023296	2129	1064.0	
94675	chr22	41028835	41029267	432	216.0	
94676	chr22	41034619	41035116	497	248.0	
94677	chr22	41038804	41039098	294	147.0	
94678	chr22	41043661	41044128	467	234.0	
94679	chr22	41068804	41069575	771	386.0	
94680	chr22	41071058	41071288	230	115.0	
94681	chr22	41079150	41079249	99	50.0	
94682	chr22	41090974	41095468	4494	2247.0	
94683	chr22	41106463	41106864	401	200.0	
94684	chr22	41127456	41127890	434	217.0	
94685	chr22	41181771	41182311	540	270.0	
94686	chr22	41196785	41198643	1858	929.0	
94687	chr22	41204571	41206047	1476	738.0	
94688	chr22	41217373	41218326	953	476.0	
94689	chr22	41226692	41227025	333	166.0	
94690	chr22	41237231	41238413	1182	591.0	
94691	chr22	41243789	41243801	12	6.0	
94692	chr22	41285048	41287234	2186	1093.0	
94693	chr22	41289932	41289933	1	0.0	
94694	chr22	41300834	41303316	2482	1241.0	
94695	chr22	41342096	41342123	27	14.0	
94696	chr22	41366827	41367734	907	454.0	
94697	chr22	41380519	41383157	2638	1319.0	
94698	chr22	41403515	41404442	927	464.0	
94699	chr22	41411384	41411785	401	200.0	
94700	chr22	41412316	41415127	2811	1406.0	
94701	chr22	41422778	41423198	420	210.0	
94702	chr22	41425642	41426541	899	450.0	
94703	chr22	41429043	41433345	4302	2151.0	
94704	chr22	41434466	41435830	1364	682.0	
94705	chr22	41436350	41437413	1063	532.0	
94706	chr22	41438393	41439101	708	354.0	
94707	chr22	41440640	41440658	18	9.0	
94708	chr22	41442129	41442557	428	214.0	
94709	chr22	41443826	41449649	5823	2912.0	
94710	chr22	41468041	41469822	1781	890.0	
94711	chr22	41501185	41501615	430	215.0	
94712	chr22	41517688	41518165	477	238.0	
94713	chr22	41524567	41525629	1062	531.0	
94714	chr22	41526449	41527354	905	452.0	
94715	chr22	41532986	41533674	688	344.0	
94716	chr22	41542308	41542321	13	6.0	
94717	chr22	41543678	41545386	1708	854.0	
94718	chr22	41576876	41577297	421	210.0	
94719	chr22	41588904	41590727	1823	912.0	
94720	chr22	41597063	41597710	647	324.0	
94721	chr22	41603745	41604556	811	406.0	
94722	chr22	41618670	41622315	3645	1822.0	
94723	chr22	41666314	41667864	1550	775.0	
94724	chr22	41673066	41673524	458	229.0	
94725	chr22	41681598	41683467	1869	934.0	
94726	chr22	41687523	41689611	2088	1044.0	
94727	chr22	41690318	41691309	991	496.0	
94728	chr22	41696663	41697854	1191	596.0	
94729	chr22	41699015	41699887	872	436.0	
94730	chr22	41746485	41747387	902	451.0	
94731	chr22	41757546	41757627	81	40.0	
94732	chr22	41763101	41763452	351	176.0	
94733	chr22	41768276	41768963	687	344.0	
94734	chr22	41777800	41778588	788	394.0	
94735	chr22	41779870	41783127	3257	1628.0	
94736	chr22	41799004	41801944	2940	1470.0	
94737	chr22	41822358	41823284	926	463.0	
94738	chr22	41830147	41830677	530	265.0	
94739	chr22	41831313	41834871	3558	1779.0	
94740	chr22	41848294	41848959	665	332.0	
94741	chr22	41857196	41858151	955	478.0	
94742	chr22	41859023	41859608	585	292.0	
94743	chr22	41862060	41863263	1203	602.0	
94744	chr22	41873272	41873787	515	258.0	
94745	chr22	41883806	41884294	488	244.0	
94746	chr22	41908077	41911596	3519	1760.0	
94747	chr22	41913984	41915613	1629	814.0	
94748	chr22	41917901	41918577	676	338.0	
94749	chr22	41919105	41921052	1947	974.0	
94750	chr22	41921553	41923154	1601	800.0	
94751	chr22	41924194	41927522	3328	1664.0	
94752	chr22	41928464	41929742	1278	639.0	
94753	chr22	41931597	41932248	651	326.0	
94754	chr22	41933629	41934381	752	376.0	
94755	chr22	41935127	41942056	6929	3464.0	enhancer
94756	chr22	41943571	41943926	355	178.0	
94757	chr22	41945587	41947622	2035	1018.0	
94758	chr22	41952153	41952523	370	185.0	
94759	chr22	41957386	41958289	903	452.0	
94760	chr22	41966459	41967133	674	337.0	
94761	chr22	41976199	41977536	1337	668.0	
94762	chr22	41998069	41999358	1289	644.0	
94763	chr22	42022487	42022823	336	168.0	
94764	chr22	42053311	42053358	47	24.0	
94765	chr22	42069654	42071599	1945	972.0	
94766	chr22	42073981	42075022	1041	520.0	
94767	chr22	42078760	42081024	2264	1132.0	
94768	chr22	42089019	42091793	2774	1387.0	
94769	chr22	42120167	42121168	1001	500.0	
94770	chr22	42130980	42131185	205	102.0	
94771	chr22	42131798	42131975	177	88.0	
94772	chr22	42132571	42132872	301	150.0	
94773	chr22	42139056	42139728	672	336.0	
94774	chr22	42141534	42141620	86	43.0	
94775	chr22	42168896	42169403	507	254.0	
94776	chr22	42174048	42174493	445	222.0	
94777	chr22	42180175	42180918	743	372.0	
94778	chr22	42183463	42184016	553	276.0	
94779	chr22	42184791	42185317	526	263.0	
94780	chr22	42202063	42203035	972	486.0	
94781	chr22	42207962	42208284	322	161.0	
94782	chr22	42217726	42217780	54	27.0	
94783	chr22	42262976	42263318	342	171.0	
94784	chr22	42268880	42271353	2473	1236.0	
94785	chr22	42272603	42272962	359	180.0	
94786	chr22	42278344	42278682	338	169.0	
94787	chr22	42283326	42284329	1003	502.0	
94788	chr22	42286158	42286650	492	246.0	
94789	chr22	42293964	42294758	794	397.0	
94790	chr22	42296527	42296966	439	220.0	
94791	chr22	42297702	42297714	12	6.0	
94792	chr22	42298414	42301413	2999	1500.0	
94793	chr22	42311651	42312008	357	178.0	
94794	chr22	42313889	42314380	491	246.0	
94795	chr22	42316862	42317717	855	428.0	
94796	chr22	42324936	42325372	436	218.0	
94797	chr22	42343202	42344309	1107	554.0	
94798	chr22	42367793	42369999	2206	1103.0	
94799	chr22	42374634	42375501	867	434.0	
94800	chr22	42376642	42377125	483	242.0	
94801	chr22	42381945	42381946	1	0.0	
94802	chr22	42396438	42398156	1718	859.0	
94803	chr22	42414878	42415306	428	214.0	
94804	chr22	42418894	42420017	1123	562.0	
94805	chr22	42430308	42432796	2488	1244.0	
94806	chr22	42434818	42435202	384	192.0	
94807	chr22	42435977	42436717	740	370.0	
94808	chr22	42437228	42438466	1238	619.0	
94809	chr22	42439503	42440586	1083	542.0	
94810	chr22	42443512	42445141	1629	814.0	
94811	chr22	42473484	42473937	453	226.0	
94812	chr22	42498868	42499221	353	176.0	
94813	chr22	42499789	42501145	1356	678.0	
94814	chr22	42519172	42520499	1327	664.0	
94815	chr22	42532792	42534036	1244	622.0	
94816	chr22	42537090	42537870	780	390.0	
94817	chr22	42539626	42539711	85	42.0	
94818	chr22	42551454	42552473	1019	510.0	
94819	chr22	42553328	42554420	1092	546.0	
94820	chr22	42560831	42561227	396	198.0	
94821	chr22	42562353	42562777	424	212.0	
94822	chr22	42581039	42582709	1670	835.0	
94823	chr22	42586337	42586996	659	330.0	
94824	chr22	42587536	42588274	738	369.0	
94825	chr22	42605050	42605161	111	56.0	
94826	chr22	42610282	42610550	268	134.0	
94827	chr22	42612814	42617992	5178	2589.0	
94828	chr22	42618936	42619931	995	498.0	
94829	chr22	42621262	42622116	854	427.0	
94830	chr22	42623382	42623880	498	249.0	
94831	chr22	42642791	42643220	429	214.0	
94832	chr22	42648202	42650222	2020	1010.0	
94833	chr22	42651126	42651197	71	36.0	
94834	chr22	42655599	42656164	565	282.0	
94835	chr22	42657488	42658060	572	286.0	
94836	chr22	42661706	42662973	1267	634.0	
94837	chr22	42665514	42665777	263	132.0	
94838	chr22	42671365	42671766	401	200.0	
94839	chr22	42692240	42692641	401	200.0	
94840	chr22	42716797	42717170	373	186.0	
94841	chr22	42720218	42721122	904	452.0	
94842	chr22	42751909	42752101	192	96.0	
94843	chr22	42755746	42755760	14	7.0	
94844	chr22	42766904	42767137	233	116.0	
94845	chr22	42769589	42770117	528	264.0	
94846	chr22	42780013	42780558	545	272.0	
94847	chr22	42799638	42800081	443	222.0	
94848	chr22	42828295	42828938	643	322.0	
94849	chr22	42855356	42858078	2722	1361.0	
94850	chr22	42863083	42864077	994	497.0	
94851	chr22	42867335	42868347	1012	506.0	
94852	chr22	42882535	42882557	22	11.0	
94853	chr22	42888939	42890235	1296	648.0	
94854	chr22	42892216	42894289	2073	1036.0	
94855	chr22	42894792	42896080	1288	644.0	
94856	chr22	42902146	42902474	328	164.0	
94857	chr22	42911983	42912562	579	290.0	
94858	chr22	42919310	42919587	277	138.0	
94859	chr22	42921298	42921737	439	220.0	
94860	chr22	42922663	42923485	822	411.0	
94861	chr22	42929197	42930015	818	409.0	
94862	chr22	42930752	42932476	1724	862.0	
94863	chr22	42933287	42934245	958	479.0	
94864	chr22	42935359	42935645	286	143.0	
94865	chr22	42937150	42937974	824	412.0	
94866	chr22	42959748	42960545	797	398.0	
94867	chr22	42962033	42963058	1025	512.0	
94868	chr22	42964999	42965225	226	113.0	
94869	chr22	42967889	42968424	535	268.0	
94870	chr22	42973094	42973848	754	377.0	
94871	chr22	42977475	42978073	598	299.0	
94872	chr22	42990105	42990430	325	162.0	
94873	chr22	42992959	42994293	1334	667.0	
94874	chr22	42994813	42995781	968	484.0	
94875	chr22	42998214	42998336	122	61.0	
94876	chr22	43001298	43001998	700	350.0	
94877	chr22	43004272	43004748	476	238.0	
94878	chr22	43013462	43016129	2667	1334.0	
94879	chr22	43025148	43025198	50	25.0	
94880	chr22	43033807	43034315	508	254.0	
94881	chr22	43060295	43060299	4	2.0	
94882	chr22	43067554	43067673	119	60.0	
94883	chr22	43085743	43086692	949	474.0	
94884	chr22	43088549	43090649	2100	1050.0	
94885	chr22	43092088	43092303	215	108.0	
94886	chr22	43093970	43094512	542	271.0	
94887	chr22	43110001	43111762	1761	880.0	
94888	chr22	43115936	43116429	493	246.0	
94889	chr22	43118482	43119439	957	478.0	
94890	chr22	43122166	43122587	421	210.0	
94891	chr22	43128122	43130173	2051	1026.0	
94892	chr22	43136196	43136730	534	267.0	
94893	chr22	43142541	43143872	1331	666.0	
94894	chr22	43146256	43149024	2768	1384.0	
94895	chr22	43150779	43153215	2436	1218.0	
94896	chr22	43154730	43156118	1388	694.0	
94897	chr22	43163657	43164486	829	414.0	
94898	chr22	43185854	43188307	2453	1226.0	
94899	chr22	43205343	43206632	1289	644.0	
94900	chr22	43230888	43231665	777	388.0	
94901	chr22	43255428	43255560	132	66.0	
94902	chr22	43262966	43264672	1706	853.0	
94903	chr22	43273877	43274312	435	218.0	
94904	chr22	43280523	43280782	259	130.0	
94905	chr22	43288829	43289863	1034	517.0	
94906	chr22	43293726	43294132	406	203.0	
94907	chr22	43342528	43344016	1488	744.0	
94908	chr22	43345755	43347841	2086	1043.0	
94909	chr22	43376655	43377367	712	356.0	
94910	chr22	43378423	43378649	226	113.0	
94911	chr22	43381787	43381996	209	104.0	
94912	chr22	43385458	43386322	864	432.0	
94913	chr22	43388243	43388760	517	258.0	
94914	chr22	43479983	43480312	329	164.0	
94915	chr22	43481485	43482221	736	368.0	
94916	chr22	43811615	43813173	1558	779.0	
94917	chr22	43883084	43883448	364	182.0	
94918	chr22	43884990	43885339	349	174.0	
94919	chr22	43923110	43924543	1433	716.0	
94920	chr22	43928347	43928897	550	275.0	
94921	chr22	43945666	43946463	797	398.0	
94922	chr22	43954279	43956519	2240	1120.0	
94923	chr22	43993034	43993792	758	379.0	
94924	chr22	43995673	43996932	1259	630.0	
94925	chr22	44005357	44005996	639	320.0	
94926	chr22	44023531	44027735	4204	2102.0	
94927	chr22	44030707	44031766	1059	530.0	
94928	chr22	44042320	44042556	236	118.0	
94929	chr22	44048029	44048123	94	47.0	
94930	chr22	44049887	44050052	165	82.0	
94931	chr22	44067978	44069507	1529	764.0	
94932	chr22	44080942	44081781	839	420.0	
94933	chr22	44085674	44086111	437	218.0	
94934	chr22	44091360	44091461	101	50.0	
94935	chr22	44116637	44117012	375	188.0	
94936	chr22	44127387	44127846	459	230.0	
94937	chr22	44129165	44129180	15	8.0	
94938	chr22	44154500	44154809	309	154.0	
94939	chr22	44171553	44173200	1647	824.0	
94940	chr22	44180043	44183492	3449	1724.0	
94941	chr22	44190940	44191531	591	296.0	
94942	chr22	44192192	44193138	946	473.0	
94943	chr22	44211409	44211946	537	268.0	
94944	chr22	44309164	44309452	288	144.0	
94945	chr22	44329460	44329684	224	112.0	
94946	chr22	44449316	44449727	411	206.0	
94947	chr22	44455050	44456135	1085	542.0	
94948	chr22	44492955	44493844	889	444.0	
94949	chr22	44496315	44499041	2726	1363.0	
94950	chr22	44551032	44551740	708	354.0	
94951	chr22	44558762	44558979	217	108.0	
94952	chr22	44567908	44568259	351	176.0	
94953	chr22	44586967	44587318	351	176.0	
94954	chr22	44595833	44596215	382	191.0	
94955	chr22	44603711	44604273	562	281.0	
94956	chr22	44605447	44605936	489	244.0	
94957	chr22	44616777	44617460	683	342.0	
94958	chr22	44618284	44618683	399	200.0	
94959	chr22	44619708	44621323	1615	808.0	
94960	chr22	44621987	44622490	503	252.0	
94961	chr22	44623642	44624301	659	330.0	
94962	chr22	44625800	44626781	981	490.0	
94963	chr22	44632785	44633458	673	336.0	
94964	chr22	44652186	44653383	1197	598.0	
94965	chr22	44663711	44665610	1899	950.0	
94966	chr22	44667158	44670118	2960	1480.0	
94967	chr22	44671638	44672341	703	352.0	
94968	chr22	44676806	44677621	815	408.0	
94969	chr22	44684301	44686211	1910	955.0	
94970	chr22	44697172	44698195	1023	512.0	
94971	chr22	44701317	44703214	1897	948.0	
94972	chr22	44709181	44711686	2505	1252.0	
94973	chr22	44718253	44718940	687	344.0	
94974	chr22	44721313	44721554	241	120.0	
94975	chr22	44723985	44723988	3	2.0	
94976	chr22	44729365	44730066	701	350.0	
94977	chr22	44735578	44736490	912	456.0	
94978	chr22	44752318	44753128	810	405.0	
94979	chr22	44820617	44820983	366	183.0	
94980	chr22	44975512	44975960	448	224.0	
94981	chr22	45096218	45096658	440	220.0	
94982	chr22	45101787	45102349	562	281.0	
94983	chr22	45129535	45130340	805	402.0	
94984	chr22	45130848	45132223	1375	688.0	
94985	chr22	45155374	45155775	401	200.0	
94986	chr22	45158717	45160200	1483	742.0	
94987	chr22	45162596	45165510	2914	1457.0	
94988	chr22	45166965	45167334	369	184.0	
94989	chr22	45169962	45170288	326	163.0	
94990	chr22	45172808	45173376	568	284.0	
94991	chr22	45179246	45179693	447	224.0	
94992	chr22	45209098	45209657	559	280.0	
94993	chr22	45212929	45214080	1151	576.0	
94994	chr22	45218983	45219461	478	239.0	
94995	chr22	45225768	45228764	2996	1498.0	
94996	chr22	45230132	45230908	776	388.0	
94997	chr22	45234883	45236180	1297	648.0	
94998	chr22	45238687	45243089	4402	2201.0	
94999	chr22	45246430	45247370	940	470.0	
95000	chr22	45249177	45249962	785	392.0	
95001	chr22	45251829	45252128	299	150.0	
95002	chr22	45254630	45255380	750	375.0	
95003	chr22	45261898	45264229	2331	1166.0	
95004	chr22	45267893	45270640	2747	1374.0	
95005	chr22	45271872	45272357	485	242.0	
95006	chr22	45279596	45280310	714	357.0	
95007	chr22	45284543	45285469	926	463.0	
95008	chr22	45287829	45288515	686	343.0	
95009	chr22	45290712	45291494	782	391.0	
95010	chr22	45292684	45293448	764	382.0	
95011	chr22	45296421	45297349	928	464.0	
95012	chr22	45301943	45302491	548	274.0	
95013	chr22	45308660	45311290	2630	1315.0	
95014	chr22	45311802	45311847	45	22.0	
95015	chr22	45314090	45314711	621	310.0	
95016	chr22	45315832	45320889	5057	2528.0	
95017	chr22	45322875	45323207	332	166.0	
95018	chr22	45328564	45329169	605	302.0	
95019	chr22	45336890	45337418	528	264.0	
95020	chr22	45376689	45377205	516	258.0	
95021	chr22	45398070	45398119	49	24.0	
95022	chr22	45413239	45414341	1102	551.0	
95023	chr22	45421609	45422917	1308	654.0	
95024	chr22	45424073	45424811	738	369.0	
95025	chr22	45430158	45430481	323	162.0	
95026	chr22	45434915	45436284	1369	684.0	
95027	chr22	45436868	45437399	531	266.0	
95028	chr22	45441010	45441535	525	262.0	
95029	chr22	45551938	45551991	53	26.0	
95030	chr22	45553718	45554182	464	232.0	
95031	chr22	45577949	45578433	484	242.0	
95032	chr22	45584110	45584362	252	126.0	
95033	chr22	45604359	45604792	433	216.0	
95034	chr22	45608886	45609228	342	171.0	
95035	chr22	45612432	45613025	593	296.0	
95036	chr22	45638769	45639915	1146	573.0	
95037	chr22	45645331	45646258	927	464.0	
95038	chr22	45671235	45672903	1668	834.0	
95039	chr22	45683095	45684544	1449	724.0	
95040	chr22	45742916	45743260	344	172.0	
95041	chr22	45863857	45864406	549	274.0	
95042	chr22	45911824	45911970	146	73.0	
95043	chr22	45948085	45948479	394	197.0	
95044	chr22	45977003	45979678	2675	1338.0	
95045	chr22	45984433	45984714	281	140.0	
95046	chr22	45993594	45995432	1838	919.0	
95047	chr22	45996021	45998240	2219	1110.0	
95048	chr22	46000995	46001331	336	168.0	
95049	chr22	46002801	46003150	349	174.0	
95050	chr22	46004087	46004907	820	410.0	
95051	chr22	46006072	46007542	1470	735.0	
95052	chr22	46013055	46014584	1529	764.0	
95053	chr22	46027227	46027750	523	262.0	
95054	chr22	46035239	46037367	2128	1064.0	
95055	chr22	46043785	46046221	2436	1218.0	
95056	chr22	46047532	46048613	1081	540.0	
95057	chr22	46050212	46050583	371	186.0	
95058	chr22	46052698	46055611	2913	1456.0	
95059	chr22	46057812	46058572	760	380.0	
95060	chr22	46069084	46072843	3759	1880.0	
95061	chr22	46114502	46114990	488	244.0	
95062	chr22	46115990	46117168	1178	589.0	
95063	chr22	46122171	46123374	1203	602.0	
95064	chr22	46128971	46130262	1291	646.0	
95065	chr22	46146729	46152100	5371	2686.0	
95066	chr22	46233317	46233710	393	196.0	
95067	chr22	46239473	46240876	1403	702.0	
95068	chr22	46242113	46242514	401	200.0	
95069	chr22	46249565	46251513	1948	974.0	
95070	chr22	46262374	46263351	977	488.0	
95071	chr22	46267343	46268588	1245	622.0	
95072	chr22	46277085	46277481	396	198.0	
95073	chr22	46280280	46281749	1469	734.0	
95074	chr22	46287979	46291067	3088	1544.0	
95075	chr22	46293559	46294002	443	222.0	
95076	chr22	46295722	46297655	1933	966.0	
95077	chr22	46314170	46314698	528	264.0	
95078	chr22	46335070	46336736	1666	833.0	
95079	chr22	46355308	46355878	570	285.0	
95080	chr22	46362258	46362601	343	172.0	
95081	chr22	46366834	46368218	1384	692.0	
95082	chr22	46369936	46371595	1659	830.0	
95083	chr22	46373085	46374860	1775	888.0	
95084	chr22	46393936	46394215	279	140.0	
95085	chr22	46403758	46404328	570	285.0	
95086	chr22	46421047	46421811	764	382.0	
95087	chr22	46432219	46433815	1596	798.0	
95088	chr22	46476377	46477053	676	338.0	
95089	chr22	46488032	46488596	564	282.0	
95090	chr22	46527989	46528590	601	300.0	
95091	chr22	46537104	46537987	883	442.0	
95092	chr22	46542213	46542900	687	344.0	
95093	chr22	46547879	46548253	374	187.0	
95094	chr22	46562406	46564142	1736	868.0	
95095	chr22	46573837	46574414	577	288.0	
95096	chr22	46575598	46578835	3237	1618.0	
95097	chr22	46587072	46588158	1086	543.0	
95098	chr22	46592276	46593954	1678	839.0	
95099	chr22	46598814	46599605	791	396.0	
95100	chr22	46600315	46600633	318	159.0	
95101	chr22	46601908	46602634	726	363.0	
95102	chr22	46603855	46604884	1029	514.0	
95103	chr22	46612331	46615074	2743	1372.0	
95104	chr22	46617047	46617818	771	386.0	
95105	chr22	46619872	46620549	677	338.0	
95106	chr22	46622003	46622776	773	386.0	
95107	chr22	46623610	46623638	28	14.0	
95108	chr22	46624191	46624493	302	151.0	
95109	chr22	46653670	46653817	147	74.0	
95110	chr22	46660551	46661904	1353	676.0	
95111	chr22	46672104	46672364	260	130.0	
95112	chr22	46673799	46675478	1679	840.0	
95113	chr22	46678000	46678062	62	31.0	
95114	chr22	46681305	46681364	59	30.0	
95115	chr22	46683520	46685594	2074	1037.0	
95116	chr22	46686439	46686861	422	211.0	
95117	chr22	46689232	46689245	13	6.0	
95118	chr22	46696024	46696432	408	204.0	
95119	chr22	46731093	46731432	339	170.0	
95120	chr22	46734732	46739888	5156	2578.0	
95121	chr22	46748816	46750432	1616	808.0	
95122	chr22	46753761	46754957	1196	598.0	
95123	chr22	46758035	46759379	1344	672.0	
95124	chr22	46761131	46763664	2533	1266.0	
95125	chr22	46764306	46764542	236	118.0	
95126	chr22	46768233	46769695	1462	731.0	
95127	chr22	46770410	46771218	808	404.0	
95128	chr22	46772962	46775313	2351	1176.0	
95129	chr22	46776757	46778119	1362	681.0	
95130	chr22	46788385	46789059	674	337.0	
95131	chr22	46790801	46792235	1434	717.0	
95132	chr22	46798309	46799190	881	440.0	
95133	chr22	46802876	46803928	1052	526.0	
95134	chr22	46816401	46816817	416	208.0	
95135	chr22	46853827	46854862	1035	518.0	
95136	chr22	46933505	46933807	302	151.0	
95137	chr22	46942178	46943416	1238	619.0	
95138	chr22	46971382	46971520	138	69.0	
95139	chr22	47090606	47091595	989	494.0	
95140	chr22	47129900	47130265	365	182.0	
95141	chr22	47193181	47193420	239	120.0	
95142	chr22	47213651	47213949	298	149.0	
95143	chr22	47494921	47495715	794	397.0	
95144	chr22	48084163	48084538	375	188.0	
95145	chr22	48097669	48099310	1641	820.0	
95146	chr22	48185584	48186000	416	208.0	
95147	chr22	48241683	48242112	429	214.0	
95148	chr22	48492410	48492788	378	189.0	
95149	chr22	48702625	48702899	274	137.0	
95150	chr22	48832692	48832947	255	128.0	
95151	chr22	48912808	48912854	46	23.0	
95152	chr22	49052202	49052645	443	222.0	
95153	chr22	49656831	49658308	1477	738.0	
95154	chr22	49667096	49667587	491	246.0	
95155	chr22	49669814	49671523	1709	854.0	
95156	chr22	49705688	49706069	381	190.0	
95157	chr22	49724117	49725271	1154	577.0	
95158	chr22	49760790	49761440	650	325.0	
95159	chr22	49767213	49767924	711	356.0	
95160	chr22	49772073	49772160	87	44.0	
95161	chr22	49784982	49785680	698	349.0	
95162	chr22	49788463	49790080	1617	808.0	
95163	chr22	49803154	49803206	52	26.0	
95164	chr22	49807850	49808595	745	372.0	
95165	chr22	49810650	49811580	930	465.0	
95166	chr22	49812615	49813029	414	207.0	
95167	chr22	49815883	49815897	14	7.0	
95168	chr22	49824872	49828788	3916	1958.0	
95169	chr22	49829428	49830353	925	462.0	
95170	chr22	49834646	49834929	283	142.0	
95171	chr22	49838434	49839909	1475	738.0	
95172	chr22	49848004	49850157	2153	1076.0	
95173	chr22	49852720	49856182	3462	1731.0	
95174	chr22	49861795	49862811	1016	508.0	
95175	chr22	49863947	49864301	354	177.0	
95176	chr22	49867693	49868501	808	404.0	
95177	chr22	49869008	49870844	1836	918.0	
95178	chr22	49880336	49880691	355	178.0	
95179	chr22	49916689	49919363	2674	1337.0	
95180	chr22	49925020	49926550	1530	765.0	
95181	chr22	49928754	49931871	3117	1558.0	
95182	chr22	49932922	49938689	5767	2884.0	
95183	chr22	49943025	49946083	3058	1529.0	
95184	chr22	49950830	49951627	797	398.0	
95185	chr22	49953174	49954089	915	458.0	
95186	chr22	49955967	49955990	23	12.0	
95187	chr22	49956899	49971129	14230	7115.0	
95188	chr22	49979552	49980019	467	234.0	
95189	chr22	49982993	49984251	1258	629.0	
95190	chr22	49993086	49993968	882	441.0	
95191	chr22	49999223	50000140	917	458.0	
95192	chr22	50010413	50011757	1344	672.0	
95193	chr22	50014942	50015456	514	257.0	
95194	chr22	50018743	50019318	575	288.0	
95195	chr22	50027746	50028333	587	294.0	
95196	chr22	50029711	50030909	1198	599.0	
95197	chr22	50034783	50035444	661	330.0	
95198	chr22	50084693	50086287	1594	797.0	
95199	chr22	50089635	50090102	467	234.0	
95200	chr22	50105735	50106120	385	192.0	
95201	chr22	50112013	50113001	988	494.0	
95202	chr22	50148820	50149753	933	466.0	
95203	chr22	50169603	50170714	1111	556.0	
95204	chr22	50173165	50173837	672	336.0	
95205	chr22	50183888	50187838	3950	1975.0	
95206	chr22	50188566	50193790	5224	2612.0	
95207	chr22	50194655	50195581	926	463.0	
95208	chr22	50196172	50196204	32	16.0	
95209	chr22	50199331	50202277	2946	1473.0	
95210	chr22	50204532	50205217	685	342.0	
95211	chr22	50206609	50207983	1374	687.0	
95212	chr22	50209434	50210425	991	496.0	
95213	chr22	50215401	50215544	143	72.0	
95214	chr22	50216497	50216762	265	132.0	
95215	chr22	50218137	50220193	2056	1028.0	
95216	chr22	50221232	50222338	1106	553.0	
95217	chr22	50237129	50237398	269	134.0	
95218	chr22	50241010	50241918	908	454.0	
95219	chr22	50243550	50246060	2510	1255.0	
95220	chr22	50246568	50246918	350	175.0	
95221	chr22	50247503	50248467	964	482.0	
95222	chr22	50250344	50253246	2902	1451.0	
95223	chr22	50253868	50254151	283	142.0	
95224	chr22	50260747	50262962	2215	1108.0	
95225	chr22	50265633	50265753	120	60.0	
95226	chr22	50267501	50268455	954	477.0	
95227	chr22	50269446	50272696	3250	1625.0	
95228	chr22	50274172	50274820	648	324.0	
95229	chr22	50275878	50276999	1121	560.0	
95230	chr22	50282409	50282820	411	206.0	
95231	chr22	50292246	50294578	2332	1166.0	
95232	chr22	50299235	50300378	1143	572.0	
95233	chr22	50301640	50302783	1143	572.0	
95234	chr22	50303384	50309456	6072	3036.0	
95235	chr22	50314115	50315702	1587	794.0	
95236	chr22	50326451	50327985	1534	767.0	
95237	chr22	50338427	50341042	2615	1308.0	
95238	chr22	50341862	50343925	2063	1032.0	
95239	chr22	50346429	50346537	108	54.0	
95240	chr22	50376208	50376627	419	210.0	
95241	chr22	50381585	50382175	590	295.0	
95242	chr22	50384462	50385002	540	270.0	
95243	chr22	50398658	50400650	1992	996.0	
95244	chr22	50403193	50404110	917	458.0	
95245	chr22	50435584	50435999	415	208.0	
95246	chr22	50437810	50438278	468	234.0	
95247	chr22	50438800	50440941	2141	1070.0	
95248	chr22	50441497	50442527	1030	515.0	
95249	chr22	50443119	50446261	3142	1571.0	
95250	chr22	50446933	50447295	362	181.0	
95251	chr22	50447860	50448313	453	226.0	
95252	chr22	50449442	50450131	689	344.0	
95253	chr22	50453187	50454618	1431	716.0	
95254	chr22	50456823	50457183	360	180.0	
95255	chr22	50459559	50459938	379	190.0	
95256	chr22	50467431	50471550	4119	2060.0	
95257	chr22	50472914	50475998	3084	1542.0	
95258	chr22	50479801	50480107	306	153.0	
95259	chr22	50480960	50482602	1642	821.0	
95260	chr22	50490823	50491407	584	292.0	
95261	chr22	50497932	50498982	1050	525.0	
95262	chr22	50506757	50509124	2367	1184.0	
95263	chr22	50519346	50519504	158	79.0	
95264	chr22	50520945	50521780	835	418.0	
95265	chr22	50522597	50535468	12871	6436.0	
95266	chr22	50537856	50543101	5245	2622.0	"enhancer	sequence_feature"
95267	chr22	50543734	50546476	2742	1371.0	
95268	chr22	50547590	50549461	1871	936.0	
95269	chr22	50561170	50563921	2751	1376.0	
95270	chr22	50577459	50577566	107	54.0	
95271	chr22	50581313	50583872	2559	1280.0	
95272	chr22	50599893	50601051	1158	579.0	
95273	chr22	50612499	50613120	621	310.0	
95274	chr22	50619915	50622954	3039	1520.0	
95275	chr22	50627248	50629342	2094	1047.0	
95276	chr22	50672679	50675650	2971	1486.0	
95277	chr22	50687156	50687762	606	303.0	
95278	chr22	50691535	50691908	373	186.0	
95279	chr22	50732070	50732563	493	246.0	
95280	chr22	50756693	50757563	870	435.0	
95281	chr22	50783088	50784269	1181	590.0	
95282	chrX	10072	10472	400	200.0	
95283	chrX	19812	20256	444	222.0	
95284	chrX	249197	249875	678	339.0	
95285	chrX	250931	251761	830	415.0	
95286	chrX	274715	277346	2631	1316.0	
95287	chrX	282919	283955	1036	518.0	
95288	chrX	320649	321184	535	268.0	
95289	chrX	322446	323908	1462	731.0	
95290	chrX	324918	325008	90	45.0	
95291	chrX	331022	331697	675	338.0	
95292	chrX	339262	339298	36	18.0	
95293	chrX	357377	358124	747	374.0	
95294	chrX	373653	374212	559	280.0	
95295	chrX	386110	388022	1912	956.0	
95296	chrX	989849	990710	861	430.0	
95297	chrX	1026251	1026693	442	221.0	
95298	chrX	1123678	1123986	308	154.0	
95299	chrX	1157552	1157884	332	166.0	
95300	chrX	1205558	1206743	1185	592.0	
95301	chrX	1208148	1208955	807	404.0	
95302	chrX	1212463	1212971	508	254.0	
95303	chrX	1215030	1215720	690	345.0	
95304	chrX	1222423	1223437	1014	507.0	
95305	chrX	1232184	1232401	217	108.0	
95306	chrX	1239478	1240445	967	484.0	
95307	chrX	1242953	1243485	532	266.0	
95308	chrX	1244664	1245059	395	198.0	
95309	chrX	1246472	1247350	878	439.0	
95310	chrX	1248264	1250115	1851	926.0	
95311	chrX	1252908	1253214	306	153.0	
95312	chrX	1268457	1269761	1304	652.0	
95313	chrX	1273777	1275336	1559	780.0	
95314	chrX	1279449	1280172	723	362.0	
95315	chrX	1292641	1292971	330	165.0	
95316	chrX	1306680	1307226	546	273.0	
95317	chrX	1316276	1317216	940	470.0	
95318	chrX	1320109	1320738	629	314.0	
95319	chrX	1322429	1323733	1304	652.0	
95320	chrX	1325551	1325996	445	222.0	
95321	chrX	1330515	1331056	541	270.0	
95322	chrX	1332860	1335282	2422	1211.0	
95323	chrX	1335943	1337482	1539	770.0	
95324	chrX	1339709	1340193	484	242.0	
95325	chrX	1341456	1342270	814	407.0	
95326	chrX	1355419	1355895	476	238.0	
95327	chrX	1359314	1359446	132	66.0	
95328	chrX	1378461	1378643	182	91.0	
95329	chrX	1380651	1384153	3502	1751.0	
95330	chrX	1384854	1388226	3372	1686.0	
95331	chrX	1391082	1393242	2160	1080.0	
95332	chrX	1401275	1401336	61	30.0	
95333	chrX	1435035	1436090	1055	528.0	
95334	chrX	1445289	1447561	2272	1136.0	
95335	chrX	1448984	1450234	1250	625.0	
95336	chrX	1450853	1454734	3881	1940.0	
95337	chrX	1462383	1465476	3093	1546.0	
95338	chrX	1466529	1472631	6102	3051.0	
95339	chrX	1480026	1482752	2726	1363.0	
95340	chrX	1483832	1484915	1083	542.0	
95341	chrX	1491882	1494668	2786	1393.0	
95342	chrX	1500700	1502744	2044	1022.0	
95343	chrX	1503943	1505686	1743	872.0	
95344	chrX	1507235	1508561	1326	663.0	
95345	chrX	1516206	1517904	1698	849.0	
95346	chrX	1521273	1522735	1462	731.0	
95347	chrX	1531388	1531449	61	30.0	
95348	chrX	1534149	1538248	4099	2050.0	
95349	chrX	1546897	1546948	51	26.0	
95350	chrX	1554378	1555680	1302	651.0	
95351	chrX	1570251	1571412	1161	580.0	
95352	chrX	1576271	1577091	820	410.0	
95353	chrX	1580938	1581597	659	330.0	
95354	chrX	1583010	1583442	432	216.0	
95355	chrX	1589460	1590516	1056	528.0	
95356	chrX	1591087	1593528	2441	1220.0	
95357	chrX	1620981	1621431	450	225.0	
95358	chrX	1648375	1649188	813	406.0	
95359	chrX	1652091	1652894	803	402.0	
95360	chrX	1657002	1658709	1707	854.0	
95361	chrX	1660858	1662564	1706	853.0	
95362	chrX	1673207	1673700	493	246.0	
95363	chrX	1679251	1679790	539	270.0	
95364	chrX	1681799	1682447	648	324.0	
95365	chrX	2233312	2233410	98	49.0	
95366	chrX	2320454	2321763	1309	654.0	
95367	chrX	2325012	2325522	510	255.0	
95368	chrX	2373675	2374056	381	190.0	
95369	chrX	2430203	2430761	558	279.0	
95370	chrX	2497162	2497631	469	234.0	
95371	chrX	2498550	2499388	838	419.0	
95372	chrX	2500015	2503474	3459	1730.0	
95373	chrX	2516632	2516960	328	164.0	
95374	chrX	2521107	2522358	1251	626.0	
95375	chrX	2593214	2593919	705	352.0	
95376	chrX	2608244	2611115	2871	1436.0	
95377	chrX	2614589	2615404	815	408.0	
95378	chrX	2627231	2627705	474	237.0	
95379	chrX	2628652	2632885	4233	2116.0	
95380	chrX	2638307	2638610	303	152.0	
95381	chrX	2644191	2644977	786	393.0	
95382	chrX	2658625	2658956	331	166.0	
95383	chrX	2690125	2695002	4877	2438.0	
95384	chrX	2696273	2698660	2387	1194.0	
95385	chrX	2701498	2702117	619	310.0	
95386	chrX	2703324	2704343	1019	510.0	
95387	chrX	2707033	2711056	4023	2012.0	
95388	chrX	2766934	2768066	1132	566.0	
95389	chrX	2812627	2812794	167	84.0	
95390	chrX	2889693	2889860	167	84.0	
95391	chrX	2897749	2898500	751	376.0	
95392	chrX	2927751	2929635	1884	942.0	
95393	chrX	2935302	2935768	466	233.0	
95394	chrX	3035780	3036079	299	150.0	
95395	chrX	3252769	3253101	332	166.0	
95396	chrX	3638294	3638661	367	184.0	
95397	chrX	3651254	3651655	401	200.0	
95398	chrX	3663524	3664301	777	388.0	
95399	chrX	3695291	3695448	157	78.0	
95400	chrX	3697234	3697449	215	108.0	
95401	chrX	3699637	3700535	898	449.0	
95402	chrX	3705327	3705935	608	304.0	
95403	chrX	3707614	3708402	788	394.0	
95404	chrX	3711042	3714429	3387	1694.0	
95405	chrX	3743537	3744457	920	460.0	
95406	chrX	3785862	3786260	398	199.0	
95407	chrX	3811486	3812414	928	464.0	
95408	chrX	3814190	3817245	3055	1528.0	
95409	chrX	3842847	3843191	344	172.0	
95410	chrX	4240571	4241279	708	354.0	
95411	chrX	4909301	4909885	584	292.0	
95412	chrX	4935535	4936636	1101	550.0	
95413	chrX	5051797	5052216	419	210.0	
95414	chrX	5306704	5306929	225	112.0	
95415	chrX	6738838	6739273	435	218.0	
95416	chrX	7059292	7059692	400	200.0	
95417	chrX	7069039	7069342	303	152.0	
95418	chrX	7083660	7084598	938	469.0	
95419	chrX	7088957	7089400	443	222.0	
95420	chrX	7132414	7133503	1089	544.0	
95421	chrX	7146718	7148983	2265	1132.0	
95422	chrX	7170897	7171280	383	192.0	
95423	chrX	7244232	7244865	633	316.0	
95424	chrX	7247372	7247817	445	222.0	
95425	chrX	7252187	7252588	401	200.0	
95426	chrX	7261616	7262083	467	234.0	
95427	chrX	7270103	7270423	320	160.0	
95428	chrX	7273352	7273389	37	18.0	
95429	chrX	7373003	7373057	54	27.0	
95430	chrX	7925809	7928144	2335	1168.0	
95431	chrX	8037874	8037939	65	32.0	
95432	chrX	8743160	8743500	340	170.0	
95433	chrX	8749050	8749198	148	74.0	
95434	chrX	8783044	8783469	425	212.0	
95435	chrX	8815463	8815827	364	182.0	
95436	chrX	8961048	8961437	389	194.0	
95437	chrX	8971129	8971512	383	192.0	
95438	chrX	8987567	8988304	737	368.0	
95439	chrX	9055250	9055767	517	258.0	
95440	chrX	9091176	9091751	575	288.0	
95441	chrX	9122514	9122978	464	232.0	
95442	chrX	9144925	9145320	395	198.0	
95443	chrX	9165853	9166409	556	278.0	
95444	chrX	9205572	9206212	640	320.0	
95445	chrX	9278973	9279581	608	304.0	
95446	chrX	9282316	9282685	369	184.0	
95447	chrX	9286239	9286622	383	192.0	
95448	chrX	9313128	9313679	551	276.0	
95449	chrX	9315891	9316866	975	488.0	
95450	chrX	9318176	9318559	383	192.0	
95451	chrX	9339756	9343195	3439	1720.0	
95452	chrX	9351164	9353498	2334	1167.0	
95453	chrX	9355686	9356204	518	259.0	
95454	chrX	9369678	9370299	621	310.0	
95455	chrX	9370976	9371002	26	13.0	
95456	chrX	9376164	9376517	353	176.0	
95457	chrX	9378885	9379470	585	292.0	
95458	chrX	9442287	9442399	112	56.0	
95459	chrX	9454002	9454787	785	392.0	
95460	chrX	9456170	9457176	1006	503.0	
95461	chrX	9458109	9458389	280	140.0	
95462	chrX	9462522	9466675	4153	2076.0	
95463	chrX	9475564	9475692	128	64.0	
95464	chrX	9530673	9531380	707	354.0	
95465	chrX	9533688	9533976	288	144.0	
95466	chrX	9644236	9644798	562	281.0	
95467	chrX	9672160	9672357	197	98.0	
95468	chrX	9677036	9677883	847	424.0	
95469	chrX	9708656	9709408	752	376.0	
95470	chrX	9873921	9874389	468	234.0	
95471	chrX	9885116	9885571	455	228.0	
95472	chrX	9942017	9942575	558	279.0	
95473	chrX	9981378	9981957	579	290.0	
95474	chrX	9986632	9987234	602	301.0	
95475	chrX	9995704	9996390	686	343.0	
95476	chrX	9997555	9997930	375	188.0	
95477	chrX	10003593	10004163	570	285.0	
95478	chrX	10007598	10007994	396	198.0	
95479	chrX	10011048	10012042	994	497.0	
95480	chrX	10014094	10016387	2293	1146.0	
95481	chrX	10077580	10077869	289	144.0	
95482	chrX	10082637	10083737	1100	550.0	
95483	chrX	10085187	10085673	486	243.0	
95484	chrX	10097556	10099273	1717	858.0	
95485	chrX	10106757	10107335	578	289.0	
95486	chrX	10108505	10108688	183	92.0	
95487	chrX	10110385	10112234	1849	924.0	
95488	chrX	10117966	10118357	391	196.0	
95489	chrX	10118984	10120180	1196	598.0	
95490	chrX	10120742	10122292	1550	775.0	
95491	chrX	10156313	10157152	839	420.0	
95492	chrX	10158301	10158671	370	185.0	
95493	chrX	10165457	10166082	625	312.0	
95494	chrX	10166771	10167388	617	308.0	
95495	chrX	10168235	10168647	412	206.0	
95496	chrX	10171279	10171680	401	200.0	
95497	chrX	10176200	10176504	304	152.0	
95498	chrX	10189539	10190804	1265	632.0	
95499	chrX	10198240	10199777	1537	768.0	
95500	chrX	10217188	10217589	401	200.0	
95501	chrX	10810963	10811665	702	351.0	
95502	chrX	11110846	11112538	1692	846.0	
95503	chrX	11113606	11114178	572	286.0	
95504	chrX	11131155	11131504	349	174.0	
95505	chrX	11137574	11137883	309	154.0	
95506	chrX	11144199	11144708	509	254.0	
95507	chrX	11341296	11342373	1077	538.0	
95508	chrX	11350858	11351604	746	373.0	
95509	chrX	11362957	11363457	500	250.0	
95510	chrX	11381506	11381813	307	154.0	
95511	chrX	11423315	11423719	404	202.0	
95512	chrX	11427321	11427741	420	210.0	
95513	chrX	11431772	11432128	356	178.0	
95514	chrX	11532994	11533644	650	325.0	
95515	chrX	11541050	11541374	324	162.0	
95516	chrX	11558950	11559349	399	200.0	
95517	chrX	11724415	11724790	375	188.0	
95518	chrX	11750051	11750385	334	167.0	
95519	chrX	11756977	11760436	3459	1730.0	
95520	chrX	11766724	11766840	116	58.0	
95521	chrX	11768233	11768341	108	54.0	
95522	chrX	11770026	11770892	866	433.0	
95523	chrX	11774513	11774933	420	210.0	
95524	chrX	11787457	11787970	513	256.0	
95525	chrX	11792649	11793414	765	382.0	
95526	chrX	11824884	11825412	528	264.0	
95527	chrX	11908416	11908720	304	152.0	
95528	chrX	12610056	12610372	316	158.0	
95529	chrX	12770459	12771931	1472	736.0	
95530	chrX	12790816	12792399	1583	792.0	
95531	chrX	12814402	12814864	462	231.0	
95532	chrX	12865357	12865674	317	158.0	
95533	chrX	12866706	12867974	1268	634.0	
95534	chrX	12890386	12890934	548	274.0	
95535	chrX	12892743	12892934	191	96.0	
95536	chrX	12894023	12894479	456	228.0	
95537	chrX	12896853	12897405	552	276.0	
95538	chrX	12901456	12901948	492	246.0	
95539	chrX	12903597	12904047	450	225.0	
95540	chrX	12906057	12906843	786	393.0	
95541	chrX	12910634	12911171	537	268.0	
95542	chrX	12919043	12919435	392	196.0	
95543	chrX	12946668	12947538	870	435.0	
95544	chrX	12948302	12948310	8	4.0	
95545	chrX	12949604	12952010	2406	1203.0	
95546	chrX	12953402	12953779	377	188.0	
95547	chrX	12954310	12958332	4022	2011.0	
95548	chrX	12961191	12961615	424	212.0	
95549	chrX	12966885	12968478	1593	796.0	
95550	chrX	12970281	12980565	10284	5142.0	
95551	chrX	12981738	12982408	670	335.0	
95552	chrX	12984571	12985552	981	490.0	
95553	chrX	12999308	13000949	1641	820.0	
95554	chrX	13002201	13002314	113	56.0	
95555	chrX	13004081	13004780	699	350.0	
95556	chrX	13005543	13006412	869	434.0	
95557	chrX	13013399	13014260	861	430.0	
95558	chrX	13015776	13017093	1317	658.0	
95559	chrX	13026933	13027307	374	187.0	
95560	chrX	13029281	13029690	409	204.0	
95561	chrX	13030414	13030812	398	199.0	
95562	chrX	13051324	13052234	910	455.0	
95563	chrX	13074501	13075255	754	377.0	
95564	chrX	13077106	13077597	491	246.0	
95565	chrX	13078807	13079737	930	465.0	
95566	chrX	13081516	13082671	1155	578.0	
95567	chrX	13085445	13085991	546	273.0	
95568	chrX	13086766	13088604	1838	919.0	
95569	chrX	13090034	13094052	4018	2009.0	
95570	chrX	13101596	13102216	620	310.0	
95571	chrX	13123949	13124078	129	64.0	
95572	chrX	13128158	13128455	297	148.0	
95573	chrX	13131684	13132301	617	308.0	
95574	chrX	13151647	13152412	765	382.0	
95575	chrX	13167451	13168411	960	480.0	
95576	chrX	13283660	13283930	270	135.0	
95577	chrX	13305143	13305484	341	170.0	
95578	chrX	13473594	13474548	954	477.0	
95579	chrX	13483795	13484127	332	166.0	
95580	chrX	13486864	13488625	1761	880.0	
95581	chrX	13491128	13491403	275	138.0	
95582	chrX	13506575	13506998	423	212.0	
95583	chrX	13646069	13646391	322	161.0	
95584	chrX	13647560	13648727	1167	584.0	
95585	chrX	13652368	13653976	1608	804.0	
95586	chrX	13658575	13659517	942	471.0	
95587	chrX	13669078	13669814	736	368.0	
95588	chrX	13688289	13690143	1854	927.0	
95589	chrX	13690827	13694015	3188	1594.0	
95590	chrX	13697412	13698065	653	326.0	
95591	chrX	13699472	13699819	347	174.0	
95592	chrX	13716439	13717392	953	476.0	
95593	chrX	13719143	13719646	503	252.0	
95594	chrX	13724788	13725715	927	464.0	
95595	chrX	13733709	13735542	1833	916.0	
95596	chrX	13736323	13736821	498	249.0	
95597	chrX	13742371	13743341	970	485.0	
95598	chrX	13747806	13748262	456	228.0	
95599	chrX	13750168	13750668	500	250.0	
95600	chrX	13752631	13753096	465	232.0	
95601	chrX	13754793	13755561	768	384.0	
95602	chrX	13758981	13759786	805	402.0	
95603	chrX	13760475	13760813	338	169.0	
95604	chrX	13764273	13764691	418	209.0	
95605	chrX	13938334	13938434	100	50.0	
95606	chrX	14027518	14028121	603	302.0	
95607	chrX	14029196	14030640	1444	722.0	
95608	chrX	14032018	14033195	1177	588.0	
95609	chrX	14038530	14039790	1260	630.0	
95610	chrX	14095634	14096040	406	203.0	
95611	chrX	14497044	14497789	745	372.0	
95612	chrX	14819672	14820333	661	330.0	
95613	chrX	14851504	14852230	726	363.0	
95614	chrX	14872632	14874049	1417	708.0	
95615	chrX	14875166	14875800	634	317.0	
95616	chrX	14899712	14900040	328	164.0	
95617	chrX	15107487	15107752	265	132.0	
95618	chrX	15142350	15143709	1359	680.0	
95619	chrX	15150669	15150944	275	138.0	
95620	chrX	15151465	15151988	523	262.0	
95621	chrX	15158542	15159360	818	409.0	
95622	chrX	15242927	15243309	382	191.0	
95623	chrX	15269583	15270360	777	388.0	
95624	chrX	15301783	15302445	662	331.0	
95625	chrX	15321376	15321918	542	271.0	
95626	chrX	15334438	15336685	2247	1124.0	
95627	chrX	15349030	15349452	422	211.0	
95628	chrX	15366461	15366913	452	226.0	
95629	chrX	15467998	15468411	413	206.0	
95630	chrX	15470960	15471548	588	294.0	
95631	chrX	15493069	15493848	779	390.0	
95632	chrX	15497858	15498296	438	219.0	
95633	chrX	15565257	15565558	301	150.0	
95634	chrX	15674198	15677330	3132	1566.0	enhancer
95635	chrX	15680460	15680821	361	180.0	
95636	chrX	15687007	15687578	571	286.0	
95637	chrX	15737211	15739207	1996	998.0	
95638	chrX	15745243	15745545	302	151.0	
95639	chrX	15749608	15752218	2610	1305.0	
95640	chrX	15758003	15758614	611	306.0	
95641	chrX	15761520	15762062	542	271.0	
95642	chrX	15781923	15782994	1071	536.0	
95643	chrX	15785323	15785755	432	216.0	
95644	chrX	15786852	15787452	600	300.0	
95645	chrX	15789725	15791430	1705	852.0	
95646	chrX	15804457	15805041	584	292.0	
95647	chrX	15816028	15817420	1392	696.0	
95648	chrX	15834173	15834392	219	110.0	
95649	chrX	15838071	15838379	308	154.0	
95650	chrX	15853805	15856627	2822	1411.0	
95651	chrX	15883017	15883568	551	276.0	
95652	chrX	15903008	15903785	777	388.0	
95653	chrX	15911569	15912366	797	398.0	
95654	chrX	15916226	15916743	517	258.0	
95655	chrX	15918410	15918821	411	206.0	
95656	chrX	15931415	15931772	357	178.0	
95657	chrX	15939648	15940193	545	272.0	
95658	chrX	15973288	15973677	389	194.0	
95659	chrX	15976406	15976770	364	182.0	
95660	chrX	15977669	15978001	332	166.0	
95661	chrX	16024470	16024832	362	181.0	
95662	chrX	16098461	16099347	886	443.0	
95663	chrX	16114034	16114948	914	457.0	
95664	chrX	16119288	16120209	921	460.0	
95665	chrX	16123155	16123705	550	275.0	
95666	chrX	16137470	16137750	280	140.0	
95667	chrX	16185580	16186096	516	258.0	
95668	chrX	16436540	16436983	443	222.0	
95669	chrX	16445134	16445584	450	225.0	
95670	chrX	16484198	16484779	581	290.0	
95671	chrX	16528556	16529060	504	252.0	
95672	chrX	16695021	16695499	478	239.0	
95673	chrX	16711682	16713166	1484	742.0	
95674	chrX	16718889	16721399	2510	1255.0	
95675	chrX	16733256	16733435	179	90.0	
95676	chrX	16739560	16740095	535	268.0	
95677	chrX	16785592	16787549	1957	978.0	
95678	chrX	16797452	16797851	399	200.0	
95679	chrX	16807489	16808376	887	444.0	
95680	chrX	16814628	16814971	343	172.0	
95681	chrX	16826168	16826579	411	206.0	
95682	chrX	16836414	16836818	404	202.0	
95683	chrX	16856072	16856408	336	168.0	
95684	chrX	16868915	16871608	2693	1346.0	
95685	chrX	16882159	16883664	1505	752.0	
95686	chrX	16889114	16889707	593	296.0	
95687	chrX	16892672	16893246	574	287.0	
95688	chrX	16903710	16903937	227	114.0	
95689	chrX	16911264	16911673	409	204.0	
95690	chrX	16914057	16914532	475	238.0	
95691	chrX	16946046	16947651	1605	802.0	
95692	chrX	16956235	16956936	701	350.0	
95693	chrX	17005960	17006293	333	166.0	
95694	chrX	17030260	17030357	97	48.0	
95695	chrX	17038615	17038697	82	41.0	
95696	chrX	17046487	17046910	423	212.0	
95697	chrX	17527236	17528688	1452	726.0	
95698	chrX	17564638	17565318	680	340.0	
95699	chrX	17591184	17591537	353	176.0	
95700	chrX	17654166	17654555	389	194.0	
95701	chrX	17655666	17655761	95	48.0	
95702	chrX	17689915	17690511	596	298.0	
95703	chrX	17736541	17739098	2557	1278.0	
95704	chrX	17788412	17788828	416	208.0	
95705	chrX	17792792	17793178	386	193.0	
95706	chrX	17860742	17861654	912	456.0	
95707	chrX	17987780	17988183	403	202.0	
95708	chrX	18353804	18355457	1653	826.0	
95709	chrX	18377740	18378202	462	231.0	
95710	chrX	18390872	18391412	540	270.0	
95711	chrX	18424485	18426546	2061	1030.0	
95712	chrX	18436308	18436396	88	44.0	
95713	chrX	18523089	18523488	399	200.0	
95714	chrX	18666506	18668792	2286	1143.0	
95715	chrX	18673945	18675876	1931	966.0	
95716	chrX	18687830	18688336	506	253.0	
95717	chrX	18885580	18887827	2247	1124.0	
95718	chrX	18917866	18918152	286	143.0	
95719	chrX	18956347	18956774	427	214.0	
95720	chrX	18958615	18958863	248	124.0	
95721	chrX	18961655	18962126	471	236.0	
95722	chrX	18983583	18985511	1928	964.0	
95723	chrX	19086023	19086564	541	270.0	
95724	chrX	19334011	19335434	1423	712.0	
95725	chrX	19342542	19342725	183	92.0	
95726	chrX	19343247	19344732	1485	742.0	
95727	chrX	19350689	19351542	853	426.0	
95728	chrX	19358672	19358896	224	112.0	
95729	chrX	19372142	19373472	1330	665.0	
95730	chrX	19382496	19383173	677	338.0	
95731	chrX	19514900	19515727	827	414.0	
95732	chrX	19544653	19545100	447	224.0	
95733	chrX	19566354	19567034	680	340.0	
95734	chrX	19593696	19594065	369	184.0	
95735	chrX	19599223	19599645	422	211.0	
95736	chrX	19625608	19626065	457	228.0	
95737	chrX	19630209	19630861	652	326.0	
95738	chrX	19638997	19639657	660	330.0	
95739	chrX	19673470	19674019	549	274.0	
95740	chrX	19678766	19679406	640	320.0	
95741	chrX	19682548	19684391	1843	922.0	
95742	chrX	19685689	19685736	47	24.0	
95743	chrX	19716295	19716339	44	22.0	
95744	chrX	19725479	19726236	757	378.0	
95745	chrX	19739612	19740125	513	256.0	
95746	chrX	19743438	19743739	301	150.0	
95747	chrX	19745147	19745712	565	282.0	
95748	chrX	19747174	19748995	1821	910.0	
95749	chrX	19750170	19752398	2228	1114.0	
95750	chrX	19755812	19755918	106	53.0	
95751	chrX	19758470	19759000	530	265.0	
95752	chrX	19761688	19762203	515	258.0	
95753	chrX	19770487	19770596	109	54.0	
95754	chrX	19772345	19774025	1680	840.0	
95755	chrX	19774935	19775208	273	136.0	
95756	chrX	19776704	19777188	484	242.0	
95757	chrX	19785766	19785913	147	74.0	
95758	chrX	19791538	19792035	497	248.0	
95759	chrX	19797206	19798049	843	422.0	
95760	chrX	19798785	19800303	1518	759.0	
95761	chrX	19805048	19805899	851	426.0	
95762	chrX	19810412	19811178	766	383.0	
95763	chrX	19811813	19812634	821	410.0	
95764	chrX	19814117	19814720	603	302.0	
95765	chrX	19824657	19824982	325	162.0	
95766	chrX	19836214	19836737	523	262.0	
95767	chrX	19839649	19842098	2449	1224.0	
95768	chrX	19842700	19842833	133	66.0	
95769	chrX	19846825	19847786	961	480.0	
95770	chrX	19849395	19850259	864	432.0	
95771	chrX	19856284	19856924	640	320.0	
95772	chrX	19860363	19860963	600	300.0	
95773	chrX	19863299	19864194	895	448.0	
95774	chrX	19864996	19865019	23	12.0	
95775	chrX	19865648	19866534	886	443.0	
95776	chrX	19869223	19869606	383	192.0	
95777	chrX	19871123	19871200	77	38.0	
95778	chrX	19874322	19875707	1385	692.0	
95779	chrX	19879799	19880211	412	206.0	
95780	chrX	19883797	19884333	536	268.0	
95781	chrX	19885880	19890399	4519	2260.0	
95782	chrX	19897137	19897538	401	200.0	
95783	chrX	19904723	19905221	498	249.0	
95784	chrX	19924401	19924609	208	104.0	
95785	chrX	19990172	19991891	1719	860.0	
95786	chrX	20061249	20061790	541	270.0	
95787	chrX	20067156	20068049	893	446.0	
95788	chrX	20116538	20117099	561	280.0	
95789	chrX	20132637	20133136	499	250.0	
95790	chrX	20140449	20142613	2164	1082.0	
95791	chrX	20147563	20147967	404	202.0	
95792	chrX	20252274	20253570	1296	648.0	
95793	chrX	20263202	20263993	791	396.0	
95794	chrX	20265008	20268594	3586	1793.0	
95795	chrX	20313884	20314272	388	194.0	
95796	chrX	20315128	20315419	291	146.0	
95797	chrX	20318147	20318459	312	156.0	
95798	chrX	20320653	20321249	596	298.0	
95799	chrX	20362493	20363150	657	328.0	
95800	chrX	20374443	20375636	1193	596.0	
95801	chrX	20394411	20395410	999	500.0	
95802	chrX	20412655	20413685	1030	515.0	
95803	chrX	20418258	20419107	849	424.0	
95804	chrX	20433008	20433553	545	272.0	
95805	chrX	20437752	20438046	294	147.0	
95806	chrX	20442412	20443084	672	336.0	
95807	chrX	20452485	20452875	390	195.0	
95808	chrX	20515817	20516638	821	410.0	
95809	chrX	20527439	20527902	463	232.0	
95810	chrX	20530303	20530765	462	231.0	
95811	chrX	21373517	21375810	2293	1146.0	
95812	chrX	21438776	21439273	497	248.0	
95813	chrX	21479857	21480261	404	202.0	
95814	chrX	21590524	21590621	97	48.0	
95815	chrX	21657851	21658630	779	390.0	
95816	chrX	21698391	21698603	212	106.0	
95817	chrX	21745883	21746164	281	140.0	
95818	chrX	21839197	21840296	1099	550.0	
95819	chrX	21932292	21933044	752	376.0	
95820	chrX	21940108	21942150	2042	1021.0	
95821	chrX	21943544	21943634	90	45.0	
95822	chrX	21948969	21949274	305	152.0	
95823	chrX	21955521	21955682	161	80.0	
95824	chrX	21972682	21973212	530	265.0	
95825	chrX	21973869	21974548	679	340.0	
95826	chrX	21985172	21985756	584	292.0	
95827	chrX	21989451	21989740	289	144.0	
95828	chrX	21990811	21991233	422	211.0	
95829	chrX	21993070	21993825	755	378.0	
95830	chrX	21996707	21997413	706	353.0	
95831	chrX	22056331	22056556	225	112.0	
95832	chrX	22063319	22063648	329	164.0	
95833	chrX	22081491	22081850	359	180.0	
95834	chrX	22135906	22136522	616	308.0	
95835	chrX	22192642	22193075	433	216.0	
95836	chrX	22526463	22526651	188	94.0	
95837	chrX	23318325	23318467	142	71.0	
95838	chrX	23662159	23662651	492	246.0	
95839	chrX	23666376	23668449	2073	1036.0	
95840	chrX	23694505	23694961	456	228.0	
95841	chrX	23699569	23700281	712	356.0	
95842	chrX	23726150	23726721	571	286.0	
95843	chrX	23732643	23733283	640	320.0	
95844	chrX	23742246	23743879	1633	816.0	
95845	chrX	23745726	23746262	536	268.0	
95846	chrX	23756040	23756680	640	320.0	
95847	chrX	23766520	23767640	1120	560.0	
95848	chrX	23773105	23774163	1058	529.0	
95849	chrX	23780928	23788980	8052	4026.0	
95850	chrX	23789670	23789725	55	28.0	
95851	chrX	23810995	23811959	964	482.0	
95852	chrX	23817190	23817743	553	276.0	
95853	chrX	23826673	23827013	340	170.0	
95854	chrX	23844399	23845083	684	342.0	
95855	chrX	23871820	23872397	577	288.0	
95856	chrX	23884645	23885029	384	192.0	
95857	chrX	23900238	23902914	2676	1338.0	
95858	chrX	23907116	23908931	1815	908.0	
95859	chrX	23911447	23911631	184	92.0	
95860	chrX	23931076	23931606	530	265.0	
95861	chrX	23952851	23954204	1353	676.0	
95862	chrX	23959638	23960346	708	354.0	
95863	chrX	23994333	23994343	10	5.0	
95864	chrX	23997823	23998198	375	188.0	
95865	chrX	24002752	24002773	21	10.0	
95866	chrX	24009969	24010654	685	342.0	
95867	chrX	24014507	24015098	591	296.0	
95868	chrX	24019635	24019852	217	108.0	
95869	chrX	24021385	24021783	398	199.0	
95870	chrX	24024190	24026682	2492	1246.0	
95871	chrX	24053391	24055592	2201	1100.0	
95872	chrX	24081506	24082247	741	370.0	
95873	chrX	24148146	24151428	3282	1641.0	
95874	chrX	24153156	24153537	381	190.0	
95875	chrX	24169126	24170059	933	466.0	
95876	chrX	24242145	24242405	260	130.0	
95877	chrX	24261087	24261572	485	242.0	
95878	chrX	24371331	24371801	470	235.0	
95879	chrX	24395677	24396255	578	289.0	
95880	chrX	24426284	24426760	476	238.0	
95881	chrX	24428537	24428903	366	183.0	
95882	chrX	24464306	24466229	1923	962.0	
95883	chrX	24478948	24481086	2138	1069.0	
95884	chrX	24494809	24494819	10	5.0	
95885	chrX	24498193	24499413	1220	610.0	
95886	chrX	24605930	24606597	667	334.0	
95887	chrX	24646714	24648045	1331	666.0	
95888	chrX	24676486	24676813	327	164.0	
95889	chrX	24693238	24694481	1243	622.0	
95890	chrX	24733148	24733576	428	214.0	
95891	chrX	24777661	24778037	376	188.0	
95892	chrX	25012871	25013808	937	468.0	"sequence_feature	sequence_feature	repeat_region"
95893	chrX	25015788	25016238	450	225.0	
95894	chrX	25020629	25021490	861	430.0	
95895	chrX	27254671	27255085	414	207.0	
95896	chrX	27915703	27915981	278	139.0	
95897	chrX	29024785	29025227	442	221.0	
95898	chrX	30533372	30533773	401	200.0	
95899	chrX	30568018	30568525	507	254.0	
95900	chrX	30570544	30570859	315	158.0	
95901	chrX	30577012	30578188	1176	588.0	
95902	chrX	30588834	30589549	715	358.0	
95903	chrX	30590327	30590794	467	234.0	
95904	chrX	30592806	30593286	480	240.0	
95905	chrX	30597157	30598163	1006	503.0	
95906	chrX	30612430	30614209	1779	890.0	
95907	chrX	30618381	30618739	358	179.0	
95908	chrX	30620869	30621634	765	382.0	
95909	chrX	30627758	30628227	469	234.0	
95910	chrX	30638340	30638886	546	273.0	
95911	chrX	30643151	30644010	859	430.0	
95912	chrX	30649788	30650348	560	280.0	
95913	chrX	30651342	30651625	283	142.0	
95914	chrX	30652292	30654460	2168	1084.0	
95915	chrX	30658531	30659920	1389	694.0	
95916	chrX	30712986	30713382	396	198.0	
95917	chrX	30735740	30736229	489	244.0	
95918	chrX	30822287	30822679	392	196.0	
95919	chrX	30831205	30831512	307	154.0	
95920	chrX	30851502	30851868	366	183.0	
95921	chrX	30864215	30865299	1084	542.0	
95922	chrX	30888121	30890419	2298	1149.0	
95923	chrX	30910156	30910579	423	212.0	
95924	chrX	30971745	30972394	649	324.0	
95925	chrX	30982476	30982766	290	145.0	
95926	chrX	31136300	31136518	218	109.0	
95927	chrX	31228911	31229369	458	229.0	
95928	chrX	31266778	31267145	367	184.0	
95929	chrX	32448345	32448762	417	208.0	
95930	chrX	35699522	35700145	623	312.0	
95931	chrX	35868480	35868991	511	256.0	
95932	chrX	37349182	37349520	338	169.0	
95933	chrX	37571320	37572605	1285	642.0	
95934	chrX	37685550	37686319	769	384.0	
95935	chrX	37745297	37747059	1762	881.0	
95936	chrX	37752928	37753799	871	436.0	
95937	chrX	37754785	37755718	933	466.0	
95938	chrX	37763353	37763695	342	171.0	
95939	chrX	37776631	37777343	712	356.0	
95940	chrX	37779821	37780239	418	209.0	
95941	chrX	37781748	37782299	551	276.0	
95942	chrX	37785459	37788000	2541	1270.0	
95943	chrX	37796710	37797377	667	334.0	
95944	chrX	37800690	37801214	524	262.0	
95945	chrX	37802010	37802445	435	218.0	
95946	chrX	37825188	37825719	531	266.0	
95947	chrX	37846188	37848131	1943	972.0	
95948	chrX	37993833	37994217	384	192.0	
95949	chrX	38192243	38192331	88	44.0	
95950	chrX	38230324	38230665	341	170.0	
95951	chrX	38275614	38276064	450	225.0	
95952	chrX	38326602	38328276	1674	837.0	
95953	chrX	38336693	38336984	291	146.0	
95954	chrX	38347046	38347646	600	300.0	
95955	chrX	38365923	38366398	475	238.0	
95956	chrX	38560945	38562671	1726	863.0	
95957	chrX	38618110	38618503	393	196.0	
95958	chrX	38627690	38628087	397	198.0	
95959	chrX	38669502	38669787	285	142.0	
95960	chrX	38754092	38754493	401	200.0	
95961	chrX	38799934	38802240	2306	1153.0	
95962	chrX	38803189	38806452	3263	1632.0	
95963	chrX	38807127	38807651	524	262.0	
95964	chrX	38811698	38812369	671	336.0	
95965	chrX	38816079	38817457	1378	689.0	
95966	chrX	38848705	38849028	323	162.0	
95967	chrX	38862436	38862978	542	271.0	
95968	chrX	38868731	38870789	2058	1029.0	
95969	chrX	38879597	38880839	1242	621.0	
95970	chrX	38985342	38985720	378	189.0	
95971	chrX	38989127	38989196	69	34.0	
95972	chrX	39008460	39009009	549	274.0	
95973	chrX	39035100	39035287	187	94.0	
95974	chrX	39062899	39063902	1003	502.0	
95975	chrX	39144191	39145453	1262	631.0	
95976	chrX	39149705	39150139	434	217.0	
95977	chrX	39152126	39152469	343	172.0	
95978	chrX	39159327	39159805	478	239.0	
95979	chrX	39162357	39162799	442	221.0	
95980	chrX	39174554	39175384	830	415.0	
95981	chrX	39196391	39197038	647	324.0	
95982	chrX	39201390	39201643	253	126.0	
95983	chrX	39309208	39310155	947	474.0	
95984	chrX	39336980	39336994	14	7.0	
95985	chrX	39436694	39436852	158	79.0	
95986	chrX	39440196	39440516	320	160.0	
95987	chrX	39477678	39478169	491	246.0	
95988	chrX	39491369	39493035	1666	833.0	
95989	chrX	39497713	39498101	388	194.0	
95990	chrX	39508398	39508608	210	105.0	
95991	chrX	39563100	39563550	450	225.0	
95992	chrX	39578303	39578581	278	139.0	
95993	chrX	39688731	39689386	655	328.0	
95994	chrX	39724603	39724918	315	158.0	
95995	chrX	39730540	39731169	629	314.0	
95996	chrX	39749707	39751228	1521	760.0	
95997	chrX	39752461	39753057	596	298.0	
95998	chrX	39766067	39766719	652	326.0	
95999	chrX	39771957	39772856	899	450.0	
96000	chrX	39774078	39774833	755	378.0	
96001	chrX	39777739	39778140	401	200.0	
96002	chrX	39780174	39780627	453	226.0	
96003	chrX	39788584	39788848	264	132.0	
96004	chrX	39814351	39814795	444	222.0	
96005	chrX	39815737	39816100	363	182.0	
96006	chrX	39821001	39821728	727	364.0	
96007	chrX	39828019	39828302	283	142.0	
96008	chrX	39850726	39850959	233	116.0	
96009	chrX	39854493	39856298	1805	902.0	
96010	chrX	39859913	39860982	1069	534.0	
96011	chrX	39869865	39870953	1088	544.0	
96012	chrX	39883759	39884022	263	132.0	
96013	chrX	39908264	39909249	985	492.0	
96014	chrX	39936069	39937807	1738	869.0	
96015	chrX	39969618	39969619	1	0.0	
96016	chrX	40004971	40006803	1832	916.0	
96017	chrX	40008732	40011104	2372	1186.0	
96018	chrX	40012249	40015334	3085	1542.0	
96019	chrX	40022384	40022739	355	178.0	
96020	chrX	40026869	40027635	766	383.0	
96021	chrX	40042059	40042231	172	86.0	
96022	chrX	40061743	40062160	417	208.0	
96023	chrX	40068022	40068495	473	236.0	
96024	chrX	40082727	40084833	2106	1053.0	
96025	chrX	40085802	40086135	333	166.0	
96026	chrX	40089733	40090827	1094	547.0	
96027	chrX	40094021	40100523	6502	3251.0	
96028	chrX	40104524	40107901	3377	1688.0	
96029	chrX	40108658	40110116	1458	729.0	
96030	chrX	40121215	40121597	382	191.0	
96031	chrX	40127017	40127452	435	218.0	
96032	chrX	40141337	40141464	127	64.0	
96033	chrX	40145979	40146980	1001	500.0	
96034	chrX	40148554	40149397	843	422.0	
96035	chrX	40152264	40156057	3793	1896.0	
96036	chrX	40157776	40158799	1023	512.0	
96037	chrX	40166715	40168515	1800	900.0	
96038	chrX	40169230	40173094	3864	1932.0	
96039	chrX	40173885	40178390	4505	2252.0	
96040	chrX	40179230	40179801	571	286.0	
96041	chrX	40201325	40202885	1560	780.0	
96042	chrX	40207652	40208032	380	190.0	
96043	chrX	40208635	40208961	326	163.0	
96044	chrX	40266548	40268149	1601	800.0	
96045	chrX	40273387	40273821	434	217.0	
96046	chrX	40278469	40279375	906	453.0	
96047	chrX	40281272	40281825	553	276.0	
96048	chrX	40299690	40300084	394	197.0	
96049	chrX	40303598	40304167	569	284.0	
96050	chrX	40380498	40381121	623	312.0	
96051	chrX	40385244	40386069	825	412.0	
96052	chrX	40387384	40387442	58	29.0	
96053	chrX	40406447	40406949	502	251.0	
96054	chrX	40411320	40411744	424	212.0	
96055	chrX	40418842	40419128	286	143.0	
96056	chrX	40434916	40435318	402	201.0	
96057	chrX	40439563	40440198	635	318.0	
96058	chrX	40467490	40469044	1554	777.0	
96059	chrX	40472048	40472569	521	260.0	
96060	chrX	40539030	40540137	1107	554.0	
96061	chrX	40543655	40544299	644	322.0	
96062	chrX	40570350	40571656	1306	653.0	
96063	chrX	40573768	40574169	401	200.0	
96064	chrX	40579144	40582116	2972	1486.0	
96065	chrX	40589560	40590147	587	294.0	
96066	chrX	40644109	40645872	1763	882.0	
96067	chrX	40646396	40648324	1928	964.0	
96068	chrX	40651591	40652087	496	248.0	
96069	chrX	40663281	40663754	473	236.0	
96070	chrX	40716366	40716404	38	19.0	
96071	chrX	40730168	40730611	443	222.0	
96072	chrX	40732746	40732887	141	70.0	
96073	chrX	40733568	40734080	512	256.0	
96074	chrX	40734849	40737422	2573	1286.0	
96075	chrX	40749858	40750313	455	228.0	
96076	chrX	40793842	40794651	809	404.0	
96077	chrX	40933103	40934303	1200	600.0	
96078	chrX	40945263	40945726	463	232.0	
96079	chrX	40952790	40953264	474	237.0	
96080	chrX	40996746	40997395	649	324.0	
96081	chrX	41005563	41005717	154	77.0	
96082	chrX	41009721	41010917	1196	598.0	
96083	chrX	41082829	41083077	248	124.0	
96084	chrX	41083909	41087528	3619	1810.0	
96085	chrX	41090630	41090708	78	39.0	
96086	chrX	41095959	41096839	880	440.0	
96087	chrX	41103012	41103030	18	9.0	
96088	chrX	41105257	41105293	36	18.0	
96089	chrX	41108290	41108372	82	41.0	
96090	chrX	41111074	41111546	472	236.0	
96091	chrX	41114310	41115564	1254	627.0	
96092	chrX	41116683	41117414	731	366.0	
96093	chrX	41118081	41118537	456	228.0	
96094	chrX	41119968	41120017	49	24.0	
96095	chrX	41122639	41122679	40	20.0	
96096	chrX	41180155	41180921	766	383.0	
96097	chrX	41184296	41184685	389	194.0	
96098	chrX	41236755	41236892	137	68.0	
96099	chrX	41238514	41239267	753	376.0	
96100	chrX	41240476	41241006	530	265.0	
96101	chrX	41253080	41254302	1222	611.0	
96102	chrX	41265508	41266297	789	394.0	
96103	chrX	41275686	41277284	1598	799.0	
96104	chrX	41293319	41293636	317	158.0	
96105	chrX	41297849	41298281	432	216.0	
96106	chrX	41308823	41309337	514	257.0	
96107	chrX	41317004	41317891	887	444.0	
96108	chrX	41323120	41323826	706	353.0	
96109	chrX	41330022	41338477	8455	4228.0	
96110	chrX	41339176	41343123	3947	1974.0	
96111	chrX	41343742	41359287	15545	7772.0	
96112	chrX	41360224	41364503	4279	2140.0	
96113	chrX	41381677	41382127	450	225.0	
96114	chrX	41383033	41384527	1494	747.0	
96115	chrX	41412708	41413106	398	199.0	
96116	chrX	41435431	41436193	762	381.0	
96117	chrX	41440040	41440298	258	129.0	
96118	chrX	41441803	41443456	1653	826.0	
96119	chrX	41449131	41449991	860	430.0	
96120	chrX	41491702	41492071	369	184.0	
96121	chrX	41556879	41557376	497	248.0	
96122	chrX	41558533	41559938	1405	702.0	
96123	chrX	41560928	41561462	534	267.0	
96124	chrX	41580617	41581101	484	242.0	
96125	chrX	41688824	41689185	361	180.0	
96126	chrX	41695495	41695909	414	207.0	
96127	chrX	41705633	41706438	805	402.0	
96128	chrX	41719682	41720600	918	459.0	
96129	chrX	41723838	41724300	462	231.0	
96130	chrX	41733844	41734902	1058	529.0	
96131	chrX	41737079	41737435	356	178.0	
96132	chrX	41760046	41760219	173	86.0	
96133	chrX	41781499	41781879	380	190.0	
96134	chrX	41798081	41798505	424	212.0	
96135	chrX	41909035	41909468	433	216.0	
96136	chrX	41917839	41917848	9	4.0	
96137	chrX	41921434	41924814	3380	1690.0	
96138	chrX	42399272	42399955	683	342.0	
96139	chrX	42495196	42495435	239	120.0	
96140	chrX	42531494	42531770	276	138.0	
96141	chrX	42715434	42715728	294	147.0	
96142	chrX	42739184	42739733	549	274.0	
96143	chrX	42934122	42934811	689	344.0	
96144	chrX	42943051	42945019	1968	984.0	
96145	chrX	42946869	42946955	86	43.0	
96146	chrX	42948675	42949333	658	329.0	
96147	chrX	42967909	42968237	328	164.0	
96148	chrX	43349434	43349740	306	153.0	
96149	chrX	43526171	43526618	447	224.0	
96150	chrX	43557817	43558210	393	196.0	
96151	chrX	43644355	43644623	268	134.0	
96152	chrX	43654104	43656563	2459	1230.0	
96153	chrX	43750041	43750814	773	386.0	
96154	chrX	43949687	43950042	355	178.0	
96155	chrX	43958382	43958924	542	271.0	
96156	chrX	44004044	44004277	233	116.0	
96157	chrX	44011556	44011874	318	159.0	
96158	chrX	44012520	44013237	717	358.0	
96159	chrX	44026487	44026987	500	250.0	
96160	chrX	44040477	44040681	204	102.0	
96161	chrX	44106988	44107171	183	92.0	
96162	chrX	44152872	44153092	220	110.0	
96163	chrX	44244007	44244316	309	154.0	
96164	chrX	44247506	44247840	334	167.0	
96165	chrX	44252978	44253952	974	487.0	
96166	chrX	44255728	44256105	377	188.0	
96167	chrX	44265651	44265830	179	90.0	
96168	chrX	44314162	44314670	508	254.0	
96169	chrX	44328563	44328605	42	21.0	
96170	chrX	44343233	44345193	1960	980.0	
96171	chrX	44462741	44463130	389	194.0	
96172	chrX	44542382	44543508	1126	563.0	
96173	chrX	44545540	44545836	296	148.0	
96174	chrX	44596269	44596614	345	172.0	
96175	chrX	44621369	44621447	78	39.0	
96176	chrX	44872086	44875210	3124	1562.0	
96177	chrX	44876081	44876363	282	141.0	
96178	chrX	44889744	44890481	737	368.0	
96179	chrX	44897981	44900183	2202	1101.0	
96180	chrX	44903985	44904420	435	218.0	
96181	chrX	44907374	44907500	126	63.0	
96182	chrX	44908403	44909074	671	336.0	
96183	chrX	44915368	44915732	364	182.0	
96184	chrX	44921110	44922122	1012	506.0	
96185	chrX	44945990	44946067	77	38.0	
96186	chrX	44997440	44997774	334	167.0	
96187	chrX	45007581	45008022	441	220.0	
96188	chrX	45068433	45069092	659	330.0	
96189	chrX	45070063	45070888	825	412.0	
96190	chrX	45071911	45072226	315	158.0	
96191	chrX	45077706	45078123	417	208.0	
96192	chrX	45138888	45138957	69	34.0	
96193	chrX	45172955	45173238	283	142.0	
96194	chrX	45186868	45187718	850	425.0	
96195	chrX	45191162	45191894	732	366.0	
96196	chrX	45230344	45230850	506	253.0	
96197	chrX	45232103	45232577	474	237.0	
96198	chrX	45446164	45446442	278	139.0	
96199	chrX	45515164	45516003	839	420.0	
96200	chrX	45714759	45715364	605	302.0	
96201	chrX	45749635	45749663	28	14.0	
96202	chrX	45753305	45754368	1063	532.0	
96203	chrX	45756498	45756796	298	149.0	
96204	chrX	45758159	45759583	1424	712.0	
96205	chrX	45762485	45763416	931	466.0	
96206	chrX	45765695	45766218	523	262.0	
96207	chrX	45766897	45767845	948	474.0	
96208	chrX	45768842	45772333	3491	1746.0	
96209	chrX	45778587	45779049	462	231.0	
96210	chrX	45781928	45782228	300	150.0	
96211	chrX	45800963	45801983	1020	510.0	
96212	chrX	45803573	45804047	474	237.0	
96213	chrX	45806150	45808439	2289	1144.0	
96214	chrX	45849249	45852125	2876	1438.0	
96215	chrX	46320663	46320735	72	36.0	
96216	chrX	46381668	46381970	302	151.0	
96217	chrX	46408808	46409182	374	187.0	
96218	chrX	46446559	46448054	1495	748.0	
96219	chrX	46543534	46543711	177	88.0	
96220	chrX	46544819	46546173	1354	677.0	
96221	chrX	46555030	46555326	296	148.0	
96222	chrX	46562012	46562702	690	345.0	
96223	chrX	46572285	46576535	4250	2125.0	
96224	chrX	46587806	46588622	816	408.0	
96225	chrX	46611626	46612126	500	250.0	
96226	chrX	46626462	46627463	1001	500.0	
96227	chrX	46628087	46629469	1382	691.0	
96228	chrX	46642097	46642510	413	206.0	
96229	chrX	46649489	46649863	374	187.0	
96230	chrX	46677036	46677269	233	116.0	
96231	chrX	46686024	46686468	444	222.0	
96232	chrX	46711248	46711591	343	172.0	
96233	chrX	46713778	46713924	146	73.0	
96234	chrX	46754374	46755089	715	358.0	
96235	chrX	46758137	46759941	1804	902.0	
96236	chrX	46791883	46793189	1306	653.0	
96237	chrX	46796532	46797011	479	240.0	
96238	chrX	46833865	46834266	401	200.0	
96239	chrX	46836330	46838603	2273	1136.0	
96240	chrX	46850002	46850157	155	78.0	
96241	chrX	46865200	46865595	395	198.0	
96242	chrX	46903594	46904366	772	386.0	
96243	chrX	46911979	46913883	1904	952.0	
96244	chrX	46978572	46979007	435	218.0	
96245	chrX	47128831	47130064	1233	616.0	
96246	chrX	47143965	47146953	2988	1494.0	
96247	chrX	47190258	47191955	1697	848.0	
96248	chrX	47192966	47194964	1998	999.0	
96249	chrX	47217030	47221052	4022	2011.0	
96250	chrX	47221608	47222178	570	285.0	
96251	chrX	47222754	47223155	401	200.0	
96252	chrX	47232051	47234291	2240	1120.0	
96253	chrX	47235471	47236142	671	336.0	
96254	chrX	47237246	47237429	183	92.0	
96255	chrX	47312389	47312813	424	212.0	
96256	chrX	47358335	47358878	543	272.0	
96257	chrX	47361515	47362693	1178	589.0	
96258	chrX	47365841	47366920	1079	540.0	
96259	chrX	47380028	47380806	778	389.0	
96260	chrX	47384424	47384968	544	272.0	
96261	chrX	47390749	47391082	333	166.0	
96262	chrX	47458534	47458935	401	200.0	
96263	chrX	47481984	47483859	1875	938.0	
96264	chrX	47484875	47485238	363	182.0	
96265	chrX	47512540	47514054	1514	757.0	
96266	chrX	47523175	47524189	1014	507.0	
96267	chrX	47541083	47541549	466	233.0	
96268	chrX	47551815	47551962	147	74.0	
96269	chrX	47555896	47556869	973	486.0	
96270	chrX	47560383	47563022	2639	1320.0	
96271	chrX	47563984	47564275	291	146.0	
96272	chrX	47568868	47569334	466	233.0	
96273	chrX	47573256	47573324	68	34.0	
96274	chrX	47574174	47574951	777	388.0	
96275	chrX	47578587	47580127	1540	770.0	
96276	chrX	47581829	47582803	974	487.0	
96277	chrX	47587140	47587278	138	69.0	
96278	chrX	47608535	47608586	51	26.0	
96279	chrX	47619428	47620592	1164	582.0	
96280	chrX	47623430	47624308	878	439.0	
96281	chrX	47629081	47630926	1845	922.0	
96282	chrX	47632543	47633154	611	306.0	
96283	chrX	47633989	47635560	1571	786.0	
96284	chrX	47637407	47638370	963	482.0	
96285	chrX	47643956	47645080	1124	562.0	
96286	chrX	47649910	47651525	1615	808.0	
96287	chrX	47658236	47659785	1549	774.0	
96288	chrX	47831739	47832232	493	246.0	
96289	chrX	47836095	47837332	1237	618.0	
96290	chrX	47854524	47854789	265	132.0	
96291	chrX	47900880	47901111	231	116.0	
96292	chrX	47936492	47936843	351	176.0	
96293	chrX	47958963	47959319	356	178.0	
96294	chrX	47960357	47960861	504	252.0	
96295	chrX	48003303	48004622	1319	660.0	
96296	chrX	48020498	48021998	1500	750.0	
96297	chrX	48025562	48027281	1719	860.0	
96298	chrX	48070879	48072225	1346	673.0	
96299	chrX	48083164	48083642	478	239.0	
96300	chrX	48468127	48469944	1817	908.0	
96301	chrX	48475279	48476837	1558	779.0	
96302	chrX	48487192	48487971	779	390.0	
96303	chrX	48508226	48509720	1494	747.0	
96304	chrX	48520475	48522761	2286	1143.0	
96305	chrX	48531566	48532040	474	237.0	
96306	chrX	48538937	48541531	2594	1297.0	
96307	chrX	48550319	48550707	388	194.0	
96308	chrX	48573572	48575492	1920	960.0	
96309	chrX	48576358	48576506	148	74.0	
96310	chrX	48578603	48580348	1745	872.0	
96311	chrX	48597027	48598823	1796	898.0	
96312	chrX	48631277	48632065	788	394.0	
96313	chrX	48648248	48648751	503	252.0	
96314	chrX	48667406	48668085	679	340.0	
96315	chrX	48675758	48677482	1724	862.0	
96316	chrX	48680358	48680999	641	320.0	
96317	chrX	48682637	48684420	1783	892.0	
96318	chrX	48695486	48697569	2083	1042.0	
96319	chrX	48712658	48715269	2611	1306.0	
96320	chrX	48716324	48716406	82	41.0	
96321	chrX	48720061	48721323	1262	631.0	
96322	chrX	48736415	48738102	1687	844.0	
96323	chrX	48751406	48751660	254	127.0	
96324	chrX	48800654	48802974	2320	1160.0	
96325	chrX	48826103	48826569	466	233.0	
96326	chrX	48834669	48835983	1314	657.0	
96327	chrX	48890583	48892400	1817	908.0	
96328	chrX	48896687	48898875	2188	1094.0	
96329	chrX	48903132	48905506	2374	1187.0	
96330	chrX	48906255	48906814	559	280.0	
96331	chrX	48908253	48915725	7472	3736.0	
96332	chrX	48916281	48920929	4648	2324.0	
96333	chrX	48921573	48922200	627	314.0	
96334	chrX	48934502	48935524	1022	511.0	
96335	chrX	48936546	48940774	4228	2114.0	
96336	chrX	48941543	48942370	827	414.0	
96337	chrX	48945710	48946382	672	336.0	
96338	chrX	48950744	48951041	297	148.0	
96339	chrX	48952426	48953621	1195	598.0	
96340	chrX	48956591	48959303	2712	1356.0	
96341	chrX	48960228	48960719	491	246.0	
96342	chrX	48971536	48972792	1256	628.0	
96343	chrX	49001278	49003072	1794	897.0	
96344	chrX	49012800	49013248	448	224.0	
96345	chrX	49032910	49033420	510	255.0	
96346	chrX	49039596	49040475	879	440.0	
96347	chrX	49041693	49044344	2651	1326.0	
96348	chrX	49053028	49054392	1364	682.0	
96349	chrX	49073392	49074802	1410	705.0	
96350	chrX	49078965	49080782	1817	908.0	
96351	chrX	49100377	49101996	1619	810.0	
96352	chrX	49117798	49117842	44	22.0	
96353	chrX	49123194	49124402	1208	604.0	
96354	chrX	49129426	49129817	391	196.0	
96355	chrX	49142268	49142585	317	158.0	
96356	chrX	49155087	49156930	1843	922.0	
96357	chrX	49163367	49164689	1322	661.0	
96358	chrX	49165905	49168001	2096	1048.0	
96359	chrX	49171521	49173188	1667	834.0	
96360	chrX	49176276	49177978	1702	851.0	
96361	chrX	49184274	49185230	956	478.0	
96362	chrX	49185738	49186879	1141	570.0	
96363	chrX	49189944	49192039	2095	1048.0	
96364	chrX	49192717	49193140	423	212.0	
96365	chrX	49199256	49200760	1504	752.0	
96366	chrX	49230123	49231422	1299	650.0	
96367	chrX	49235164	49236038	874	437.0	
96368	chrX	49236988	49237628	640	320.0	
96369	chrX	49254010	49254113	103	52.0	
96370	chrX	49258045	49258349	304	152.0	
96371	chrX	49264705	49264966	261	130.0	
96372	chrX	49268540	49270525	1985	992.0	
96373	chrX	49272350	49273999	1649	824.0	
96374	chrX	49291813	49292452	639	320.0	
96375	chrX	49308732	49310129	1397	698.0	
96376	chrX	49312054	49312678	624	312.0	
96377	chrX	49754212	49754666	454	227.0	
96378	chrX	49840724	49841110	386	193.0	
96379	chrX	49849953	49850414	461	230.0	
96380	chrX	49876783	49877998	1215	608.0	
96381	chrX	49878635	49880360	1725	862.0	
96382	chrX	49884189	49884822	633	316.0	
96383	chrX	49892490	49892887	397	198.0	
96384	chrX	49915566	49916072	506	253.0	
96385	chrX	49919628	49920098	470	235.0	
96386	chrX	49921991	49923507	1516	758.0	
96387	chrX	49947796	49948148	352	176.0	
96388	chrX	49959000	49959584	584	292.0	
96389	chrX	49977440	49977644	204	102.0	
96390	chrX	50002408	50002728	320	160.0	
96391	chrX	50103205	50103611	406	203.0	
96392	chrX	50204156	50205137	981	490.0	
96393	chrX	50470755	50470956	201	100.0	
96394	chrX	50579952	50580346	394	197.0	
96395	chrX	50691774	50692147	373	186.0	
96396	chrX	51332553	51333046	493	246.0	
96397	chrX	51336622	51336986	364	182.0	
96398	chrX	51395631	51396977	1346	673.0	
96399	chrX	51420644	51421007	363	182.0	
96400	chrX	51461249	51461390	141	70.0	
96401	chrX	51487886	51487924	38	19.0	
96402	chrX	51496378	51497224	846	423.0	
96403	chrX	51614428	51614736	308	154.0	
96404	chrX	51737215	51737219	4	2.0	
96405	chrX	51743130	51744052	922	461.0	
96406	chrX	51802759	51803817	1058	529.0	
96407	chrX	51891840	51892025	185	92.0	
96408	chrX	51892861	51895371	2510	1255.0	
96409	chrX	51917645	51917938	293	146.0	
96410	chrX	52261146	52262550	1404	702.0	
96411	chrX	52271272	52271527	255	128.0	
96412	chrX	52281021	52281065	44	22.0	
96413	chrX	52574656	52575056	400	200.0	
96414	chrX	52897259	52897688	429	214.0	
96415	chrX	52920161	52921911	1750	875.0	
96416	chrX	52923664	52924115	451	226.0	
96417	chrX	52934242	52935828	1586	793.0	
96418	chrX	52989984	52990489	505	252.0	
96419	chrX	52994961	52996376	1415	708.0	
96420	chrX	53000489	53001014	525	262.0	
96421	chrX	53048432	53048441	9	4.0	
96422	chrX	53053976	53054400	424	212.0	
96423	chrX	53064542	53064816	274	137.0	
96424	chrX	53071428	53073640	2212	1106.0	
96425	chrX	53074950	53076355	1405	702.0	
96426	chrX	53077531	53077899	368	184.0	
96427	chrX	53080716	53089698	8982	4491.0	
96428	chrX	53090657	53090706	49	24.0	
96429	chrX	53092936	53094826	1890	945.0	
96430	chrX	53223105	53223339	234	117.0	
96431	chrX	53223902	53225966	2064	1032.0	
96432	chrX	53262840	53263961	1121	560.0	
96433	chrX	53266866	53267267	401	200.0	
96434	chrX	53280104	53280529	425	212.0	
96435	chrX	53281245	53281885	640	320.0	
96436	chrX	53284555	53285412	857	428.0	
96437	chrX	53287317	53288676	1359	680.0	
96438	chrX	53312885	53313829	944	472.0	
96439	chrX	53317398	53317927	529	264.0	
96440	chrX	53319627	53322030	2403	1202.0	
96441	chrX	53362426	53362873	447	224.0	
96442	chrX	53374323	53374991	668	334.0	
96443	chrX	53421471	53423474	2003	1002.0	
96444	chrX	53433792	53434942	1150	575.0	
96445	chrX	53435925	53436579	654	327.0	
96446	chrX	53440488	53442670	2182	1091.0	
96447	chrX	53445967	53446396	429	214.0	
96448	chrX	53474678	53475098	420	210.0	
96449	chrX	53482041	53482483	442	221.0	
96450	chrX	53547525	53548055	530	265.0	
96451	chrX	53595288	53595633	345	172.0	
96452	chrX	53678706	53679048	342	171.0	
96453	chrX	53682401	53684956	2555	1278.0	
96454	chrX	53685884	53687212	1328	664.0	
96455	chrX	53714379	53715482	1103	552.0	
96456	chrX	53716136	53717152	1016	508.0	
96457	chrX	53831846	53832305	459	230.0	
96458	chrX	54042488	54045415	2927	1464.0	
96459	chrX	54177665	54178066	401	200.0	
96460	chrX	54182081	54183961	1880	940.0	
96461	chrX	54357437	54359228	1791	896.0	
96462	chrX	54408832	54409441	609	304.0	
96463	chrX	54439814	54441034	1220	610.0	
96464	chrX	54495616	54496459	843	422.0	
96465	chrX	54529397	54531142	1745	872.0	
96466	chrX	54639020	54640476	1456	728.0	
96467	chrX	54777244	54777451	207	104.0	
96468	chrX	54787008	54787327	319	160.0	
96469	chrX	54807396	54809563	2167	1084.0	
96470	chrX	54891602	54891960	358	179.0	
96471	chrX	54920807	54922193	1386	693.0	
96472	chrX	54964996	54965167	171	86.0	
96473	chrX	54999400	55000999	1599	800.0	
96474	chrX	55008744	55009351	607	304.0	
96475	chrX	55025812	55026166	354	177.0	enhancer
96476	chrX	55056928	55058083	1155	578.0	
96477	chrX	55135245	55135544	299	150.0	
96478	chrX	55159657	55159863	206	103.0	
96479	chrX	55160370	55161971	1601	800.0	
96480	chrX	55343072	55343553	481	240.0	
96481	chrX	55451505	55453096	1591	796.0	
96482	chrX	55488114	55490161	2047	1024.0	
96483	chrX	55647510	55647870	360	180.0	
96484	chrX	55695263	55695657	394	197.0	
96485	chrX	55714107	55714404	297	148.0	
96486	chrX	55717045	55718675	1630	815.0	
96487	chrX	55907875	55909324	1449	724.0	
96488	chrX	55919414	55919840	426	213.0	
96489	chrX	56068209	56068800	591	296.0	
96490	chrX	56232105	56232766	661	330.0	
96491	chrX	56233740	56234020	280	140.0	
96492	chrX	56248443	56248905	462	231.0	
96493	chrX	56281770	56282214	444	222.0	
96494	chrX	56314395	56314794	399	200.0	
96495	chrX	56365251	56365607	356	178.0	
96496	chrX	56385561	56385639	78	39.0	
96497	chrX	56563029	56565919	2890	1445.0	
96498	chrX	56569763	56569946	183	92.0	
96499	chrX	56726569	56727022	453	226.0	
96500	chrX	56728765	56730650	1885	942.0	
96501	chrX	56733413	56733902	489	244.0	
96502	chrX	56745089	56745095	6	3.0	
96503	chrX	56762249	56762805	556	278.0	
96504	chrX	56763827	56766169	2342	1171.0	
96505	chrX	56781999	56782751	752	376.0	
96506	chrX	56791458	56791857	399	200.0	
96507	chrX	56800697	56801311	614	307.0	
96508	chrX	56803458	56803953	495	248.0	
96509	chrX	56812389	56814073	1684	842.0	
96510	chrX	56978130	56978609	479	240.0	
96511	chrX	56995046	56995997	951	476.0	
96512	chrX	57120934	57122070	1136	568.0	
96513	chrX	57282663	57282879	216	108.0	
96514	chrX	57286312	57287329	1017	508.0	
96515	chrX	57573834	57574120	286	143.0	
96516	chrX	57591383	57593286	1903	952.0	
96517	chrX	57595379	57595638	259	130.0	
96518	chrX	57821730	57822120	390	195.0	
96519	chrX	57909330	57911184	1854	927.0	
96520	chrX	57919064	57919463	399	200.0	
96521	chrX	57929401	57929687	286	143.0	
96522	chrX	57951602	57952424	822	411.0	
96523	chrX	58534732	58535366	634	317.0	
96524	chrX	62498195	62498553	358	179.0	
96525	chrX	62501298	62501944	646	323.0	
96526	chrX	62508978	62509152	174	87.0	
96527	chrX	62511372	62511782	410	205.0	
96528	chrX	62513287	62513979	692	346.0	
96529	chrX	62514515	62514869	354	177.0	
96530	chrX	62661850	62662191	341	170.0	
96531	chrX	63250198	63250651	453	226.0	
96532	chrX	63330630	63331165	535	268.0	
96533	chrX	63350312	63351794	1482	741.0	
96534	chrX	63560462	63561360	898	449.0	
96535	chrX	63657821	63658139	318	159.0	
96536	chrX	63687135	63687459	324	162.0	
96537	chrX	63746232	63746771	539	270.0	
96538	chrX	63754032	63755850	1818	909.0	
96539	chrX	63761536	63762012	476	238.0	
96540	chrX	64204690	64206932	2242	1121.0	
96541	chrX	64394569	64395964	1395	698.0	
96542	chrX	64975226	64977034	1808	904.0	
96543	chrX	65034208	65035822	1614	807.0	
96544	chrX	65406510	65406768	258	129.0	
96545	chrX	65522801	65522939	138	69.0	
96546	chrX	65528652	65529162	510	255.0	
96547	chrX	65534123	65535456	1333	666.0	
96548	chrX	65581839	65582369	530	265.0	
96549	chrX	65588230	65588551	321	160.0	
96550	chrX	65595149	65596939	1790	895.0	
96551	chrX	65598431	65598979	548	274.0	
96552	chrX	65601057	65602217	1160	580.0	
96553	chrX	65610026	65610471	445	222.0	
96554	chrX	65644916	65645267	351	176.0	
96555	chrX	65656391	65656899	508	254.0	
96556	chrX	65667017	65669172	2155	1078.0	
96557	chrX	65669887	65671835	1948	974.0	
96558	chrX	65673781	65675030	1249	624.0	
96559	chrX	65677921	65677922	1	0.0	
96560	chrX	65679037	65679631	594	297.0	
96561	chrX	65681810	65682106	296	148.0	
96562	chrX	65683255	65683423	168	84.0	
96563	chrX	65685186	65685565	379	190.0	
96564	chrX	65686224	65686624	400	200.0	
96565	chrX	65688379	65688971	592	296.0	
96566	chrX	65690077	65690928	851	426.0	
96567	chrX	65694341	65699458	5117	2558.0	
96568	chrX	65701247	65701514	267	134.0	
96569	chrX	65703660	65704409	749	374.0	
96570	chrX	65706055	65707193	1138	569.0	
96571	chrX	65720390	65721108	718	359.0	
96572	chrX	65722284	65724382	2098	1049.0	
96573	chrX	65745184	65745566	382	191.0	
96574	chrX	65750558	65751305	747	374.0	
96575	chrX	65821980	65822620	640	320.0	
96576	chrX	65866213	65866482	269	134.0	
96577	chrX	65872061	65872075	14	7.0	
96578	chrX	65873441	65873707	266	133.0	
96579	chrX	65894078	65894608	530	265.0	
96580	chrX	65926048	65927072	1024	512.0	
96581	chrX	65985886	65986701	815	408.0	
96582	chrX	65987666	65988025	359	180.0	
96583	chrX	65997797	65998785	988	494.0	
96584	chrX	66005407	66006307	900	450.0	
96585	chrX	66012044	66012559	515	258.0	
96586	chrX	66013104	66013964	860	430.0	
96587	chrX	66015030	66016307	1277	638.0	
96588	chrX	66018553	66019038	485	242.0	
96589	chrX	66020517	66021170	653	326.0	
96590	chrX	66022178	66022201	23	12.0	
96591	chrX	66023162	66023563	401	200.0	
96592	chrX	66030871	66031374	503	252.0	
96593	chrX	66046638	66047376	738	369.0	
96594	chrX	66049949	66050702	753	376.0	
96595	chrX	66074766	66075541	775	388.0	
96596	chrX	66110099	66110530	431	216.0	
96597	chrX	66638980	66639533	553	276.0	
96598	chrX	66728697	66729438	741	370.0	
96599	chrX	67546270	67546606	336	168.0	
96600	chrX	67695766	67695827	61	30.0	
96601	chrX	67725968	67726441	473	236.0	
96602	chrX	67733994	67734626	632	316.0	
96603	chrX	67780350	67781258	908	454.0	
96604	chrX	68084752	68085113	361	180.0	
96605	chrX	68114702	68115171	469	234.0	
96606	chrX	68186737	68187340	603	302.0	
96607	chrX	68196955	68197308	353	176.0	
96608	chrX	68203702	68204048	346	173.0	
96609	chrX	68415310	68415710	400	200.0	
96610	chrX	68419931	68420481	550	275.0	
96611	chrX	68432927	68434048	1121	560.0	
96612	chrX	68462622	68463144	522	261.0	
96613	chrX	68490890	68490892	2	1.0	
96614	chrX	68498167	68499520	1353	676.0	
96615	chrX	68508810	68509281	471	236.0	
96616	chrX	68511235	68511678	443	222.0	
96617	chrX	68666444	68667107	663	332.0	
96618	chrX	68684207	68684760	553	276.0	
96619	chrX	68685689	68687016	1327	664.0	
96620	chrX	68693304	68694796	1492	746.0	
96621	chrX	68696257	68696683	426	213.0	
96622	chrX	68698862	68698949	87	44.0	
96623	chrX	68699868	68700713	845	422.0	
96624	chrX	68703507	68704230	723	362.0	
96625	chrX	68710839	68711269	430	215.0	
96626	chrX	68732876	68733312	436	218.0	
96627	chrX	68822716	68822944	228	114.0	
96628	chrX	68827689	68830771	3082	1541.0	
96629	chrX	68831367	68832485	1118	559.0	
96630	chrX	68834001	68834145	144	72.0	
96631	chrX	68841653	68841839	186	93.0	
96632	chrX	68842715	68843427	712	356.0	
96633	chrX	68865246	68865804	558	279.0	
96634	chrX	68867493	68867799	306	153.0	
96635	chrX	68889524	68889556	32	16.0	
96636	chrX	68894403	68895548	1145	572.0	
96637	chrX	68994567	68995053	486	243.0	
96638	chrX	69028464	69028761	297	148.0	
96639	chrX	69152367	69153004	637	318.0	
96640	chrX	69158446	69158798	352	176.0	
96641	chrX	69163837	69165981	2144	1072.0	
96642	chrX	69222019	69222548	529	264.0	
96643	chrX	69285936	69286388	452	226.0	
96644	chrX	69504089	69504090	1	0.0	
96645	chrX	69538183	69538680	497	248.0	
96646	chrX	69615641	69616864	1223	612.0	
96647	chrX	69989121	69989416	295	148.0	
96648	chrX	70030463	70030836	373	186.0	
96649	chrX	70097409	70097711	302	151.0	
96650	chrX	70132769	70134574	1805	902.0	
96651	chrX	70197178	70197642	464	232.0	
96652	chrX	70289473	70290766	1293	646.0	
96653	chrX	70338327	70338664	337	168.0	
96654	chrX	70398746	70399410	664	332.0	
96655	chrX	70433183	70435521	2338	1169.0	
96656	chrX	70436456	70437065	609	304.0	
96657	chrX	70438956	70439422	466	233.0	
96658	chrX	70444325	70445560	1235	618.0	
96659	chrX	70451828	70456652	4824	2412.0	
96660	chrX	70470723	70471340	617	308.0	
96661	chrX	70970643	70970713	70	35.0	
96662	chrX	71052796	71053673	877	438.0	
96663	chrX	71058242	71058475	233	116.0	
96664	chrX	71067352	71069116	1764	882.0	
96665	chrX	71072963	71073289	326	163.0	
96666	chrX	71095161	71098788	3627	1814.0	
96667	chrX	71099874	71099900	26	13.0	
96668	chrX	71100909	71101895	986	493.0	
96669	chrX	71102784	71104461	1677	838.0	
96670	chrX	71105518	71106954	1436	718.0	
96671	chrX	71107508	71112922	5414	2707.0	
96672	chrX	71118016	71119460	1444	722.0	
96673	chrX	71128922	71129777	855	428.0	
96674	chrX	71145644	71146662	1018	509.0	
96675	chrX	71178871	71179385	514	257.0	
96676	chrX	71181248	71182981	1733	866.0	
96677	chrX	71195837	71196958	1121	560.0	
96678	chrX	71197902	71198600	698	349.0	
96679	chrX	71251483	71251833	350	175.0	
96680	chrX	71253202	71255913	2711	1356.0	
96681	chrX	71282583	71284466	1883	942.0	
96682	chrX	71302769	71303247	478	239.0	
96683	chrX	71365473	71367829	2356	1178.0	
96684	chrX	71492007	71493494	1487	744.0	
96685	chrX	71514294	71515140	846	423.0	
96686	chrX	71531817	71535113	3296	1648.0	
96687	chrX	71536161	71537222	1061	530.0	
96688	chrX	71537825	71537988	163	82.0	
96689	chrX	71539078	71539646	568	284.0	
96690	chrX	71540803	71542024	1221	610.0	
96691	chrX	71550070	71550360	290	145.0	
96692	chrX	71555106	71555519	413	206.0	
96693	chrX	71606659	71607352	693	346.0	
96694	chrX	71615670	71619930	4260	2130.0	
96695	chrX	71621788	71624146	2358	1179.0	
96696	chrX	71636999	71637252	253	126.0	
96697	chrX	71638005	71638133	128	64.0	
96698	chrX	71650566	71650995	429	214.0	
96699	chrX	71652371	71652862	491	246.0	
96700	chrX	71662585	71663653	1068	534.0	
96701	chrX	71669990	71670344	354	177.0	
96702	chrX	71859687	71859804	117	58.0	
96703	chrX	71910803	71911668	865	432.0	
96704	chrX	71992333	71993304	971	486.0	
96705	chrX	71999042	71999510	468	234.0	
96706	chrX	72018168	72019203	1035	518.0	
96707	chrX	72020819	72021220	401	200.0	
96708	chrX	72048997	72049193	196	98.0	
96709	chrX	72057335	72058207	872	436.0	
96710	chrX	72069430	72070118	688	344.0	
96711	chrX	72079576	72080565	989	494.0	
96712	chrX	72094717	72095646	929	464.0	
96713	chrX	72097015	72098750	1735	868.0	
96714	chrX	72099929	72102513	2584	1292.0	
96715	chrX	72104899	72106216	1317	658.0	
96716	chrX	72107256	72108695	1439	720.0	
96717	chrX	72120912	72122072	1160	580.0	
96718	chrX	72123382	72124275	893	446.0	
96719	chrX	72126088	72127223	1135	568.0	
96720	chrX	72128833	72129247	414	207.0	
96721	chrX	72131188	72132446	1258	629.0	
96722	chrX	72142655	72142798	143	72.0	
96723	chrX	72168778	72169722	944	472.0	
96724	chrX	72180896	72182323	1427	714.0	
96725	chrX	72238549	72239608	1059	530.0	
96726	chrX	72245436	72245880	444	222.0	
96727	chrX	72269888	72270279	391	196.0	
96728	chrX	72276188	72277780	1592	796.0	
96729	chrX	72298023	72298328	305	152.0	
96730	chrX	72304893	72309619	4726	2363.0	
96731	chrX	72382305	72382683	378	189.0	
96732	chrX	72572225	72573419	1194	597.0	
96733	chrX	72576574	72576816	242	121.0	
96734	chrX	73127873	73128184	311	156.0	
96735	chrX	73214221	73215662	1441	720.0	
96736	chrX	73562469	73564368	1899	950.0	
96737	chrX	73855507	73855934	427	214.0	
96738	chrX	73937875	73938216	341	170.0	
96739	chrX	73943598	73944963	1365	682.0	
96740	chrX	73955805	73956022	217	108.0	
96741	chrX	73977395	73978020	625	312.0	
96742	chrX	74015361	74015825	464	232.0	
96743	chrX	74133391	74133768	377	188.0	
96744	chrX	74250908	74251812	904	452.0	
96745	chrX	74290434	74294022	3588	1794.0	
96746	chrX	74343588	74344438	850	425.0	
96747	chrX	74370552	74370863	311	156.0	
96748	chrX	74381793	74383106	1313	656.0	
96749	chrX	74420005	74422003	1998	999.0	
96750	chrX	74422656	74422884	228	114.0	
96751	chrX	74451042	74451513	471	236.0	
96752	chrX	74534676	74537217	2541	1270.0	
96753	chrX	74549969	74550805	836	418.0	
96754	chrX	74603258	74603291	33	16.0	
96755	chrX	74612887	74615330	2443	1222.0	
96756	chrX	74924324	74925726	1402	701.0	
96757	chrX	75155478	75156909	1431	716.0	
96758	chrX	75273383	75275227	1844	922.0	
96759	chrX	75522932	75523551	619	310.0	
96760	chrX	75746806	75747354	548	274.0	
96761	chrX	76145645	76146276	631	316.0	
96762	chrX	76148178	76149501	1323	662.0	
96763	chrX	76172375	76174068	1693	846.0	
96764	chrX	76253438	76253839	401	200.0	
96765	chrX	76279227	76279336	109	54.0	
96766	chrX	76420274	76420436	162	81.0	
96767	chrX	76427328	76428902	1574	787.0	
96768	chrX	76454540	76455004	464	232.0	
96769	chrX	77668980	77669305	325	162.0	
96770	chrX	77783973	77786885	2912	1456.0	
96771	chrX	77787779	77788647	868	434.0	
96772	chrX	77894252	77896346	2094	1047.0	
96773	chrX	77898833	77901055	2222	1111.0	
96774	chrX	77910083	77912106	2023	1012.0	
96775	chrX	77917136	77917972	836	418.0	
96776	chrX	77943228	77943511	283	142.0	
96777	chrX	77962476	77962765	289	144.0	
96778	chrX	78024672	78025154	482	241.0	
96779	chrX	78073182	78074150	968	484.0	
96780	chrX	78092219	78092695	476	238.0	
96781	chrX	78101757	78102448	691	346.0	
96782	chrX	78103343	78107078	3735	1868.0	
96783	chrX	78107918	78108321	403	202.0	
96784	chrX	78109537	78109544	7	4.0	
96785	chrX	78116442	78117035	593	296.0	
96786	chrX	78119575	78119988	413	206.0	
96787	chrX	78124323	78124709	386	193.0	
96788	chrX	78138936	78140222	1286	643.0	
96789	chrX	78199897	78200231	334	167.0	
96790	chrX	78321746	78322321	575	288.0	
96791	chrX	78322888	78323307	419	210.0	
96792	chrX	78327127	78327888	761	380.0	
96793	chrX	78329466	78329990	524	262.0	
96794	chrX	78331777	78332086	309	154.0	
96795	chrX	78333458	78334053	595	298.0	
96796	chrX	78516997	78517701	704	352.0	
96797	chrX	78555357	78555799	442	221.0	
96798	chrX	78651085	78651334	249	124.0	
96799	chrX	78653157	78653551	394	197.0	
96800	chrX	78687577	78687842	265	132.0	
96801	chrX	78886604	78886898	294	147.0	
96802	chrX	78944798	78945968	1170	585.0	
96803	chrX	78949866	78950549	683	342.0	
96804	chrX	78957663	78958171	508	254.0	
96805	chrX	78998084	78998209	125	62.0	
96806	chrX	79065696	79066160	464	232.0	
96807	chrX	79081799	79082394	595	298.0	
96808	chrX	79088341	79088901	560	280.0	
96809	chrX	79090163	79090303	140	70.0	
96810	chrX	79096009	79096824	815	408.0	
96811	chrX	79107711	79108615	904	452.0	
96812	chrX	79133797	79134417	620	310.0	
96813	chrX	79138744	79139511	767	384.0	
96814	chrX	79143884	79144916	1032	516.0	
96815	chrX	79146504	79148029	1525	762.0	
96816	chrX	79153331	79153738	407	204.0	
96817	chrX	79158384	79158431	47	24.0	
96818	chrX	79161528	79162332	804	402.0	
96819	chrX	79165758	79166687	929	464.0	
96820	chrX	79167630	79167632	2	1.0	
96821	chrX	79176055	79176424	369	184.0	
96822	chrX	79258772	79259834	1062	531.0	
96823	chrX	79270290	79270840	550	275.0	
96824	chrX	79325217	79325733	516	258.0	
96825	chrX	79337267	79337791	524	262.0	
96826	chrX	79366363	79368187	1824	912.0	
96827	chrX	79408917	79409178	261	130.0	
96828	chrX	79450231	79450584	353	176.0	
96829	chrX	80223794	80224509	715	358.0	
96830	chrX	80807517	80810753	3236	1618.0	
96831	chrX	80811981	80812644	663	332.0	
96832	chrX	81120501	81122453	1952	976.0	
96833	chrX	81195674	81196170	496	248.0	
96834	chrX	81201437	81203195	1758	879.0	
96835	chrX	81348424	81348750	326	163.0	
96836	chrX	81367436	81367578	142	71.0	
96837	chrX	82127775	82128106	331	166.0	
96838	chrX	82141898	82142366	468	234.0	
96839	chrX	82218403	82218710	307	154.0	
96840	chrX	83634743	83635668	925	462.0	
96841	chrX	84188200	84188567	367	184.0	
96842	chrX	84339542	84339932	390	195.0	
96843	chrX	84415097	84415587	490	245.0	
96844	chrX	84479088	84479568	480	240.0	
96845	chrX	84487696	84488107	411	206.0	
96846	chrX	84501582	84502817	1235	618.0	
96847	chrX	84729752	84730095	343	172.0	
96848	chrX	85002975	85004375	1400	700.0	
96849	chrX	85243749	85245053	1304	652.0	
96850	chrX	86023889	86024168	279	140.0	
96851	chrX	86046879	86048099	1220	610.0	
96852	chrX	86148112	86148570	458	229.0	
96853	chrX	87900225	87900955	730	365.0	
96854	chrX	93672874	93674170	1296	648.0	
96855	chrX	96372970	96373057	87	44.0	
96856	chrX	96425186	96425536	350	175.0	
96857	chrX	96564654	96564881	227	114.0	
96858	chrX	96682482	96682918	436	218.0	
96859	chrX	96684004	96686730	2726	1363.0	
96860	chrX	96722663	96723308	645	322.0	
96861	chrX	96994140	96994497	357	178.0	
96862	chrX	97563400	97564954	1554	777.0	
96863	chrX	97617109	97617523	414	207.0	
96864	chrX	100410326	100410434	108	54.0	
96865	chrX	100636237	100637164	927	464.0	
96866	chrX	100674672	100675173	501	250.0	
96867	chrX	100685631	100686120	489	244.0	
96868	chrX	100768641	100769188	547	274.0	
96869	chrX	100819457	100820949	1492	746.0	
96870	chrX	100829670	100830173	503	252.0	
96871	chrX	100928814	100929785	971	486.0	
96872	chrX	101051056	101052587	1531	766.0	
96873	chrX	101057119	101057419	300	150.0	
96874	chrX	101097447	101098608	1161	580.0	
96875	chrX	101347975	101349458	1483	742.0	
96876	chrX	101368898	101369070	172	86.0	
96877	chrX	101377530	101377926	396	198.0	
96878	chrX	101383794	101384128	334	167.0	
96879	chrX	101385745	101386813	1068	534.0	
96880	chrX	101390273	101392183	1910	955.0	
96881	chrX	101394083	101394095	12	6.0	
96882	chrX	101395759	101396564	805	402.0	
96883	chrX	101402695	101403306	611	306.0	
96884	chrX	101406947	101408910	1963	982.0	
96885	chrX	101410673	101410682	9	4.0	
96886	chrX	101415200	101416297	1097	548.0	
96887	chrX	101417821	101419012	1191	596.0	
96888	chrX	101452150	101452404	254	127.0	
96889	chrX	101485042	101485721	679	340.0	
96890	chrX	101550188	101551461	1273	636.0	
96891	chrX	101595826	101596549	723	362.0	
96892	chrX	101617094	101618411	1317	658.0	
96893	chrX	101622292	101624425	2133	1066.0	
96894	chrX	101626866	101626997	131	66.0	
96895	chrX	101641184	101641253	69	34.0	
96896	chrX	101642116	101642552	436	218.0	
96897	chrX	101655483	101655980	497	248.0	
96898	chrX	101658466	101660049	1583	792.0	
96899	chrX	101799276	101799913	637	318.0	
96900	chrX	101931020	101932711	1691	846.0	
96901	chrX	101948767	101948922	155	78.0	
96902	chrX	102125367	102125863	496	248.0	
96903	chrX	102154212	102156514	2302	1151.0	
96904	chrX	102339328	102339576	248	124.0	
96905	chrX	102516282	102517091	809	404.0	
96906	chrX	102598910	102600567	1657	828.0	
96907	chrX	102601774	102601860	86	43.0	
96908	chrX	102650733	102653058	2325	1162.0	
96909	chrX	102659494	102660659	1165	582.0	
96910	chrX	102674624	102674855	231	116.0	
96911	chrX	102712165	102713695	1530	765.0	
96912	chrX	102720253	102721148	895	448.0	
96913	chrX	102746043	102746661	618	309.0	
96914	chrX	102768484	102769653	1169	584.0	
96915	chrX	102863681	102864198	517	258.0	
96916	chrX	102899924	102901061	1137	568.0	
96917	chrX	102934607	102934974	367	184.0	
96918	chrX	102950891	102951983	1092	546.0	
96919	chrX	102976231	102976771	540	270.0	
96920	chrX	103152126	103152643	517	258.0	
96921	chrX	103176343	103176752	409	204.0	
96922	chrX	103210967	103211467	500	250.0	
96923	chrX	103214436	103216164	1728	864.0	
96924	chrX	103248677	103248984	307	154.0	
96925	chrX	103253968	103255607	1639	820.0	
96926	chrX	103310065	103311451	1386	693.0	
96927	chrX	103343116	103343465	349	174.0	
96928	chrX	103356254	103356743	489	244.0	
96929	chrX	103376154	103377011	857	428.0	
96930	chrX	103398494	103398924	430	215.0	
96931	chrX	103404439	103405072	633	316.0	
96932	chrX	103459954	103460460	506	253.0	
96933	chrX	103464037	103465211	1174	587.0	
96934	chrX	103489775	103490127	352	176.0	
96935	chrX	103533383	103534030	647	324.0	
96936	chrX	103554537	103555387	850	425.0	
96937	chrX	103585260	103586457	1197	598.0	
96938	chrX	103607350	103608882	1532	766.0	
96939	chrX	103628436	103630309	1873	936.0	
96940	chrX	103674591	103674787	196	98.0	
96941	chrX	103680614	103680761	147	74.0	
96942	chrX	103684831	103685087	256	128.0	
96943	chrX	103686184	103689410	3226	1613.0	
96944	chrX	103711433	103711867	434	217.0	
96945	chrX	103730183	103730597	414	207.0	
96946	chrX	103774199	103774224	25	12.0	
96947	chrX	103789087	103789358	271	136.0	
96948	chrX	103817471	103817893	422	211.0	
96949	chrX	103831544	103832612	1068	534.0	
96950	chrX	103845073	103845464	391	196.0	
96951	chrX	103917936	103920650	2714	1357.0	
96952	chrX	103941591	103941936	345	172.0	
96953	chrX	103962120	103963234	1114	557.0	
96954	chrX	104098115	104098709	594	297.0	
96955	chrX	104108962	104109363	401	200.0	
96956	chrX	104110112	104113816	3704	1852.0	
96957	chrX	104122813	104123264	451	226.0	
96958	chrX	104136246	104136865	619	310.0	
96959	chrX	104137505	104137787	282	141.0	
96960	chrX	104156129	104157658	1529	764.0	
96961	chrX	104165725	104167234	1509	754.0	
96962	chrX	104195488	104195830	342	171.0	
96963	chrX	104343547	104344107	560	280.0	
96964	chrX	104909672	104910337	665	332.0	
96965	chrX	104922047	104922576	529	264.0	
96966	chrX	106481286	106481711	425	212.0	
96967	chrX	106484118	106484736	618	309.0	
96968	chrX	106608006	106608468	462	231.0	
96969	chrX	106611291	106613166	1875	938.0	
96970	chrX	106802327	106803023	696	348.0	
96971	chrX	106894317	106894741	424	212.0	
96972	chrX	106898577	106898943	366	183.0	
96973	chrX	106917912	106918192	280	140.0	
96974	chrX	106998912	107000594	1682	841.0	
96975	chrX	107118013	107119427	1414	707.0	
96976	chrX	107135709	107136087	378	189.0	
96977	chrX	107155419	107155489	70	35.0	
96978	chrX	107205788	107206869	1081	540.0	
96979	chrX	107429235	107429308	73	36.0	
96980	chrX	107448893	107452079	3186	1593.0	
96981	chrX	107454232	107454780	548	274.0	
96982	chrX	107480240	107480701	461	230.0	
96983	chrX	107549520	107549960	440	220.0	
96984	chrX	107627761	107629828	2067	1034.0	
96985	chrX	107654547	107655730	1183	592.0	
96986	chrX	107659662	107660148	486	243.0	
96987	chrX	107672616	107677573	4957	2478.0	
96988	chrX	107678729	107679771	1042	521.0	
96989	chrX	107684748	107685480	732	366.0	
96990	chrX	107686834	107687124	290	145.0	
96991	chrX	107699493	107700071	578	289.0	
96992	chrX	107701431	107702360	929	464.0	
96993	chrX	107710384	107718569	8185	4092.0	
96994	chrX	107721227	107721756	529	264.0	
96995	chrX	107731947	107732383	436	218.0	
96996	chrX	107741425	107742969	1544	772.0	
96997	chrX	107775151	107777689	2538	1269.0	
96998	chrX	107825500	107827161	1661	830.0	
96999	chrX	107894025	107894476	451	226.0	
97000	chrX	108001410	108001843	433	216.0	
97001	chrX	108018511	108019623	1112	556.0	
97002	chrX	108020553	108021010	457	228.0	
97003	chrX	108071975	108072438	463	232.0	
97004	chrX	108090729	108092460	1731	866.0	
97005	chrX	109270951	109271443	492	246.0	
97006	chrX	109347616	109347870	254	127.0	
97007	chrX	109352084	109352511	427	214.0	
97008	chrX	109357754	109358109	355	178.0	
97009	chrX	109362120	109362530	410	205.0	
97010	chrX	109475373	109475768	395	198.0	
97011	chrX	109485645	109486198	553	276.0	
97012	chrX	109487698	109488118	420	210.0	
97013	chrX	109533006	109533402	396	198.0	
97014	chrX	109536308	109537778	1470	735.0	
97015	chrX	109600153	109600483	330	165.0	
97016	chrX	109635309	109635359	50	25.0	
97017	chrX	109707281	109707713	432	216.0	
97018	chrX	109709187	109709761	574	287.0	
97019	chrX	109712933	109713440	507	254.0	
97020	chrX	109720928	109721400	472	236.0	
97021	chrX	109731889	109734113	2224	1112.0	
97022	chrX	109735008	109735470	462	231.0	
97023	chrX	109739837	109740457	620	310.0	
97024	chrX	109830638	109831359	721	360.0	
97025	chrX	109839931	109841101	1170	585.0	
97026	chrX	109856889	109857319	430	215.0	
97027	chrX	109880553	109881147	594	297.0	
97028	chrX	109886126	109886553	427	214.0	
97029	chrX	109888746	109889998	1252	626.0	
97030	chrX	109890834	109891322	488	244.0	
97031	chrX	110001714	110004003	2289	1144.0	
97032	chrX	110026467	110026484	17	8.0	
97033	chrX	110086929	110088179	1250	625.0	
97034	chrX	110089848	110090402	554	277.0	
97035	chrX	110108191	110109048	857	428.0	
97036	chrX	110145737	110146970	1233	616.0	
97037	chrX	110160415	110160902	487	244.0	
97038	chrX	110167812	110168305	493	246.0	
97039	chrX	110172180	110172666	486	243.0	
97040	chrX	110175131	110175422	291	146.0	
97041	chrX	110229395	110230567	1172	586.0	
97042	chrX	110238208	110238703	495	248.0	
97043	chrX	110310902	110311333	431	216.0	
97044	chrX	110316765	110318910	2145	1072.0	
97045	chrX	110327232	110327802	570	285.0	
97046	chrX	110331664	110331997	333	166.0	
97047	chrX	110408102	110408539	437	218.0	
97048	chrX	110412946	110413583	637	318.0	
97049	chrX	110450095	110450409	314	157.0	
97050	chrX	110847366	110847623	257	128.0	
97051	chrX	111040805	111041561	756	378.0	
97052	chrX	111095696	111096755	1059	530.0	
97053	chrX	111098699	111099458	759	380.0	
97054	chrX	111100113	111100607	494	247.0	
97055	chrX	111123100	111123575	475	238.0	
97056	chrX	111680594	111682409	1815	908.0	
97057	chrX	111779534	111780008	474	237.0	
97058	chrX	112051512	112052180	668	334.0	
97059	chrX	112642349	112642736	387	194.0	
97060	chrX	112669148	112669373	225	112.0	
97061	chrX	112669896	112669938	42	21.0	
97062	chrX	112678804	112680476	1672	836.0	
97063	chrX	112734505	112734520	15	8.0	
97064	chrX	112761532	112761888	356	178.0	
97065	chrX	112839760	112842148	2388	1194.0	
97066	chrX	112851433	112852102	669	334.0	
97067	chrX	113929028	113929339	311	156.0	
97068	chrX	113962344	113962726	382	191.0	
97069	chrX	113980992	113981380	388	194.0	
97070	chrX	114059159	114059515	356	178.0	
97071	chrX	115362370	115362800	430	215.0	
97072	chrX	115498993	115499600	607	304.0	
97073	chrX	115642942	115643270	328	164.0	
97074	chrX	118116376	118117485	1109	554.0	
97075	chrX	118345242	118348049	2807	1404.0	
97076	chrX	118350227	118351134	907	454.0	
97077	chrX	118353162	118353509	347	174.0	
97078	chrX	118459477	118459893	416	208.0	
97079	chrX	118494874	118497925	3051	1526.0	
97080	chrX	118502051	118502582	531	266.0	
97081	chrX	118503413	118504050	637	318.0	
97082	chrX	118513473	118513874	401	200.0	
97083	chrX	118523841	118524423	582	291.0	
97084	chrX	118525197	118525708	511	256.0	
97085	chrX	118527814	118529165	1351	676.0	
97086	chrX	118530479	118531604	1125	562.0	
97087	chrX	118536227	118537497	1270	635.0	
97088	chrX	118552570	118552849	279	140.0	
97089	chrX	118586320	118586582	262	131.0	
97090	chrX	118594983	118595427	444	222.0	
97091	chrX	118601473	118601943	470	235.0	
97092	chrX	118603840	118604397	557	278.0	
97093	chrX	118614139	118614484	345	172.0	
97094	chrX	118630827	118631250	423	212.0	
97095	chrX	118631806	118631876	70	35.0	
97096	chrX	118675383	118675691	308	154.0	
97097	chrX	118698360	118699383	1023	512.0	
97098	chrX	118706655	118707083	428	214.0	
97099	chrX	118709845	118710086	241	120.0	
97100	chrX	118714516	118714917	401	200.0	
97101	chrX	118717587	118719305	1718	859.0	
97102	chrX	118723438	118723725	287	144.0	
97103	chrX	118724347	118725168	821	410.0	
97104	chrX	118726422	118728392	1970	985.0	
97105	chrX	118730780	118731088	308	154.0	
97106	chrX	118752087	118752879	792	396.0	
97107	chrX	118756096	118756450	354	177.0	
97108	chrX	118802846	118803258	412	206.0	
97109	chrX	118807352	118807774	422	211.0	
97110	chrX	118823460	118824266	806	403.0	
97111	chrX	118839168	118839895	727	364.0	
97112	chrX	118847642	118848043	401	200.0	
97113	chrX	118973397	118977221	3824	1912.0	
97114	chrX	118978396	118978946	550	275.0	
97115	chrX	118988874	118989360	486	243.0	
97116	chrX	118992640	118993131	491	246.0	
97117	chrX	118999289	118999368	79	40.0	
97118	chrX	119004864	119005348	484	242.0	
97119	chrX	119008118	119008512	394	197.0	
97120	chrX	119013989	119014446	457	228.0	
97121	chrX	119015170	119016223	1053	526.0	
97122	chrX	119017001	119017510	509	254.0	
97123	chrX	119029068	119029303	235	118.0	
97124	chrX	119067015	119067478	463	232.0	
97125	chrX	119071459	119071725	266	133.0	
97126	chrX	119089676	119089955	279	140.0	
97127	chrX	119118807	119119151	344	172.0	
97128	chrX	119132985	119133335	350	175.0	
97129	chrX	119235672	119237666	1994	997.0	
97130	chrX	119266633	119266733	100	50.0	
97131	chrX	119273401	119274033	632	316.0	
97132	chrX	119398675	119399953	1278	639.0	
97133	chrX	119427106	119427451	345	172.0	
97134	chrX	119467797	119469951	2154	1077.0	
97135	chrX	119482173	119483270	1097	548.0	
97136	chrX	119488728	119489154	426	213.0	
97137	chrX	119500884	119501456	572	286.0	
97138	chrX	119502648	119503270	622	311.0	
97139	chrX	119512434	119512886	452	226.0	
97140	chrX	119516099	119516714	615	308.0	
97141	chrX	119529327	119529816	489	244.0	
97142	chrX	119564929	119565751	822	411.0	
97143	chrX	119573721	119575727	2006	1003.0	
97144	chrX	119579353	119579815	462	231.0	
97145	chrX	119604897	119607220	2323	1162.0	
97146	chrX	119609870	119610542	672	336.0	
97147	chrX	119617602	119618985	1383	692.0	
97148	chrX	119620066	119620096	30	15.0	
97149	chrX	119638582	119639188	606	303.0	
97150	chrX	119640642	119641363	721	360.0	
97151	chrX	119646530	119646874	344	172.0	
97152	chrX	119647800	119648774	974	487.0	
97153	chrX	119654122	119655561	1439	720.0	
97154	chrX	119664982	119665028	46	23.0	
97155	chrX	119666133	119666582	449	224.0	
97156	chrX	119676564	119679632	3068	1534.0	
97157	chrX	119680769	119683418	2649	1324.0	
97158	chrX	119684213	119686714	2501	1250.0	
97159	chrX	119687376	119694957	7581	3790.0	
97160	chrX	119698804	119699237	433	216.0	
97161	chrX	119727098	119727565	467	234.0	
97162	chrX	119729654	119730392	738	369.0	
97163	chrX	119734796	119735361	565	282.0	
97164	chrX	119753361	119754423	1062	531.0	
97165	chrX	119755210	119759504	4294	2147.0	
97166	chrX	119760101	119760496	395	198.0	
97167	chrX	119767787	119768220	433	216.0	
97168	chrX	119771218	119771428	210	105.0	
97169	chrX	119774375	119774499	124	62.0	
97170	chrX	119775366	119776223	857	428.0	
97171	chrX	119779631	119780147	516	258.0	
97172	chrX	119782515	119783831	1316	658.0	
97173	chrX	119784662	119785525	863	432.0	
97174	chrX	119788572	119789707	1135	568.0	
97175	chrX	119790334	119792736	2402	1201.0	
97176	chrX	119821565	119822197	632	316.0	
97177	chrX	119852271	119853603	1332	666.0	
97178	chrX	119870332	119872700	2368	1184.0	
97179	chrX	119880677	119881275	598	299.0	
97180	chrX	119885673	119886553	880	440.0	
97181	chrX	119887557	119888295	738	369.0	
97182	chrX	119898945	119899679	734	367.0	
97183	chrX	119942796	119944258	1462	731.0	
97184	chrX	119955945	119956871	926	463.0	
97185	chrX	119981746	119982031	285	142.0	
97186	chrX	119990676	119991495	819	410.0	
97187	chrX	120015360	120015921	561	280.0	
97188	chrX	120035864	120036452	588	294.0	
97189	chrX	120213645	120214101	456	228.0	
97190	chrX	120244352	120245681	1329	664.0	
97191	chrX	120250227	120252061	1834	917.0	
97192	chrX	120264454	120264689	235	118.0	
97193	chrX	120269253	120270106	853	426.0	
97194	chrX	120286959	120287796	837	418.0	
97195	chrX	120302155	120303012	857	428.0	
97196	chrX	120304261	120304685	424	212.0	
97197	chrX	120305872	120306112	240	120.0	
97198	chrX	120308684	120311679	2995	1498.0	
97199	chrX	120319270	120319705	435	218.0	
97200	chrX	120365284	120365685	401	200.0	
97201	chrX	120380693	120381137	444	222.0	
97202	chrX	120450177	120450497	320	160.0	
97203	chrX	120452225	120452525	300	150.0	
97204	chrX	120456943	120458142	1199	600.0	
97205	chrX	120462374	120462770	396	198.0	
97206	chrX	120467952	120469775	1823	912.0	
97207	chrX	120475444	120475781	337	168.0	
97208	chrX	120485321	120486633	1312	656.0	
97209	chrX	120487992	120488435	443	222.0	
97210	chrX	120489155	120489417	262	131.0	
97211	chrX	120497769	120498527	758	379.0	
97212	chrX	120536033	120536469	436	218.0	
97213	chrX	120559759	120562214	2455	1228.0	
97214	chrX	120603546	120604966	1420	710.0	
97215	chrX	120628600	120628715	115	58.0	
97216	chrX	120629358	120630864	1506	753.0	
97217	chrX	120636474	120636937	463	232.0	
97218	chrX	120664333	120664420	87	44.0	
97219	chrX	120696919	120697556	637	318.0	
97220	chrX	120755088	120755475	387	194.0	
97221	chrX	120790061	120790446	385	192.0	
97222	chrX	123087456	123087667	211	106.0	
97223	chrX	123685302	123685613	311	156.0	
97224	chrX	123731537	123733518	1981	990.0	
97225	chrX	123764837	123765692	855	428.0	
97226	chrX	123770437	123770747	310	155.0	
97227	chrX	123777721	123778168	447	224.0	
97228	chrX	123784777	123785330	553	276.0	
97229	chrX	123803405	123803948	543	272.0	
97230	chrX	123830228	123830814	586	293.0	
97231	chrX	123833291	123833799	508	254.0	
97232	chrX	123851041	123851456	415	208.0	
97233	chrX	123859281	123861331	2050	1025.0	
97234	chrX	123869324	123869995	671	336.0	
97235	chrX	123878096	123879567	1471	736.0	
97236	chrX	123884735	123885210	475	238.0	
97237	chrX	123959371	123964684	5313	2656.0	
97238	chrX	123971969	123972548	579	290.0	
97239	chrX	123975310	123975541	231	116.0	
97240	chrX	123976612	123977099	487	244.0	
97241	chrX	123982515	123982911	396	198.0	
97242	chrX	123994696	123995148	452	226.0	
97243	chrX	124010415	124010485	70	35.0	
97244	chrX	124063904	124064707	803	402.0	
97245	chrX	124086292	124086897	605	302.0	
97246	chrX	124098094	124098462	368	184.0	
97247	chrX	124211280	124211807	527	264.0	
97248	chrX	124212652	124213061	409	204.0	
97249	chrX	124217339	124219244	1905	952.0	enhancer
97250	chrX	124223454	124223943	489	244.0	
97251	chrX	124239371	124240416	1045	522.0	
97252	chrX	124263825	124263874	49	24.0	
97253	chrX	124300354	124300809	455	228.0	
97254	chrX	124339062	124339587	525	262.0	
97255	chrX	124341444	124343606	2162	1081.0	
97256	chrX	124346043	124347596	1553	776.0	
97257	chrX	124349042	124349414	372	186.0	
97258	chrX	124358804	124359499	695	348.0	
97259	chrX	124362085	124362475	390	195.0	
97260	chrX	124388564	124388989	425	212.0	
97261	chrX	124395194	124395712	518	259.0	
97262	chrX	124406629	124407057	428	214.0	
97263	chrX	124642092	124642125	33	16.0	
97264	chrX	124736506	124737361	855	428.0	
97265	chrX	125204112	125204455	343	172.0	
97266	chrX	125204993	125205876	883	442.0	
97267	chrX	125293783	125294349	566	283.0	
97268	chrX	125295562	125295674	112	56.0	
97269	chrX	127556097	127556230	133	66.0	
97270	chrX	127571978	127572174	196	98.0	
97271	chrX	129522758	129523894	1136	568.0	
97272	chrX	129539962	129541225	1263	632.0	
97273	chrX	129553850	129554328	478	239.0	
97274	chrX	129601073	129601536	463	232.0	
97275	chrX	129603730	129604536	806	403.0	
97276	chrX	129605393	129605813	420	210.0	
97277	chrX	129606713	129607410	697	348.0	
97278	chrX	129637359	129638091	732	366.0	
97279	chrX	129654235	129655347	1112	556.0	
97280	chrX	129655851	129656199	348	174.0	
97281	chrX	129677509	129679024	1515	758.0	
97282	chrX	129721867	129722135	268	134.0	
97283	chrX	129726331	129726773	442	221.0	
97284	chrX	129731118	129731796	678	339.0	
97285	chrX	129737833	129738414	581	290.0	
97286	chrX	129742419	129742692	273	136.0	
97287	chrX	129754287	129754898	611	306.0	
97288	chrX	129755743	129756754	1011	506.0	
97289	chrX	129757864	129760635	2771	1386.0	
97290	chrX	129768973	129770195	1222	611.0	
97291	chrX	129771178	129771985	807	404.0	
97292	chrX	129772564	129774430	1866	933.0	
97293	chrX	129775135	129775510	375	188.0	
97294	chrX	129776424	129784810	8386	4193.0	
97295	chrX	129785489	129786873	1384	692.0	
97296	chrX	129787617	129787925	308	154.0	
97297	chrX	129798896	129799158	262	131.0	
97298	chrX	129808399	129809794	1395	698.0	
97299	chrX	129823057	129823882	825	412.0	
97300	chrX	129842486	129844489	2003	1002.0	
97301	chrX	129846899	129847008	109	54.0	
97302	chrX	129905573	129906734	1161	580.0	
97303	chrX	129925343	129926214	871	436.0	
97304	chrX	129930872	129933333	2461	1230.0	
97305	chrX	129952368	129953581	1213	606.0	
97306	chrX	129956973	129958177	1204	602.0	
97307	chrX	129960888	129962088	1200	600.0	
97308	chrX	129979449	129984990	5541	2770.0	
97309	chrX	129996836	129997547	711	356.0	
97310	chrX	130023832	130024800	968	484.0	
97311	chrX	130028175	130028601	426	213.0	
97312	chrX	130059901	130061308	1407	704.0	
97313	chrX	130079708	130080365	657	328.0	
97314	chrX	130081805	130087783	5978	2989.0	
97315	chrX	130089434	130090542	1108	554.0	
97316	chrX	130091512	130092949	1437	718.0	
97317	chrX	130094738	130095115	377	188.0	
97318	chrX	130097409	130098417	1008	504.0	
97319	chrX	130100197	130100418	221	110.0	
97320	chrX	130108472	130111635	3163	1582.0	
97321	chrX	130120331	130121530	1199	600.0	
97322	chrX	130165086	130166754	1668	834.0	
97323	chrX	130170537	130173956	3419	1710.0	
97324	chrX	130183454	130184086	632	316.0	
97325	chrX	130192184	130192863	679	340.0	
97326	chrX	130267956	130269286	1330	665.0	
97327	chrX	130339273	130340431	1158	579.0	
97328	chrX	130401300	130402569	1269	634.0	
97329	chrX	130413350	130413894	544	272.0	
97330	chrX	130539945	130540042	97	48.0	
97331	chrX	130902505	130903801	1296	648.0	
97332	chrX	130916799	130917298	499	250.0	
97333	chrX	130958801	130959000	199	100.0	
97334	chrX	131633609	131633629	20	10.0	
97335	chrX	131677720	131678033	313	156.0	
97336	chrX	131802993	131803412	419	210.0	
97337	chrX	131812719	131813828	1109	554.0	
97338	chrX	131816428	131817512	1084	542.0	
97339	chrX	131818269	131818670	401	200.0	
97340	chrX	131827906	131828279	373	186.0	
97341	chrX	131830427	131831324	897	448.0	
97342	chrX	131841298	131841817	519	260.0	
97343	chrX	131850906	131851366	460	230.0	
97344	chrX	131985644	131986044	400	200.0	
97345	chrX	131987056	131987961	905	452.0	
97346	chrX	132017193	132017732	539	270.0	
97347	chrX	132022041	132025295	3254	1627.0	
97348	chrX	132035735	132036064	329	164.0	
97349	chrX	132044173	132044376	203	102.0	
97350	chrX	132090478	132090797	319	160.0	
97351	chrX	132092433	132092894	461	230.0	
97352	chrX	132209714	132209723	9	4.0	
97353	chrX	132216345	132219926	3581	1790.0	
97354	chrX	132292802	132293133	331	166.0	
97355	chrX	132443773	132444066	293	146.0	
97356	chrX	132474520	132474991	471	236.0	
97357	chrX	132480320	132481385	1065	532.0	
97358	chrX	132488116	132491722	3606	1803.0	
97359	chrX	132613193	132613382	189	94.0	
97360	chrX	132615347	132615724	377	188.0	
97361	chrX	132631624	132631944	320	160.0	
97362	chrX	132677089	132677541	452	226.0	
97363	chrX	132737665	132738048	383	192.0	
97364	chrX	132924223	132924587	364	182.0	
97365	chrX	133323312	133323816	504	252.0	
97366	chrX	133414279	133415586	1307	654.0	
97367	chrX	133445411	133445637	226	113.0	
97368	chrX	133543895	133544769	874	437.0	
97369	chrX	133546353	133546948	595	298.0	
97370	chrX	133555670	133556161	491	246.0	
97371	chrX	133646236	133647462	1226	613.0	
97372	chrX	133670422	133670595	173	86.0	
97373	chrX	133745436	133745783	347	174.0	
97374	chrX	133749491	133749747	256	128.0	
97375	chrX	133783299	133783670	371	186.0	
97376	chrX	133792403	133792872	469	234.0	
97377	chrX	133923160	133923327	167	84.0	
97378	chrX	133985233	133986104	871	436.0	
97379	chrX	134144278	134144588	310	155.0	
97380	chrX	134171588	134174142	2554	1277.0	
97381	chrX	134186642	134187239	597	298.0	
97382	chrX	134338577	134338783	206	103.0	
97383	chrX	134368114	134368609	495	248.0	
97384	chrX	134369608	134369943	335	168.0	
97385	chrX	134372665	134374855	2190	1095.0	
97386	chrX	134388633	134389171	538	269.0	
97387	chrX	134396199	134396537	338	169.0	
97388	chrX	134459539	134461049	1510	755.0	"origin_of_replication	origin_of_replication"
97389	chrX	134482419	134482703	284	142.0	
97390	chrX	134484048	134484437	389	194.0	
97391	chrX	134520906	134521211	305	152.0	
97392	chrX	134544834	134544869	35	18.0	
97393	chrX	134548458	134551306	2848	1424.0	
97394	chrX	134671383	134671727	344	172.0	
97395	chrX	134746177	134746332	155	78.0	
97396	chrX	134764193	134764651	458	229.0	
97397	chrX	134796150	134797686	1536	768.0	
97398	chrX	134803740	134804329	589	294.0	
97399	chrX	134806540	134808221	1681	840.0	
97400	chrX	134908418	134908772	354	177.0	
97401	chrX	134914237	134915865	1628	814.0	
97402	chrX	134965289	134965825	536	268.0	
97403	chrX	134990716	134991392	676	338.0	
97404	chrX	134999476	134999866	390	195.0	
97405	chrX	135003726	135004792	1066	533.0	
97406	chrX	135021635	135022835	1200	600.0	
97407	chrX	135031780	135033048	1268	634.0	
97408	chrX	135051271	135052726	1455	728.0	
97409	chrX	135053839	135053925	86	43.0	
97410	chrX	135086235	135086957	722	361.0	
97411	chrX	135097884	135099572	1688	844.0	
97412	chrX	135112088	135112546	458	229.0	
97413	chrX	135186011	135186460	449	224.0	
97414	chrX	135295359	135296360	1001	500.0	
97415	chrX	135342545	135345400	2855	1428.0	
97416	chrX	135347329	135347849	520	260.0	
97417	chrX	135383906	135384634	728	364.0	
97418	chrX	135421289	135422759	1470	735.0	
97419	chrX	135463982	135464262	280	140.0	
97420	chrX	135477561	135477962	401	200.0	
97421	chrX	135484636	135485018	382	191.0	
97422	chrX	135487838	135488398	560	280.0	
97423	chrX	135512647	135513407	760	380.0	
97424	chrX	135516294	135516775	481	240.0	
97425	chrX	135519930	135523551	3621	1810.0	
97426	chrX	135536805	135537252	447	224.0	
97427	chrX	135543928	135544867	939	470.0	
97428	chrX	135596503	135596913	410	205.0	
97429	chrX	135740626	135740931	305	152.0	
97430	chrX	135931890	135932253	363	182.0	
97431	chrX	135972822	135975108	2286	1143.0	
97432	chrX	135983602	135983657	55	28.0	
97433	chrX	135984733	135986385	1652	826.0	
97434	chrX	136028353	136028804	451	226.0	
97435	chrX	136056889	136057212	323	162.0	
97436	chrX	136065040	136065460	420	210.0	
97437	chrX	136070384	136071012	628	314.0	
97438	chrX	136143698	136144165	467	234.0	
97439	chrX	136146659	136148199	1540	770.0	
97440	chrX	136159484	136159890	406	203.0	
97441	chrX	136162810	136163245	435	218.0	
97442	chrX	136191251	136191580	329	164.0	
97443	chrX	136193209	136193873	664	332.0	
97444	chrX	136204495	136205017	522	261.0	
97445	chrX	136209292	136209658	366	183.0	
97446	chrX	136210362	136210586	224	112.0	
97447	chrX	136250402	136252081	1679	840.0	
97448	chrX	136268442	136268846	404	202.0	
97449	chrX	136495052	136495491	439	220.0	
97450	chrX	136496159	136498173	2014	1007.0	
97451	chrX	136577471	136578023	552	276.0	
97452	chrX	136586180	136586930	750	375.0	
97453	chrX	136587891	136588510	619	310.0	
97454	chrX	136608486	136609146	660	330.0	
97455	chrX	136617314	136617415	101	50.0	
97456	chrX	136627101	136627849	748	374.0	
97457	chrX	136629127	136629726	599	300.0	
97458	chrX	136630790	136631270	480	240.0	
97459	chrX	136634949	136635959	1010	505.0	
97460	chrX	136639971	136640007	36	18.0	
97461	chrX	136643223	136643668	445	222.0	
97462	chrX	136646491	136647020	529	264.0	
97463	chrX	136647992	136648304	312	156.0	
97464	chrX	136658092	136658501	409	204.0	
97465	chrX	136659181	136659186	5	2.0	
97466	chrX	136662115	136662450	335	168.0	
97467	chrX	136663011	136663292	281	140.0	
97468	chrX	136665500	136665895	395	198.0	
97469	chrX	136674197	136675357	1160	580.0	
97470	chrX	136689503	136689829	326	163.0	
97471	chrX	136690911	136692065	1154	577.0	
97472	chrX	136693920	136695236	1316	658.0	
97473	chrX	136710266	136711544	1278	639.0	
97474	chrX	136714871	136715817	946	473.0	
97475	chrX	136726867	136727251	384	192.0	
97476	chrX	136735674	136735937	263	132.0	
97477	chrX	136745282	136745732	450	225.0	
97478	chrX	136746951	136748071	1120	560.0	
97479	chrX	136754544	136754999	455	228.0	
97480	chrX	136759939	136760475	536	268.0	
97481	chrX	136765628	136765686	58	29.0	
97482	chrX	136766939	136768987	2048	1024.0	
97483	chrX	136778869	136779918	1049	524.0	
97484	chrX	136780555	136781829	1274	637.0	
97485	chrX	136784257	136784647	390	195.0	
97486	chrX	136825826	136826129	303	152.0	
97487	chrX	136828799	136829737	938	469.0	
97488	chrX	136850468	136850838	370	185.0	
97489	chrX	136856493	136857043	550	275.0	
97490	chrX	136867410	136867639	229	114.0	
97491	chrX	136870166	136870317	151	76.0	
97492	chrX	136878614	136881312	2698	1349.0	
97493	chrX	136886250	136886572	322	161.0	
97494	chrX	136908737	136910952	2215	1108.0	
97495	chrX	136911652	136912069	417	208.0	
97496	chrX	136925060	136925591	531	266.0	
97497	chrX	136935391	136936143	752	376.0	
97498	chrX	136954065	136955258	1193	596.0	
97499	chrX	137031580	137032316	736	368.0	
97500	chrX	137033822	137034229	407	204.0	
97501	chrX	137051706	137053241	1535	768.0	
97502	chrX	137428509	137428744	235	118.0	
97503	chrX	138356586	138356928	342	171.0	
97504	chrX	138925300	138925825	525	262.0	
97505	chrX	138982343	138982761	418	209.0	
97506	chrX	139077278	139078242	964	482.0	
97507	chrX	139113668	139114015	347	174.0	
97508	chrX	139194602	139195164	562	281.0	
97509	chrX	139205068	139205631	563	282.0	
97510	chrX	139553756	139554212	456	228.0	
97511	chrX	139559642	139559971	329	164.0	
97512	chrX	139739128	139739613	485	242.0	
97513	chrX	139766395	139766985	590	295.0	
97514	chrX	139795243	139795479	236	118.0	
97515	chrX	139831719	139832016	297	148.0	
97516	chrX	139909656	139910121	465	232.0	
97517	chrX	139930926	139933942	3016	1508.0	
97518	chrX	140056957	140057379	422	211.0	
97519	chrX	140066016	140066644	628	314.0	
97520	chrX	140091110	140091857	747	374.0	
97521	chrX	140712891	140713175	284	142.0	
97522	chrX	140762103	140762433	330	165.0	
97523	chrX	140918386	140918833	447	224.0	
97524	chrX	141176707	141177587	880	440.0	
97525	chrX	143632630	143634245	1615	808.0	
97526	chrX	143634870	143635050	180	90.0	
97527	chrX	143648722	143649111	389	194.0	
97528	chrX	147911068	147913100	2032	1016.0	"origin_of_replication	origin_of_replication	origin_of_replication	repeat_region	repeat_region	sequence_feature	origin_of_replication	origin_of_replication"
97529	chrX	147915300	147915604	304	152.0	
97530	chrX	147917645	147918791	1146	573.0	
97531	chrX	148024713	148025159	446	223.0	
97532	chrX	148069755	148070052	297	148.0	
97533	chrX	148310305	148310817	512	256.0	
97534	chrX	148333996	148334364	368	184.0	
97535	chrX	148355041	148355282	241	120.0	
97536	chrX	148380105	148382059	1954	977.0	
97537	chrX	148416109	148416634	525	262.0	
97538	chrX	148459356	148459759	403	202.0	
97539	chrX	148495146	148495621	475	238.0	
97540	chrX	148497979	148498438	459	230.0	
97541	chrX	148500333	148501885	1552	776.0	"origin_of_replication	repeat_region	sequence_feature"
97542	chrX	148542635	148542655	20	10.0	
97543	chrX	148562857	148563151	294	147.0	
97544	chrX	148609831	148610367	536	268.0	
97545	chrX	148647587	148648332	745	372.0	
97546	chrX	149074481	149074789	308	154.0	
97547	chrX	149286938	149287213	275	138.0	
97548	chrX	149470806	149471353	547	274.0	
97549	chrX	149476522	149476941	419	210.0	
97550	chrX	149477449	149477602	153	76.0	
97551	chrX	149480650	149480931	281	140.0	
97552	chrX	149482831	149484296	1465	732.0	
97553	chrX	149484955	149487811	2856	1428.0	"recombination_feature	recombination_feature	recombination_feature"
97554	chrX	149488586	149489340	754	377.0	"recombination_feature	recombination_feature"
97555	chrX	149489910	149498270	8360	4180.0	recombination_feature
97556	chrX	149499090	149505870	6780	3390.0	recombination_feature
97557	chrX	149510210	149510905	695	348.0	
97558	chrX	149512171	149512936	765	382.0	
97559	chrX	149513559	149514560	1001	500.0	
97560	chrX	149516184	149516550	366	183.0	
97561	chrX	149520947	149521921	974	487.0	
97562	chrX	149524917	149526714	1797	898.0	"recombination_feature	recombination_feature	recombination_feature"
97563	chrX	149527621	149528163	542	271.0	"recombination_feature	recombination_feature	recombination_feature"
97564	chrX	149531489	149531949	460	230.0	
97565	chrX	149538909	149541961	3052	1526.0	
97566	chrX	149630791	149632309	1518	759.0	"repeat_region	sequence_feature	sequence_feature"
97567	chrX	149829664	149830857	1193	596.0	
97568	chrX	149858545	149859054	509	254.0	
97569	chrX	149871908	149872418	510	255.0	
97570	chrX	149937729	149941039	3310	1655.0	
97571	chrX	149962874	149963245	371	186.0	
97572	chrX	150063594	150064128	534	267.0	
97573	chrX	150200790	150201527	737	368.0	
97574	chrX	150202688	150203635	947	474.0	
97575	chrX	150360941	150367361	6420	3210.0	
97576	chrX	150410462	150410856	394	197.0	
97577	chrX	150429588	150430042	454	227.0	
97578	chrX	150478577	150479318	741	370.0	
97579	chrX	150486017	150486432	415	208.0	
97580	chrX	150507600	150507974	374	187.0	
97581	chrX	150527072	150527473	401	200.0	
97582	chrX	150546318	150548297	1979	990.0	
97583	chrX	150567898	150569719	1821	910.0	
97584	chrX	150570509	150570885	376	188.0	
97585	chrX	150572212	150572511	299	150.0	
97586	chrX	150573777	150574105	328	164.0	
97587	chrX	150574835	150575611	776	388.0	
97588	chrX	150587600	150587980	380	190.0	
97589	chrX	150607131	150607662	531	266.0	
97590	chrX	150649427	150649888	461	230.0	
97591	chrX	150683465	150683997	532	266.0	
97592	chrX	150692209	150695579	3370	1685.0	
97593	chrX	150696174	150697240	1066	533.0	
97594	chrX	150703296	150703861	565	282.0	
97595	chrX	150716752	150717276	524	262.0	
97596	chrX	150736128	150736910	782	391.0	
97597	chrX	150767084	150768561	1477	738.0	
97598	chrX	150772093	150772615	522	261.0	
97599	chrX	150779400	150779795	395	198.0	
97600	chrX	150841437	150842173	736	368.0	
97601	chrX	150848797	150849210	413	206.0	
97602	chrX	150850262	150850775	513	256.0	
97603	chrX	150879773	150880298	525	262.0	
97604	chrX	150897646	150900093	2447	1224.0	
97605	chrX	150982466	150984914	2448	1224.0	
97606	chrX	151082242	151082831	589	294.0	
97607	chrX	151151909	151151953	44	22.0	
97608	chrX	151360214	151360606	392	196.0	
97609	chrX	151393273	151394001	728	364.0	
97610	chrX	151396133	151398116	1983	992.0	
97611	chrX	152830275	152831621	1346	673.0	
97612	chrX	152904504	152904932	428	214.0	
97613	chrX	152913364	152913770	406	203.0	
97614	chrX	152915579	152916087	508	254.0	
97615	chrX	152917704	152918305	601	300.0	
97616	chrX	152926186	152926683	497	248.0	
97617	chrX	152941014	152942382	1368	684.0	
97618	chrX	152958303	152959496	1193	596.0	
97619	chrX	152988626	152989769	1143	572.0	
97620	chrX	152991139	152992065	926	463.0	
97621	chrX	153032170	153033298	1128	564.0	
97622	chrX	153105950	153106121	171	86.0	
97623	chrX	153333567	153334946	1379	690.0	
97624	chrX	153336179	153336410	231	116.0	
97625	chrX	153381965	153382448	483	242.0	
97626	chrX	153400025	153400546	521	260.0	
97627	chrX	153411026	153412155	1129	564.0	
97628	chrX	153415104	153415309	205	102.0	
97629	chrX	153460836	153461246	410	205.0	
97630	chrX	153469740	153471520	1780	890.0	
97631	chrX	153474247	153475227	980	490.0	
97632	chrX	153507286	153508149	863	432.0	
97633	chrX	153539385	153539939	554	277.0	
97634	chrX	153554707	153555212	505	252.0	
97635	chrX	153582790	153583540	750	375.0	
97636	chrX	153591536	153591758	222	111.0	
97637	chrX	153598360	153600363	2003	1002.0	
97638	chrX	153608395	153608718	323	162.0	
97639	chrX	153609562	153610958	1396	698.0	
97640	chrX	153636266	153636657	391	196.0	
97641	chrX	153642192	153642543	351	176.0	
97642	chrX	153644032	153644473	441	220.0	
97643	chrX	153646866	153648227	1361	680.0	
97644	chrX	153649627	153650082	455	228.0	
97645	chrX	153662143	153662687	544	272.0	
97646	chrX	153667617	153668472	855	428.0	
97647	chrX	153669208	153669671	463	232.0	
97648	chrX	153686996	153688835	1839	920.0	
97649	chrX	153692312	153692408	96	48.0	
97650	chrX	153708339	153708903	564	282.0	
97651	chrX	153722646	153727806	5160	2580.0	
97652	chrX	153731467	153732795	1328	664.0	
97653	chrX	153735208	153735713	505	252.0	
97654	chrX	153740070	153740569	499	250.0	
97655	chrX	153763824	153764548	724	362.0	
97656	chrX	153766296	153766666	370	185.0	
97657	chrX	153793226	153795407	2181	1090.0	
97658	chrX	153816597	153817319	722	361.0	
97659	chrX	153818760	153819657	897	448.0	
97660	chrX	153821520	153822738	1218	609.0	
97661	chrX	153829231	153831143	1912	956.0	
97662	chrX	153875102	153875966	864	432.0	
97663	chrX	153885584	153886553	969	484.0	
97664	chrX	153888334	153888822	488	244.0	
97665	chrX	153900637	153901742	1105	552.0	
97666	chrX	153902442	153902530	88	44.0	
97667	chrX	153903128	153906953	3825	1912.0	
97668	chrX	153909140	153909396	256	128.0	
97669	chrX	153911109	153911361	252	126.0	
97670	chrX	153922100	153923286	1186	593.0	
97671	chrX	153923961	153928891	4930	2465.0	
97672	chrX	153933927	153935857	1930	965.0	
97673	chrX	153938515	153938517	2	1.0	
97674	chrX	153941179	153941384	205	102.0	
97675	chrX	153944159	153945149	990	495.0	
97676	chrX	153946999	153947999	1000	500.0	
97677	chrX	153948822	153949283	461	230.0	
97678	chrX	153953112	153953971	859	430.0	
97679	chrX	153955771	153956210	439	220.0	
97680	chrX	153966421	153973576	7155	3578.0	
97681	chrX	153974144	153975019	875	438.0	
97682	chrX	153980233	153986109	5876	2938.0	
97683	chrX	153990793	153990816	23	12.0	
97684	chrX	154000310	154000415	105	52.0	
97685	chrX	154002026	154003059	1033	516.0	
97686	chrX	154007648	154008368	720	360.0	
97687	chrX	154010265	154010991	726	363.0	
97688	chrX	154013401	154014388	987	494.0	
97689	chrX	154018416	154021608	3192	1596.0	
97690	chrX	154036557	154036947	390	195.0	
97691	chrX	154040121	154040957	836	418.0	
97692	chrX	154051142	154051652	510	255.0	
97693	chrX	154056621	154057358	737	368.0	
97694	chrX	154067409	154067515	106	53.0	
97695	chrX	154077142	154077470	328	164.0	
97696	chrX	154083240	154083431	191	96.0	
97697	chrX	154084746	154085113	367	184.0	
97698	chrX	154091563	154093260	1697	848.0	
97699	chrX	154093867	154095544	1677	838.0	
97700	chrX	154096103	154098597	2494	1247.0	
97701	chrX	154123559	154124318	759	380.0	
97702	chrX	154135500	154137393	1893	946.0	
97703	chrX	154172812	154173139	327	164.0	
97704	chrX	154247676	154248145	469	234.0	
97705	chrX	154300806	154301213	407	204.0	
97706	chrX	154305629	154305963	334	167.0	
97707	chrX	154308102	154308967	865	432.0	
97708	chrX	154313216	154313569	353	176.0	
97709	chrX	154317420	154317781	361	180.0	
97710	chrX	154326862	154327597	735	368.0	
97711	chrX	154333717	154334425	708	354.0	
97712	chrX	154341920	154342373	453	226.0	recombination_feature
97713	chrX	154346921	154375108	28187	14094.0	"recombination_feature	recombination_feature	sequence_feature	sequence_feature	sequence_feature"
97714	chrX	154377736	154380882	3146	1573.0	
97715	chrX	154383831	154385075	1244	622.0	"recombination_feature	sequence_feature	recombination_feature"
97716	chrX	154397056	154403568	6512	3256.0	
97717	chrX	154406793	154407227	434	217.0	
97718	chrX	154408574	154409787	1213	606.0	
97719	chrX	154410978	154413114	2136	1068.0	
97720	chrX	154427375	154429483	2108	1054.0	
97721	chrX	154430525	154431823	1298	649.0	
97722	chrX	154436319	154437840	1521	760.0	
97723	chrX	154441465	154442070	605	302.0	
97724	chrX	154443445	154444807	1362	681.0	
97725	chrX	154457376	154459672	2296	1148.0	
97726	chrX	154472976	154473244	268	134.0	
97727	chrX	154478235	154479920	1685	842.0	
97728	chrX	154484524	154484970	446	223.0	
97729	chrX	154485601	154487444	1843	922.0	
97730	chrX	154489526	154491461	1935	968.0	
97731	chrX	154515189	154517177	1988	994.0	
97732	chrX	154527002	154527819	817	408.0	
97733	chrX	154534493	154535465	972	486.0	
97734	chrX	154541688	154543776	2088	1044.0	"enhancer	sequence_feature"
97735	chrX	154546160	154548487	2327	1164.0	origin_of_replication
97736	chrX	154549124	154549240	116	58.0	
97737	chrX	154552132	154552554	422	211.0	
97738	chrX	154661224	154661572	348	174.0	
97739	chrX	154678643	154678941	298	149.0	
97740	chrX	154712566	154713472	906	453.0	
97741	chrX	154714870	154715365	495	248.0	
97742	chrX	154717649	154719877	2228	1114.0	
97743	chrX	154724379	154725731	1352	676.0	
97744	chrX	154731107	154733137	2030	1015.0	
97745	chrX	154733772	154734988	1216	608.0	
97746	chrX	154737954	154738430	476	238.0	
97747	chrX	154740025	154740439	414	207.0	
97748	chrX	154748448	154751959	3511	1756.0	
97749	chrX	154761864	154763953	2089	1044.0	
97750	chrX	154795022	154795349	327	164.0	
97751	chrX	154799020	154799650	630	315.0	
97752	chrX	154800721	154802448	1727	864.0	
97753	chrX	154804532	154806076	1544	772.0	
97754	chrX	154827504	154828043	539	270.0	
97755	chrX	154840857	154841288	431	216.0	
97756	chrX	154917934	154918553	619	310.0	
97757	chrX	154980594	154981454	860	430.0	
97758	chrX	155026368	155028436	2068	1034.0	
97759	chrX	155048977	155049443	466	233.0	
97760	chrX	155056566	155057987	1421	710.0	
97761	chrX	155070090	155072400	2310	1155.0	
97762	chrX	155086409	155086836	427	214.0	
97763	chrX	155094456	155094895	439	220.0	
97764	chrX	155148956	155149269	313	156.0	recombination_feature
97765	chrX	155188697	155189261	564	282.0	
97766	chrX	155215636	155217190	1554	777.0	
97767	chrX	155242275	155242794	519	260.0	
97768	chrX	155262921	155264851	1930	965.0	
97769	chrX	155334516	155335377	861	430.0	
97770	chrX	155577636	155578118	482	241.0	
97771	chrX	155611276	155613355	2079	1040.0	
97772	chrX	155632377	155633053	676	338.0	
97773	chrX	155767269	155767825	556	278.0	"recombination_feature	recombination_feature	sequence_feature	sequence_feature"
97774	chrX	155768365	155768841	476	238.0	recombination_feature
97775	chrX	155820089	155820536	447	224.0	
97776	chrX	155841324	155841770	446	223.0	
97777	chrX	155880572	155882081	1509	754.0	
97778	chrX	155966926	155967219	293	146.0	
97779	chrX	155997360	155997875	515	258.0	
97780	chrY	2841207	2842266	1059	530.0	
97781	chrY	2857628	2857966	338	169.0	
97782	chrY	2912994	2913569	575	288.0	
97783	chrY	2934537	2938165	3628	1814.0	
97784	chrY	3002215	3004510	2295	1148.0	
97785	chrY	3005995	3006443	448	224.0	
97786	chrY	3016631	3017022	391	196.0	
97787	chrY	6964717	6965216	499	250.0	
97788	chrY	7040635	7041138	503	252.0	
97789	chrY	7085285	7086061	776	388.0	
97790	chrY	7099814	7100082	268	134.0	
97791	chrY	7239816	7240705	889	444.0	
97792	chrY	7263703	7264261	558	279.0	
97793	chrY	7272077	7276552	4475	2238.0	
97794	chrY	7278431	7278723	292	146.0	
97795	chrY	7279732	7280858	1126	563.0	
97796	chrY	7282661	7283499	838	419.0	
97797	chrY	7289950	7291108	1158	579.0	
97798	chrY	7300001	7300276	275	138.0	
97799	chrY	7310636	7311411	775	388.0	
97800	chrY	7326240	7327321	1081	540.0	
97801	chrY	7339415	7340170	755	378.0	
97802	chrY	7344644	7345084	440	220.0	
97803	chrY	7658986	7659400	414	207.0	
97804	chrY	7722465	7722962	497	248.0	
97805	chrY	7724017	7724904	887	444.0	
97806	chrY	7730071	7730523	452	226.0	
97807	chrY	7814276	7814793	517	258.0	
97808	chrY	8535757	8536165	408	204.0	
97809	chrY	10205998	10206286	288	144.0	
97810	chrY	10627473	10628192	719	360.0	
97811	chrY	10629786	10630247	461	230.0	
97812	chrY	11039180	11039739	559	280.0	
97813	chrY	11040591	11040612	21	10.0	
97814	chrY	11210910	11211261	351	176.0	
97815	chrY	11214730	11215197	467	234.0	
97816	chrY	11290843	11297080	6237	3118.0	
97817	chrY	11302309	11303323	1014	507.0	
97818	chrY	11303832	11304198	366	183.0	
97819	chrY	11305322	11305495	173	86.0	
97820	chrY	11306465	11306662	197	98.0	
97821	chrY	11307436	11308345	909	454.0	
97822	chrY	11310097	11310601	504	252.0	
97823	chrY	11312249	11312732	483	242.0	
97824	chrY	11313663	11315056	1393	696.0	
97825	chrY	11320567	11321116	549	274.0	
97826	chrY	11322470	11322820	350	175.0	
97827	chrY	11324604	11324695	91	46.0	
97828	chrY	11329744	11330114	370	185.0	
97829	chrY	11332047	11334362	2315	1158.0	
97830	chrY	11494740	11495572	832	416.0	
97831	chrY	11503370	11503881	511	256.0	
97832	chrY	11510020	11510537	517	258.0	
97833	chrY	11511475	11511910	435	218.0	
97834	chrY	11513825	11514064	239	120.0	
97835	chrY	11525128	11525474	346	173.0	
97836	chrY	11527252	11527453	201	100.0	
97837	chrY	11531122	11533168	2046	1023.0	
97838	chrY	11533983	11534424	441	220.0	
97839	chrY	11539043	11539665	622	311.0	
97840	chrY	11550233	11550244	11	6.0	
97841	chrY	11678554	11678788	234	117.0	
97842	chrY	11680227	11680559	332	166.0	
97843	chrY	11681397	11681764	367	184.0	
97844	chrY	11683661	11684380	719	360.0	
97845	chrY	11688968	11689789	821	410.0	
97846	chrY	11692564	11693606	1042	521.0	
97847	chrY	11704142	11704241	99	50.0	
97848	chrY	11712159	11712875	716	358.0	
97849	chrY	11719185	11719524	339	170.0	
97850	chrY	11721905	11722315	410	205.0	
97851	chrY	11725619	11725973	354	177.0	
97852	chrY	11730435	11731212	777	388.0	
97853	chrY	11735850	11736223	373	186.0	
97854	chrY	11738691	11739674	983	492.0	
97855	chrY	11740535	11741127	592	296.0	
97856	chrY	11746101	11746498	397	198.0	
97857	chrY	11747473	11749287	1814	907.0	
97858	chrY	12215410	12216223	813	406.0	
97859	chrY	12303445	12303884	439	220.0	
97860	chrY	12391996	12392072	76	38.0	
97861	chrY	12479338	12479779	441	220.0	
97862	chrY	12490802	12491264	462	231.0	
97863	chrY	12593537	12593999	462	231.0	
97864	chrY	12621687	12622075	388	194.0	
97865	chrY	12661510	12663864	2354	1177.0	
97866	chrY	12859899	12859937	38	19.0	
97867	chrY	12904190	12910005	5815	2908.0	
97868	chrY	12910556	12911486	930	465.0	
97869	chrY	12912733	12914343	1610	805.0	
97870	chrY	12915956	12928586	12630	6315.0	
97871	chrY	12930154	12930955	801	400.0	
97872	chrY	12932189	12932960	771	386.0	
97873	chrY	12934605	12934635	30	15.0	
97874	chrY	12936972	12937488	516	258.0	
97875	chrY	13338840	13339259	419	210.0	
97876	chrY	13343513	13343988	475	238.0	
97877	chrY	13347271	13347349	78	39.0	
97878	chrY	13362006	13363158	1152	576.0	
97879	chrY	13368004	13368195	191	96.0	
97880	chrY	13371244	13371672	428	214.0	
97881	chrY	13381261	13381780	519	260.0	
97882	chrY	13432564	13432883	319	160.0	
97883	chrY	13433576	13433837	261	130.0	
97884	chrY	13435631	13437193	1562	781.0	
97885	chrY	13474966	13475318	352	176.0	
97886	chrY	13478257	13480684	2427	1214.0	
97887	chrY	13703253	13704998	1745	872.0	
97888	chrY	13738620	13738977	357	178.0	
97889	chrY	13750694	13752287	1593	796.0	
97890	chrY	13753979	13755316	1337	668.0	
97891	chrY	14256510	14256859	349	174.0	
97892	chrY	14340348	14341389	1041	520.0	
97893	chrY	14344419	14345619	1200	600.0	
97894	chrY	15424548	15425247	699	350.0	
97895	chrY	15455717	15456756	1039	520.0	
97896	chrY	18992621	18993139	518	259.0	
97897	chrY	19075663	19078117	2454	1227.0	
97898	chrY	19232148	19233028	880	440.0	
97899	chrY	19433018	19433687	669	334.0	
97900	chrY	19498519	19499149	630	315.0	
97901	chrY	19502144	19503588	1444	722.0	
97902	chrY	19566512	19568534	2022	1011.0	
97903	chrY	19571044	19571394	350	175.0	
97904	chrY	19580984	19581355	371	186.0	
97905	chrY	19587347	19587429	82	41.0	
97906	chrY	19743911	19745490	1579	790.0	
97907	chrY	19816165	19816529	364	182.0	
97908	chrY	20558686	20559051	365	182.0	
97909	chrY	20574867	20576971	2104	1052.0	
97910	chrY	20577600	20577764	164	82.0	
97911	chrY	20740839	20740955	116	58.0	
97912	chrY	20763895	20764264	369	184.0	
97913	chrY	20798244	20798897	653	326.0	
97914	chrY	20925297	20925818	521	260.0	
97915	chrY	20987809	20988195	386	193.0	
97916	chrY	20990675	20991548	873	436.0	
97917	chrY	21022433	21022717	284	142.0	
97918	chrY	21033405	21033694	289	144.0	
97919	chrY	21040745	21041067	322	161.0	
97920	chrY	21073477	21074272	795	398.0	
97921	chrY	21174576	21175278	702	351.0	
97922	chrY	21177219	21177956	737	368.0	
97923	chrY	21180846	21181334	488	244.0	
97924	chrY	21192635	21193203	568	284.0	
97925	chrY	21213977	21214258	281	140.0	
97926	chrY	21239921	21240996	1075	538.0	
97927	chrY	21246767	21247152	385	192.0	
97928	chrY	21248613	21250039	1426	713.0	
97929	chrY	21256855	21257227	372	186.0	
97930	chrY	21260236	21260806	570	285.0	
97931	chrY	21421910	21422630	720	360.0	
97932	chrY	21440569	21440885	316	158.0	
97933	chrY	21737143	21737544	401	200.0	
97934	chrY	26638116	26638412	296	148.0	
97935	chrY	26639433	26639784	351	176.0	
97936	chrY	26641751	26642025	274	137.0	
97937	chrY	26652870	26652942	72	36.0	
97938	chrY	26654084	26654100	16	8.0	
97939	chrY	26670270	26671864	1594	797.0	
97940	chrY	56763349	56763688	339	170.0	
97941	chrY	56734575	56735008	433	216.0	
97942	chrY	56727961	56728261	300	150.0	
97943	chrY	56826661	56827195	534	267.0	
97944	chrY	56828798	56838326	9528	4764.0	
97945	chrY	56839135	56839441	306	153.0	
97946	chrY	56841482	56841723	241	120.0	
97947	chrY	56842235	56842837	602	301.0	
97948	chrY	56843783	56844053	270	135.0	
97949	chrY	56847301	56847675	374	187.0	
97950	chrY	56849515	56849533	18	9.0	
97951	chrY	56850617	56851146	529	264.0	
97952	chrY	56855694	56855977	283	142.0	
97953	chrY	56873727	56873847	120	60.0	
